name,gender,ratio,females,males,total
Michael,M,100,19203,3835174,3854377
David,M,100,10321,2830626,2840947
James,M,100,12269,2805634,2817903
John,M,100,10146,2690071,2700217
Robert,M,100,10462,2546476,2556938
William,M,100,7634,2040682,2048316
Christopher,M,100,9223,1969404,1978627
Joseph,M,100,6562,1645771,1652333
Daniel,M,100,7202,1624716,1631918
Matthew,M,100,5414,1520004,1525418
Jennifer,F,100,1451581,4825,1456406
Thomas,M,100,4896,1429111,1434007
Richard,M,100,5440,1425102,1430542
Mary,F,100,1337729,4486,1342215
Mark,M,100,4059,1272083,1276142
Anthony,M,99,6124,1200977,1207101
Steven,M,100,4311,1180200,1184511
Joshua,M,100,4867,1169616,1174483
Kevin,M,100,5162,1139514,1144676
Brian,M,100,4515,1131304,1135819
Andrew,M,100,4116,1114087,1118203
Charles,M,100,5380,1108300,1113680
Jessica,F,100,1036661,3570,1040231
Elizabeth,F,100,1031059,3278,1034337
Jason,M,100,4998,1010311,1015309
Timothy,M,100,4151,1005129,1009280
Lisa,F,100,960409,2788,963197
Jeffrey,M,100,3374,934568,937942
Ryan,M,98,20771,899498,920269
Linda,F,100,880656,2291,882947
Susan,F,100,861919,1927,863846
Patricia,F,100,852447,2704,855151
Sarah,F,100,850064,2428,852492
Eric,M,99,4261,844024,848285
Ashley,F,98,834620,13529,848149
Jacob,M,100,2136,839182,841318
Paul,M,100,3248,836366,839614
Kimberly,F,99,826857,4165,831022
Nicholas,M,100,2924,825931,828855
Jonathan,M,100,3493,800367,803860
Michelle,F,100,798390,3230,801620
Karen,F,100,798321,2238,800559
Kenneth,M,100,3493,794273,797766
Amanda,F,100,760241,2133,762374
Justin,M,100,3775,757958,761733
Scott,M,100,2566,750638,753204
Melissa,F,100,743750,2491,746241
Brandon,M,99,4117,740363,744480
Emily,F,100,732342,1555,733897
Stephanie,F,100,716490,2622,719112
Stephen,M,100,2489,692700,695189
Deborah,F,100,690133,1566,691699
Amy,F,100,658028,1819,659847
Gregory,M,100,2746,653360,656106
Rebecca,F,100,651827,1849,653676
Gary,M,100,2348,634829,637177
Cynthia,F,100,631848,1786,633634
Ronald,M,100,2549,626014,628563
Angela,F,100,626379,1988,628367
Donald,M,100,2550,621798,624348
Laura,F,100,620186,1954,622140
Benjamin,M,100,2089,608558,610647
Tyler,M,97,15845,569367,585212
Barbara,F,100,581823,1498,583321
Nicole,F,100,579299,1956,581255
Alexander,M,99,4205,573654,577859
Patrick,M,100,2423,573927,576350
Edward,M,100,2432,565895,568327
Sandra,F,100,559439,1798,561237
Samantha,F,100,554638,1186,555824
Donna,F,100,553971,1383,555354
Debra,F,100,544134,1140,545274
Kelly,F,86,468329,74432,542761
Samuel,M,100,2010,539939,541949
Aaron,M,99,4087,529412,533499
Nancy,F,100,529495,1587,531082
Heather,F,100,521400,1482,522882
Adam,M,100,1992,517459,519451
Pamela,F,100,517863,1209,519072
Zachary,M,100,1497,517541,519038
Rachel,F,100,497681,1497,499178
Jose,M,99,3411,492515,495926
Nathan,M,100,1650,490399,492049
Brenda,F,100,488331,1793,490124
George,M,99,2883,480163,483046
Julie,F,100,478321,1370,479691
Kyle,M,98,8358,467991,476349
Jordan,M,73,126910,349416,476326
Larry,M,99,2452,471909,474361
Sharon,F,100,467039,1884,468923
Christine,F,100,466220,1584,467804
Kathleen,F,100,466625,1077,467702
Lauren,F,99,457238,3272,460510
Christina,F,100,451746,1975,453721
Katherine,F,100,452220,1254,453474
Maria,F,99,435731,3152,438883
Megan,F,100,433986,1103,435089
Jeremy,M,99,2261,426808,429069
Douglas,M,100,1377,423158,424535
Dennis,M,100,1923,411845,413768
Sean,M,99,2906,410656,413562
Taylor,F,75,308130,103785,411915
Terry,M,81,79669,330645,410314
Victoria,F,100,408385,1038,409423
Andrea,F,99,402259,5397,407656
Christian,M,95,18938,385920,404858
Peter,M,100,1272,392003,393275
Hannah,F,100,388986,665,389651
Alexis,F,85,326985,59616,386601
Austin,M,99,4107,376803,380910
Keith,M,100,1848,378076,379924
Carol,F,99,375704,1964,377668
Anna,F,100,374680,1011,375691
Emma,F,100,374584,607,375191
Ethan,M,100,633,370693,371326
Diane,F,100,369460,994,370454
Teresa,F,100,366390,1035,367425
Bryan,M,100,1707,365579,367286
Cheryl,F,100,366394,836,367230
Amber,F,100,365517,980,366497
Danielle,F,99,362222,1895,364117
Denise,F,100,358597,1341,359938
Margaret,F,100,357759,941,358700
Brittany,F,100,356473,1078,357551
Olivia,F,100,353430,589,354019
Catherine,F,100,351517,907,352424
Madison,F,99,346477,4981,351458
Jamie,F,76,261699,82591,344290
Raymond,M,100,1681,340830,342511
Shannon,F,85,292193,50310,342503
Dylan,M,97,9326,331731,341057
Lori,F,100,339441,853,340294
Jerry,M,99,5083,334682,339765
Tiffany,F,100,334277,1191,335468
Sara,F,100,332524,979,333503
Tammy,F,100,331039,1386,332425
Shawn,M,90,32637,298614,331251
Kayla,F,100,328919,565,329484
Frank,M,100,1503,323389,324892
Crystal,F,100,322781,1169,323950
Jesse,M,97,10137,311001,321138
Jacqueline,F,100,319698,1097,320795
Abigail,F,100,319451,598,320049
Robin,F,88,281340,38646,319986
Erin,F,97,308547,8978,317525
Randy,M,99,4194,311142,315336
Janet,F,100,311060,842,311902
Noah,M,100,1492,308452,309944
Natalie,F,100,308537,705,309242
Jack,M,100,790,307294,308084
Juan,M,99,2210,305609,307819
Tracy,F,81,248884,57036,305920
Gabriel,M,98,6424,299248,305672
Kathryn,F,100,301122,774,301896
Logan,M,93,21625,279371,300996
Kathy,F,100,296850,661,297511
Alyssa,F,100,296309,432,296741
Angel,M,69,90930,205684,296614
Leslie,F,83,245017,49331,294348
Bradley,M,100,1368,288996,290364
Travis,M,99,1720,286336,288056
Diana,F,100,285474,1113,286587
Tina,F,100,282217,900,283117
Cody,M,98,4845,277558,282403
Allison,F,99,279541,1679,281220
Todd,M,100,1061,277888,278949
Cameron,M,91,25360,250921,276281
Courtney,F,93,255478,20375,275853
Julia,F,100,274352,934,275286
Dawn,F,100,274350,925,275275
Craig,M,100,941,274181,275122
Sophia,F,100,269849,362,270211
Carolyn,F,100,266414,764,267178
Isabella,F,100,266371,323,266694
Theresa,F,100,265451,781,266232
Bruce,M,100,869,263111,263980
Alan,M,100,892,262905,263797
Carlos,M,99,1753,254700,256453
Henry,M,99,1276,253255,254531
Wendy,F,100,250755,947,251702
Caleb,M,100,560,250921,251481
Cindy,F,100,249484,754,250238
Roger,M,100,942,248642,249584
Luis,M,99,1417,248075,249492
Vanessa,F,100,247069,983,248052
Evan,M,98,3720,239941,243661
Brianna,F,100,241165,412,241577
Morgan,F,85,205463,34877,240340
Chad,M,100,1039,238049,239088
Jasmine,F,99,236267,1253,237520
Vincent,M,100,978,235092,236070
Monica,F,100,234491,977,235468
Phillip,M,100,1097,233963,235060
Alex,M,97,7959,226471,234430
Grace,F,100,233032,423,233455
April,F,100,232426,667,233093
Valerie,F,100,230820,660,231480
Elijah,M,100,986,228696,229682
Erica,F,100,228139,1025,229164
Melanie,F,100,227776,609,228385
Dana,F,80,182495,44635,227130
Victor,M,99,1314,225722,227036
Joel,M,99,1934,224114,226048
Danny,M,99,1297,224591,225888
Luke,M,100,485,225059,225544
Derek,M,100,910,223548,224458
Jeffery,M,99,1189,222663,223852
Mason,M,99,2561,220969,223530
Janice,F,100,221621,597,222218
Paula,F,100,221264,715,221979
Carl,M,99,1445,220456,221901
Nathaniel,M,100,939,220735,221674
Alexandra,F,100,220497,859,221356
Ann,F,100,220635,599,221234
Isaac,M,100,622,218657,219279
Kristen,F,99,216004,2057,218061
Adrian,M,94,13900,201924,215824
Antonio,M,99,1660,213546,215206
Hunter,M,95,10634,204084,214718
Ricky,M,99,1627,212131,213758
Lawrence,M,100,1020,212488,213508
Michele,F,99,210796,2128,212924
Johnny,M,99,2031,210070,212101
Marcus,M,99,1281,210323,211604
Alicia,F,100,210934,666,211600
Russell,M,100,910,209955,210865
Kim,F,85,177759,31719,209478
Philip,M,100,682,207005,207687
Ian,M,100,711,205193,205904
Dustin,M,99,1380,202855,204235
Rodney,M,100,1017,202972,203989
Rhonda,F,100,202564,571,203135
Tony,M,99,2105,200893,202998
Lucas,M,100,400,200205,200605
Martin,M,100,954,198384,199338
Gerald,M,99,1095,196150,197245
Jesus,M,99,1913,195330,197243
Jared,M,100,768,195720,196488
Wayne,M,100,804,194861,195665
Ava,F,100,195197,238,195435
Jill,F,100,194044,477,194521
Holly,F,100,193179,796,193975
Sherry,F,100,192370,646,193016
Jayden,M,90,19764,169456,189220
Sheila,F,100,188591,502,189093
Joyce,F,100,187782,649,188431
Troy,M,99,2036,186381,188417
Katie,F,100,187967,369,188336
Judy,F,100,187647,523,188170
Shane,M,98,3402,184309,187711
Corey,M,95,8788,178694,187482
Jackson,M,100,525,186484,187009
Walter,M,99,1003,185810,186813
Leah,F,100,185148,417,185565
Connie,F,99,183188,2164,185352
Curtis,M,99,1181,184089,185270
Connor,M,99,1485,183682,185167
Brooke,F,99,182735,1676,184411
Debbie,F,100,183671,434,184105
Joe,M,98,3510,180046,183556
Billy,M,99,2224,179937,182161
Casey,M,59,75002,106825,181827
Stacy,F,89,161414,20276,181690
Isaiah,M,100,565,179923,180488
Willie,M,91,15320,163740,179060
Veronica,F,100,177772,813,178585
Dale,M,93,13348,165157,178505
Kristin,F,99,176857,1629,178486
Jimmy,M,99,1201,176536,177737
Chloe,F,100,176558,285,176843
Judith,F,100,175185,437,175622
Evelyn,F,100,173479,631,174110
Bobby,M,97,4363,169620,173983
Mia,F,100,173440,237,173677
Randall,M,99,1028,172449,173477
Martha,F,100,172741,671,173412
Anne,F,100,172752,460,173212
Tara,F,100,172602,543,173145
Steve,M,100,667,171045,171712
Lynn,F,86,146665,24446,171111
Shirley,F,99,169778,1097,170875
Renee,F,99,169102,1511,170613
Gloria,F,100,169752,788,170540
Arthur,M,99,999,168961,169960
Beverly,F,99,166776,942,167718
Blake,M,96,6330,160942,167272
Jeremiah,M,100,630,165667,166297
Bonnie,F,99,164518,1057,165575
Carrie,F,100,164697,523,165220
Betty,F,100,163285,574,163859
Allen,M,99,939,162720,163659
Cassandra,F,100,162605,377,162982
Devin,M,90,16546,146363,162909
Sydney,F,97,158289,4100,162389
Jane,F,100,161506,431,161937
Riley,F,50,81562,80257,161819
Lee,M,76,39022,122302,161324
Miguel,M,99,957,159995,160952
Stacey,F,92,146585,13373,159958
Laurie,F,100,158976,716,159692
Aiden,M,99,1711,157918,159629
Lindsey,F,97,154457,4885,159342
Brett,M,98,3245,155801,159046
Kaitlyn,F,100,158601,232,158833
Suzanne,F,100,158207,370,158577
Virginia,F,100,157264,473,157737
Julian,M,98,2425,155021,157446
Albert,M,99,859,156330,157189
Gavin,M,100,358,156629,156987
Chelsea,F,100,156327,395,156722
Roy,M,99,912,155003,155915
Wesley,M,99,1812,154004,155816
Charlotte,F,100,154677,233,154910
Cathy,F,100,153682,299,153981
Seth,M,100,489,153269,153758
Audrey,F,99,152694,954,153648
Caroline,F,100,153015,242,153257
Trevor,M,100,611,152376,152987
Haley,F,100,151788,680,152468
Chris,M,86,20957,129459,150416
Gina,F,100,149880,399,150279
Louis,M,99,885,148631,149516
Kelsey,F,97,143599,4686,148285
Erik,M,100,666,147582,148248
Chase,M,98,3265,144564,147829
Savannah,F,100,145440,186,145626
Mitchell,M,99,996,144220,145216
Hailey,F,100,144978,237,145215
Rose,F,100,144163,512,144675
Ruth,F,100,143880,490,144370
Glenn,M,99,864,143337,144201
Jay,M,99,1517,142044,143561
Molly,F,100,143114,360,143474
Jean,F,90,128409,14798,143207
Terri,F,99,141362,892,142254
Mike,M,100,443,141177,141620
Beth,F,100,141219,325,141544
Jenna,F,100,141025,257,141282
Shelby,F,93,130370,10436,140806
Destiny,F,100,140222,468,140690
Derrick,M,99,997,139141,140138
Jon,M,99,915,138741,139656
Micheal,M,99,1723,137424,139147
Joan,F,97,134830,4057,138887
Heidi,F,100,138231,361,138592
Wanda,F,100,138048,491,138539
Marie,F,99,137164,706,137870
Colleen,F,100,137370,307,137677
Liam,M,100,233,137176,137409
Ella,F,100,136665,195,136860
Peggy,F,100,136360,312,136672
Harold,M,100,678,135970,136648
Barry,M,100,600,135800,136400
Marilyn,F,100,135183,380,135563
Carla,F,100,134874,415,135289
Dorothy,F,100,134698,420,135118
Regina,F,100,133563,490,134053
Avery,F,68,90945,43032,133977
Sabrina,F,100,133417,348,133765
Kristina,F,100,133395,352,133747
Lillian,F,100,133332,242,133574
Ronnie,M,96,4821,128679,133500
Brent,M,100,561,132619,133180
Dominic,M,99,1129,131677,132806
Paige,F,99,131460,925,132385
Lindsay,F,98,128164,3226,131390
Marc,M,100,513,130852,131365
Gail,F,98,128911,2079,130990
Cory,M,95,6390,124337,130727
Ellen,F,100,130079,280,130359
Landon,M,99,687,128903,129590
Ricardo,M,99,697,128599,129296
Darlene,F,100,128756,344,129100
Owen,M,100,314,128416,128730
Vicki,F,100,128169,250,128419
Melinda,F,100,127767,337,128104
Gabrielle,F,99,127389,705,128094
Katelyn,F,100,127809,161,127970
Helen,F,100,127497,401,127898
Anita,F,100,127253,387,127640
Tamara,F,100,127167,417,127584
Mario,M,99,1006,125762,126768
Frederick,M,99,672,125877,126549
Ralph,M,100,553,125561,126114
Manuel,M,99,786,125189,125975
Calvin,M,99,787,124668,125455
Alice,F,100,124594,354,124948
Jorge,M,99,689,122452,123141
Dean,M,99,861,122199,123060
Alejandro,M,99,841,122036,122877
Garrett,M,100,451,122299,122750
Oscar,M,99,632,121926,122558
Darrell,M,99,847,121622,122469
Erika,F,100,121814,548,122362
Stanley,M,100,583,121516,122099
Cole,M,100,423,121434,121857
Madeline,F,100,121449,170,121619
Mackenzie,F,94,114255,7227,121482
Edwin,M,99,638,120528,121166
Claire,F,100,119687,313,120000
Tonya,F,100,119155,435,119590
Eddie,M,98,2892,116147,119039
Annette,F,100,118221,350,118571
Marissa,F,100,117620,270,117890
Carter,M,97,3172,114163,117335
Eugene,M,99,793,115936,116729
Wyatt,M,100,244,116260,116504
Xavier,M,99,814,115558,116372
Rita,F,100,116031,289,116320
Andre,M,98,1978,114134,116112
Colin,M,100,430,114830,115260
Francisco,M,99,803,114186,114989
Tanya,F,100,113538,405,113943
Jaime,M,57,49400,64380,113780
Deanna,F,100,113306,227,113533
Faith,F,100,113149,216,113365
Kaylee,F,100,112670,169,112839
Sebastian,M,100,262,110624,110886
Leonard,M,99,563,110195,110758
Caitlin,F,100,110413,283,110696
Marvin,M,99,719,109917,110636
Elaine,F,100,110076,236,110312
Lily,F,100,110186,122,110308
Dakota,M,75,27741,82298,110039
Tommy,M,99,1462,108537,109999
Joanne,F,100,109419,220,109639
Frances,F,99,107962,1187,109149
Autumn,F,100,108197,264,108461
Brandy,F,98,105850,2205,108055
Alexa,F,100,107727,241,107968
Amelia,F,100,107636,110,107746
Addison,F,91,97466,10030,107496
Bailey,F,83,88793,18688,107481
Hayden,M,81,20897,86571,107468
Theodore,M,100,374,106956,107330
Carmen,F,94,100239,6920,107159
Jeff,M,100,243,106915,107158
Alison,F,100,106379,472,106851
Miranda,F,100,106546,183,106729
Jackie,F,61,65326,41204,106530
Spencer,M,97,3036,102867,105903
Ernest,M,99,668,105062,105730
Levi,M,99,678,104632,105310
Sylvia,F,100,104690,401,105091
Aidan,M,98,2559,102121,104680
Jake,M,100,205,104342,104547
Howard,M,100,476,103986,104462
Lydia,F,100,104090,169,104259
Tristan,M,94,6122,98015,104137
Bryce,M,97,2776,101088,103864
Zoe,F,100,101446,419,101865
Peyton,F,58,58567,43191,101758
Brandi,F,100,101206,389,101595
Grant,M,100,197,100692,100889
Darren,M,99,562,99993,100555
Jessie,M,55,45290,55163,100453
Mariah,F,100,99811,182,99993
Gabriella,F,100,99822,60,99882
Maureen,F,100,99359,238,99597
Colton,M,100,158,99165,99323
Vickie,F,100,98958,325,99283
Aubrey,F,86,85563,13706,99269
Katrina,F,100,98393,238,98631
Whitney,F,96,94269,4247,98516
Melvin,M,99,832,96947,97779
Yvonne,F,100,97122,389,97511
Brayden,M,99,927,96518,97445
Kylie,F,100,96903,427,97330
Christy,F,99,96184,955,97139
Sofia,F,100,96921,97,97018
Harry,M,100,444,96534,96978
Kara,F,100,96495,270,96765
Lance,M,100,345,96339,96684
Ivan,M,99,498,96137,96635
Francis,M,91,8745,87412,96157
Jocelyn,F,100,95778,345,96123
Eduardo,M,100,433,95493,95926
Roberto,M,99,652,94765,95417
Makayla,F,100,95097,152,95249
Yolanda,F,99,94203,490,94693
Sally,F,100,94238,235,94473
Tracey,F,91,86059,8380,94439
Bethany,F,100,94232,184,94416
Natasha,F,100,94024,285,94309
Joy,F,99,93313,917,94230
Meghan,F,100,93829,226,94055
Jo,F,99,92962,1006,93968
Clayton,M,100,372,93540,93912
Eva,F,100,93560,269,93829
Sierra,F,100,93505,269,93774
Diego,M,100,195,93499,93694
Parker,M,89,10357,83150,93507
Ana,F,99,92319,579,92898
Jerome,M,99,633,91973,92606
Reginald,M,99,729,91693,92422
Alexandria,F,100,91990,214,92204
Ruby,F,99,91129,709,91838
Kendra,F,100,91486,349,91835
Kerry,F,51,46914,44733,91647
Hector,M,99,476,91018,91494
Claudia,F,99,90569,495,91064
Ruben,M,99,563,90484,91047
Briana,F,100,90621,201,90822
Javier,M,99,488,89978,90466
Phyllis,F,100,89806,193,89999
Carson,M,93,6059,83868,89927
Max,M,100,334,89430,89764
Micah,M,88,10992,78457,89449
Johnathan,M,100,349,89049,89398
Preston,M,99,542,87455,87997
Tanner,M,98,1981,85941,87922
Toni,F,99,86595,1283,87878
Omar,M,100,435,87099,87534
Devon,M,78,19539,67752,87291
Fernando,M,99,578,85962,86540
Brendan,M,100,325,86192,86517
Felicia,F,100,86129,279,86408
Angelica,F,100,86061,321,86382
Naomi,F,100,86264,117,86381
Angelina,F,100,86293,80,86373
Joanna,F,100,85980,306,86286
Eli,M,99,628,85108,85736
Edgar,M,100,408,85104,85512
Charlene,F,100,85096,258,85354
Eileen,F,100,84701,161,84862
Misty,F,100,84210,237,84447
Darryl,M,99,954,83446,84400
Shelly,F,99,83093,1141,84234
Jody,F,64,54035,30189,84224
Melody,F,100,83824,164,83988
Bridget,F,100,83593,149,83742
Karla,F,100,82803,309,83112
Ariana,F,100,82786,168,82954
Adriana,F,100,82474,399,82873
Vivian,F,99,82126,511,82637
Kendall,F,64,52614,29887,82501
Ray,M,99,1156,80982,82138
Brittney,F,100,81538,265,81803
Penny,F,100,81411,275,81686
Isabel,F,99,80836,836,81672
Brad,M,100,233,81091,81324
Sherri,F,100,81103,176,81279
Jenny,F,99,80778,415,81193
Brooklyn,F,99,79995,1158,81153
Desiree,F,100,80603,198,80801
Brady,M,98,1583,79054,80637
Jaden,M,84,13093,67168,80261
Fred,M,100,376,79716,80092
Breanna,F,100,79998,65,80063
Jodi,F,99,79011,906,79917
Rosa,F,99,79283,575,79858
Kurt,M,100,196,79609,79805
Kristine,F,100,79406,185,79591
Maya,F,100,79277,152,79429
Jillian,F,100,79199,227,79426
Norman,M,99,522,78443,78965
Maurice,M,99,956,77941,78897
Earl,M,99,533,78161,78694
Josiah,M,100,317,78377,78694
Monique,F,100,77623,377,78000
Rachael,F,100,77808,181,77989
Jade,F,93,72632,5249,77881
Jeanette,F,100,77513,278,77791
Clifford,M,99,476,77299,77775
Candace,F,100,76983,153,77136
Marcia,F,100,76978,150,77128
Nicolas,M,100,169,76942,77111
Becky,F,100,76950,139,77089
Priscilla,F,100,76887,182,77069
Ariel,F,79,60787,15871,76658
Arianna,F,100,76418,65,76483
Oliver,M,100,219,76246,76465
Ashton,M,76,18026,58114,76140
Maxwell,M,100,202,75698,75900
Drew,M,92,6298,69574,75872
Kristi,F,100,75636,138,75774
Lucy,F,100,75498,106,75604
Alfred,M,99,456,75138,75594
Joann,F,100,75126,276,75402
Norma,F,99,74665,490,75155
Warren,M,100,341,74770,75111
Rick,M,100,130,74880,75010
Kelli,F,100,74547,300,74847
Gabriela,F,100,74266,370,74636
Jeanne,F,100,74385,138,74523
Nina,F,100,74312,151,74463
Marsha,F,100,73633,190,73823
Andy,M,99,815,72919,73734
Krystal,F,100,73500,190,73690
Clarence,M,99,552,73065,73617
Andres,M,99,433,73109,73542
Gwendolyn,F,100,72871,180,73051
Daisy,F,100,72711,334,73045
Krista,F,100,72775,148,72923
Roberta,F,100,72491,336,72827
Tyrone,M,99,703,72109,72812
Dalton,M,100,363,72272,72635
Damian,M,100,321,72292,72613
Hope,F,100,72263,181,72444
Greg,M,100,143,72049,72192
Tim,M,100,181,71946,72127
Trinity,F,96,69264,2677,71941
Summer,F,100,71625,211,71836
Doris,F,99,71424,404,71828
Collin,M,99,418,71318,71736
Pedro,M,99,406,71309,71715
Sergio,M,100,356,71056,71412
Dominique,F,70,49654,21657,71311
Shaun,M,96,3071,68201,71272
Raul,M,99,419,70822,71241
Irene,F,100,70914,246,71160
Lorraine,F,100,70957,163,71120
Jim,M,100,177,70847,71024
Duane,M,99,390,70322,70712
Nolan,M,100,227,70479,70706
Karl,M,99,810,69650,70460
Shelley,F,99,69468,896,70364
Rebekah,F,100,70110,119,70229
Don,M,99,454,69771,70225
Neil,M,100,256,69933,70189
Kristy,F,100,69818,179,69997
Aaliyah,F,100,69833,84,69917
Esther,F,100,69608,199,69807
Charlie,M,83,11543,58107,69650
Dwayne,M,99,452,69171,69623
Bianca,F,100,69105,195,69300
Annie,F,100,68790,231,69021
Rafael,M,99,533,67695,68228
Belinda,F,100,67997,150,68147
Kaleb,M,100,192,67867,68059
Glen,M,99,412,67583,67995
Alvin,M,99,479,67134,67613
Leon,M,99,454,67146,67600
Cesar,M,100,315,67233,67548
Loretta,F,100,67285,173,67458
Sheryl,F,100,67302,128,67430
Payton,F,67,45424,21940,67364
Meredith,F,98,65821,1341,67162
Mathew,M,100,207,66925,67132
Cheyenne,F,96,64451,2625,67076
Sue,F,100,66796,280,67076
Cooper,M,98,1355,65514,66869
Leo,M,100,316,66400,66716
Bernard,M,99,376,66170,66546
Josephine,F,100,66159,111,66270
Guadalupe,F,75,49612,16291,65903
Madelyn,F,100,65635,33,65668
Juanita,F,100,65381,269,65650
Erick,M,99,412,65210,65622
Sandy,F,90,59104,6372,65476
Clinton,M,100,293,65051,65344
Marco,M,99,333,64963,65296
Nevaeh,F,99,64713,380,65093
Candice,F,100,64880,155,65035
Emmanuel,M,99,337,64080,64417
Constance,F,100,64204,136,64340
Nora,F,100,64032,199,64231
Franklin,M,99,363,63795,64158
Jonathon,M,100,224,63334,63558
Kirk,M,100,197,63156,63353
Skylar,F,75,47236,15986,63222
Jacquelyn,F,100,63007,95,63102
Nichole,F,100,62916,184,63100
Glenda,F,100,62939,138,63077
Tom,M,100,134,62730,62864
Abraham,M,100,196,62604,62800
Armando,M,99,362,61978,62340
Layla,F,100,61907,73,61980
Sophie,F,100,61913,43,61956
Jada,F,100,61238,237,61475
Terrance,M,99,695,60602,61297
Dan,M,100,261,60859,61120
Marlene,F,100,60955,148,61103
Rosemary,F,100,60766,134,60900
Leroy,M,99,412,60461,60873
Carly,F,100,60697,160,60857
Kate,F,100,60740,77,60817
Robyn,F,98,59547,1097,60644
Sonya,F,100,60418,183,60601
Rene,M,68,19568,40980,60548
Terrence,M,99,482,60019,60501
Gilbert,M,99,304,60095,60399
Kristopher,M,100,297,60094,60391
Dillon,M,99,530,59856,60386
Gordon,M,100,172,59956,60128
Kennedy,F,90,54133,5766,59899
Cecilia,F,100,59481,152,59633
Cristian,M,98,1102,57834,58936
Damon,M,99,316,58495,58811
Kari,F,99,58150,623,58773
Dianne,F,100,58400,104,58504
Miriam,F,100,58201,219,58420
Bill,M,100,108,58279,58387
Sheri,F,100,58210,114,58324
Ross,M,100,245,57978,58223
Miles,M,100,173,58044,58217
Yvette,F,100,57804,186,57990
Zoey,F,100,57701,180,57881
Ayden,M,97,1987,55808,57795
Jan,F,75,43550,14150,57700
Sonia,F,100,57302,283,57585
Giovanni,M,99,841,56585,57426
Rickey,M,99,511,56739,57250
Lonnie,M,95,2870,54146,57016
Adrienne,F,99,56604,375,56979
Isabelle,F,100,56938,20,56958
Byron,M,100,249,56594,56843
Brody,M,100,201,56599,56800
Clara,F,100,56680,82,56762
Kaitlin,F,100,56678,75,56753
Daryl,M,94,3262,53490,56752
Tabitha,F,100,56475,146,56621
Ramon,M,99,419,55947,56366
Karina,F,100,56069,253,56322
Lois,F,99,55835,370,56205
Skyler,M,64,20165,35954,56119
Elena,F,100,55974,86,56060
Sadie,F,100,55587,42,55629
Elias,M,100,144,55467,55611
Roxanne,F,100,55013,55,55068
Kent,M,100,161,54875,55036
Cassidy,F,94,51789,3128,54917
Joey,M,90,5656,48918,54574
Alisha,F,100,54351,131,54482
Abby,F,100,54300,153,54453
Marshall,M,99,783,53478,54261
Gianna,F,100,54027,28,54055
Herbert,M,99,281,53741,54022
Julio,M,99,382,53456,53838
Jonah,M,99,495,53339,53834
Caden,M,99,792,53020,53812
Daniela,F,100,53486,163,53649
Kaden,M,98,990,52622,53612
Natalia,F,100,53462,41,53503
Alberto,M,99,353,53098,53451
Lewis,M,99,314,52991,53305
Mckenzie,F,96,51185,2049,53234
Vernon,M,99,425,52571,52996
Gage,M,100,218,52702,52920
Allan,M,100,157,52699,52856
Genesis,F,97,51048,1654,52702
Valeria,F,100,52536,105,52641
Trenton,M,100,78,52560,52638
Mallory,F,98,51676,803,52479
Traci,F,100,52029,233,52262
Kirsten,F,100,51957,211,52168
Dwight,M,99,273,51813,52086
Colby,M,93,3644,48264,51908
Camille,F,99,51448,408,51856
Wade,M,100,129,51617,51746
Damien,M,99,260,51376,51636
Eleanor,F,100,51589,19,51608
Elise,F,100,51551,41,51592
Maggie,F,100,51491,35,51526
Angie,F,100,51242,126,51368
Aimee,F,100,51201,78,51279
Israel,M,98,1017,50186,51203
Sidney,M,61,19672,31261,50933
Stella,F,100,50774,41,50815
Harrison,M,100,203,50540,50743
Caitlyn,F,100,50566,34,50600
Kellie,F,100,50349,251,50600
Kelley,F,90,45764,4835,50599
Lloyd,M,100,225,50314,50539
Dallas,M,82,9241,41143,50384
Perry,M,97,1717,48483,50200
Mikayla,F,100,50041,11,50052
Angelo,M,99,691,49215,49906
Enrique,M,99,255,49555,49810
Alana,F,100,49567,31,49598
Jordyn,F,91,45103,4423,49526
Lacey,F,98,48672,846,49518
Donovan,M,100,205,49295,49500
Cristina,F,99,49192,270,49462
Georgia,F,100,49320,106,49426
Geoffrey,M,100,140,49266,49406
Guy,M,100,130,49247,49377
Leonardo,M,100,124,48938,49062
Lorenzo,M,99,273,48715,48988
Conner,M,98,767,48154,48921
Cara,F,100,48826,62,48888
Janelle,F,100,48649,86,48735
Johnnie,M,76,11511,37177,48688
Alec,M,99,331,48330,48661
Gerardo,M,100,239,48195,48434
Darius,M,99,272,48065,48337
Kelvin,M,99,304,47989,48293
Trent,M,100,102,48116,48218
Allyson,F,100,48193,21,48214
Celeste,F,100,48166,45,48211
Grayson,M,94,3096,44951,48047
Marisa,F,100,47952,66,48018
Bobbie,F,89,42704,5269,47973
Gracie,F,100,47931,33,47964
Jace,M,99,586,47293,47879
Jaclyn,F,100,47750,103,47853
Gene,M,98,1164,46610,47774
Stuart,M,100,204,47446,47650
Michaela,F,100,47573,69,47642
Alejandra,F,99,47042,525,47567
Vicky,F,99,47172,353,47525
Juliana,F,100,47461,49,47510
Mya,F,100,47380,54,47434
Jaxon,M,100,225,47020,47245
Hayley,F,100,47088,46,47134
Nelson,M,99,249,46818,47067
Lynda,F,100,46984,61,47045
Arlene,F,100,46847,71,46918
Bryson,M,100,214,46383,46597
Arturo,M,100,203,45954,46157
Quinn,M,61,17946,27909,45855
Reagan,F,87,40076,5771,45847
Roman,M,100,199,45497,45696
Latoya,F,100,45412,185,45597
Donnie,M,96,2001,43498,45499
Alfredo,M,99,275,45168,45443
Raquel,F,99,45171,266,45437
Kiara,F,100,45215,221,45436
Shawna,F,100,45127,105,45232
Louise,F,99,44759,460,45219
June,F,98,44136,821,44957
Liliana,F,100,44700,157,44857
Bryant,M,99,232,44597,44829
Marcos,M,100,156,44599,44755
Lynne,F,100,44569,181,44750
Dianna,F,100,44406,48,44454
Marion,F,57,25462,18942,44404
Noel,M,74,11604,32777,44381
Iris,F,99,44000,282,44282
Camila,F,100,44196,40,44236
Rylee,F,91,40013,4181,44194
Selena,F,100,44013,57,44070
Dominick,M,99,262,43745,44007
Christie,F,99,43508,396,43904
Billie,F,85,37295,6453,43748
Josue,M,100,185,43458,43643
Kylee,F,99,43198,422,43620
Kenny,M,99,436,43175,43611
Ty,M,98,691,42738,43429
Kay,F,98,42714,674,43388
Jasmin,F,99,42791,584,43375
Jimmie,M,91,4105,39264,43369
Chance,M,98,1074,42238,43312
Shelia,F,100,43132,111,43243
Ashlee,F,99,42890,258,43148
Kasey,F,74,31492,11260,42752
Marjorie,F,100,42670,53,42723
Harper,F,91,38649,3903,42552
Tessa,F,100,42507,13,42520
Edith,F,100,42362,109,42471
Teri,F,100,42179,207,42386
Ashlyn,F,100,42313,54,42367
Serenity,F,100,42308,59,42367
Braden,M,99,273,42060,42333
Felix,M,99,356,41732,42088
Santiago,M,100,61,41927,41988
Esmeralda,F,100,41775,180,41955
Leigh,F,92,38650,3163,41813
Floyd,M,99,269,41539,41808
Marianne,F,100,41648,43,41691
Jana,F,100,41637,39,41676
Simon,M,100,126,41528,41654
Mindy,F,100,41550,67,41617
Sam,M,99,578,41017,41595
Geraldine,F,100,41453,129,41582
Meagan,F,100,41228,72,41300
Leticia,F,99,40986,215,41201
Adrianna,F,100,41179,18,41197
Frankie,M,72,11645,29450,41095
Ellie,F,99,40561,224,40785
Malik,M,99,259,40461,40720
Jermaine,M,98,911,39777,40688
Orlando,M,99,242,40335,40577
Gretchen,F,100,40526,38,40564
Bella,F,100,40498,34,40532
Alexia,F,100,40326,44,40370
Kayden,M,84,6552,33773,40325
Alma,F,98,39547,733,40280
Ginger,F,100,40034,41,40075
Tricia,F,100,39785,88,39873
Ted,M,100,63,39413,39476
Trisha,F,100,39339,53,39392
Raven,F,93,36584,2795,39379
Gayle,F,97,38128,1238,39366
Roderick,M,99,263,39093,39356
Antoinette,F,100,39290,46,39336
Roland,M,100,136,39184,39320
Rochelle,F,99,38983,280,39263
Lester,M,99,304,38906,39210
Freddie,M,94,2196,36943,39139
Harley,M,52,18739,20344,39083
Ebony,F,99,38580,455,39035
Jazmin,F,99,38759,227,38986
Stacie,F,100,38746,194,38940
Ramona,F,100,38638,137,38775
Fredrick,M,99,235,38521,38756
Giselle,F,100,38688,44,38732
Reese,F,65,25317,13363,38680
Tyson,M,99,308,38282,38590
Shari,F,100,38453,46,38499
Nikki,F,98,37534,873,38407
Brock,M,100,75,38219,38294
Clyde,M,99,233,38056,38289
Milton,M,100,187,38079,38266
Yesenia,F,99,37910,314,38224
Patty,F,100,38126,59,38185
Cassie,F,99,37980,191,38171
Dante,M,99,453,37683,38136
Patti,F,100,38027,46,38073
Zane,M,99,339,37718,38057
Nadia,F,100,37929,62,37991
Mandy,F,100,37811,138,37949
Cedric,M,99,273,37624,37897
Kristie,F,100,37844,44,37888
Everett,M,99,229,37572,37801
Tami,F,100,37713,72,37785
Kimberley,F,99,37545,228,37773
Julianna,F,100,37741,26,37767
Malachi,M,99,200,37353,37553
Lana,F,100,37405,5,37410
Chandler,M,80,7330,30067,37397
Violet,F,100,37340,20,37360
Salvador,M,100,176,37141,37317
Abel,M,100,97,37198,37295
Dave,M,100,48,37187,37235
Lynette,F,100,37140,53,37193
Malcolm,M,100,74,37107,37181
Kerri,F,99,36771,348,37119
Lilly,F,100,37063,24,37087
Clifton,M,99,189,36851,37040
Callie,F,100,36725,127,36852
Alissa,F,100,36668,31,36699
Neal,M,100,67,36558,36625
Ernesto,M,100,121,36424,36545
Stefanie,F,100,36338,43,36381
Serena,F,100,36293,16,36309
Pablo,M,100,57,36244,36301
Kyla,F,100,36208,29,36237
Jalen,M,96,1618,34615,36233
Darla,F,100,36104,27,36131
Dolores,F,99,35828,256,36084
Julius,M,99,186,35889,36075
Elisabeth,F,100,36014,27,36041
Elisa,F,100,35852,111,35963
Trey,M,100,97,35865,35962
Doreen,F,100,35841,53,35894
Scarlett,F,100,35839,13,35852
Emanuel,M,100,82,35556,35638
Makenzie,F,99,35332,282,35614
Mercedes,F,99,35306,278,35584
Hudson,M,98,721,34828,35549
Loren,M,67,11552,23982,35534
Gerard,M,100,75,35446,35521
Johanna,F,100,35328,129,35457
Lena,F,100,35434,16,35450
Tasha,F,100,35322,106,35428
Tammie,F,100,35253,134,35387
Ben,M,100,105,35188,35293
Lora,F,100,35200,75,35275
Braxton,M,98,633,34634,35267
Alondra,F,100,35025,122,35147
Tori,F,97,34019,1104,35123
Fabian,M,99,327,34763,35090
Cora,F,100,34980,19,34999
Carolina,F,100,34860,109,34969
Lesley,F,91,31897,2968,34865
Janie,F,100,34502,134,34636
Garry,M,100,116,34443,34559
Camden,M,93,2448,32091,34539
Demetrius,M,95,1721,32784,34505
London,F,79,27229,7200,34429
Rudy,M,98,686,33727,34413
Toby,M,87,4392,30010,34402
Laurel,F,99,33983,382,34365
Jayla,F,100,34310,51,34361
Marla,F,100,34321,38,34359
Lane,M,91,3232,31046,34278
Ivy,F,96,32895,1248,34143
Sasha,F,96,32839,1297,34136
Gustavo,M,100,104,34009,34113
Britney,F,100,33992,83,34075
Hanna,F,100,33958,115,34073
Bernadette,F,100,33949,60,34009
Clarissa,F,100,33930,21,33951
Arnold,M,100,126,33811,33937
Justine,F,93,31581,2339,33920
Genevieve,F,100,33874,12,33886
Anastasia,F,100,33859,23,33882
Jazmine,F,100,33772,99,33871
Rex,M,100,84,33778,33862
Annabelle,F,100,33777,10,33787
Quentin,M,99,178,33588,33766
Herman,M,99,205,33491,33696
Alaina,F,100,33551,6,33557
Diamond,F,94,31577,1946,33523
Pauline,F,100,33449,63,33512
Jaylen,M,88,3884,29615,33499
Nickolas,M,100,47,33450,33497
Gregg,M,100,113,33383,33496
Patrice,F,98,32603,754,33357
Randolph,M,100,97,33233,33330
Harvey,M,100,144,33097,33241
Betsy,F,100,33139,5,33144
Terrell,M,96,1367,31709,33076
Patsy,F,98,32263,735,32998
Kyra,F,100,32931,23,32954
Griffin,M,98,508,32432,32940
Marty,M,91,3105,29822,32927
Hazel,F,99,32553,336,32889
Keegan,M,91,2905,29953,32858
Cheri,F,100,32719,12,32731
Delaney,F,97,31675,955,32630
Tracie,F,99,32381,218,32599
Asher,M,98,550,31912,32462
Alisa,F,100,32432,22,32454
Mckenna,F,99,32270,183,32453
Delores,F,100,32333,67,32400
Darin,M,99,359,32031,32390
Ronda,F,99,32196,187,32383
Josie,F,99,32070,297,32367
Ciara,F,100,32338,7,32345
Rachelle,F,100,32308,37,32345
Tucker,M,99,260,32084,32344
Sawyer,M,86,4564,27736,32300
Jennie,F,100,32187,74,32261
Tia,F,100,32106,64,32170
Kai,M,84,5034,27083,32117
Keri,F,99,31786,324,32110
Marina,F,100,32016,51,32067
Maryann,F,100,32011,11,32022
Mayra,F,99,31627,345,31972
Kira,F,100,31884,27,31911
Edna,F,100,31834,53,31887
Tatiana,F,100,31843,35,31878
Elliot,M,92,2547,29321,31868
Marisol,F,99,31502,315,31817
Elliott,M,93,2306,29480,31786
Christa,F,100,31706,27,31733
Penelope,F,100,31719,0,31719
Ali,M,71,9309,22400,31709
Myles,M,100,124,31582,31706
Marian,F,99,31302,302,31604
Mildred,F,100,31525,69,31594
Aliyah,F,100,31423,28,31451
Jaiden,M,75,7728,23710,31438
Trina,F,100,31406,30,31436
Ashleigh,F,100,31315,83,31398
Mariana,F,100,31299,84,31383
Janine,F,100,31343,11,31354
Myra,F,100,31321,30,31351
Paris,F,77,24233,7078,31311
Brennan,M,94,1918,29355,31273
Graham,M,100,113,31146,31259
Sherrie,F,100,31232,11,31243
Lincoln,M,99,437,30775,31212
Kameron,M,88,3876,27247,31123
Ryder,M,98,642,30447,31089
Saul,M,100,74,30964,31038
Ismael,M,100,73,30962,31035
Carole,F,100,31017,7,31024
Chelsey,F,100,30843,65,30908
Kassandra,F,100,30751,16,30767
Asia,F,99,30532,191,30723
Drake,M,100,78,30643,30721
Piper,F,100,30504,153,30657
Jamal,M,99,266,30377,30643
Charity,F,100,30586,39,30625
Weston,M,100,23,30582,30605
Aurora,F,100,30488,5,30493
Cecil,M,98,626,29798,30424
Emilio,M,100,57,30247,30304
Latasha,F,100,30162,114,30276
Beatrice,F,100,30200,37,30237
Sonja,F,100,30204,29,30233
Bentley,M,94,1951,28196,30147
Lorena,F,99,29926,219,30145
Bob,M,100,66,30033,30099
Eden,F,87,25999,4017,30016
Corinne,F,100,29908,15,29923
Clay,M,100,94,29790,29884
Jayson,M,100,32,29659,29691
Pam,F,100,29643,23,29666
Bret,M,99,232,29408,29640
Ron,M,100,70,29515,29585
Carlton,M,99,199,29377,29576
Lucia,F,100,29473,86,29559
Nadine,F,100,29523,16,29539
Terence,M,99,165,29253,29418
Chester,M,100,123,29269,29392
Randi,F,96,28229,1123,29352
Corbin,M,98,498,28849,29347
Zackary,M,100,7,29338,29345
Easton,M,98,497,28846,29343
Dawson,M,98,467,28875,29342
Shana,F,100,29224,113,29337
Dane,M,99,359,28970,29329
Darrin,M,100,133,29097,29230
Desmond,M,99,233,28945,29178
Zachery,M,100,38,29095,29133
Clint,M,100,54,29030,29084
Robbie,M,65,10258,18785,29043
Khloe,F,100,29003,19,29022
Paulette,F,100,28901,25,28926
Katelynn,F,100,28857,11,28868
Noelle,F,100,28791,50,28841
Justice,M,52,13778,15054,28832
Shayla,F,100,28766,17,28783
Madeleine,F,100,28715,15,28730
Beau,M,98,438,28251,28689
Daphne,F,100,28594,7,28601
Debora,F,100,28554,28,28582
Gladys,F,100,28489,79,28568
Jakob,M,100,0,28564,28564
Hillary,F,98,27929,596,28525
Cayden,M,95,1532,26989,28521
Jeannie,F,100,28378,49,28427
Margarita,F,100,28213,120,28333
Wendell,M,99,321,27982,28303
Fatima,F,100,28222,46,28268
Allie,F,98,27547,638,28185
Dina,F,100,28103,76,28179
Ezra,M,95,1402,26774,28176
Eliza,F,100,28083,32,28115
Savanna,F,100,28018,15,28033
Darnell,M,94,1802,26230,28032
Laila,F,100,27993,23,28016
Joni,F,98,27441,501,27942
Ezekiel,M,100,7,27925,27932
Shanna,F,100,27842,88,27930
Jude,M,95,1530,26388,27918
Jodie,F,93,25940,1867,27807
Marlon,M,99,309,27490,27799
Rory,M,82,4946,22819,27765
Jeannette,F,100,27715,11,27726
Lila,F,100,27609,0,27609
Shauna,F,100,27528,55,27583
Dena,F,100,27452,56,27508
Mona,F,100,27483,10,27493
Carissa,F,100,27460,12,27472
Alfonso,M,100,80,27342,27422
Janis,F,100,27297,95,27392
Katharine,F,100,27293,11,27304
Mateo,M,100,14,27275,27289
Lucille,F,100,27254,22,27276
Brenna,F,100,27274,0,27274
Kayleigh,F,100,27146,7,27153
Irma,F,100,27047,93,27140
Leanne,F,100,27138,0,27138
Tania,F,100,27062,60,27122
Kyler,M,94,1522,25539,27061
Sammy,M,97,808,26174,26982
Cierra,F,100,26939,36,26975
Aubree,F,100,26904,31,26935
Rodolfo,M,100,83,26833,26916
Branden,M,99,330,26554,26884
Lukas,M,100,19,26844,26863
Kaiden,M,95,1219,25638,26857
Dexter,M,100,115,26727,26842
Angelique,F,100,26789,6,26795
Heath,M,99,181,26609,26790
Alyson,F,100,26690,10,26700
Randal,M,100,127,26535,26662
Bradford,M,100,39,26582,26621
Dora,F,100,26522,94,26616
Deandre,M,98,452,26155,26607
Alonzo,M,99,139,26455,26594
Hugh,M,100,34,26519,26553
Esteban,M,100,31,26462,26493
Clark,M,100,102,26361,26463
Lea,F,99,26230,206,26436
Macy,F,99,26070,325,26395
Margie,F,100,26340,37,26377
Vera,F,100,26318,24,26342
Nick,M,100,55,26260,26315
Kris,M,51,12934,13359,26293
Haylee,F,100,26198,20,26218
Lola,F,100,26200,0,26200
Jolene,F,100,26163,12,26175
Jaxson,M,100,49,26109,26158
Leila,F,100,26137,0,26137
Rylan,M,87,3419,22707,26126
Salvatore,M,100,26,26066,26092
Camryn,F,87,22776,3313,26089
Candy,F,100,25970,90,26060
Bennett,M,97,767,25175,25942
Lillie,F,100,25870,50,25920
Eliana,F,100,25881,22,25903
Guillermo,M,100,74,25822,25896
Francesca,F,100,25846,33,25879
Cherie,F,100,25819,26,25845
Axel,M,100,88,25734,25822
Reid,M,98,593,25224,25817
Emerson,F,51,13225,12557,25782
Zion,M,81,4865,20857,25722
Silas,M,100,34,25605,25639
Julianne,F,100,25635,0,25635
Delilah,F,100,25626,0,25626
Staci,F,100,25419,60,25479
Blaine,M,96,980,24470,25450
Ken,M,100,25,25325,25350
Quinton,M,100,42,25308,25350
Kendrick,M,99,322,25013,25335
Keira,F,100,25306,7,25313
Kenya,F,92,23169,2089,25258
Lara,F,100,25225,29,25254
Brooklynn,F,100,25190,20,25210
Susie,F,100,25160,36,25196
Daniella,F,100,25122,6,25128
Jarrod,M,100,65,24876,24941
Francine,F,100,24916,11,24927
Jenifer,F,100,24897,22,24919
Antoine,M,99,359,24541,24900
Claude,M,99,232,24661,24893
Karin,F,99,24751,135,24886
Lucinda,F,100,24868,11,24879
Taryn,F,97,24230,637,24867
Timmy,M,99,168,24600,24768
Celia,F,100,24747,15,24762
Tiana,F,100,24669,9,24678
Lamar,M,97,743,23912,24655
Carey,M,51,11972,12671,24643
Makenna,F,100,24624,8,24632
Benny,M,99,214,24402,24616
Cathleen,F,100,24513,10,24523
Felipe,M,99,128,24382,24510
Zachariah,M,100,37,24418,24455
Johnathon,M,100,52,24345,24397
Marcella,F,100,24316,66,24382
Forrest,M,99,361,23993,24354
Brenden,M,100,42,24282,24324
Kristian,M,73,6560,17718,24278
Rocky,M,99,198,24020,24218
Hugo,M,100,30,24120,24150
Alina,F,100,24133,0,24133
Leland,M,99,202,23886,24088
Cade,M,100,91,23941,24032
Amari,M,52,11469,12562,24031
Hilary,F,97,23261,759,24020
Cary,M,81,4545,19373,23918
Quincy,M,88,2754,21119,23873
Moises,M,100,52,23775,23827
Bertha,F,100,23731,67,23798
Aria,F,98,23295,473,23768
Bernice,F,98,23312,418,23730
Blair,F,52,12372,11312,23684
Stephan,M,99,229,23402,23631
Amaya,F,100,23544,12,23556
Chasity,F,100,23521,23,23544
Valentina,F,100,23515,7,23522
Kailey,F,100,23499,10,23509
Athena,F,100,23504,0,23504
Blanca,F,99,23308,126,23434
Sheldon,M,98,464,22969,23433
Grady,M,99,163,23140,23303
Luz,F,97,22657,592,23249
Maribel,F,99,23025,185,23210
Rosemarie,F,100,23196,5,23201
Lizbeth,F,100,23119,31,23150
Reed,M,97,617,22457,23074
Gilberto,M,100,52,23011,23063
Amir,M,98,353,22696,23049
Emmett,M,100,38,23011,23049
Kiana,F,100,23012,19,23031
Leilani,F,100,22959,19,22978
Tiara,F,100,22821,61,22882
Cecelia,F,100,22869,0,22869
Darcy,F,90,20554,2276,22830
Sage,F,63,14457,8349,22806
Ericka,F,100,22756,46,22802
Bridgette,F,100,22780,16,22796
Antonia,F,89,20384,2398,22782
Tamika,F,100,22689,90,22779
Bobbi,F,100,22701,64,22765
Marquis,M,98,474,22276,22750
Simone,F,98,22347,403,22750
Leann,F,100,22736,7,22743
Wallace,M,99,129,22613,22742
Janette,F,100,22600,42,22642
Adan,M,100,84,22542,22626
Joaquin,M,100,53,22567,22620
Moses,M,100,25,22526,22551
Tristen,M,82,4051,18496,22547
Therese,F,100,22464,0,22464
Elisha,F,59,13178,9285,22463
Wilson,M,99,120,22340,22460
Lyle,M,99,229,22208,22437
Talia,F,100,22380,5,22385
Mickey,M,86,3060,19301,22361
Ida,F,100,22302,46,22348
Brielle,F,100,22283,0,22283
Imani,F,96,21305,974,22279
Thelma,F,100,22162,65,22227
Heaven,F,99,21964,256,22220
Jami,F,96,21294,900,22194
Alivia,F,100,22156,10,22166
Myron,M,99,211,21900,22111
Sheena,F,100,22039,67,22106
Alayna,F,100,22034,0,22034
Dorian,M,81,4138,17889,22027
Bonita,F,100,21978,12,21990
Maddox,M,97,767,21187,21954
Deana,F,100,21901,14,21915
Maritza,F,100,21835,79,21914
Julissa,F,100,21877,11,21888
Ingrid,F,100,21853,17,21870
Rolando,M,100,78,21772,21850
Rosie,F,100,21756,60,21816
Dewayne,M,100,106,21695,21801
Keisha,F,100,21745,44,21789
Latonya,F,100,21720,67,21787
Kody,M,97,691,21092,21783
Larissa,F,100,21780,0,21780
Davis,M,98,518,21199,21717
Rogelio,M,100,66,21641,21707
Sterling,M,91,1908,19769,21677
Marley,F,87,18700,2910,21610
Jameson,M,97,703,20871,21574
Paola,F,99,21374,148,21522
Angelia,F,100,21484,22,21506
Jasper,M,97,607,20896,21503
Tonia,F,100,21392,53,21445
Otis,M,99,191,21238,21429
Declan,M,100,86,21295,21381
Juliet,F,100,21364,0,21364
Maxine,F,100,21340,13,21353
Ira,M,92,1762,19586,21348
Arielle,F,100,21307,40,21347
Morris,M,99,145,21187,21332
Lorie,F,100,21229,71,21300
Tomas,M,100,16,21280,21296
Jarrett,M,100,78,21203,21281
Lamont,M,99,165,21074,21239
Fiona,F,100,21211,5,21216
Florence,F,100,21135,50,21185
Landen,M,99,162,20889,21051
Phoebe,F,100,21039,5,21044
Audra,F,100,20966,52,21018
Emilee,F,100,20910,8,20918
Rodrigo,M,100,5,20820,20825
Ramiro,M,100,28,20763,20791
Rowan,M,60,8293,12465,20758
Christi,F,100,20601,22,20623
Rosalie,F,100,20580,5,20585
Izabella,F,100,20566,0,20566
Olga,F,100,20502,64,20566
Ashlynn,F,100,20537,12,20549
Kali,F,97,19992,541,20533
Pat,M,59,8457,12036,20493
Jayne,F,100,20431,32,20463
Lacy,F,89,18099,2315,20414
Aileen,F,100,20370,5,20375
Aniyah,F,100,20313,5,20318
Darian,M,70,6064,14231,20295
Tatum,F,84,17047,3169,20216
Faye,F,100,20093,71,20164
Kamryn,F,86,17308,2802,20110
Marcy,F,99,19880,138,20018
Brianne,F,100,19948,32,19980
Jeanine,F,100,19967,11,19978
Sienna,F,100,19929,10,19939
Cortney,F,85,16850,3051,19901
India,F,100,19838,27,19865
Cornelius,M,99,264,19596,19860
Conor,M,100,69,19745,19814
Mollie,F,100,19770,6,19776
Stevie,M,58,8259,11513,19772
Gwen,F,99,19654,109,19763
Leanna,F,100,19753,5,19758
Doug,M,100,5,19737,19742
Jeri,F,99,19478,257,19735
Virgil,M,99,251,19476,19727
Emery,F,60,11743,7971,19714
Elmer,M,99,139,19541,19680
Matt,M,100,5,19551,19556
Bennie,M,92,1618,17925,19543
Brynn,F,98,19163,319,19482
Wilma,F,100,19423,55,19478
Aisha,F,100,19434,27,19461
Alanna,F,100,19436,7,19443
Solomon,M,100,11,19407,19418
Alton,M,100,85,19301,19386
Tommie,M,73,5133,14236,19369
Harmony,F,100,19324,19,19343
Hadley,F,94,18143,1176,19319
Stewart,M,100,69,19229,19298
Delia,F,100,19263,24,19287
Tabatha,F,100,19263,0,19263
Amie,F,100,19204,19,19223
Lexi,F,100,19213,0,19213
Helena,F,100,19212,0,19212
August,M,84,3017,16145,19162
Freddy,M,100,66,19051,19117
Nia,F,100,19081,10,19091
Nikolas,M,100,15,19026,19041
Brendon,M,100,22,18997,19019
Tanisha,F,100,18995,21,19016
Hallie,F,99,18821,184,19005
Elaina,F,100,18962,0,18962
Clare,F,98,18568,376,18944
Karissa,F,100,18909,0,18909
Ada,F,100,18868,34,18902
Ethel,F,100,18814,86,18900
Mauricio,M,100,6,18850,18856
Kiley,F,94,17755,1092,18847
Earnest,M,99,251,18592,18843
Malia,F,100,18799,0,18799
Geneva,F,100,18761,11,18772
Noe,M,99,265,18497,18762
Lyla,F,100,18757,0,18757
Yasmin,F,100,18666,80,18746
Emilia,F,100,18679,0,18679
Elsa,F,100,18654,16,18670
Kaylie,F,100,18657,0,18657
Susana,F,100,18565,52,18617
Cruz,M,90,1924,16673,18597
Teddy,M,97,601,17975,18576
Xander,M,100,12,18556,18568
Kiera,F,100,18527,19,18546
Keaton,M,94,1051,17491,18542
Pete,M,100,62,18453,18515
Skye,F,88,16266,2233,18499
Alexus,F,99,18232,237,18469
Presley,F,84,15576,2882,18458
Melisa,F,100,18435,10,18445
Viviana,F,100,18403,22,18425
Ellis,M,87,2328,16092,18420
Jayce,M,94,1191,17161,18352
Latisha,F,100,18311,38,18349
Brooks,M,94,1049,17299,18348
Jonas,M,100,28,18289,18317
Mattie,F,100,18256,46,18302
Teagan,F,78,14248,4020,18268
Paisley,F,100,18183,24,18207
Mara,F,100,18185,16,18201
Terrie,F,98,17892,309,18201
Katlyn,F,100,18188,5,18193
Derick,M,100,39,18127,18166
Elsie,F,100,18116,16,18132
Kelsie,F,99,17958,130,18088
Eve,F,100,18040,0,18040
Edmund,M,100,5,18030,18035
Sherman,M,99,138,17885,18023
Darrel,M,100,83,17921,18004
Regan,F,82,14695,3290,17985
Noemi,F,100,17892,69,17961
Lauryn,F,100,17928,12,17940
Isiah,M,100,11,17920,17931
Cadence,F,94,16720,1152,17872
Bryanna,F,100,17852,0,17852
Nathanael,M,100,12,17840,17852
Stefan,M,100,42,17805,17847
Ryleigh,F,98,17553,285,17838
Will,M,100,32,17776,17808
Precious,F,100,17709,82,17791
Susanne,F,100,17790,0,17790
Issac,M,100,17,17764,17781
Devan,M,72,5015,12752,17767
Perla,F,100,17735,30,17765
Greyson,M,98,435,17313,17748
Reece,M,82,3227,14512,17739
Colette,F,100,17722,0,17722
Trudy,F,100,17722,0,17722
Dion,M,94,1116,16573,17689
Maximus,M,100,7,17659,17666
Luther,M,100,57,17607,17664
Van,M,93,1228,16396,17624
Maura,F,100,17614,5,17619
Emilie,F,100,17609,7,17616
Lionel,M,100,34,17521,17555
Silvia,F,100,17479,51,17530
Luca,M,96,754,16760,17514
Baylee,F,97,16894,611,17505
Conrad,M,100,0,17498,17498
Scotty,M,99,179,17306,17485
Willow,F,99,17277,161,17438
Shea,F,59,10204,7218,17422
Rusty,M,97,517,16878,17395
Katy,F,100,17356,5,17361
Vance,M,100,22,17305,17327
Kurtis,M,100,25,17280,17305
Araceli,F,99,17155,138,17293
Madalyn,F,100,17280,0,17280
Kimberlee,F,100,17274,0,17274
Chandra,F,100,17179,66,17245
Hollie,F,98,16906,328,17234
Rena,F,100,17131,75,17206
Holden,M,99,124,17076,17200
Jayme,F,79,13542,3652,17194
Anderson,M,97,579,16563,17142
Gale,F,78,13399,3739,17138
Kaylin,F,97,16583,509,17092
Mila,F,100,17069,13,17082
Monte,M,98,384,16657,17041
Zackery,M,100,5,17036,17041
Valarie,F,100,16944,0,16944
Dixie,F,99,16754,121,16875
Greta,F,100,16847,0,16847
Hilda,F,100,16799,40,16839
Aden,M,97,512,16316,16828
Royce,M,94,1075,15741,16816
Sylvester,M,99,113,16590,16703
Lorrie,F,100,16647,50,16697
Leona,F,100,16693,0,16693
Kassidy,F,98,16387,291,16678
Abbey,F,100,16648,19,16667
Walker,M,99,227,16376,16603
Jayda,F,100,16562,24,16586
Laurence,M,99,148,16417,16565
Margo,F,100,16496,22,16518
Mikaela,F,100,16511,0,16511
Phoenix,M,61,6457,10050,16507
Ladonna,F,100,16481,0,16481
Juliette,F,100,16444,0,16444
Elyse,F,100,16389,19,16408
Emiliano,M,100,0,16405,16405
Emely,F,100,16380,16,16396
Willard,M,100,55,16287,16342
Pearl,F,98,16038,270,16308
Dulce,F,100,16229,49,16278
Efrain,M,100,29,16245,16274
Rickie,M,92,1369,14899,16268
Javon,M,95,755,15504,16259
Annmarie,F,100,16212,0,16212
Jamison,M,90,1625,14554,16179
Keenan,M,98,329,15800,16129
Reynaldo,M,100,23,16081,16104
Rudolph,M,100,23,15910,15933
Janae,F,100,15909,6,15915
Danna,F,99,15751,110,15861
Kyleigh,F,100,15853,6,15859
Tate,M,94,912,14909,15821
Rocco,M,100,5,15782,15787
Maddison,F,100,15728,47,15775
Brandie,F,100,15736,29,15765
Ximena,F,100,15739,6,15745
Sondra,F,100,15740,0,15740
Marguerite,F,100,15730,5,15735
Selina,F,100,15726,0,15726
Jaylin,M,57,6800,8918,15718
Annika,F,100,15647,0,15647
Deirdre,F,100,15623,0,15623
Damion,M,100,39,15577,15616
Nayeli,F,100,15601,14,15615
Gael,M,98,347,15239,15586
Chanel,F,100,15528,33,15561
Zander,M,100,21,15518,15539
Jerald,M,100,60,15460,15520
Leonel,M,100,5,15504,15509
Destinee,F,100,15506,0,15506
Adeline,F,100,15491,5,15496
Ahmad,M,100,18,15449,15467
Deshawn,M,92,1183,14275,15458
Nicolette,F,100,15414,5,15419
Deja,F,99,15323,86,15409
Jewel,F,92,14099,1295,15394
Carley,F,99,15249,126,15375
Rylie,F,94,14404,963,15367
Joselyn,F,100,15360,5,15365
Unknown,M,51,7604,7759,15363
Casandra,F,100,15332,7,15339
Shayna,F,100,15293,5,15298
Reuben,M,100,18,15260,15278
Thaddeus,M,100,26,15238,15264
Kaitlynn,F,100,15248,5,15253
Della,F,100,15249,0,15249
Malinda,F,100,15246,0,15246
Jeannine,F,100,15239,0,15239
Aron,M,98,355,14859,15214
Gillian,F,100,15148,61,15209
Cristal,F,100,15145,55,15200
Lorna,F,100,15164,15,15179
Irvin,M,100,20,15125,15145
Duncan,M,100,6,15119,15125
Jefferson,M,100,0,15107,15107
Elissa,F,100,15104,0,15104
Vicente,M,100,0,15102,15102
Sarai,F,100,15082,6,15088
Lou,F,88,13301,1784,15085
Rosalind,F,100,15085,0,15085
Lia,F,100,15066,10,15076
Eunice,F,99,14917,155,15072
Jarvis,M,99,107,14954,15061
Khalil,M,99,127,14905,15032
Roosevelt,M,99,113,14916,15029
Kory,M,92,1206,13768,14974
Paulina,F,100,14967,5,14972
Beatriz,F,100,14898,53,14951
Curt,M,100,0,14937,14937
Kierra,F,100,14903,18,14921
Winston,M,100,26,14854,14880
Suzette,F,100,14858,5,14863
Alessandra,F,100,14854,0,14854
Nathalie,F,100,14833,6,14839
Kaleigh,F,100,14793,6,14799
Tyrell,M,99,145,14653,14798
Tiffani,F,100,14795,0,14795
Archie,M,99,158,14614,14772
Chantel,F,100,14702,11,14713
Shania,F,100,14689,0,14689
Abbie,F,100,14620,41,14661
Jordon,M,88,1818,12829,14647
Pierre,M,99,74,14563,14637
Chrystal,F,100,14631,5,14636
Donte,M,99,137,14499,14636
Tierra,F,100,14550,70,14620
Kingston,M,99,86,14525,14611
Rashad,M,99,85,14508,14593
Chuck,M,100,5,14561,14566
Jamar,M,99,73,14484,14557
Kobe,M,98,251,14305,14556
Kellen,M,92,1136,13415,14551
Deon,M,91,1276,13258,14534
Ayla,F,100,14526,0,14526
Tobias,M,100,0,14519,14519
Aniya,F,100,14497,0,14497
Caiden,M,97,404,14067,14471
Melina,F,100,14463,0,14463
River,M,74,3810,10618,14428
Terra,F,100,14417,5,14422
Uriel,M,99,180,14237,14417
Marta,F,100,14355,46,14401
Liza,F,100,14381,14,14395
Jase,M,99,89,14302,14391
Jadyn,F,78,11189,3189,14378
Darwin,M,100,57,14314,14371
Lyric,F,83,11893,2477,14370
Carina,F,100,14323,35,14358
Dusty,M,70,4242,10116,14358
Wendi,F,100,14357,0,14357
Cheyanne,F,100,14350,0,14350
Janna,F,100,14342,0,14342
Cyrus,M,100,5,14322,14327
Raphael,M,99,153,14136,14289
Titus,M,100,6,14280,14286
Jaqueline,F,100,14251,23,14274
Humberto,M,100,10,14262,14272
Marcie,F,100,14228,8,14236
Willis,M,99,106,14092,14198
Anya,F,100,14130,0,14130
Itzel,F,99,14027,101,14128
Kareem,M,99,193,13933,14126
Amos,M,100,22,14101,14123
Lyndsey,F,100,14072,32,14104
Bryon,M,100,17,14049,14066
Tyra,F,99,13933,126,14059
Deidre,F,100,14035,11,14046
Jeffry,M,100,10,14024,14034
Jacklyn,F,100,14028,5,14033
Luann,F,100,14025,6,14031
Bart,M,100,5,14021,14026
Kiersten,F,100,13999,5,14004
Ayanna,F,100,13998,0,13998
Meaghan,F,100,13955,7,13962
Dayna,F,99,13866,87,13953
Josh,M,100,0,13952,13952
Delbert,M,100,23,13927,13950
Macie,F,100,13947,0,13947
Dee,F,82,11450,2494,13944
Danica,F,100,13935,0,13935
Jerri,F,98,13682,247,13929
Corina,F,100,13924,0,13924
Nanette,F,100,13918,0,13918
Denis,M,94,778,13132,13910
Tammi,F,100,13884,0,13884
Raegan,F,99,13734,138,13872
Graciela,F,100,13816,39,13855
Kirby,M,76,3303,10519,13822
Ervin,M,100,37,13780,13817
Judah,M,97,405,13395,13800
Tamera,F,100,13795,0,13795
Barrett,M,95,670,13105,13775
Hailee,F,100,13765,6,13771
Kade,M,99,157,13604,13761
Polly,F,100,13690,0,13690
Vaughn,M,97,461,13223,13684
Waylon,M,100,16,13654,13670
Stephany,F,100,13662,5,13667
Susanna,F,100,13662,0,13662
Lesly,F,97,13195,459,13654
Armani,M,56,5985,7662,13647
Kourtney,F,94,12871,763,13634
Marci,F,100,13600,11,13611
Brantley,M,96,563,13044,13607
Camron,M,97,399,13192,13591
Elvis,M,100,57,13525,13582
Kenzie,F,97,13201,375,13576
Anahi,F,100,13544,31,13575
Mari,F,100,13542,10,13552
Chelsie,F,100,13545,0,13545
Camilla,F,100,13531,0,13531
Rhiannon,F,100,13525,5,13530
Scot,M,100,11,13512,13523
Marcel,M,94,783,12665,13448
Cash,M,100,40,13401,13441
Janell,F,100,13410,23,13433
Mack,M,100,26,13390,13416
Ryker,M,99,128,13283,13411
Evangeline,F,100,13410,0,13410
Anton,M,100,21,13375,13396
Sheree,F,100,13395,0,13395
Lourdes,F,99,13295,69,13364
Madilyn,F,100,13362,0,13362
Norah,F,100,13337,23,13360
Donnell,M,94,865,12489,13354
Mae,F,100,13312,36,13348
Tamra,F,100,13335,5,13340
Brice,M,97,335,12998,13333
Quintin,M,100,7,13324,13331
Maci,F,100,13323,6,13329
Brenton,M,100,18,13309,13327
Tyree,M,95,728,12596,13324
Nyla,F,100,13316,0,13316
Leeann,F,100,13309,0,13309
Alvaro,M,100,5,13293,13298
Ignacio,M,100,15,13282,13297
Sonny,M,96,545,12749,13294
Ari,M,84,2134,11146,13280
Lynnette,F,100,13245,0,13245
Layne,M,74,3490,9731,13221
Trevon,M,100,25,13192,13217
Haleigh,F,100,13193,9,13202
Kaila,F,100,13195,0,13195
Brook,F,76,10085,3101,13186
Rosalyn,F,100,13176,0,13176
Santos,M,94,754,12403,13157
Horace,M,100,43,13070,13113
Paxton,M,90,1299,11814,13113
Renae,F,100,13073,33,13106
Madisyn,F,100,13098,5,13103
Tayler,F,82,10725,2375,13100
Martina,F,100,13057,40,13097
Reyna,F,100,13064,32,13096
Carlie,F,97,12712,379,13091
Wilbert,M,100,46,13042,13088
Luna,F,100,13078,7,13085
Bria,F,100,13024,55,13079
Fernanda,F,100,13039,26,13065
Miracle,F,98,12825,240,13065
Rosalinda,F,100,13046,5,13051
Devyn,F,54,7041,6000,13041
Karyn,F,100,13015,5,13020
Braylon,M,99,95,12911,13006
Jarred,M,100,8,12982,12990
Krystle,F,100,12926,44,12970
Rocio,F,97,12528,426,12954
Brayan,M,100,18,12934,12952
Christen,F,85,10984,1968,12952
Liana,F,100,12924,0,12924
Shayne,M,79,2677,10220,12897
Nellie,F,100,12876,0,12876
Osvaldo,M,100,12,12859,12871
Bridgett,F,100,12837,0,12837
Romeo,M,100,0,12835,12835
Esperanza,F,100,12815,15,12830
Mohamed,M,100,0,12828,12828
Lakeisha,F,100,12786,36,12822
Kaelyn,F,99,12746,69,12815
Rhett,M,100,63,12709,12772
Tameka,F,100,12724,41,12765
Rodger,M,100,0,12762,12762
Nehemiah,M,97,372,12362,12734
Charmaine,F,100,12713,20,12733
Addyson,F,100,12698,33,12731
Junior,M,100,5,12705,12710
Jena,F,100,12701,7,12708
Markus,M,100,0,12707,12707
Jess,M,98,306,12372,12678
Colten,M,100,0,12670,12670
Ainsley,F,97,12330,331,12661
Harriet,F,100,12648,5,12653
Haven,F,77,9727,2919,12646
Catalina,F,100,12635,7,12642
Kaydence,F,98,12345,294,12639
Chadwick,M,100,22,12604,12626
Halle,F,100,12584,6,12590
Braeden,M,98,230,12358,12588
Celina,F,100,12554,6,12560
Velma,F,100,12541,15,12556
Deanne,F,100,12546,5,12551
Magdalena,F,100,12533,10,12543
Adolfo,M,100,10,12527,12537
Hubert,M,100,0,12537,12537
Anika,F,100,12523,0,12523
Tess,F,100,12511,0,12511
Cari,F,100,12449,55,12504
Lilian,F,100,12499,0,12499
Cali,F,99,12405,87,12492
Kaley,F,100,12446,25,12471
Samara,F,100,12419,0,12419
Estrella,F,100,12417,0,12417
Colt,M,100,11,12396,12407
Joelle,F,97,12075,327,12402
Maricela,F,100,12346,56,12402
Laverne,F,84,10356,2031,12387
Davon,M,97,367,12009,12376
Garret,M,100,5,12370,12375
Nikita,F,82,10205,2170,12375
Aspen,F,91,11289,1079,12368
Lilliana,F,100,12366,0,12366
Deena,F,100,12358,5,12363
Maximilian,M,100,0,12336,12336
Finley,F,60,7416,4909,12325
Lakisha,F,100,12301,12,12313
Trista,F,100,12290,5,12295
Desirae,F,100,12289,0,12289
Demarcus,M,100,29,12257,12286
Kinsley,F,99,12176,109,12285
Kendal,F,66,8155,4112,12267
Nataly,F,100,12226,10,12236
Yadira,F,100,12187,23,12210
Bailee,F,98,11972,216,12188
Dara,F,95,11593,577,12170
Janessa,F,100,12151,0,12151
Jaelyn,F,92,11097,1029,12126
Louie,M,98,273,11834,12107
Finn,M,98,193,11909,12102
Lowell,M,100,33,12039,12072
Cori,F,91,10908,1125,12033
Gerry,M,82,2141,9892,12033
Lenora,F,100,12031,0,12031
Ahmed,M,100,0,12022,12022
Kieran,M,89,1363,10658,12021
Christin,F,92,11039,967,12006
Verna,F,99,11912,91,12003
Adrianne,F,100,11969,31,12000
Lexie,F,99,11865,135,12000
Monty,M,99,155,11840,11995
Aldo,M,100,10,11973,11983
Tianna,F,100,11975,0,11975
Agustin,M,100,21,11934,11955
Yasmine,F,100,11948,5,11953
Viola,F,100,11925,0,11925
Mohammad,M,100,10,11899,11909
Gia,F,100,11894,5,11899
Ashanti,F,94,11135,756,11891
Korey,M,89,1278,10613,11891
Eugenia,F,100,11859,10,11869
Kori,F,90,10627,1241,11868
Adele,F,100,11858,0,11858
Keely,F,100,11832,21,11853
Pierce,M,99,152,11692,11844
Kristal,F,100,11834,0,11834
Kacey,F,84,9910,1914,11824
Agnes,F,100,11822,0,11822
Juana,F,99,11744,76,11820
Noreen,F,100,11803,0,11803
Braydon,M,100,23,11755,11778
Gunner,M,100,5,11760,11765
Eloise,F,100,11761,0,11761
Michel,M,72,3267,8482,11749
Kailyn,F,99,11662,72,11734
Mckayla,F,100,11729,5,11734
Antwan,M,99,113,11614,11727
Princess,F,100,11707,7,11714
Angeline,F,100,11708,0,11708
Brittani,F,100,11685,22,11707
Rae,F,97,11345,309,11654
Caryn,F,100,11641,0,11641
Abram,M,100,0,11630,11630
Kacie,F,100,11588,32,11620
Jarod,M,100,5,11578,11583
Anissa,F,100,11569,5,11574
Lizette,F,100,11569,5,11574
Cullen,M,99,101,11468,11569
King,M,100,5,11563,11568
Madelynn,F,100,11566,0,11566
Kathie,F,100,11547,0,11547
Hattie,F,100,11529,16,11545
Madyson,F,100,11540,0,11540
Marlin,M,89,1245,10282,11527
Asa,M,91,998,10493,11491
Tristin,M,76,2735,8754,11489
Alecia,F,100,11476,0,11476
Janel,F,100,11443,32,11475
Doyle,M,100,40,11426,11466
Rebeca,F,100,11455,5,11460
Isaias,M,100,0,11444,11444
Kinley,F,98,11198,245,11443
Micaela,F,100,11414,6,11420
Jeanie,F,100,11401,0,11401
Georgina,F,100,11397,0,11397
Moshe,M,100,21,11340,11361
Damaris,F,96,10847,498,11345
Gena,F,100,11332,0,11332
Libby,F,100,11317,5,11322
Orion,M,97,313,10975,11288
Lesa,F,100,11267,12,11279
Tamia,F,100,11266,0,11266
Melany,F,100,11247,5,11252
Deven,M,88,1294,9953,11247
Londyn,F,98,10990,246,11236
Shaina,F,100,11217,18,11235
Ezequiel,M,100,0,11212,11212
Mohammed,M,100,0,11209,11209
Octavia,F,99,11063,132,11195
Milo,M,99,98,11077,11175
Maranda,F,100,11152,0,11152
Ciera,F,100,11145,5,11150
Dayton,M,96,452,10681,11133
Nigel,M,99,68,11060,11128
Bessie,F,100,11109,10,11119
Gunnar,M,100,6,11097,11103
Kathrine,F,100,11100,0,11100
Joesph,M,100,12,11084,11096
Darien,M,84,1763,9324,11087
Katina,F,100,11051,34,11085
Maia,F,100,11068,0,11068
Galen,M,96,495,10563,11058
Flora,F,100,11048,6,11054
Baby,M,53,5219,5829,11048
Mitzi,F,100,11046,0,11046
Mckinley,F,60,6606,4427,11033
Moriah,F,99,10933,94,11027
Roxanna,F,100,11018,7,11025
Coleman,M,100,24,10985,11009
Breana,F,100,10997,0,10997
Estella,F,100,10976,10,10986
Aleah,F,100,10965,0,10965
Ivory,F,57,6196,4744,10940
Rosario,F,78,8490,2429,10919
Cathryn,F,100,10918,0,10918
Karlee,F,100,10914,0,10914
Kaylyn,F,100,10880,32,10912
Lauri,F,100,10873,37,10910
Alena,F,100,10880,0,10880
Ashly,F,99,10746,122,10868
Mitchel,M,100,22,10840,10862
Hans,M,100,5,10852,10857
Rosanne,F,100,10850,0,10850
Sammie,M,77,2453,8392,10845
Abbigail,F,100,10799,5,10804
Scottie,M,91,1022,9779,10801
Davion,M,98,216,10584,10800
Jazlyn,F,100,10796,0,10796
Donny,M,100,40,10736,10776
Mariam,F,100,10769,5,10774
Thalia,F,100,10773,0,10773
Triston,M,97,274,10494,10768
Kailee,F,100,10735,23,10758
Isis,F,100,10710,12,10722
Deloris,F,100,10711,6,10717
Tevin,M,99,59,10655,10714
Jamel,M,97,367,10346,10713
Aubrie,F,100,10707,0,10707
Annemarie,F,100,10704,0,10704
Karson,M,86,1468,9227,10695
Kolby,M,91,989,9687,10676
Charley,F,51,5386,5270,10656
Amani,F,82,8753,1894,10647
Marianna,F,100,10643,0,10643
Adalyn,F,100,10642,0,10642
Corrine,F,100,10642,0,10642
Milan,M,53,5023,5614,10637
Dalia,F,100,10622,6,10628
Chaya,F,100,10609,10,10619
Ronny,M,96,397,10206,10603
Deangelo,M,100,21,10554,10575
Mikel,M,91,913,9644,10557
Rufus,M,100,32,10515,10547
Minnie,F,100,10517,21,10538
Maverick,M,99,63,10473,10536
Nakia,F,81,8541,1982,10523
Elle,F,100,10515,0,10515
Devonte,M,100,32,10481,10513
Miley,F,100,10490,7,10497
Remington,M,81,2029,8460,10489
Ernie,M,99,82,10401,10483
America,F,100,10470,0,10470
Trace,M,97,343,10127,10470
Buddy,M,100,6,10456,10462
Ernestine,F,100,10437,16,10453
Daren,M,98,194,10257,10451
Rosanna,F,100,10443,6,10449
Denny,M,97,286,10158,10444
Jaron,M,100,48,10395,10443
Demetria,F,99,10297,141,10438
Carlee,F,99,10344,74,10418
Erich,M,100,32,10386,10418
Zayden,M,99,96,10319,10415
Marquita,F,100,10381,30,10411
Boyd,M,100,0,10404,10404
Jett,M,97,282,10096,10378
Justina,F,100,10347,6,10353
Carroll,M,80,2028,8324,10352
Jamari,M,94,656,9643,10299
Lashawn,F,71,7309,2983,10292
Jaimie,F,91,9390,899,10289
Amira,F,100,10282,0,10282
Rigoberto,M,100,7,10267,10274
Ivette,F,100,10263,10,10273
Helene,F,100,10270,0,10270
Irving,M,100,0,10267,10267
Liberty,F,99,10141,114,10255
Lawanda,F,100,10225,6,10231
Tory,M,64,3629,6590,10219
Valencia,F,100,10197,11,10208
Kolton,M,100,0,10196,10196
Cristopher,M,100,0,10193,10193
Marlee,F,99,10104,85,10189
Vince,M,100,5,10184,10189
Cayla,F,100,10184,0,10184
Annabella,F,100,10169,0,10169
Shantel,F,99,10090,59,10149
Arabella,F,100,10140,0,10140
Reggie,M,97,293,9846,10139
Edmond,M,100,7,10121,10128
Benita,F,100,10097,0,10097
Prince,M,99,148,9945,10093
Danette,F,100,10081,0,10081
Breanne,F,100,10079,0,10079
Dirk,M,100,0,10071,10071
Marlena,F,100,10070,0,10070
Roxana,F,100,10023,26,10049
Jolie,F,100,10038,0,10038
Eddy,M,98,195,9833,10028
Mariela,F,100,10011,8,10019
Catrina,F,100,10018,0,10018
Denice,F,100,10017,0,10017
Maximiliano,M,100,0,10015,10015
Emory,M,67,3279,6733,10012
Robby,M,98,157,9836,9993
Carlo,M,99,80,9910,9990
Felecia,F,100,9982,0,9982
Roseann,F,100,9960,0,9960
Dewey,M,100,11,9937,9948
Lina,F,100,9942,5,9947
Deidra,F,100,9938,0,9938
Ashlie,F,100,9932,5,9937
Dionne,F,96,9517,419,9936
Tatyana,F,100,9936,0,9936
Giovanna,F,100,9934,0,9934
Mandi,F,100,9931,0,9931
Kane,M,100,24,9897,9921
Isla,F,100,9920,0,9920
Marquise,M,96,392,9522,9914
Sunny,F,72,7109,2779,9888
Ulysses,M,100,15,9865,9880
Robbin,F,84,8332,1546,9878
Percy,M,99,107,9762,9869
Racheal,F,100,9864,0,9864
Marisela,F,100,9833,29,9862
Homer,M,100,21,9838,9859
Shay,F,59,5789,4070,9859
Myrna,F,100,9858,0,9858
Latanya,F,100,9820,23,9843
Chana,F,100,9835,0,9835
Iliana,F,100,9834,0,9834
Montana,F,70,6856,2965,9821
Freda,F,100,9819,0,9819
Benito,M,100,26,9787,9813
Porter,M,97,303,9507,9810
Karli,F,100,9801,0,9801
Alphonso,M,100,21,9773,9794
Shiloh,F,67,6533,3259,9792
Kaylynn,F,100,9773,5,9778
Felicity,F,100,9771,6,9777
Gideon,M,100,11,9762,9773
Phil,M,100,22,9747,9769
Muhammad,M,100,0,9768,9768
Coleen,F,100,9766,0,9766
Jovan,M,89,1079,8686,9765
Gay,F,97,9456,302,9758
Davin,M,97,335,9420,9755
Jimena,F,100,9746,8,9754
Gianni,M,83,1658,8071,9729
Karrie,F,100,9727,0,9727
Dayana,F,100,9712,0,9712
Gino,M,100,12,9690,9702
Jaquan,M,99,58,9644,9702
Karly,F,100,9695,5,9700
Darby,F,74,7176,2511,9687
Macey,F,100,9663,18,9681
Farrah,F,100,9640,7,9647
Bert,M,99,53,9581,9634
Lilia,F,100,9620,5,9625
Lacie,F,100,9612,0,9612
Lorelei,F,100,9594,0,9594
Talon,M,96,415,9175,9590
Alycia,F,100,9581,0,9581
Ayana,F,100,9569,5,9574
Chastity,F,100,9572,0,9572
Nathanial,M,100,0,9572,9572
Wilbur,M,100,17,9535,9552
Saundra,F,100,9519,0,9519
Journey,F,91,8647,870,9517
Luisa,F,100,9415,33,9448
Alberta,F,100,9377,36,9413
Jamey,M,69,2904,6505,9409
Monika,F,100,9407,0,9407
Shanice,F,100,9401,5,9406
Tera,F,100,9406,0,9406
Roslyn,F,100,9405,0,9405
Christal,F,100,9400,0,9400
Kelsi,F,100,9396,0,9396
Cohen,M,99,88,9307,9395
Nasir,M,100,29,9364,9393
Annamarie,F,100,9388,0,9388
Shellie,F,98,9169,213,9382
Kadence,F,92,8661,709,9370
Scarlet,F,100,9366,0,9366
Aida,F,100,9344,5,9349
Ulises,M,100,15,9331,9346
Sharron,F,96,9016,328,9344
Kristofer,M,100,0,9342,9342
Tisha,F,100,9339,0,9339
Johnna,F,100,9337,0,9337
Janiya,F,100,9315,6,9321
Bo,M,94,572,8743,9315
Laney,F,98,9132,181,9313
Skyla,F,100,9302,0,9302
Adelaide,F,100,9292,0,9292
Kathi,F,100,9290,0,9290
Chaz,M,98,160,9107,9267
Al,M,99,98,9163,9261
Anaya,F,100,9242,0,9242
Christiana,F,100,9235,0,9235
Deann,F,100,9226,0,9226
Adelyn,F,100,9219,6,9225
Karlie,F,100,9221,0,9221
Patience,F,100,9204,17,9221
Reba,F,100,9221,0,9221
Haylie,F,100,9220,0,9220
Lashonda,F,100,9217,0,9217
Sade,F,99,9124,86,9210
Izaiah,M,100,5,9204,9209
Ibrahim,M,100,0,9208,9208
Yahir,M,99,50,9152,9202
Octavio,M,100,5,9188,9193
Gemma,F,100,9192,0,9192
Lilah,F,100,9169,0,9169
Amara,F,98,9003,164,9167
Kasandra,F,100,9144,0,9144
Joslyn,F,100,9110,28,9138
Cleveland,M,100,32,9103,9135
Danika,F,100,9133,0,9133
Gayla,F,100,9127,6,9133
Jerrod,M,100,10,9118,9128
Katheryn,F,100,9126,0,9126
Marybeth,F,100,9123,0,9123
Claudette,F,100,9116,5,9121
Denver,M,89,988,8130,9118
Alysha,F,100,9117,0,9117
Ursula,F,100,9109,0,9109
Annabel,F,100,9106,0,9106
Jadon,M,98,168,8929,9097
Latrice,F,100,9068,17,9085
Alysia,F,100,9074,0,9074
Elton,M,100,12,9060,9072
Maegan,F,100,9065,0,9065
Wilfredo,M,100,0,9065,9065
Elvin,M,100,6,9057,9063
Lisette,F,100,9063,0,9063
Bradly,M,100,11,9047,9058
Janiyah,F,100,9039,0,9039
Antony,M,100,0,9031,9031
Sky,F,65,5885,3137,9022
Kallie,F,100,9021,0,9021
Nico,M,93,641,8379,9020
Cherish,F,100,9015,0,9015
Jaylon,M,97,247,8745,8992
Cortez,M,100,33,8958,8991
Maeve,F,100,8989,0,8989
Tiffanie,F,100,8978,0,8978
Heriberto,M,100,16,8960,8976
Raina,F,100,8975,0,8975
Houston,M,97,261,8712,8973
Jax,M,99,56,8909,8965
Denzel,M,100,11,8951,8962
Melodie,F,100,8931,0,8931
Rhea,F,99,8833,92,8925
Savanah,F,100,8916,0,8916
Mekhi,M,99,112,8802,8914
Ansley,F,98,8698,197,8895
Gisselle,F,100,8887,0,8887
Hana,F,100,8871,6,8877
Annalise,F,100,8875,0,8875
Laci,F,100,8869,0,8869
Inez,F,96,8534,331,8865
Jairo,M,100,0,8847,8847
Harlan,M,99,110,8735,8845
Garland,M,97,303,8532,8835
Debby,F,100,8824,0,8824
Kennedi,F,100,8807,15,8822
Addie,F,99,8768,51,8819
Kenna,F,99,8691,126,8817
Katelin,F,100,8808,0,8808
Johan,M,100,40,8758,8798
Rayna,F,100,8795,0,8795
Brycen,M,100,21,8773,8794
Sharlene,F,100,8789,0,8789
Leighton,M,56,3854,4934,8788
Rosetta,F,100,8777,0,8777
Karter,M,89,989,7779,8768
Hank,M,100,0,8765,8765
Cornell,M,99,118,8645,8763
Maryanne,F,100,8749,0,8749
Reina,F,100,8741,0,8741
Elbert,M,100,24,8712,8736
Essence,F,100,8724,0,8724
Kirstin,F,100,8715,0,8715
Alden,M,92,711,7997,8708
Sallie,F,100,8696,5,8701
Kaci,F,99,8629,70,8699
Glenna,F,100,8696,0,8696
Brant,M,100,10,8685,8695
Sandi,F,100,8665,21,8686
Milagros,F,100,8668,5,8673
Kristyn,F,100,8651,0,8651
Shyanne,F,100,8648,0,8648
Lupe,F,72,6250,2396,8646
Adalynn,F,100,8643,0,8643
Ryann,F,93,7995,645,8640
Lela,F,100,8621,0,8621
Julien,M,98,172,8448,8620
Kerrie,F,99,8508,104,8612
Jacoby,M,99,109,8483,8592
Carlene,F,100,8591,0,8591
Jaycee,F,89,7611,968,8579
Kenton,M,100,0,8575,8575
Reilly,F,55,4723,3851,8574
Rohan,M,100,16,8557,8573
Holli,F,100,8554,5,8559
Millie,F,100,8551,0,8551
Dashawn,M,94,541,8009,8550
Hal,M,100,0,8543,8543
Domingo,M,100,0,8542,8542
Griselda,F,99,8475,61,8536
Celine,F,100,8531,0,8531
Andria,F,100,8503,27,8530
Coby,M,96,349,8154,8503
Alonso,M,100,0,8501,8501
Hassan,M,100,7,8490,8497
Keven,M,99,116,8381,8497
Rico,M,99,45,8452,8497
Brodie,M,96,338,8152,8490
Brennen,M,98,178,8299,8477
Fallon,F,96,8162,315,8477
Elvira,F,100,8476,0,8476
Amiyah,F,100,8474,0,8474
Alia,F,100,8473,0,8473
Jeanna,F,100,8458,0,8458
Natalee,F,100,8457,0,8457
Aylin,F,100,8451,5,8456
Isabela,F,100,8438,0,8438
Randell,M,98,137,8300,8437
Liz,F,100,8432,0,8432
Cordell,M,100,18,8411,8429
Marlo,F,72,6027,2399,8426
Aracely,F,100,8389,11,8400
German,M,100,5,8389,8394
Nestor,M,100,0,8384,8384
Kami,F,100,8342,20,8362
Shelton,M,98,162,8197,8359
Santana,F,55,4606,3739,8345
Brigitte,F,100,8344,0,8344
Amya,F,100,8339,0,8339
Beckett,M,97,248,8082,8330
Misti,F,100,8320,0,8320
Jorden,M,73,2227,6088,8315
Ally,F,100,8290,10,8300
Starr,F,98,8119,175,8294
Tyrese,M,98,148,8135,8283
Carmela,F,100,8268,5,8273
Maryellen,F,100,8259,0,8259
Fabiola,F,99,8200,53,8253
Caren,F,100,8252,0,8252
Bernardo,M,100,0,8248,8248
Alexandrea,F,100,8242,0,8242
Merle,M,79,1696,6538,8234
Tylor,M,95,446,7780,8226
Zoie,F,100,8224,0,8224
Louisa,F,100,8220,0,8220
Richelle,F,100,8218,0,8218
Lindy,F,91,7446,771,8217
Tana,F,100,8207,6,8213
Roxann,F,100,8195,0,8195
Sarina,F,100,8186,0,8186
Zechariah,M,100,13,8162,8175
Lakesha,F,100,8168,6,8174
Chantal,F,100,8163,7,8170
Channing,M,63,3019,5145,8164
Maliyah,F,100,8162,0,8162
Kamari,M,63,2990,5161,8151
Gonzalo,M,100,0,8142,8142
Rodrick,M,100,5,8134,8139
Arely,F,100,8135,0,8135
Lidia,F,100,8127,0,8127
Jazmyn,F,100,8123,0,8123
Mina,F,94,7621,497,8118
Augustine,M,88,1009,7108,8117
Luciano,M,100,0,8105,8105
Keagan,M,84,1274,6820,8094
Diann,F,100,8080,0,8080
Coy,M,97,224,7854,8078
Campbell,F,58,4668,3407,8075
Consuelo,F,100,8067,5,8072
Jamaal,M,99,45,8022,8067
Ed,M,100,0,8051,8051
Anabel,F,100,8013,35,8048
Josefina,F,100,8026,13,8039
Adriel,M,92,663,7356,8019
Matteo,M,100,5,8011,8016
Rob,M,100,0,8006,8006
Raelynn,F,100,7998,7,8005
Cristy,F,99,7946,56,8002
Letitia,F,100,8002,0,8002
Shakira,F,100,7998,0,7998
Suzanna,F,100,7994,0,7994
Bruno,M,100,0,7985,7985
Alijah,M,88,969,7015,7984
Fidel,M,100,0,7984,7984
Jaydon,M,98,195,7789,7984
Charlee,F,98,7798,185,7983
Amina,F,100,7978,0,7978
Portia,F,100,7963,8,7971
Shanda,F,100,7971,0,7971
Lorri,F,100,7967,0,7967
Augustus,M,100,0,7958,7958
Ilene,F,100,7949,0,7949
Stacia,F,100,7948,0,7948
Stephon,M,100,14,7934,7948
Elliana,F,100,7943,0,7943
Landyn,M,91,719,7218,7937
Althea,F,100,7935,0,7935
Amalia,F,100,7934,0,7934
Carli,F,100,7919,5,7924
Jaida,F,100,7917,0,7917
Kaya,F,94,7417,498,7915
Darrick,M,100,11,7902,7913
Bree,F,100,7893,17,7910
Myla,F,100,7889,0,7889
Broderick,M,100,0,7845,7845
Jacques,M,97,242,7598,7840
Infant,M,52,3764,4072,7836
Yazmin,F,100,7827,7,7834
Fannie,F,100,7833,0,7833
Katarina,F,100,7823,0,7823
Hollis,M,65,2773,5046,7819
Lizeth,F,100,7810,9,7819
Mireya,F,100,7810,0,7810
Austen,M,92,611,7189,7800
Chaim,M,100,6,7793,7799
Adrien,M,83,1308,6470,7778
Jensen,M,72,2178,5545,7723
Sydnee,F,100,7697,0,7697
Kayley,F,100,7695,0,7695
Jaidyn,F,67,5142,2551,7693
Nicky,M,78,1679,6003,7682
Wilfred,M,100,5,7672,7677
Belen,F,99,7613,63,7676
Marques,M,100,23,7653,7676
Josef,M,100,0,7668,7668
Keon,M,98,152,7507,7659
Cale,M,99,84,7562,7646
Dahlia,F,100,7645,0,7645
Georgette,F,100,7645,0,7645
Dona,F,99,7600,44,7644
Ollie,M,51,3758,3886,7644
Nola,F,100,7642,0,7642
Dario,M,100,0,7640,7640
Dino,M,100,0,7636,7636
Lorene,F,100,7623,10,7633
Devante,M,99,57,7567,7624
Kia,F,98,7457,164,7621
Aja,F,99,7533,84,7617
Kaia,F,100,7591,25,7616
Danial,M,99,76,7530,7606
Arron,M,98,173,7432,7605
Jaylynn,F,94,7161,443,7604
Estevan,M,100,10,7589,7599
Starla,F,100,7595,0,7595
Aliya,F,100,7593,0,7593
Vivienne,F,100,7552,0,7552
Jed,M,100,0,7550,7550
Mabel,F,100,7548,0,7548
Theron,M,100,21,7527,7548
Cindi,F,100,7546,0,7546
Caylee,F,100,7544,0,7544
Zaria,F,100,7541,0,7541
Woodrow,M,100,6,7528,7534
Renata,F,100,7523,6,7529
Raymundo,M,100,0,7521,7521
Jayleen,F,97,7327,192,7519
Thea,F,100,7515,0,7515
Kala,F,99,7421,92,7513
Paloma,F,100,7508,0,7508
Giuliana,F,100,7497,0,7497
Ryland,M,95,396,7100,7496
Venus,F,99,7455,38,7493
Deonte,M,99,41,7419,7460
Uriah,M,92,632,6820,7452
Shonda,F,100,7444,0,7444
Valentin,M,100,0,7428,7428
Karol,F,88,6526,898,7424
Malissa,F,100,7424,0,7424
Iesha,F,100,7404,15,7419
Kalyn,F,95,7053,366,7419
Matilda,F,100,7413,0,7413
Kianna,F,100,7411,0,7411
Michell,F,93,6863,548,7411
Destiney,F,100,7408,0,7408
Antionette,F,100,7407,0,7407
Elana,F,100,7403,0,7403
Ami,F,96,7136,266,7402
Omari,M,96,271,7128,7399
Dani,F,90,6633,761,7394
Rod,M,100,0,7394,7394
Dominik,M,99,95,7294,7389
Daquan,M,100,6,7381,7387
Ruthie,F,100,7371,0,7371
Angelita,F,100,7364,5,7369
Daria,F,100,7362,5,7367
Dinah,F,100,7359,0,7359
May,F,98,7200,149,7349
Gregorio,M,100,5,7337,7342
Emil,M,100,5,7336,7341
Daron,M,98,160,7174,7334
Donavan,M,100,5,7326,7331
Jeana,F,100,7331,0,7331
Danita,F,100,7329,0,7329
Erwin,M,100,13,7310,7323
Willa,F,100,7311,0,7311
Corrie,F,84,6167,1142,7309
Kenyatta,F,58,4209,3093,7302
Myah,F,100,7294,6,7300
Alesha,F,100,7293,6,7299
Destini,F,100,7298,0,7298
Aliza,F,100,7292,5,7297
Bronson,M,100,0,7297,7297
Mamie,F,100,7297,0,7297
Lissette,F,100,7291,5,7296
Coral,F,99,7241,43,7284
Lawson,M,97,247,7034,7281
Margot,F,100,7281,0,7281
Tod,M,100,0,7279,7279
Brylee,F,95,6873,400,7273
Kamila,F,100,7267,0,7267
Kip,M,98,143,7124,7267
Carmelo,M,100,0,7263,7263
Andra,F,65,4732,2530,7262
Halie,F,100,7262,0,7262
Jabari,M,100,0,7258,7258
Jacey,F,94,6837,407,7244
Renita,F,100,7218,0,7218
Brisa,F,100,7215,0,7215
Rhoda,F,100,7215,0,7215
Braylen,M,94,408,6804,7212
Olive,F,100,7189,11,7200
Dorothea,F,100,7192,6,7198
Bryn,F,84,6035,1159,7194
Henrietta,F,100,7194,0,7194
Dimitri,M,99,99,7092,7191
Vonda,F,100,7177,11,7188
Jaylene,F,99,7108,75,7183
Alesia,F,100,7179,0,7179
Erma,F,100,7173,5,7178
Jessi,F,82,5911,1265,7176
Aryanna,F,100,7175,0,7175
Justus,M,91,635,6527,7162
Tamela,F,100,7156,0,7156
Asha,F,100,7119,32,7151
Misael,M,100,16,7135,7151
Luanne,F,100,7147,0,7147
Aric,M,100,5,7141,7146
Candi,F,100,7145,0,7145
Stormy,F,89,6373,769,7142
Britt,M,60,2883,4255,7138
Arya,F,76,5414,1721,7135
Otto,M,100,0,7132,7132
Cherry,F,100,7086,33,7119
Maryjane,F,100,7109,0,7109
Emmalee,F,100,7106,0,7106
Ronan,M,99,54,7045,7099
Darrius,M,100,0,7096,7096
Darion,M,92,561,6530,7091
Unique,F,90,6371,718,7089
Jacquelin,F,100,7072,0,7072
Marcela,F,100,7070,0,7070
Norris,M,98,112,6955,7067
Tyron,M,100,16,7049,7065
Suzan,F,100,7053,0,7053
Rikki,F,91,6443,605,7048
Kale,M,97,226,6818,7044
Aiyana,F,100,7038,0,7038
Yessenia,F,100,7020,12,7032
Marcelo,M,100,0,7025,7025
Kenyon,M,97,187,6835,7022
Major,M,100,11,7008,7019
Nita,F,100,7008,0,7008
Kole,M,100,28,6972,7000
Lyndon,M,97,177,6818,6995
Giana,F,100,6990,0,6990
Jaliyah,F,100,6990,0,6990
Mira,F,100,6980,5,6985
Anabelle,F,100,6968,0,6968
Roselyn,F,100,6962,0,6962
Dandre,M,99,37,6922,6959
Kimora,F,100,6953,0,6953
Aleena,F,100,6950,0,6950
Elva,F,99,6862,88,6950
Shelli,F,100,6944,0,6944
Chauncey,M,93,502,6439,6941
Judson,M,100,0,6941,6941
Nash,M,100,25,6914,6939
Kaycee,F,97,6726,212,6938
Fletcher,M,100,5,6930,6935
Sherlyn,F,100,6923,8,6931
Eliseo,M,100,0,6928,6928
Rubi,F,100,6909,14,6923
Davina,F,100,6921,0,6921
Kason,M,100,32,6885,6917
Jamila,F,100,6915,0,6915
Danelle,F,99,6864,46,6910
Winter,F,94,6459,448,6907
Geri,F,100,6904,0,6904
Francisca,F,99,6864,37,6901
Tonja,F,100,6885,5,6890
Dangelo,M,100,0,6888,6888
Adonis,M,99,71,6814,6885
Luciana,F,100,6885,0,6885
Semaj,M,77,1611,5274,6885
Braelyn,F,90,6187,697,6884
Kellan,M,94,429,6451,6880
Adela,F,100,6877,0,6877
Remy,M,57,2927,3945,6872
Domonique,F,75,5132,1738,6870
Kimber,F,96,6629,241,6870
Joana,F,100,6869,0,6869
Jamil,M,96,254,6609,6863
Kenia,F,100,6851,12,6863
Leif,M,100,5,6857,6862
Domenic,M,100,0,6855,6855
Petra,F,100,6839,10,6849
Salma,F,100,6841,5,6846
Star,F,98,6735,105,6840
Kaye,F,100,6802,33,6835
Enzo,M,100,0,6829,6829
Charla,F,100,6825,0,6825
Kaylen,F,87,5917,904,6821
Messiah,M,89,730,6087,6817
Karon,F,61,4137,2676,6813
Harris,M,99,82,6726,6808
Alessandro,M,100,0,6805,6805
Kinsey,F,96,6549,252,6801
Efren,M,100,0,6795,6795
Garth,M,100,0,6794,6794
Alysa,F,100,6792,0,6792
Leia,F,100,6792,0,6792
Minerva,F,100,6791,0,6791
Samir,M,99,54,6735,6789
Niki,F,97,6558,224,6782
Xiomara,F,100,6779,0,6779
Ariella,F,100,6773,0,6773
Demi,F,100,6771,0,6771
Rhys,M,93,447,6323,6770
Raheem,M,100,6,6758,6764
Carmella,F,100,6763,0,6763
Maren,F,100,6763,0,6763
Yaretzi,F,100,6754,0,6754
Karley,F,100,6743,0,6743
Clarice,F,100,6740,0,6740
Stefani,F,100,6732,0,6732
Lula,F,100,6721,5,6726
Ester,F,98,6581,135,6716
Andreas,M,99,49,6666,6715
Iker,M,100,0,6714,6714
Tosha,F,100,6712,0,6712
Berenice,F,100,6700,11,6711
Nicola,F,69,4609,2098,6707
Samson,M,100,0,6689,6689
Vito,M,100,0,6686,6686
Zara,F,100,6683,0,6683
Zariah,F,99,6632,51,6683
Giancarlo,M,100,0,6679,6679
Nikole,F,100,6679,0,6679
Abril,F,100,6667,5,6672
Flor,F,99,6581,91,6672
Brynlee,F,100,6657,10,6667
Austyn,M,65,2363,4301,6664
Sloane,F,96,6406,251,6657
Lyndsay,F,100,6656,0,6656
Addisyn,F,100,6651,0,6651
Shyla,F,100,6651,0,6651
Yareli,F,100,6650,0,6650
Tristian,M,91,616,6032,6648
Britton,M,78,1487,5158,6645
Russel,M,100,0,6645,6645
Jacquline,F,100,6633,0,6633
Maryam,F,100,6620,0,6620
Siobhan,F,100,6620,0,6620
Kisha,F,100,6607,12,6619
Lenny,M,95,306,6308,6614
Eryn,F,98,6459,146,6605
Linnea,F,100,6605,0,6605
Valorie,F,100,6604,0,6604
Lenore,F,100,6600,0,6600
Garrison,M,100,5,6593,6598
Patrica,F,100,6592,5,6597
Kandice,F,100,6594,0,6594
Estelle,F,100,6581,0,6581
Lainey,F,100,6572,0,6572
Melba,F,100,6564,0,6564
Dillan,M,96,270,6288,6558
Alyse,F,100,6555,0,6555
Gracelyn,F,100,6551,0,6551
Kaliyah,F,100,6545,5,6550
Eldon,M,100,0,6545,6545
Saige,F,90,5903,641,6544
Arden,F,60,3926,2614,6540
Kennith,M,100,5,6526,6531
Merry,F,100,6530,0,6530
Federico,M,100,0,6529,6529
Gus,M,100,0,6529,6529
Fay,F,96,6242,282,6524
Rashawn,M,89,709,5814,6523
Shanon,F,74,4791,1726,6517
Cason,M,99,60,6454,6514
Elyssa,F,100,6513,0,6513
Lexus,F,96,6235,263,6498
Tegan,F,73,4718,1776,6494
Dania,F,100,6485,5,6490
Layton,M,94,384,6106,6490
Rian,M,60,2612,3875,6487
Salina,F,100,6484,0,6484
Krysta,F,100,6476,0,6476
Ashely,F,99,6392,70,6462
Eboni,F,100,6455,5,6460
Lucero,F,97,6267,191,6458
Michal,M,51,3174,3277,6451
Chantelle,F,100,6438,8,6446
Latosha,F,100,6441,0,6441
Tawana,F,100,6441,0,6441
Allyssa,F,100,6428,0,6428
Jaylah,F,100,6427,0,6427
Kassie,F,100,6425,0,6425
Edwina,F,100,6424,0,6424
Dannie,M,85,952,5467,6419
Blaise,M,93,475,5943,6418
Quinten,M,100,0,6413,6413
Nova,F,90,5791,618,6409
Audrina,F,100,6400,0,6400
Kayli,F,100,6400,0,6400
Averie,F,98,6256,143,6399
Madalynn,F,100,6395,0,6395
Cecily,F,100,6389,0,6389
Mariano,M,100,0,6379,6379
Lyn,F,85,5419,959,6378
Shae,F,78,4943,1435,6378
Evangelina,F,100,6358,0,6358
Susannah,F,100,6358,0,6358
Santino,M,100,0,6352,6352
Yaritza,F,100,6347,5,6352
Miah,F,100,6340,10,6350
Jaelynn,F,99,6253,94,6347
Evelin,F,100,6341,5,6346
Braiden,M,98,152,6192,6344
Pamala,F,100,6343,0,6343
Sheridan,F,76,4798,1528,6326
Tad,M,100,0,6324,6324
Kayleen,F,100,6319,0,6319
Danae,F,100,6300,6,6306
Leandra,F,99,6265,38,6303
Kamden,M,93,426,5874,6300
Jewell,F,83,5208,1086,6294
Sariah,F,100,6288,0,6288
Jenelle,F,100,6287,0,6287
Cleo,F,65,4085,2196,6281
Corinna,F,100,6278,0,6278
Cliff,M,100,0,6266,6266
Raelyn,F,100,6231,20,6251
Evie,F,100,6226,5,6231
Britany,F,100,6230,0,6230
Arjun,M,100,0,6226,6226
Akira,F,84,5234,990,6224
Dominque,F,62,3871,2353,6224
Adelina,F,100,6216,0,6216
Vincenzo,M,100,0,6216,6216
Darci,F,100,6204,0,6204
Carmine,M,96,240,5960,6200
Murray,M,98,96,6104,6200
Vanesa,F,100,6190,5,6195
Shameka,F,100,6191,0,6191
Francesco,M,100,0,6188,6188
Jaylyn,F,76,4689,1498,6187
Adriane,F,96,5912,274,6186
Astrid,F,100,6183,0,6183
Boston,M,91,542,5641,6183
Moira,F,100,6183,0,6183
Yosef,M,100,0,6181,6181
Jalyn,F,74,4574,1587,6161
Sullivan,M,91,538,5623,6161
Rey,M,100,0,6157,6157
Keyla,F,100,6155,0,6155
Coty,M,88,768,5386,6154
Travon,M,100,28,6119,6147
Ginny,F,100,6138,0,6138
Armand,M,100,0,6127,6127
Hiram,M,100,0,6117,6117
Dereck,M,100,0,6116,6116
Alexandro,M,100,0,6112,6112
Trever,M,100,0,6103,6103
Emerald,F,98,5996,105,6101
Forest,M,98,141,5958,6099
Simeon,M,100,25,6072,6097
Juli,F,100,6092,0,6092
Wiley,M,98,116,5971,6087
Khadijah,F,100,6078,7,6085
Juliann,F,100,6065,18,6083
Jammie,F,63,3851,2231,6082
Kaela,F,100,6076,0,6076
Maleah,F,100,6076,0,6076
Xzavier,M,100,0,6076,6076
Gertrude,F,100,6072,0,6072
Isidro,M,100,0,6070,6070
Chanda,F,100,6052,16,6068
Cristobal,M,100,11,6054,6065
Judi,F,100,6061,0,6061
Laureen,F,100,6061,0,6061
Katerina,F,100,6059,0,6059
Lolita,F,100,6057,0,6057
Richie,M,97,163,5890,6053
Kian,M,99,81,5971,6052
Kristan,F,90,5449,599,6048
Keila,F,100,6036,0,6036
Royal,M,88,712,5322,6034
Jordin,F,65,3924,2100,6024
Taliyah,F,100,6024,0,6024
Tamar,F,86,5188,835,6023
Ramsey,M,80,1207,4810,6017
Amaris,F,97,5857,159,6016
Atticus,M,99,34,5982,6016
Shante,F,96,5795,216,6011
Shaylee,F,100,6009,0,6009
Anais,F,99,5965,41,6006
Landry,M,55,2708,3290,5998
Noelia,F,100,5998,0,5998
Brittni,F,100,5985,6,5991
Kandace,F,100,5991,0,5991
Jamarion,M,100,0,5990,5990
Torrey,M,80,1183,4806,5989
Rivka,F,100,5985,0,5985
Niko,M,94,342,5640,5982
Ashtyn,F,82,4901,1080,5981
Kylan,M,88,714,5267,5981
Kamron,M,95,281,5696,5977
Siena,F,100,5970,0,5970
Sincere,M,83,985,4983,5968
Frederic,M,100,0,5960,5960
Chiquita,F,100,5949,6,5955
Stan,M,100,0,5947,5947
Ned,M,100,0,5945,5945
Camren,M,91,529,5415,5944
Shaniya,F,100,5944,0,5944
Briley,F,80,4761,1178,5939
Burton,M,100,5,5934,5939
Dayanara,F,100,5939,0,5939
Ryley,M,56,2608,3331,5939
Dolly,F,100,5930,5,5935
Kendell,M,70,1767,4164,5931
Darron,M,100,5,5916,5921
Thad,M,100,0,5920,5920
Sharla,F,100,5918,0,5918
Lilyana,F,100,5915,0,5915
Antwon,M,100,5,5906,5911
Vikki,F,100,5909,0,5909
Jerod,M,100,0,5908,5908
Seamus,M,100,0,5904,5904
Jayde,F,94,5556,339,5895
Shyann,F,100,5892,0,5892
Jackeline,F,100,5883,0,5883
Matias,M,100,0,5881,5881
Benson,M,100,0,5880,5880
Cedrick,M,100,10,5867,5877
Felisha,F,100,5871,0,5871
Lavonne,F,98,5762,106,5868
Isabell,F,100,5867,0,5867
Eloy,M,100,0,5865,5865
Etta,F,100,5860,0,5860
Lani,F,98,5740,119,5859
Twila,F,100,5859,0,5859
Teressa,F,100,5848,0,5848
Denisse,F,100,5840,0,5840
Sharonda,F,100,5839,0,5839
Jessika,F,100,5835,0,5835
Cinthia,F,100,5826,6,5832
Jessy,M,71,1715,4113,5828
Mika,F,84,4911,915,5826
Ricki,F,64,3706,2120,5826
Arleen,F,100,5825,0,5825
Jalisa,F,100,5815,6,5821
Korbin,M,98,101,5718,5819
Janeen,F,100,5809,0,5809
Demario,M,100,17,5781,5798
Mathias,M,100,0,5791,5791
Selene,F,100,5782,5,5787
Ward,M,100,5,5776,5781
Jedidiah,M,100,18,5761,5779
Kaylah,F,100,5777,0,5777
Kraig,M,100,0,5776,5776
Estela,F,100,5773,0,5773
Eliezer,M,100,0,5768,5768
Bryana,F,100,5767,0,5767
Barton,M,100,0,5763,5763
Monserrat,F,100,5737,26,5763
Miya,F,100,5761,0,5761
Johana,F,100,5749,11,5760
Estefania,F,100,5750,5,5755
Franco,M,100,0,5751,5751
Eliot,M,94,341,5399,5740
Edwardo,M,100,0,5735,5735
Jerrell,M,99,75,5659,5734
Sommer,F,100,5732,0,5732
Cannon,M,98,120,5610,5730
Lucretia,F,100,5729,0,5729
Selah,F,98,5638,91,5729
Litzy,F,100,5721,6,5727
Ivonne,F,100,5711,14,5725
Lucian,M,100,22,5690,5712
Madilynn,F,100,5704,0,5704
Abdullah,M,100,0,5702,5702
Amiya,F,100,5701,0,5701
Kacy,F,84,4778,918,5696
Ivana,F,100,5693,0,5693
Ace,M,100,10,5682,5692
Barney,M,100,22,5669,5691
Matthias,M,100,0,5691,5691
Livia,F,100,5679,0,5679
Collette,F,100,5678,0,5678
Elvia,F,100,5666,10,5676
Jacky,M,84,894,4782,5676
Keshawn,M,94,342,5333,5675
Draven,M,96,219,5454,5673
Keeley,F,99,5623,49,5672
Shaquille,M,93,387,5283,5670
Maira,F,100,5646,17,5663
Danyelle,F,99,5625,37,5662
Deandra,F,85,4821,838,5659
Kortney,F,92,5220,436,5656
Breann,F,100,5653,0,5653
Laquita,F,100,5651,0,5651
Venessa,F,100,5649,0,5649
Yael,F,54,3044,2604,5648
Nelda,F,100,5647,0,5647
Lon,M,100,15,5631,5646
Mariel,F,98,5534,111,5645
Jakayla,F,100,5643,0,5643
Ashli,F,100,5639,0,5639
Abigayle,F,100,5630,5,5635
Genaro,M,100,0,5633,5633
Ember,F,99,5564,66,5630
Leigha,F,100,5627,0,5627
Saniya,F,100,5623,0,5623
Joleen,F,100,5620,0,5620
Giovani,M,100,5,5610,5615
Brandan,M,98,96,5514,5610
Truman,M,100,0,5610,5610
Shamar,M,96,249,5353,5602
Errol,M,100,0,5601,5601
Giovanny,M,99,30,5571,5601
Mellissa,F,100,5600,0,5600
Shanika,F,100,5585,11,5596
Muriel,F,99,5519,68,5587
Tena,F,100,5587,0,5587
Kenley,F,84,4710,876,5586
Nathaly,F,100,5581,0,5581
Brigette,F,100,5577,0,5577
Lesli,F,100,5577,0,5577
Missy,F,100,5561,0,5561
Emmy,F,100,5558,0,5558
Nicki,F,96,5314,244,5558
Janay,F,100,5554,0,5554
Jaylee,F,98,5467,87,5554
Natalya,F,100,5553,0,5553
Nelly,F,99,5515,38,5553
Samira,F,100,5551,0,5551
Edgardo,M,100,0,5548,5548
Demond,M,100,25,5522,5547
Nicolle,F,100,5547,0,5547
Rhianna,F,100,5546,0,5546
Jasmyn,F,100,5545,0,5545
Aurelia,F,100,5538,0,5538
Emelia,F,100,5538,0,5538
Leyla,F,100,5533,0,5533
Blaze,M,93,376,5154,5530
Yusuf,M,100,0,5529,5529
Brigid,F,100,5527,0,5527
Archer,M,98,90,5434,5524
Theo,M,95,270,5252,5522
Edison,M,99,65,5448,5513
Jovani,M,98,109,5402,5511
Benton,M,100,0,5510,5510
Westley,M,100,5,5504,5509
Ina,F,100,5491,11,5502
Evette,F,100,5500,0,5500
Khalid,M,100,0,5494,5494
Stephenie,F,100,5493,0,5493
Monroe,M,72,1513,3979,5492
Yoselin,F,100,5490,0,5490
Calista,F,100,5480,0,5480
Lars,M,100,0,5478,5478
Shannan,F,94,5160,317,5477
Adina,F,100,5474,0,5474
Terese,F,100,5470,0,5470
Turner,M,97,188,5281,5469
Karmen,F,100,5457,10,5467
Deron,M,99,35,5431,5466
Elia,F,88,4812,653,5465
Linwood,M,100,0,5465,5465
Barbra,F,100,5458,0,5458
Nylah,F,100,5458,0,5458
Katlin,F,98,5331,126,5457
Marylou,F,100,5456,0,5456
Enoch,M,100,0,5455,5455
Tariq,M,100,7,5446,5453
Alexzander,M,100,0,5449,5449
Brandee,F,100,5447,0,5447
Hamza,M,100,0,5445,5445
Kandi,F,100,5444,0,5444
Amberly,F,100,5443,0,5443
Nathen,M,100,0,5440,5440
Alfreda,F,100,5411,25,5436
Roscoe,M,100,0,5424,5424
Valery,F,99,5359,64,5423
Kelton,M,100,26,5396,5422
Aryana,F,100,5421,0,5421
Bernadine,F,100,5421,0,5421
Kitty,F,100,5418,0,5418
Adria,F,100,5410,7,5417
Kaiya,F,99,5379,33,5412
Nichelle,F,100,5407,5,5412
Akeem,M,100,0,5409,5409
Marnie,F,100,5404,0,5404
Roxie,F,99,5372,30,5402
Dax,M,100,0,5396,5396
Raleigh,M,72,1502,3894,5396
Corrina,F,100,5389,0,5389
Reanna,F,100,5389,0,5389
Kelsea,F,100,5383,5,5388
Keshia,F,100,5381,6,5387
Destin,M,89,613,4763,5376
Sarahi,F,100,5376,0,5376
Latricia,F,100,5369,0,5369
Abagail,F,100,5368,0,5368
Malaysia,F,100,5367,0,5367
Shelbi,F,100,5362,0,5362
Winifred,F,96,5139,219,5358
Serina,F,100,5355,0,5355
Marlen,F,91,4848,500,5348
Teena,F,100,5348,0,5348
Valentino,M,100,0,5348,5348
Marin,F,87,4629,717,5346
Maryjo,F,100,5344,0,5344
Amelie,F,100,5343,0,5343
Shon,M,93,354,4989,5343
Dawna,F,100,5342,0,5342
Lazaro,M,100,0,5334,5334
Darcie,F,100,5332,0,5332
Yajaira,F,100,5326,5,5331
Mercy,F,100,5310,20,5330
Loraine,F,100,5328,0,5328
Laken,F,82,4373,954,5327
Jaeden,M,84,852,4465,5317
Mitch,M,100,0,5313,5313
Isai,M,99,27,5282,5309
Zack,M,100,0,5309,5309
Tanesha,F,100,5306,0,5306
Hailie,F,100,5302,0,5302
Zaire,M,77,1234,4067,5301
Lavern,F,52,2767,2533,5300
Grover,M,100,0,5297,5297
Avis,F,92,4892,404,5296
Lanny,M,99,45,5250,5295
Karie,F,100,5291,0,5291
Opal,F,100,5281,0,5281
Knox,M,99,27,5251,5278
Jacque,F,68,3598,1678,5276
Tre,M,99,58,5218,5276
Joi,F,100,5274,0,5274
Oswaldo,M,100,0,5267,5267
Soren,M,94,299,4966,5265
Jenni,F,100,5263,0,5263
Dontae,M,100,17,5245,5262
Josette,F,100,5261,0,5261
Tatianna,F,100,5261,0,5261
Shanta,F,97,5111,142,5253
Nanci,F,100,5252,0,5252
Kalen,M,73,1404,3846,5250
Sloan,F,65,3413,1832,5245
Rayne,F,86,4491,739,5230
Abdul,M,100,0,5227,5227
Brandt,M,99,38,5188,5226
Noor,F,88,4596,630,5226
Sybil,F,100,5226,0,5226
Charisse,F,100,5225,0,5225
Deshaun,M,96,231,4994,5225
Abigale,F,100,5206,0,5206
Baron,M,100,0,5206,5206
Chet,M,100,0,5205,5205
Karis,F,99,5128,75,5203
Kesha,F,100,5193,5,5198
Melonie,F,100,5188,0,5188
Derik,M,100,0,5185,5185
Areli,F,99,5119,64,5183
Zakary,M,100,0,5182,5182
Lavon,M,61,2031,3149,5180
Alexi,F,72,3721,1457,5178
Chyna,F,100,5178,0,5178
Amirah,F,100,5175,0,5175
Katia,F,100,5172,0,5172
Cami,F,100,5167,0,5167
Shelbie,F,100,5163,0,5163
Jocelynn,F,100,5161,0,5161
Kalvin,M,100,0,5159,5159
Stephani,F,100,5159,0,5159
Reva,F,100,5158,0,5158
Ora,F,86,4420,735,5155
Killian,M,92,419,4728,5147
Vickey,F,98,5037,108,5145
Tressa,F,100,5136,0,5136
Mimi,F,100,5134,0,5134
Koby,M,99,55,5075,5130
Aryan,M,90,527,4600,5127
Branson,M,100,5,5120,5125
Finnegan,M,99,37,5087,5124
Frida,F,100,5122,0,5122
Jazlynn,F,100,5122,0,5122
Leandro,M,100,0,5119,5119
Meg,F,100,5119,0,5119
Shaniqua,F,100,5117,0,5117
Priya,F,100,5115,0,5115
Linsey,F,98,4999,113,5112
Deacon,M,100,0,5110,5110
Lonny,M,99,60,5050,5110
Bambi,F,100,5109,0,5109
Latonia,F,100,5093,16,5109
Garrick,M,100,0,5103,5103
Kelby,M,73,1379,3721,5100
Keyon,M,98,101,4996,5097
Emmitt,M,100,0,5092,5092
Karma,F,98,4992,100,5092
Roseanne,F,100,5092,0,5092
Bettina,F,100,5087,0,5087
Alani,F,99,5037,44,5081
Jonna,F,100,5076,0,5076
Sydni,F,100,5075,0,5075
Dejuan,M,99,40,5034,5074
Evelynn,F,100,5073,0,5073
Germaine,F,55,2797,2270,5067
Marcellus,M,100,5,5049,5054
Shamika,F,100,5047,6,5053
Duke,M,100,0,5048,5048
Shantell,F,99,5022,26,5048
Jessenia,F,100,5046,0,5046
Maximillian,M,100,0,5043,5043
Makena,F,98,4958,84,5042
Brinley,F,98,4953,88,5041
Lilianna,F,100,5041,0,5041
Jerrold,M,100,0,5040,5040
Maribeth,F,100,5040,0,5040
Bernie,M,90,510,4523,5033
Annalisa,F,100,5031,0,5031
Yasmeen,F,100,5028,0,5028
Saniyah,F,100,5027,0,5027
Treasure,F,98,4918,107,5025
Imelda,F,100,5019,0,5019
Jair,M,100,11,5008,5019
Lorin,F,51,2540,2478,5018
Demarco,M,100,0,5015,5015
Rihanna,F,100,5007,5,5012
Cornelia,F,100,5004,5,5009
Azariah,F,62,3081,1921,5002
Alize,F,94,4679,322,5001
Arian,M,74,1311,3690,5001
Marietta,F,100,4999,0,4999
Kandy,F,100,4993,5,4998
Fawn,F,100,4994,0,4994
Russ,M,100,0,4991,4991
Jamarcus,M,100,0,4987,4987
Deion,M,98,123,4859,4982
Yuliana,F,100,4979,0,4979
Lennon,M,72,1395,3583,4978
Violeta,F,100,4972,5,4977
Iva,F,98,4896,76,4972
Shira,F,100,4971,0,4971
Marquez,M,100,5,4959,4964
Ayesha,F,100,4961,0,4961
Charissa,F,100,4960,0,4960
Odell,M,94,291,4665,4956
Whitley,F,96,4745,207,4952
Nikolai,M,100,0,4945,4945
Tawnya,F,100,4943,0,4943
Tye,M,94,320,4623,4943
Kalie,F,100,4940,0,4940
Breonna,F,100,4939,0,4939
Marilynn,F,100,4938,0,4938
Neva,F,100,4936,0,4936
Claudine,F,100,4935,0,4935
Codi,F,63,3119,1816,4935
Lisbeth,F,100,4934,0,4934
Greggory,M,100,0,4927,4927
Thurman,M,100,0,4921,4921
Marcelino,M,100,0,4919,4919
Catharine,F,100,4918,0,4918
Brandyn,M,92,414,4503,4917
Aydan,M,91,424,4492,4916
Roxane,F,100,4913,0,4913
Savana,F,100,4913,0,4913
Taya,F,100,4913,0,4913
Marva,F,100,4912,0,4912
Kevon,M,99,56,4855,4911
Case,M,100,0,4910,4910
Jazmyne,F,100,4910,0,4910
Leisa,F,100,4910,0,4910
Jaren,M,95,253,4656,4909
Sydnie,F,100,4903,0,4903
Kermit,M,100,0,4902,4902
Windy,F,100,4889,12,4901
Zain,M,96,174,4726,4900
Blakely,F,79,3868,1030,4898
Meadow,F,100,4893,0,4893
Javion,M,100,11,4876,4887
Bettie,F,100,4881,5,4886
Johnpaul,M,100,0,4884,4884
Karsyn,F,86,4208,674,4882
Arnulfo,M,100,0,4875,4875
Dasia,F,100,4871,0,4871
Malakai,M,100,16,4853,4869
Brea,F,100,4867,0,4867
Lynsey,F,100,4859,0,4859
Menachem,M,100,0,4859,4859
Myrtle,F,100,4858,0,4858
Ean,M,100,0,4848,4848
Eleni,F,100,4847,0,4847
Roni,F,86,4156,689,4845
Anabella,F,100,4844,0,4844
Iman,F,83,4042,801,4843
Jamya,F,100,4841,0,4841
Merlin,M,90,461,4380,4841
Sabina,F,100,4836,0,4836
Dorene,F,100,4835,0,4835
Cydney,F,99,4807,25,4832
Lizabeth,F,100,4830,0,4830
Kadin,M,96,178,4649,4827
Sanford,M,100,0,4827,4827
Madonna,F,100,4824,0,4824
Laron,M,98,119,4697,4816
Isela,F,100,4813,0,4813
Sunshine,F,99,4774,37,4811
Alannah,F,100,4802,0,4802
Jael,F,61,2942,1857,4799
Dori,F,100,4792,0,4792
Jaylan,M,84,743,4048,4791
Anjali,F,100,4788,0,4788
Ronaldo,M,100,0,4788,4788
Jacalyn,F,100,4786,0,4786
Nona,F,100,4786,0,4786
Charli,F,98,4666,119,4785
Heidy,F,100,4784,0,4784
Adelynn,F,100,4783,0,4783
Madisen,F,100,4782,0,4782
Zuri,F,89,4257,519,4776
Garett,M,100,0,4774,4774
Sami,M,76,1159,3613,4772
Orville,M,100,0,4770,4770
Anders,M,100,0,4768,4768
Nyasia,F,100,4766,0,4766
Kaylan,F,87,4146,612,4758
Chanelle,F,100,4757,0,4757
Alyce,F,100,4753,0,4753
Bristol,F,92,4358,390,4748
Jeromy,M,100,0,4744,4744
Joanie,F,100,4743,0,4743
Zayne,M,98,111,4632,4743
Casie,F,100,4712,18,4730
Ilana,F,100,4730,0,4730
Maxim,M,100,6,4723,4729
Brionna,F,100,4728,0,4728
Dwain,M,100,0,4727,4727
Nya,F,100,4726,0,4726
Anson,M,100,5,4719,4724
Tobin,M,99,48,4675,4723
Jules,M,77,1076,3642,4718
Mai,F,100,4698,20,4718
Blanche,F,100,4717,0,4717
Tyshawn,M,97,134,4583,4717
Brittanie,F,100,4716,0,4716
Maximo,M,100,0,4716,4716
Foster,M,98,82,4629,4711
Lakeshia,F,100,4708,0,4708
Kati,F,100,4707,0,4707
Giuseppe,M,100,0,4706,4706
Mariann,F,100,4704,0,4704
Salena,F,100,4703,0,4703
Caleigh,F,100,4702,0,4702
Cailyn,F,100,4696,0,4696
Bette,F,100,4695,0,4695
Amare,M,95,254,4439,4693
Jayna,F,100,4693,0,4693
Shad,M,100,0,4693,4693
Adilene,F,100,4685,7,4692
Dallin,M,100,0,4691,4691
Wilmer,M,99,33,4658,4691
Yehuda,M,100,0,4690,4690
Trena,F,100,4684,0,4684
Lashanda,F,100,4674,0,4674
Shara,F,100,4667,5,4672
Jevon,M,98,91,4580,4671
Racquel,F,100,4665,5,4670
Loyd,M,100,0,4668,4668
Jesica,F,100,4667,0,4667
Krystina,F,100,4666,0,4666
Carleigh,F,100,4662,0,4662
Gerri,F,100,4645,17,4662
Antione,M,99,49,4609,4658
Yahaira,F,100,4654,0,4654
Aundrea,F,96,4472,181,4653
Magaly,F,100,4651,0,4651
Averi,F,96,4463,187,4650
Kasen,M,98,94,4556,4650
Caitlynn,F,100,4644,0,4644
Taniya,F,100,4644,0,4644
Cordelia,F,100,4643,0,4643
Twyla,F,100,4636,0,4636
Cain,M,100,0,4635,4635
Kodi,F,51,2362,2271,4633
Basil,M,98,94,4538,4632
Shalonda,F,100,4632,0,4632
Sanaa,F,100,4631,0,4631
Sherie,F,100,4630,0,4630
Aurelio,M,100,6,4623,4629
Donell,M,88,536,4093,4629
Kyrie,F,61,2838,1785,4623
Nikhil,M,100,0,4618,4618
Pilar,F,91,4208,409,4617
Hayleigh,F,100,4616,0,4616
Tarah,F,100,4613,0,4613
Tayla,F,100,4611,0,4611
Farah,F,98,4523,85,4608
Brain,M,100,10,4591,4601
Geralyn,F,100,4601,0,4601
Trinidad,M,65,1627,2973,4600
Jovanni,M,97,156,4442,4598
Anisa,F,100,4594,0,4594
Davian,M,98,100,4493,4593
Carleen,F,100,4592,0,4592
Treva,F,100,4584,6,4590
Dalila,F,100,4589,0,4589
Millicent,F,100,4589,0,4589
Merrill,M,73,1261,3327,4588
Keara,F,100,4585,0,4585
Jalynn,F,92,4236,346,4582
Myranda,F,100,4579,0,4579
Mariyah,F,100,4573,0,4573
Mustafa,M,100,0,4569,4569
Lupita,F,100,4566,0,4566
Lizzie,F,100,4564,0,4564
Mellisa,F,100,4563,0,4563
Memphis,M,82,816,3743,4559
Tyesha,F,100,4559,0,4559
Toney,M,97,143,4411,4554
Brannon,M,97,116,4437,4553
Ofelia,F,100,4553,0,4553
Nannette,F,100,4548,0,4548
Mervin,M,100,0,4547,4547
Dakotah,M,62,1720,2825,4545
Schuyler,M,75,1151,3392,4543
Veda,F,100,4542,0,4542
Annelise,F,100,4539,0,4539
Ireland,F,98,4459,80,4539
Kalli,F,100,4536,0,4536
Rosalia,F,100,4533,0,4533
Derrell,M,100,16,4516,4532
Deric,M,100,0,4531,4531
Jesenia,F,100,4524,6,4530
Kyndall,F,96,4361,169,4530
Gwyneth,F,100,4529,0,4529
Earnestine,F,100,4527,0,4527
Bonny,F,98,4439,83,4522
Clair,F,57,2579,1943,4522
Joycelyn,F,100,4522,0,4522
Gavyn,M,98,99,4421,4520
Ileana,F,100,4520,0,4520
Alexandre,M,97,145,4373,4518
Queen,F,100,4514,0,4514
Keanu,M,96,202,4311,4513
Candis,F,100,4512,0,4512
Alyssia,F,100,4511,0,4511
Jagger,M,99,59,4452,4511
Tanika,F,100,4509,0,4509
Jailyn,F,86,3870,630,4500
Syed,M,100,11,4486,4497
Xochitl,F,100,4491,0,4491
Zaiden,M,99,28,4462,4490
Shanell,F,100,4475,12,4487
Ivanna,F,100,4486,0,4486
Cathrine,F,100,4483,0,4483
Kash,M,99,44,4436,4480
Mauro,M,100,0,4480,4480
Holland,F,73,3253,1221,4474
Luka,M,94,270,4201,4471
Remi,F,72,3228,1242,4470
Weldon,M,100,0,4470,4470
Lanette,F,100,4469,0,4469
Corie,F,78,3477,988,4465
Marcello,M,100,10,4451,4461
Noa,F,73,3262,1199,4461
Rasheed,M,99,34,4419,4453
Mable,F,100,4452,0,4452
Manuela,F,100,4449,0,4449
Jerimiah,M,100,0,4444,4444
Ephraim,M,100,0,4443,4443
Grecia,F,100,4440,0,4440
Jai,M,78,957,3481,4438
Cherise,F,100,4431,0,4431
Nevin,M,98,94,4335,4429
Vladimir,M,100,0,4427,4427
Pattie,F,100,4426,0,4426
Jeramy,M,100,5,4417,4422
Nathalia,F,100,4420,0,4420
Lemuel,M,100,0,4419,4419
Norbert,M,100,0,4418,4418
Daisha,F,100,4410,0,4410
Aliana,F,100,4406,0,4406
Mindi,F,100,4405,0,4405
Earlene,F,100,4404,0,4404
Jaimee,F,99,4361,43,4404
Jamir,M,100,20,4383,4403
Julieta,F,100,4403,0,4403
Jayceon,M,100,16,4385,4401
Leslee,F,98,4299,96,4395
Taj,M,92,361,4033,4394
Chace,M,97,122,4270,4392
Stone,M,100,17,4372,4389
Karri,F,100,4385,0,4385
Konner,M,97,113,4266,4379
Iyana,F,100,4375,0,4375
Madden,M,84,679,3695,4374
Zavier,M,100,5,4369,4374
Jordy,M,99,31,4342,4373
Galilea,F,100,4372,0,4372
Miller,M,88,507,3863,4370
Hernan,M,100,0,4369,4369
Kayle,F,86,3748,621,4369
Makaila,F,100,4368,0,4368
Kalani,F,60,2622,1744,4366
Claudio,M,99,27,4338,4365
Cristin,F,97,4244,120,4364
Shani,F,100,4345,17,4362
Christophe,M,100,0,4361,4361
Jerrica,F,100,4359,0,4359
Raiden,M,97,136,4220,4356
Hali,F,100,4344,10,4354
Celena,F,100,4353,0,4353
Keli,F,99,4302,49,4351
Alexys,F,92,3986,363,4349
Desire,F,100,4335,11,4346
Letha,F,100,4343,0,4343
Aretha,F,100,4342,0,4342
Karim,M,99,58,4283,4341
Sherrill,F,88,3807,533,4340
Rosita,F,100,4339,0,4339
Kyree,M,86,588,3750,4338
Jasen,M,100,0,4336,4336
Mac,M,100,15,4321,4336
Mechelle,F,100,4334,0,4334
Sarita,F,100,4333,0,4333
Estefany,F,100,4323,5,4328
Donavon,M,100,0,4325,4325
Jaci,F,100,4325,0,4325
Camilo,M,100,0,4324,4324
Azaria,F,98,4235,87,4322
Kya,F,100,4309,13,4322
Winnie,F,100,4317,0,4317
Anneliese,F,100,4316,0,4316
Benedict,M,100,0,4315,4315
Britni,F,100,4315,0,4315
Reyes,M,95,205,4110,4315
Dedra,F,100,4314,0,4314
Hayes,M,95,197,4114,4311
Briella,F,100,4309,0,4309
Donita,F,100,4305,0,4305
Soraya,F,100,4305,0,4305
Cassondra,F,100,4300,0,4300
Emani,F,94,4019,276,4295
Ishmael,M,100,0,4294,4294
Kendyl,F,98,4196,98,4294
Everette,M,98,71,4221,4292
Carin,F,100,4279,0,4279
Pennie,F,100,4278,0,4278
Norberto,M,100,0,4277,4277
Shoshana,F,100,4276,0,4276
Ophelia,F,100,4275,0,4275
Trystan,M,86,619,3656,4275
Hakeem,M,100,0,4274,4274
Trevin,M,100,0,4269,4269
Kylah,F,100,4268,0,4268
Harlee,F,94,4031,236,4267
Gisele,F,100,4262,0,4262
Val,M,72,1177,3084,4261
Anitra,F,100,4260,0,4260
Denisha,F,100,4260,0,4260
Oakley,M,60,1697,2563,4260
Kaylene,F,100,4259,0,4259
Gannon,M,100,0,4258,4258
Bradyn,M,95,217,4040,4257
Daniele,F,83,3541,716,4257
Shanelle,F,100,4252,0,4252
Yisroel,M,100,0,4246,4246
Essie,F,96,4088,157,4245
Hezekiah,M,100,5,4240,4245
Tremaine,M,93,288,3955,4243
Elida,F,100,4242,0,4242
Briar,M,68,1347,2894,4241
Marcell,M,87,538,3698,4236
Marilee,F,100,4235,0,4235
Migdalia,F,100,4228,5,4233
Rayan,M,86,596,3632,4228
Abner,M,100,0,4226,4226
Dylon,M,100,0,4224,4224
Shavon,F,91,3862,362,4224
Darleen,F,100,4223,0,4223
Elianna,F,100,4219,0,4219
Hadassah,F,100,4219,0,4219
Page,F,82,3440,779,4219
Annalee,F,100,4217,0,4217
Natali,F,100,4215,0,4215
Cambria,F,100,4213,0,4213
Shasta,F,100,4198,15,4213
Jeramiah,M,100,0,4209,4209
Justyn,M,97,131,4078,4209
Vernell,F,52,2176,2033,4209
Deasia,F,100,4208,0,4208
Aditya,M,100,5,4202,4207
Torey,M,67,1408,2795,4203
Nettie,F,100,4201,0,4201
Samatha,F,100,4198,0,4198
Anjelica,F,100,4197,0,4197
Jacquelynn,F,100,4193,0,4193
Crista,F,100,4192,0,4192
Melony,F,100,4187,0,4187
Fern,F,99,4154,31,4185
Mordechai,M,100,0,4180,4180
Catina,F,100,4171,8,4179
Murphy,M,81,796,3383,4179
Lianna,F,100,4173,0,4173
Tai,M,60,1661,2510,4171
Tawny,F,100,4169,0,4169
Chrissy,F,100,4158,0,4158
Jannie,F,100,4157,0,4157
Antonette,F,100,4155,0,4155
Stephaine,F,100,4155,0,4155
Jeremie,M,98,70,4082,4152
Laine,F,67,2773,1378,4151
Kirstie,F,100,4150,0,4150
Malika,F,99,4113,36,4149
Marti,F,95,3932,216,4148
Debrah,F,100,4143,0,4143
Storm,M,64,1495,2643,4138
Davonte,M,100,5,4128,4133
Dedrick,M,100,16,4117,4133
Jovany,M,100,11,4121,4132
Aydin,M,96,184,3940,4124
Jovanny,M,100,16,4106,4122
Ladarius,M,100,0,4122,4122
Carie,F,100,4120,0,4120
Tresa,F,100,4118,0,4118
Darrian,M,77,964,3152,4116
Malka,F,100,4111,5,4116
Renea,F,100,4116,0,4116
Cecile,F,100,4107,5,4112
Monet,F,100,4106,6,4112
China,F,100,4101,10,4111
Markell,M,95,219,3887,4106
Cathie,F,100,4105,0,4105
Nyah,F,100,4099,5,4104
Zelda,F,100,4104,0,4104
Codie,M,61,1608,2493,4101
Darrion,M,96,149,3952,4101
Gilda,F,100,4100,0,4100
Julisa,F,100,4097,0,4097
Malaya,F,100,4093,0,4093
Ryne,M,99,31,4060,4091
Franchesca,F,100,4088,0,4088
Charlize,F,100,4087,0,4087
Alva,F,55,2267,1818,4085
Kasie,F,99,4061,21,4082
Melia,F,100,4080,0,4080
Mikael,M,93,286,3792,4078
Leesa,F,100,4071,0,4071
Carmelita,F,100,4068,0,4068
Jaedyn,F,58,2357,1710,4067
Terrill,M,88,491,3576,4067
Jacinda,F,100,4066,0,4066
Aleta,F,100,4064,0,4064
Odessa,F,99,4032,31,4063
Konnor,M,98,81,3978,4059
Bowen,M,98,61,3996,4057
Charleen,F,100,4055,0,4055
Tawanda,F,100,4048,0,4048
Bilal,M,100,5,4042,4047
Jolynn,F,100,4047,0,4047
Iyanna,F,100,4046,0,4046
Samual,M,100,0,4044,4044
Leopoldo,M,100,0,4043,4043
Selma,F,99,4015,28,4043
Elian,M,99,44,3996,4040
Roseanna,F,100,4039,0,4039
Zainab,F,100,4038,0,4038
Lucio,M,100,0,4037,4037
Immanuel,M,100,0,4036,4036
Haiden,M,69,1244,2789,4033
Tiera,F,100,4026,6,4032
Delvin,M,99,22,4009,4031
Eleazar,M,100,7,4023,4030
Andi,F,83,3360,669,4029
Neha,F,100,4026,0,4026
Braulio,M,100,0,4021,4021
Jelani,M,91,380,3641,4021
Alba,F,100,4009,10,4019
Joellen,F,100,4015,0,4015
Adalberto,M,100,0,4010,4010
Jasiah,M,89,456,3554,4010
Viridiana,F,100,4004,5,4009
Sherita,F,100,4007,0,4007
Chiara,F,100,4004,0,4004
Anisha,F,100,4003,0,4003
Dameon,M,100,0,4003,4003
Zina,F,100,3996,5,4001
Dannielle,F,100,3998,0,3998
Linette,F,100,3995,0,3995
Markel,M,97,121,3874,3995
Tasia,F,100,3995,0,3995
Slade,M,100,0,3993,3993
Clement,M,100,0,3992,3992
Estefani,F,100,3975,16,3991
Emmalyn,F,100,3989,0,3989
Zahra,F,100,3989,0,3989
Holley,F,99,3928,57,3985
Brogan,M,82,714,3269,3983
Mavis,F,100,3975,5,3980
Melva,F,100,3978,0,3978
Gil,M,100,0,3977,3977
Priscila,F,100,3971,0,3971
Timmothy,M,100,0,3971,3971
Alfonzo,M,100,0,3969,3969
Lorinda,F,100,3969,0,3969
Gaige,M,97,104,3862,3966
Chelsi,F,100,3965,0,3965
Chante,F,99,3928,33,3961
Dudley,M,100,6,3954,3960
Nikia,F,94,3714,246,3960
Tenley,F,100,3960,0,3960
Adrain,M,86,558,3399,3957
Karan,F,66,2617,1340,3957
Carolynn,F,100,3956,0,3956
Marlyn,F,86,3396,559,3955
Yuri,F,60,2380,1575,3955
Toya,F,99,3930,23,3953
Porsha,F,100,3945,6,3951
Rana,F,98,3878,72,3950
Edie,F,100,3942,5,3947
Jessa,F,100,3947,0,3947
Lanie,F,100,3937,10,3947
Lottie,F,100,3947,0,3947
Krysten,F,100,3943,0,3943
Beverley,F,100,3919,17,3936
Jocelyne,F,100,3935,0,3935
Lillianna,F,100,3934,0,3934
Lailah,F,100,3933,0,3933
Quiana,F,100,3931,0,3931
Roel,M,100,0,3931,3931
Riya,F,100,3929,0,3929
Everardo,M,100,0,3927,3927
Shawnee,F,97,3807,120,3927
Blane,M,100,11,3914,3925
Lenard,M,100,0,3923,3923
Mikala,F,100,3912,10,3922
Celestine,F,100,3921,0,3921
Jaleel,M,99,24,3897,3921
Aaden,M,100,5,3915,3920
Calli,F,100,3920,0,3920
Savion,M,100,17,3903,3920
Cheryle,F,100,3917,0,3917
Johann,M,94,240,3677,3917
Alix,F,78,3066,848,3914
Elicia,F,100,3914,0,3914
Justen,M,100,5,3909,3914
Jannette,F,100,3913,0,3913
Arnoldo,M,100,0,3908,3908
Yamilet,F,100,3908,0,3908
Tabetha,F,100,3905,0,3905
Kenisha,F,100,3898,5,3903
Johnson,M,100,16,3886,3902
Shreya,F,100,3901,0,3901
Latrell,M,87,525,3370,3895
Katlynn,F,100,3893,0,3893
Brennon,M,100,0,3892,3892
Jourdan,F,57,2217,1669,3886
Ellery,F,65,2529,1356,3885
Goldie,F,98,3824,61,3885
Judd,M,100,0,3883,3883
Arlen,M,87,494,3388,3882
Jasmyne,F,100,3882,0,3882
Jefferey,M,100,0,3882,3882
Makai,M,95,199,3676,3875
Theodora,F,100,3867,6,3873
Dorinda,F,100,3872,0,3872
Ellison,F,69,2685,1186,3871
Tawanna,F,100,3862,0,3862
Fredric,M,100,0,3861,3861
Anastacia,F,100,3846,0,3846
Jerold,M,100,0,3842,3842
Kimberli,F,100,3840,0,3840
Gentry,M,61,1514,2323,3837
Daxton,M,100,0,3835,3835
Kindra,F,100,3833,0,3833
Darell,M,100,10,3822,3832
Mirna,F,100,3826,5,3831
Symone,F,100,3822,0,3822
Blythe,F,96,3656,165,3821
Cherri,F,100,3821,0,3821
Jacy,F,82,3146,674,3820
Kamilah,F,100,3820,0,3820
Mallorie,F,100,3819,0,3819
Kaeden,M,96,152,3666,3818
Louann,F,100,3818,0,3818
Aya,F,100,3815,0,3815
Jamia,F,100,3809,6,3815
Palmer,M,79,812,2999,3811
Oren,M,100,16,3792,3808
Jerica,F,100,3805,0,3805
Levon,M,94,244,3560,3804
Kyndal,F,97,3690,111,3801
Ila,F,100,3800,0,3800
Kristoffer,M,100,0,3793,3793
Risa,F,100,3793,0,3793
Dottie,F,100,3792,0,3792
Kalia,F,100,3790,0,3790
Meghann,F,100,3788,0,3788
Tangela,F,100,3783,0,3783
Ayleen,F,100,3782,0,3782
Cristine,F,100,3777,0,3777
Raymon,M,100,0,3777,3777
Debi,F,100,3776,0,3776
Socorro,F,92,3489,285,3774
Fredy,M,100,0,3772,3772
Arin,F,61,2285,1486,3771
Wes,M,100,0,3771,3771
Jerad,M,100,0,3769,3769
Tavon,M,98,78,3691,3769
Torrance,M,88,452,3317,3769
Lucius,M,100,0,3767,3767
Stanford,M,100,0,3765,3765
Delmar,M,100,17,3747,3764
Pricilla,F,100,3764,0,3764
Jaydin,M,72,1069,2694,3763
Carmel,F,90,3377,385,3762
Yaakov,M,100,0,3759,3759
Damarion,M,100,0,3757,3757
Paityn,F,99,3730,24,3754
Tremayne,M,99,39,3712,3751
Donta,M,98,91,3656,3747
Jaymie,F,89,3342,405,3747
Effie,F,100,3737,7,3744
Lucien,M,100,5,3738,3743
Karolyn,F,100,3741,0,3741
Milena,F,100,3740,0,3740
Laylah,F,100,3738,0,3738
Kalee,F,98,3669,68,3737
Rosendo,M,100,0,3736,3736
Audrianna,F,100,3735,0,3735
Kamille,F,100,3732,0,3732
Carrington,F,60,2237,1494,3731
Joseluis,M,100,0,3726,3726
Kegan,M,94,223,3498,3721
Arlette,F,100,3720,0,3720
Hasan,M,100,0,3720,3720
Bridger,M,100,0,3718,3718
Freeman,M,100,0,3718,3718
Blayne,M,90,366,3351,3717
Carlotta,F,100,3717,0,3717
Jered,M,100,0,3716,3716
Tarik,M,100,11,3704,3715
Alayah,F,100,3714,0,3714
Kellee,F,100,3698,16,3714
Camdyn,M,52,1786,1926,3712
Joselin,F,100,3712,0,3712
Sharee,F,100,3712,0,3712
Dick,M,100,0,3710,3710
Alaysia,F,100,3708,0,3708
Delanie,F,100,3708,0,3708
Rona,F,100,3708,0,3708
Cal,M,100,10,3697,3707
Yolonda,F,100,3707,0,3707
Malcom,M,100,0,3706,3706
Kadyn,M,67,1213,2491,3704
Alyvia,F,100,3703,0,3703
Yousef,M,100,0,3702,3702
Gisela,F,100,3701,0,3701
Ameer,M,100,0,3696,3696
Braedon,M,100,0,3694,3694
Barbie,F,100,3691,0,3691
Gracelynn,F,100,3691,0,3691
Lissa,F,100,3689,0,3689
Alisia,F,100,3688,0,3688
Niya,F,100,3686,0,3686
Douglass,M,100,5,3680,3685
Jerilyn,F,100,3685,0,3685
Rayshawn,M,95,179,3505,3684
Janiah,F,100,3683,0,3683
Kolten,M,100,0,3678,3678
Annetta,F,100,3676,0,3676
Shianne,F,100,3676,0,3676
Stefany,F,100,3676,0,3676
Cassius,M,100,0,3674,3674
Keyshawn,M,99,24,3646,3670
Zaniyah,F,100,3669,0,3669
Angelic,F,100,3668,0,3668
Tyrus,M,100,0,3668,3668
Abrianna,F,100,3664,0,3664
Corine,F,100,3663,0,3663
Loriann,F,100,3663,0,3663
Jonnie,F,68,2498,1164,3662
Gigi,F,100,3661,0,3661
Yessica,F,100,3656,0,3656
Shiela,F,100,3651,0,3651
Halley,F,99,3611,38,3649
Misha,F,90,3293,355,3648
Donn,M,98,62,3585,3647
Audriana,F,100,3646,0,3646
Barb,F,100,3646,0,3646
Delois,F,100,3646,0,3646
Martez,M,100,6,3638,3644
Everly,F,100,3638,5,3643
Horacio,M,100,0,3642,3642
Sabra,F,100,3641,0,3641
Ajay,M,100,5,3635,3640
Alethea,F,100,3639,0,3639
Von,M,92,273,3365,3638
Cris,M,71,1042,2594,3636
Gaye,F,100,3635,0,3635
Deondre,M,100,15,3618,3633
Tomeka,F,100,3627,6,3633
Gauge,M,100,0,3631,3631
Aidyn,M,82,660,2968,3628
Loni,F,97,3518,108,3626
Johnie,M,88,453,3172,3625
Fran,F,92,3340,284,3624
Jackelyn,F,100,3623,0,3623
Dru,M,61,1430,2192,3622
Janeth,F,100,3619,0,3619
Jericho,M,93,242,3376,3618
Nickie,F,75,2713,901,3614
Jeniffer,F,100,3609,0,3609
Alora,F,100,3608,0,3608
Kimberlie,F,100,3608,0,3608
Dionna,F,100,3601,5,3606
Stetson,M,100,0,3606,3606
Dayne,M,95,178,3426,3604
Deneen,F,100,3597,7,3604
Paulo,M,100,0,3604,3604
Doretha,F,100,3602,0,3602
Eula,F,100,3595,7,3602
Keren,F,100,3600,0,3600
Keyana,F,100,3600,0,3600
Stanton,M,100,0,3600,3600
Marshal,M,98,74,3524,3598
Melani,F,100,3595,0,3595
Ronna,F,100,3594,0,3594
Harriett,F,100,3593,0,3593
Trae,M,99,46,3541,3587
Delana,F,100,3585,0,3585
Kiran,M,53,1672,1913,3585
Adyson,F,99,3556,28,3584
Caron,F,75,2701,883,3584
Zeke,M,100,0,3584,3584
Raeann,F,100,3583,0,3583
Brittny,F,100,3578,0,3578
Jaquelin,F,100,3578,0,3578
Journee,F,99,3544,33,3577
Westin,M,100,0,3577,3577
Azalea,F,100,3574,0,3574
Kiarra,F,100,3574,0,3574
Yamileth,F,100,3574,0,3574
Bettye,F,100,3572,0,3572
Samaria,F,100,3569,0,3569
Gaven,M,100,0,3568,3568
Evonne,F,100,3567,0,3567
Napoleon,M,100,0,3567,3567
Arianne,F,100,3566,0,3566
Aleigha,F,100,3565,0,3565
Allegra,F,100,3564,0,3564
Kamren,M,88,436,3127,3563
Desean,M,100,11,3549,3560
Arlo,M,98,67,3491,3558
Delphine,F,100,3556,0,3556
Tierney,F,99,3531,23,3554
Lucie,F,100,3553,0,3553
Barron,M,100,0,3552,3552
Elwood,M,100,0,3552,3552
Reinaldo,M,100,0,3551,3551
Bethanie,F,100,3549,0,3549
Nereida,F,100,3543,6,3549
Annaliese,F,100,3547,0,3547
Zena,F,100,3546,0,3546
Mikal,M,85,532,3009,3541
Montrell,M,99,28,3513,3541
Ever,M,76,855,2684,3539
Juwan,M,100,5,3531,3536
Shmuel,M,100,0,3531,3531
Dequan,M,100,5,3525,3530
Rowena,F,100,3530,0,3530
Avi,M,89,395,3133,3528
Emersyn,F,99,3476,50,3526
Sutton,M,53,1673,1853,3526
Belle,F,100,3525,0,3525
Callen,M,90,365,3160,3525
Alaya,F,100,3524,0,3524
Tristyn,F,52,1846,1677,3523
Torin,M,96,153,3368,3521
Carnell,M,96,142,3378,3520
Angus,M,100,0,3513,3513
Christofer,M,100,0,3513,3513
Langston,M,94,215,3297,3512
Malorie,F,100,3512,0,3512
Rachell,F,100,3512,0,3512
Debbra,F,100,3511,0,3511
Bishop,M,100,5,3503,3508
Charis,F,99,3462,46,3508
Rianna,F,100,3508,0,3508
Kwame,M,99,38,3467,3505
Jacie,F,100,3499,5,3504
Winfred,M,98,63,3441,3504
Adison,F,83,2892,611,3503
Tenisha,F,100,3501,0,3501
Nan,F,100,3495,0,3495
Colter,M,100,0,3494,3494
Kayson,M,96,154,3340,3494
Thor,M,100,0,3493,3493
Fermin,M,100,0,3492,3492
Alek,M,98,68,3423,3491
Demetri,M,95,158,3332,3490
Shlomo,M,100,0,3487,3487
Deonna,F,100,3481,5,3486
Ruthann,F,100,3484,0,3484
Erinn,F,96,3340,143,3483
Tiarra,F,100,3483,0,3483
Giavanna,F,100,3482,0,3482
Carlin,M,55,1567,1914,3481
Karleigh,F,100,3480,0,3480
Amia,F,100,3479,0,3479
Chantell,F,100,3473,5,3478
Cyndi,F,100,3477,0,3477
Lorelai,F,100,3475,0,3475
Merrick,M,91,327,3147,3474
Freida,F,100,3469,0,3469
Amar,M,95,166,3302,3468
Meryl,F,98,3409,59,3468
Stevan,M,100,0,3466,3466
Suzy,F,100,3465,0,3465
Analisa,F,100,3463,0,3463
Cyril,M,100,10,3452,3462
Pasquale,M,100,0,3462,3462
Bayleigh,F,100,3461,0,3461
Ariah,F,99,3438,21,3459
Ely,M,90,346,3113,3459
Rina,F,100,3459,0,3459
Cailin,F,99,3428,30,3458
Margret,F,100,3458,0,3458
Odin,M,100,0,3458,3458
Rich,M,100,0,3458,3458
Montgomery,M,93,259,3198,3457
Vida,F,99,3419,38,3457
Aliah,F,100,3455,0,3455
Davida,F,100,3450,5,3455
Carri,F,100,3454,0,3454
Kirt,M,100,0,3454,3454
Nena,F,100,3453,0,3453
Isha,F,100,3451,0,3451
Talan,M,99,46,3405,3451
Acacia,F,100,3447,0,3447
Shanita,F,100,3447,0,3447
Constantine,M,99,26,3418,3444
Javonte,M,99,39,3402,3441
Yair,M,100,0,3441,3441
Elinor,F,100,3438,0,3438
Afton,F,90,3083,350,3433
Emmaline,F,100,3432,0,3432
Alea,F,100,3431,0,3431
Nate,M,91,303,3126,3429
Krishna,M,50,1713,1715,3428
Derwin,M,100,0,3423,3423
Tracee,F,100,3412,10,3422
Leena,F,100,3421,0,3421
Demetra,F,100,3408,12,3420
Vern,M,98,83,3336,3419
Dorthy,F,100,3417,0,3417
Juancarlos,M,100,0,3417,3417
Naima,F,100,3416,0,3416
Eugenio,M,100,0,3415,3415
Shanae,F,100,3415,0,3415
Tyanna,F,100,3415,0,3415
Ritchie,M,100,5,3409,3414
Taniyah,F,100,3414,0,3414
Elysia,F,100,3405,7,3412
Hamilton,M,100,0,3411,3411
Liane,F,100,3410,0,3410
Haden,M,96,144,3262,3406
Kahlil,M,100,0,3406,3406
Lorenza,M,57,1472,1933,3405
Cristofer,M,100,0,3404,3404
Jordynn,F,98,3318,85,3403
Michale,M,90,327,3076,3403
Nedra,F,100,3402,0,3402
Dillion,M,100,0,3401,3401
Christel,F,100,3396,0,3396
Jory,M,86,475,2921,3396
Harlow,F,88,2992,402,3394
Jarrell,M,99,22,3370,3392
Mayson,M,75,841,2551,3392
Caesar,M,100,0,3391,3391
Jarett,M,100,0,3389,3389
Aline,F,100,3387,0,3387
Wynter,F,98,3306,79,3385
Nydia,F,100,3384,0,3384
Adolph,M,100,0,3382,3382
Caprice,F,95,3218,164,3382
Delano,M,100,10,3372,3382
Jaheim,M,100,5,3375,3380
Kimberlyn,F,100,3380,0,3380
Brien,M,100,5,3373,3378
Dyllan,M,89,384,2993,3377
Citlali,F,100,3373,0,3373
Keanna,F,100,3373,0,3373
Merissa,F,100,3373,0,3373
Kevan,M,99,48,3323,3371
Braylee,F,99,3321,49,3370
Treyvon,M,100,0,3368,3368
Alain,M,100,6,3361,3367
Kaelin,F,76,2543,824,3367
Omarion,M,100,5,3361,3366
Rosalee,F,100,3366,0,3366
Jeremey,M,100,0,3365,3365
Leola,F,100,3363,0,3363
Jeramie,M,99,41,3321,3362
Anibal,M,99,22,3338,3360
Torrie,F,83,2774,586,3360
Zaid,M,100,0,3360,3360
Del,M,89,354,3005,3359
Kyron,M,100,0,3358,3358
Merritt,M,57,1428,1930,3358
Myesha,F,100,3358,0,3358
Demetris,M,73,892,2465,3357
Cailey,F,100,3355,0,3355
Sequoia,F,91,3038,317,3355
Kiya,F,99,3336,18,3354
Maiya,F,100,3354,0,3354
Sahara,F,100,3348,5,3353
Analise,F,100,3352,0,3352
Rishi,M,100,0,3352,3352
Isaak,M,100,0,3351,3351
Ethen,M,100,0,3350,3350
Alli,F,100,3341,5,3346
Annamaria,F,100,3345,0,3345
Magen,F,100,3344,0,3344
Tyquan,M,100,10,3332,3342
Keyonna,F,100,3340,0,3340
Marko,M,100,0,3340,3340
Rolanda,F,99,3309,31,3340
Demetrice,F,52,1749,1590,3339
Magdalene,F,100,3338,0,3338
Jarret,M,100,0,3337,3337
Mykel,M,80,663,2674,3337
Carsen,M,77,762,2574,3336
Mylee,F,100,3331,0,3331
Miguelangel,M,100,0,3329,3329
Sana,F,100,3323,5,3328
Leta,F,100,3327,0,3327
Abelardo,M,100,0,3326,3326
Makala,F,100,3321,5,3326
Destany,F,100,3324,0,3324
Venita,F,100,3324,0,3324
Sedrick,M,100,0,3322,3322
Lilith,F,100,3321,0,3321
Isreal,M,98,52,3267,3319
Jaslyn,F,100,3318,0,3318
Kaelynn,F,100,3318,0,3318
Karena,F,100,3318,0,3318
Kymani,M,79,687,2629,3316
Yulissa,F,100,3316,0,3316
Frieda,F,100,3312,0,3312
Joseline,F,100,3312,0,3312
Darrien,M,89,361,2950,3311
Charisma,F,100,3310,0,3310
Deedee,F,100,3308,0,3308
Sheyla,F,100,3306,0,3306
Kalynn,F,99,3272,33,3305
Ariane,F,100,3297,5,3302
Allyn,M,52,1574,1727,3301
Payten,F,83,2729,570,3299
Azucena,F,100,3298,0,3298
Cinda,F,100,3298,0,3298
Vidal,M,100,10,3286,3296
Mikah,M,61,1284,2011,3295
Lona,F,100,3293,0,3293
Berkley,F,71,2323,968,3291
Devorah,F,100,3291,0,3291
Romona,F,100,3291,0,3291
Ciarra,F,100,3289,0,3289
Jullian,M,72,936,2353,3289
Leeanna,F,100,3289,0,3289
Spring,F,100,3287,0,3287
Emile,M,86,456,2829,3285
Kera,F,100,3284,0,3284
Lorne,M,99,33,3249,3282
Yitzchok,M,100,0,3282,3282
Oralia,F,100,3279,0,3279
Janaya,F,100,3277,0,3277
Leana,F,100,3277,0,3277
Brittaney,F,100,3275,0,3275
Marielle,F,100,3275,0,3275
Dennise,F,97,3191,83,3274
Fisher,M,99,17,3257,3274
Aarav,M,100,0,3271,3271
Buffy,F,100,3263,6,3269
Earline,F,100,3269,0,3269
Larisa,F,100,3268,0,3268
Angella,F,100,3267,0,3267
Harlie,F,97,3159,105,3264
Jerel,M,100,0,3263,3263
Canaan,M,92,251,3008,3259
Maile,F,100,3259,0,3259
Dajuan,M,100,0,3258,3258
Samiyah,F,100,3256,0,3256
Echo,F,98,3180,75,3255
Spenser,M,89,350,2905,3255
Kailynn,F,100,3253,0,3253
Tyrel,M,100,0,3253,3253
Beckham,M,99,22,3230,3252
Millard,M,100,0,3252,3252
Callan,M,69,1001,2250,3251
Jacki,F,100,3242,5,3247
Jacobi,M,91,278,2969,3247
Shimon,M,100,0,3247,3247
Rachele,F,100,3246,0,3246
Audie,M,91,278,2967,3245
Corwin,M,100,0,3245,3245
Lelia,F,100,3245,0,3245
Raylene,F,100,3245,0,3245
Jaycob,M,100,0,3244,3244
Emalee,F,100,3243,0,3243
Leighann,F,100,3241,0,3241
Carsyn,F,71,2297,943,3240
Georgianna,F,100,3240,0,3240
Malina,F,100,3240,0,3240
Dakoda,M,81,628,2611,3239
Mica,F,77,2496,742,3238
Pranav,M,100,0,3236,3236
Rebecka,F,100,3229,0,3229
Aries,M,58,1352,1876,3228
Arman,M,100,0,3227,3227
Izabelle,F,100,3227,0,3227
Nicklaus,M,100,0,3227,3227
Damari,M,82,591,2633,3224
Eloisa,F,100,3224,0,3224
Tamie,F,100,3224,0,3224
Britta,F,100,3221,0,3221
Diya,F,100,3209,12,3221
Randa,F,100,3221,0,3221
Aiyanna,F,100,3220,0,3220
Torri,F,89,2879,341,3220
Rahul,M,100,0,3219,3219
Jaxton,M,100,0,3216,3216
Delisa,F,100,3215,0,3215
Kensley,F,94,3027,188,3215
Eamon,M,100,0,3214,3214
Analia,F,100,3212,0,3212
Geovanni,M,100,0,3211,3211
Lexis,F,99,3164,43,3207
Williams,M,99,24,3183,3207
Cherrie,F,100,3206,0,3206
Mahogany,F,100,3206,0,3206
Aubry,F,81,2593,612,3205
Marni,F,100,3200,5,3205
Boris,M,100,0,3201,3201
Chassidy,F,100,3201,0,3201
Ines,F,94,3001,200,3201
Dasha,F,100,3200,0,3200
Fritz,M,100,0,3200,3200
Keyanna,F,100,3198,0,3198
Aubrianna,F,100,3196,0,3196
Magali,F,100,3190,6,3196
Sharyn,F,100,3194,0,3194
Abdiel,M,100,0,3193,3193
Janey,F,100,3187,0,3187
Hershel,M,100,0,3185,3185
Elan,M,79,678,2506,3184
Montserrat,F,100,3184,0,3184
Winona,F,100,3183,0,3183
Burt,M,100,0,3181,3181
Jonatan,M,100,0,3181,3181
Jamin,M,96,138,3040,3178
Carolann,F,100,3176,0,3176
Kaytlin,F,100,3176,0,3176
Kierstin,F,100,3176,0,3176
Sanjuanita,F,100,3175,0,3175
Callum,M,100,0,3174,3174
Elayna,F,100,3174,0,3174
Sherilyn,F,100,3172,0,3172
Sol,F,55,1743,1429,3172
Cristi,F,100,3170,0,3170
Gibson,M,97,94,3076,3170
Irwin,M,100,0,3169,3169
Jenae,F,100,3169,0,3169
Karolina,F,100,3169,0,3169
Lesia,F,100,3169,0,3169
Baylor,M,77,715,2453,3168
Patricio,M,100,5,3162,3167
Nicholaus,M,100,0,3166,3166
Vannessa,F,100,3166,0,3166
Annabell,F,100,3165,0,3165
Janee,F,100,3159,6,3165
Tripp,M,100,0,3164,3164
Kentrell,M,98,66,3097,3163
Malena,F,100,3159,0,3159
Rileigh,F,98,3109,50,3159
Lylah,F,100,3157,0,3157
Zaira,F,100,3155,0,3155
Bradlee,M,95,157,2996,3153
Codey,M,99,28,3125,3153
Aletha,F,100,3152,0,3152
Ashlea,F,100,3151,0,3151
Aubri,F,100,3151,0,3151
Karsen,M,59,1296,1852,3148
Jaxen,M,99,44,3103,3147
Denton,M,100,0,3146,3146
Kecia,F,100,3146,0,3146
Machelle,F,100,3146,0,3146
Olin,M,100,0,3146,3146
Zandra,F,100,3144,0,3144
Dilan,M,98,77,3066,3143
Kora,F,100,3142,0,3142
Rio,M,59,1279,1863,3142
Ammon,M,100,0,3141,3141
Daryn,M,72,889,2251,3140
Andie,F,94,2955,184,3139
Braelynn,F,97,3057,81,3138
Promise,F,95,2962,172,3134
Lennox,M,82,576,2557,3133
Ronin,M,98,53,3078,3131
Deontae,M,100,0,3129,3129
Parris,M,53,1477,1649,3126
Evin,M,85,465,2660,3125
Janene,F,100,3124,0,3124
Cammie,F,100,3111,12,3123
Kalin,M,53,1466,1657,3123
Javan,M,99,43,3079,3122
Danyel,F,80,2495,625,3120
Leander,M,99,23,3096,3119
Brieanna,F,100,3117,0,3117
Noble,M,98,68,3049,3117
Alisson,F,100,3116,0,3116
Kenan,M,99,30,3084,3114
Autum,F,100,3113,0,3113
Neveah,F,100,3113,0,3113
Christoper,M,100,0,3112,3112
Leora,F,100,3111,0,3111
Ria,F,100,3111,0,3111
Sylas,M,100,5,3106,3111
Jaycie,F,100,3105,5,3110
Latesha,F,100,3109,0,3109
Kelcie,F,99,3069,37,3106
Danya,F,99,3076,29,3105
Natosha,F,100,3105,0,3105
Beulah,F,100,3104,0,3104
Booker,M,100,0,3104,3104
Fonda,F,100,3103,0,3103
Kathryne,F,100,3103,0,3103
Maynard,M,100,0,3100,3100
Benjamen,M,100,0,3098,3098
Jayvon,M,100,0,3098,3098
Krystin,F,100,3094,0,3094
Reymundo,M,100,0,3094,3094
Timmie,M,92,254,2840,3094
Baylie,F,99,3062,26,3088
Augusta,F,81,2494,593,3087
Lavonda,F,100,3087,0,3087
Breeanna,F,100,3086,0,3086
Vianey,F,100,3086,0,3086
Leonor,F,100,3079,5,3084
Pearlie,F,98,3008,76,3084
Concetta,F,100,3083,0,3083
Charleigh,F,100,3082,0,3082
Josey,F,74,2287,795,3082
Enrico,M,100,0,3080,3080
Vivien,F,100,3080,0,3080
Magnolia,F,100,3077,0,3077
Henri,M,94,181,2892,3073
Rhyan,F,61,1861,1212,3073
Hilario,M,100,0,3072,3072
Yara,F,100,3072,0,3072
Devlin,M,95,158,2913,3071
Elma,F,99,3048,20,3068
Khadija,F,100,3068,0,3068
Artis,M,92,256,2811,3067
Lili,F,100,3067,0,3067
Ridge,M,100,0,3066,3066
Jessalyn,F,100,3065,0,3065
Cloe,F,100,3063,0,3063
Shonna,F,100,3063,0,3063
Keona,F,98,2997,65,3062
Robb,M,100,0,3061,3061
Rowdy,M,100,5,3056,3061
Homero,M,100,0,3059,3059
Kary,F,60,1835,1224,3059
Lanita,F,100,3058,0,3058
Saylor,F,91,2777,280,3057
Chelsy,F,100,3053,0,3053
Maddie,F,100,3053,0,3053
Odalys,F,100,3053,0,3053
Jeanetta,F,100,3050,0,3050
Alta,F,100,3044,0,3044
Carlyn,F,100,3034,10,3044
Jalissa,F,100,3044,0,3044
Rubin,M,99,16,3026,3042
Shaelyn,F,100,3042,0,3042
Bronwyn,F,100,3041,0,3041
Abbygail,F,100,3039,0,3039
Yandel,M,100,9,3030,3039
Aislinn,F,100,3038,0,3038
Gareth,M,100,5,3031,3036
Stormie,F,100,3035,0,3035
Jaleesa,F,100,3028,6,3034
Jodee,F,99,3001,33,3034
Rashaun,M,94,182,2851,3033
Haydee,F,100,3030,0,3030
Rashaad,M,100,0,3030,3030
Marita,F,100,3028,0,3028
Karah,F,100,3026,0,3026
Trenten,M,100,0,3025,3025
Princeton,M,100,0,3022,3022
Amarion,M,99,44,2977,3021
Tobi,F,87,2627,392,3019
Kelsy,F,99,2979,39,3018
Jerrie,F,95,2854,163,3017
Yanira,F,100,3017,0,3017
Trish,F,100,3016,0,3016
Ayaan,M,96,121,2893,3014
Clementine,F,100,3014,0,3014
Maisie,F,100,3014,0,3014
Randel,M,99,25,2985,3010
Valentine,M,73,808,2202,3010
Shandra,F,100,3006,0,3006
Courtland,M,93,198,2805,3003
Makenzi,F,100,3003,0,3003
Milissa,F,100,3003,0,3003
Paolo,M,100,0,3003,3003
Elly,F,100,2991,10,3001
Luigi,M,100,0,3001,3001
Tanna,F,100,3000,0,3000
Angeles,F,98,2940,59,2999
Sebastien,M,100,0,2998,2998
Lilyanna,F,100,2996,0,2996
Azul,F,98,2949,45,2994
Avraham,M,100,0,2992,2992
Cael,M,100,13,2977,2990
Krish,M,100,10,2980,2990
Blaire,F,98,2935,54,2989
Chip,M,100,0,2989,2989
Wren,F,84,2501,487,2988
Carisa,F,100,2983,0,2983
Tamiko,F,99,2939,42,2981
Suzie,F,100,2980,0,2980
Seneca,M,52,1441,1537,2978
Torie,F,91,2709,268,2977
Amiah,F,100,2973,0,2973
Collins,M,60,1176,1797,2973
Glory,F,100,2963,8,2971
Georgiana,F,100,2970,0,2970
Kit,M,68,951,2018,2969
Rashida,F,100,2963,6,2969
Felton,M,100,0,2967,2967
Alanah,F,100,2966,0,2966
Brookelyn,F,100,2965,0,2965
Leeanne,F,100,2964,0,2964
Isa,F,50,1493,1470,2963
Flynn,M,91,273,2688,2961
Jaye,F,70,2079,882,2961
Malaki,M,100,5,2956,2961
Sabastian,M,100,0,2961,2961
Kymberly,F,100,2960,0,2960
Nailah,F,100,2960,0,2960
Linden,M,62,1122,1837,2959
Micaiah,M,63,1095,1864,2959
Parrish,M,86,426,2533,2959
Concepcion,F,83,2441,515,2956
Luc,M,100,0,2956,2956
Montez,M,95,156,2799,2955
Sofie,F,100,2955,0,2955
Curtiss,M,100,0,2953,2953
Gray,M,92,243,2710,2953
Jordana,F,100,2953,0,2953
Mikhail,M,99,24,2929,2953
Elin,F,97,2866,85,2951
Jacqulyn,F,100,2951,0,2951
Cy,M,100,10,2940,2950
Dejah,F,100,2945,5,2950
Jakobe,M,100,0,2949,2949
Jaydan,M,81,552,2397,2949
Art,M,100,0,2948,2948
Felice,F,91,2686,262,2948
Ivey,F,78,2285,662,2947
Torrence,M,94,166,2780,2946
Berry,M,95,155,2789,2944
Nakita,F,99,2913,28,2941
Shavonne,F,100,2940,0,2940
Maxx,M,99,37,2902,2939
Emmie,F,100,2938,0,2938
Konrad,M,100,0,2937,2937
Kye,M,92,229,2707,2936
Shirlene,F,100,2936,0,2936
Kiah,F,93,2731,204,2935
Gabe,M,100,0,2934,2934
Sherryl,F,100,2934,0,2934
Cameryn,F,79,2309,622,2931
Rueben,M,100,0,2930,2930
Meggan,F,100,2928,0,2928
Damarcus,M,100,0,2926,2926
Alise,F,100,2925,0,2925
Buck,M,100,0,2925,2925
Shaunna,F,100,2921,0,2921
Genna,F,100,2920,0,2920
Jemma,F,100,2920,0,2920
Aedan,M,99,43,2876,2919
Milana,F,100,2918,0,2918
Giada,F,100,2917,0,2917
Nichol,F,99,2895,22,2917
Retha,F,100,2917,0,2917
Lu,F,100,2909,6,2915
Amit,M,94,177,2736,2913
Derrek,M,100,0,2913,2913
Kairi,F,92,2673,240,2913
Shan,M,72,808,2105,2913
Jacinta,F,100,2910,0,2910
Abrielle,F,100,2909,0,2909
Dionte,M,99,26,2882,2908
Erasmo,M,100,0,2908,2908
Kalea,F,100,2908,0,2908
Mickie,F,84,2432,476,2908
Nikko,M,94,166,2742,2908
Grey,M,87,365,2542,2907
Ike,M,100,0,2904,2904
Candida,F,100,2901,0,2901
Aviana,F,100,2900,0,2900
Meranda,F,100,2899,0,2899
Deandrea,F,76,2188,710,2898
Leonidas,M,100,0,2898,2898
Kingsley,M,83,479,2416,2895
Jenessa,F,100,2894,0,2894
Nalani,F,100,2892,0,2892
Naya,F,100,2892,0,2892
Merri,F,100,2891,0,2891
Osbaldo,M,100,0,2891,2891
Charlette,F,100,2890,0,2890
Evalyn,F,100,2890,0,2890
Javen,M,97,100,2790,2890
Elina,F,100,2889,0,2889
Franklyn,M,100,0,2889,2889
Nell,F,100,2883,6,2889
Antonella,F,100,2888,0,2888
Jermiah,M,96,115,2773,2888
Clarisa,F,100,2887,0,2887
Avah,F,100,2886,0,2886
Devonta,M,99,36,2849,2885
Apryl,F,100,2884,0,2884
Karsten,M,95,157,2727,2884
Mirella,F,100,2883,0,2883
Rayden,M,94,186,2696,2882
Wilton,M,100,0,2882,2882
Dariel,M,88,358,2523,2881
Jovanna,F,100,2881,0,2881
Debbi,F,100,2880,0,2880
Haily,F,100,2880,0,2880
Candie,F,100,2878,0,2878
Lathan,M,100,0,2878,2878
Tamala,F,100,2878,0,2878
Kaylea,F,100,2877,0,2877
Jamee,F,92,2658,218,2876
Keelan,M,90,293,2583,2876
Daija,F,100,2874,0,2874
Deanthony,M,100,0,2874,2874
Obed,M,100,0,2874,2874
Wally,M,99,17,2857,2874
Keturah,F,100,2873,0,2873
Auston,M,100,0,2872,2872
Honesty,F,100,2871,0,2871
Jenniffer,F,100,2870,0,2870
Rowen,M,73,789,2081,2870
Mohamad,M,100,0,2869,2869
Manny,M,100,0,2868,2868
Arnav,M,100,0,2866,2866
Gerson,M,100,0,2865,2865
Latia,F,100,2865,0,2865
Kenji,M,99,33,2831,2864
Lamonte,M,100,0,2864,2864
Kenyetta,F,96,2735,128,2863
Talisha,F,100,2862,0,2862
Zulema,F,100,2862,0,2862
Dorcas,F,100,2861,0,2861
Kayce,F,95,2722,138,2860
Trayvon,M,100,0,2860,2860
Ronni,F,98,2804,55,2859
Julieann,F,100,2856,0,2856
Gian,M,100,0,2855,2855
Zaida,F,100,2855,0,2855
Halee,F,100,2854,0,2854
Herschel,M,100,0,2854,2854
Shawnna,F,100,2854,0,2854
Zakiya,F,100,2854,0,2854
Luella,F,100,2853,0,2853
Shawanda,F,100,2853,0,2853
Suzann,F,100,2852,0,2852
Velvet,F,100,2852,0,2852
Gracyn,F,97,2768,83,2851
Tiesha,F,100,2848,0,2848
Maliah,F,100,2847,0,2847
Jaya,F,99,2823,23,2846
Najee,M,85,417,2429,2846
Sari,F,99,2823,22,2845
Octavius,M,99,15,2827,2842
Daniell,F,72,2048,793,2841
Kyara,F,100,2840,0,2840
Scout,F,68,1934,906,2840
Karlene,F,100,2837,0,2837
Aminah,F,100,2833,0,2833
Kyson,M,100,0,2833,2833
Casen,M,99,17,2815,2832
Jaret,M,99,22,2809,2831
Izayah,M,100,0,2828,2828
Mercedez,F,100,2826,0,2826
Nisha,F,100,2826,0,2826
Ernestina,F,100,2825,0,2825
Luiz,M,100,0,2825,2825
Danyell,F,89,2500,324,2824
Nila,F,100,2824,0,2824
Samiya,F,100,2824,0,2824
Brittnee,F,100,2822,0,2822
Dian,F,97,2740,82,2822
Zariyah,F,100,2816,0,2816
Keyona,F,100,2815,0,2815
Aleshia,F,100,2812,0,2812
Tamatha,F,100,2811,0,2811
Ola,F,99,2770,40,2810
Dalilah,F,100,2808,0,2808
Shaila,F,100,2808,0,2808
Tavares,M,99,23,2785,2808
Brighton,M,66,964,1843,2807
Aleisha,F,100,2805,0,2805
Kael,M,100,10,2791,2801
Braylin,M,64,1017,1781,2798
Ford,M,100,0,2796,2796
Marcelle,F,84,2359,437,2796
Imari,F,76,2112,680,2792
Mackenna,F,100,2784,8,2792
Marlie,F,100,2792,0,2792
Veronika,F,100,2792,0,2792
Kathlyn,F,100,2790,0,2790
Hilton,M,100,11,2777,2788
Legend,M,88,326,2461,2787
Tomika,F,100,2781,5,2786
Demarion,M,100,0,2784,2784
Len,M,97,97,2687,2784
Jonelle,F,99,2762,21,2783
Rilee,F,89,2464,318,2782
Trevion,M,100,0,2782,2782
Brookelynn,F,100,2781,0,2781
Arie,F,52,1457,1322,2779
Lluvia,F,100,2778,0,2778
Mirian,F,100,2777,0,2777
Brandin,M,95,137,2639,2776
Lino,M,100,0,2776,2776
Ambrose,M,100,0,2772,2772
Jailene,F,100,2771,0,2771
Willy,M,99,21,2750,2771
Christan,M,51,1366,1403,2769
Desi,M,75,701,2068,2769
Izabel,F,100,2769,0,2769
Rochel,F,100,2766,0,2766
Margery,F,100,2763,0,2763
Wylie,M,90,280,2483,2763
Ellyn,F,100,2762,0,2762
Chevy,M,83,460,2301,2761
Jeni,F,100,2761,0,2761
Jovon,M,90,289,2472,2761
Antone,M,100,10,2748,2758
Akilah,F,100,2757,0,2757
Cristen,F,95,2630,126,2756
Chyanne,F,100,2749,5,2754
Salem,M,51,1342,1410,2752
Ceasar,M,100,0,2751,2751
Elora,F,100,2750,0,2750
Becca,F,100,2745,0,2745
Katherin,F,100,2745,0,2745
Kelcey,F,75,2053,692,2745
Christianna,F,100,2744,0,2744
Jamiya,F,100,2743,0,2743
Nixon,M,96,119,2623,2742
Magan,F,100,2739,0,2739
Charlton,M,100,5,2733,2738
Delma,F,90,2459,279,2738
Adamaris,F,100,2737,0,2737
Bethann,F,100,2736,0,2736
Vinson,M,100,0,2736,2736
Corban,M,100,6,2729,2735
Destinie,F,100,2734,0,2734
Maricruz,F,100,2734,0,2734
Denita,F,100,2733,0,2733
Dione,F,80,2191,542,2733
Jedediah,M,100,0,2730,2730
Juniper,F,99,2709,21,2730
Marleen,F,100,2730,0,2730
Kyan,M,95,132,2597,2729
Laquisha,F,100,2728,0,2728
Thiago,M,100,0,2727,2727
Micky,M,83,470,2255,2725
Dwaine,M,100,0,2724,2724
Trudi,F,100,2724,0,2724
Nada,F,100,2719,0,2719
Aryn,F,87,2377,341,2718
Lashay,F,100,2708,10,2718
Anamaria,F,100,2717,0,2717
Caydence,F,95,2575,142,2717
Soledad,F,100,2711,5,2716
Maison,M,80,542,2173,2715
Ryanne,F,100,2715,0,2715
Joshuah,M,100,0,2713,2713
Nechama,F,100,2713,0,2713
Dell,M,71,784,1928,2712
Randee,F,93,2533,179,2712
Chanell,F,100,2711,0,2711
Elexis,F,100,2710,0,2710
Jameel,M,99,18,2692,2710
Vienna,F,100,2709,0,2709
Alishia,F,100,2708,0,2708
Ananya,F,100,2706,0,2706
Capri,F,98,2654,52,2706
Lilli,F,100,2706,0,2706
Bud,M,100,0,2705,2705
Kalina,F,100,2705,0,2705
Taisha,F,100,2705,0,2705
Sylvie,F,100,2704,0,2704
Karisa,F,100,2700,0,2700
Zev,M,100,0,2700,2700
Keesha,F,100,2699,0,2699
Aditi,F,100,2697,0,2697
Quenton,M,100,0,2697,2697
Soleil,F,100,2697,0,2697
Kamya,F,100,2696,0,2696
Karey,F,80,2148,548,2696
Katalina,F,100,2696,0,2696
Warner,M,99,17,2679,2696
Mariella,F,100,2695,0,2695
Raynard,M,100,0,2692,2692
Burke,M,99,29,2662,2691
Nallely,F,100,2691,0,2691
Latoria,F,100,2690,0,2690
Sameer,M,100,0,2690,2690
Brion,M,97,84,2605,2689
Treyton,M,100,0,2689,2689
Gabriele,F,74,1982,706,2688
Lita,F,100,2688,0,2688
Teresita,F,100,2688,0,2688
Shaneka,F,100,2686,0,2686
Alessia,F,100,2685,0,2685
Heavenly,F,100,2685,0,2685
Brecken,M,77,607,2073,2680
Coleton,M,100,0,2679,2679
Jaslene,F,100,2679,0,2679
Rogers,M,100,10,2668,2678
Sanai,F,99,2661,15,2676
Jere,M,75,672,2003,2675
Lamarcus,M,100,0,2674,2674
Alliyah,F,100,2673,0,2673
Rami,M,92,212,2461,2673
Sirena,F,100,2673,0,2673
Marlana,F,100,2672,0,2672
Nilda,F,100,2672,0,2672
Yarely,F,100,2672,0,2672
Jenise,F,100,2671,0,2671
Elnora,F,100,2670,0,2670
Lianne,F,100,2670,0,2670
Vada,F,94,2508,162,2670
Freya,F,100,2669,0,2669
Terance,M,100,0,2667,2667
Tyla,F,100,2660,7,2667
Butch,M,100,0,2666,2666
Oriana,F,100,2666,0,2666
Saira,F,100,2666,0,2666
Esme,F,100,2665,0,2665
Makaylah,F,100,2665,0,2665
Sheron,F,86,2286,379,2665
Jazzlyn,F,100,2664,0,2664
Melynda,F,100,2664,0,2664
Bryton,M,94,163,2500,2663
Candyce,F,100,2663,0,2663
Daylen,M,91,244,2415,2659
Rosalba,F,100,2658,0,2658
Lucky,M,87,336,2318,2654
Quinlan,M,80,532,2122,2654
Ocean,F,51,1361,1292,2653
Yoel,M,100,0,2653,2653
Mayte,F,100,2652,0,2652
Jermey,M,100,0,2651,2651
Harleigh,F,100,2650,0,2650
Dacia,F,100,2648,0,2648
Khari,M,82,484,2164,2648
Vernita,F,100,2648,0,2648
Domenick,M,100,0,2647,2647
Evon,F,83,2206,441,2647
Margarito,M,100,0,2647,2647
Patric,M,97,73,2574,2647
Domonic,M,97,67,2579,2646
Deisy,F,100,2645,0,2645
Dashaun,M,99,32,2612,2644
Kamdyn,M,55,1201,1442,2643
Aleksander,M,100,0,2642,2642
Lise,F,100,2642,0,2642
Marquel,M,91,248,2394,2642
Kathlene,F,100,2640,0,2640
Angelena,F,100,2638,0,2638
Charly,F,64,1688,950,2638
Jolee,F,100,2638,0,2638
Aris,M,61,1020,1617,2637
Ebonie,F,100,2637,0,2637
Sharita,F,100,2637,0,2637
Shantelle,F,100,2636,0,2636
Artie,M,80,539,2093,2632
Enid,F,100,2630,0,2630
Natashia,F,100,2630,0,2630
Sapphire,F,100,2630,0,2630
Anish,M,100,0,2629,2629
Jersey,F,92,2425,203,2628
Jarell,M,100,0,2627,2627
Glynn,M,94,156,2470,2626
Kloe,F,100,2626,0,2626
Makhi,M,99,39,2586,2625
Honey,F,100,2624,0,2624
Ravi,M,100,5,2618,2623
Kylen,M,84,428,2194,2622
Kiesha,F,100,2621,0,2621
Lakia,F,100,2621,0,2621
Niles,M,100,0,2619,2619
Sindy,F,100,2619,0,2619
Kandis,F,100,2617,0,2617
Audrie,F,100,2616,0,2616
Brynna,F,100,2616,0,2616
Kady,F,100,2614,0,2614
Daylon,M,100,10,2602,2612
Ariyana,F,100,2611,0,2611
Vivianna,F,100,2611,0,2611
Amado,M,100,0,2610,2610
Ishaan,M,100,0,2610,2610
Tylar,M,57,1112,1498,2610
Crosby,M,89,274,2335,2609
Marleigh,F,100,2609,0,2609
Cherokee,F,88,2284,322,2606
Josselyn,F,100,2606,0,2606
Kailani,F,99,2588,17,2605
Keller,M,89,276,2326,2602
Talitha,F,100,2601,0,2601
Tito,M,100,0,2601,2601
Domenico,M,100,0,2600,2600
Nidia,F,100,2599,0,2599
Edson,M,100,0,2598,2598
Kimani,M,55,1161,1436,2597
Addilyn,F,100,2595,0,2595
Georgie,F,77,1988,607,2595
Ailyn,F,100,2592,0,2592
Caryl,F,98,2533,58,2591
Deeann,F,100,2590,0,2590
Hoyt,M,100,0,2590,2590
Myriam,F,100,2589,0,2589
Raya,F,100,2589,0,2589
Joslynn,F,100,2588,0,2588
Creighton,M,100,11,2573,2584
Orrin,M,100,0,2584,2584
Shaye,F,78,2021,562,2583
Clemente,M,100,0,2581,2581
Dollie,F,100,2581,0,2581
Pernell,M,99,33,2547,2580
Danilo,M,100,0,2578,2578
Janai,F,97,2492,83,2575
Kristel,F,100,2575,0,2575
Samia,F,100,2575,0,2575
Ema,F,100,2574,0,2574
Stoney,M,99,27,2546,2573
Angelika,F,100,2572,0,2572
Crissy,F,100,2571,0,2571
Makiya,F,99,2556,14,2570
Terell,M,99,38,2532,2570
Katya,F,100,2569,0,2569
Lennie,M,70,758,1811,2569
Julee,F,100,2568,0,2568
Les,M,99,32,2536,2568
Tavion,M,99,13,2555,2568
Kaytlyn,F,100,2565,0,2565
Laina,F,100,2565,0,2565
Maite,F,100,2565,0,2565
Tamya,F,100,2565,0,2565
Mendy,F,84,2160,404,2564
Mel,M,88,307,2255,2562
Kanisha,F,100,2559,0,2559
Shaniyah,F,100,2559,0,2559
Tanja,F,100,2559,0,2559
Kaili,F,99,2523,35,2558
Karoline,F,100,2555,0,2555
Pia,F,100,2552,0,2552
Anjanette,F,100,2551,0,2551
Canyon,M,95,128,2422,2550
Paislee,F,100,2550,0,2550
Sherrell,F,95,2430,120,2550
Rain,F,79,2018,531,2549
Reno,M,99,17,2532,2549
Iain,M,100,0,2548,2548
Jadiel,M,100,0,2548,2548
Rosella,F,100,2546,0,2546
Keandre,M,100,9,2535,2544
Abe,M,100,0,2542,2542
Zaniya,F,100,2542,0,2542
Dustyn,M,98,60,2480,2540
Jania,F,100,2540,0,2540
Emmet,M,100,0,2539,2539
Jennah,F,100,2539,0,2539
Shawnda,F,100,2539,0,2539
Qiana,F,100,2538,0,2538
Steffanie,F,100,2538,0,2538
Amethyst,F,100,2537,0,2537
Jame,M,84,408,2129,2537
Jamiyah,F,100,2537,0,2537
Wilford,M,100,0,2537,2537
Clarke,M,82,447,2089,2536
Martine,F,88,2236,299,2535
Tonie,F,91,2295,238,2533
Job,M,100,0,2531,2531
Keziah,F,98,2469,62,2531
Jaquelyn,F,100,2530,0,2530
Raylee,F,97,2461,69,2530
Hosea,M,100,0,2529,2529
Salomon,M,100,0,2529,2529
Laniya,F,100,2528,0,2528
Nikola,M,79,533,1993,2526
Bartholomew,M,100,0,2524,2524
Liv,F,100,2520,0,2520
Shivani,F,100,2520,0,2520
Shaquan,M,79,536,1983,2519
Jonny,M,98,52,2466,2518
Simran,F,95,2385,133,2518
Evelina,F,100,2516,0,2516
Fatimah,F,100,2516,0,2516
Kynlee,F,100,2514,0,2514
Magda,F,100,2514,0,2514
Meridith,F,100,2508,5,2513
Dariana,F,100,2512,0,2512
Dontrell,M,99,16,2495,2511
Herlinda,F,100,2511,0,2511
Davey,M,99,34,2476,2510
Allysa,F,100,2509,0,2509
Kamal,M,99,25,2484,2509
Larhonda,F,100,2509,0,2509
Anthoney,M,100,0,2508,2508
Keana,F,100,2508,0,2508
Orin,M,100,11,2497,2508
Tyana,F,100,2505,0,2505
Dezmond,M,100,0,2504,2504
Jamon,M,100,6,2498,2504
Taina,F,100,2504,0,2504
Yancy,M,82,440,2064,2504
Makiyah,F,99,2483,20,2503
Adia,F,100,2502,0,2502
Devontae,M,100,0,2502,2502
Avianna,F,100,2501,0,2501
Jaclynn,F,100,2501,0,2501
Odalis,F,98,2450,51,2501
Madysen,F,100,2495,5,2500
Tammara,F,100,2500,0,2500
Woody,M,100,0,2496,2496
Caley,F,94,2350,145,2495
Vincente,M,100,0,2494,2494
Ania,F,100,2493,0,2493
Cielo,F,98,2453,39,2492
Kerstin,F,100,2492,0,2492
Adelle,F,100,2491,0,2491
Lex,M,100,0,2491,2491
Terrel,M,98,49,2442,2491
Brie,F,100,2490,0,2490
Keily,F,100,2487,0,2487
Lauretta,F,100,2487,0,2487
Stefano,M,100,0,2487,2487
Siera,F,100,2486,0,2486
Allana,F,100,2484,0,2484
Markita,F,100,2483,0,2483
Rashard,M,100,0,2483,2483
Deante,M,100,5,2477,2482
Elroy,M,100,0,2482,2482
Jenell,F,100,2482,0,2482
Dayanna,F,100,2481,0,2481
Nickole,F,100,2481,0,2481
Sharif,M,100,5,2476,2481
Adin,M,97,86,2394,2480
Laquan,M,91,217,2260,2477
Madelaine,F,100,2477,0,2477
Aniah,F,100,2475,0,2475
Kc,M,69,769,1706,2475
Luana,F,100,2475,0,2475
Bryleigh,F,100,2474,0,2474
Delton,M,100,0,2474,2474
Faustino,M,100,0,2474,2474
Rosio,F,99,2454,19,2473
Fanny,F,100,2471,0,2471
Peggie,F,100,2471,0,2471
Ferdinand,M,100,0,2470,2470
Vilma,F,100,2470,0,2470
Kristiana,F,100,2469,0,2469
Makaela,F,100,2468,0,2468
Urijah,M,97,78,2389,2467
Rondell,M,97,67,2399,2466
Divine,F,56,1390,1075,2465
Kaleah,F,100,2465,0,2465
Tahj,M,97,73,2392,2465
Lanae,F,100,2464,0,2464
Arleth,F,100,2463,0,2463
Jocelin,F,100,2463,0,2463
Keoni,M,90,234,2229,2463
Simona,F,100,2463,0,2463
Delicia,F,100,2462,0,2462
Denae,F,100,2462,0,2462
Rebeka,F,100,2461,0,2461
Franky,M,98,40,2420,2460
Nakisha,F,100,2459,0,2459
Gizelle,F,100,2458,0,2458
Caelan,M,76,592,1865,2457
Malak,F,95,2324,133,2457
Omer,M,100,5,2452,2457
Rosalina,F,100,2457,0,2457
Augustin,M,100,0,2456,2456
Klarissa,F,100,2455,0,2455
Micayla,F,100,2454,0,2454
Janett,F,100,2453,0,2453
Yaneli,F,100,2453,0,2453
Ashlin,F,94,2297,155,2452
Farrell,M,89,272,2180,2452
Favian,M,100,0,2452,2452
Rayven,F,95,2318,133,2451
Kadie,F,100,2450,0,2450
Lonna,F,100,2450,0,2450
Deonta,M,99,36,2413,2449
Jakub,M,100,0,2449,2449
Aysha,F,100,2447,0,2447
Deshon,M,93,166,2281,2447
Khristian,M,81,458,1989,2447
Amin,M,100,0,2446,2446
Mykayla,F,100,2446,0,2446
Zyon,M,80,500,1946,2446
Janiece,F,100,2445,0,2445
Sahil,M,100,0,2444,2444
Chayse,M,70,743,1698,2441
Erlinda,F,100,2441,0,2441
Isac,M,100,0,2441,2441
Dhruv,M,100,0,2440,2440
Donya,F,89,2175,265,2440
Miesha,F,100,2440,0,2440
Demetrios,M,100,0,2439,2439
Lizet,F,100,2437,0,2437
Chadd,M,100,0,2436,2436
Fransisco,M,100,0,2436,2436
Marely,F,100,2436,0,2436
Pandora,F,100,2435,0,2435
Lucca,M,86,338,2096,2434
Corin,F,67,1629,801,2430
Idalia,F,100,2430,0,2430
Sabine,F,100,2430,0,2430
Dejon,M,97,77,2352,2429
Tionna,F,100,2427,0,2427
Anwar,M,96,90,2335,2425
Arvin,M,100,0,2425,2425
Juston,M,100,0,2425,2425
Kiel,M,99,30,2395,2425
Kaidyn,M,59,990,1433,2423
Lakota,F,53,1272,1149,2421
Anessa,F,100,2420,0,2420
Renaldo,M,100,0,2420,2420
Regis,M,95,128,2291,2419
Tylan,M,94,145,2274,2419
Jordi,M,94,143,2275,2418
Loreen,F,100,2418,0,2418
Bodie,M,100,0,2417,2417
Carletta,F,100,2417,0,2417
Rojelio,M,100,0,2417,2417
Lacee,F,100,2415,0,2415
Philippe,M,100,0,2415,2415
Demetric,M,83,411,2003,2414
Lamarr,M,99,19,2395,2414
Lexy,F,100,2414,0,2414
Kavin,M,100,0,2413,2413
Scarlette,F,100,2410,0,2410
Citlaly,F,100,2409,0,2409
Micki,F,99,2375,33,2408
Tomi,F,95,2287,120,2407
Avrohom,M,100,0,2406,2406
Carman,F,83,1999,407,2406
Noelani,F,100,2405,0,2405
Ismail,M,100,0,2404,2404
Jeremias,M,100,0,2404,2404
Pamella,F,100,2404,0,2404
Dreama,F,100,2403,0,2403
Jalil,M,100,5,2396,2401
Bodhi,M,97,61,2339,2400
Renard,M,100,0,2400,2400
Chevelle,F,93,2235,164,2399
Tessie,F,100,2399,0,2399
Edmundo,M,100,0,2396,2396
Shaquita,F,100,2391,5,2396
Kavon,M,98,41,2353,2394
Samya,F,100,2393,0,2393
Thomasina,F,100,2393,0,2393
Rolland,M,100,0,2392,2392
Darline,F,100,2391,0,2391
Madelin,F,100,2391,0,2391
Shilo,F,68,1622,767,2389
Aviva,F,100,2387,0,2387
Tiffiny,F,100,2387,0,2387
Larae,F,100,2386,0,2386
Wilhelmina,F,100,2386,0,2386
Lavell,M,96,99,2285,2384
Tuesday,F,100,2384,0,2384
Yusef,M,100,0,2384,2384
Yuridia,F,100,2383,0,2383
Nikolaus,M,100,0,2382,2382
Flavio,M,100,0,2380,2380
Phylicia,F,100,2380,0,2380
Becki,F,100,2379,0,2379
Emmeline,F,100,2379,0,2379
Shona,F,100,2377,0,2377
Laniyah,F,100,2376,0,2376
Broc,M,100,0,2375,2375
Leela,F,100,2375,0,2375
Tarsha,F,100,2375,0,2375
Jakari,M,93,175,2199,2374
Lachelle,F,100,2374,0,2374
Avalon,F,99,2350,23,2373
Masen,M,97,74,2299,2373
Breon,M,88,290,2082,2372
Taylar,F,99,2345,27,2372
Daina,F,100,2366,5,2371
Korina,F,100,2371,0,2371
Cassaundra,F,100,2370,0,2370
Corry,M,87,306,2064,2370
Amal,F,89,2110,259,2369
Madelyne,F,100,2369,0,2369
Renato,M,100,6,2363,2369
Armond,M,100,0,2368,2368
Eben,M,100,6,2362,2368
Taron,M,96,90,2277,2367
Adriene,F,97,2303,61,2364
Ashtin,M,51,1158,1206,2364
Daysha,F,100,2364,0,2364
Rayford,M,100,0,2364,2364
Kadeem,M,100,0,2363,2363
Nayely,F,100,2362,0,2362
Romina,F,100,2362,0,2362
Aleksandra,F,100,2361,0,2361
Ani,F,100,2356,5,2361
Ayah,F,100,2360,0,2360
Bjorn,M,100,0,2360,2360
Tashia,F,100,2359,0,2359
Armon,M,100,0,2357,2357
Brigham,M,100,0,2357,2357
Jeb,M,100,0,2355,2355
Tzvi,M,100,0,2353,2353
Lisha,F,100,2351,0,2351
Shakia,F,100,2351,0,2351
Ronnell,M,92,183,2167,2350
Aubriana,F,100,2349,0,2349
Faron,M,98,52,2297,2349
Shena,F,100,2349,0,2349
Kellye,F,100,2347,0,2347
Leilah,F,100,2347,0,2347
Kain,M,100,0,2346,2346
Terron,M,99,32,2314,2346
Darvin,M,100,0,2345,2345
Jacquelyne,F,100,2345,0,2345
Kelle,F,98,2302,43,2345
Penni,F,100,2344,0,2344
Roxy,F,99,2324,20,2344
Jaleah,F,100,2343,0,2343
Linus,M,100,0,2343,2343
Bentlee,M,79,497,1845,2342
Shanel,F,100,2342,0,2342
Cathi,F,100,2341,0,2341
Jaeda,F,100,2341,0,2341
Raylan,M,92,183,2156,2339
Calla,F,100,2338,0,2338
Keion,M,100,10,2328,2338
Rustin,M,100,0,2338,2338
Caterina,F,100,2336,0,2336
Daveon,M,99,16,2319,2335
Evans,M,99,24,2311,2335
Geno,M,100,0,2335,2335
Johannah,F,100,2335,0,2335
Neel,M,100,0,2334,2334
Damani,M,81,449,1884,2333
Meir,M,100,0,2333,2333
Sherron,F,79,1849,483,2332
Laticia,F,100,2331,0,2331
Leobardo,M,100,0,2331,2331
Aven,M,59,954,1376,2330
Jacelyn,F,100,2329,0,2329
Miyah,F,100,2329,0,2329
Brynne,F,100,2328,0,2328
Louella,F,100,2328,0,2328
Lyra,F,100,2327,0,2327
Kyndra,F,100,2326,0,2326
Koen,M,100,5,2320,2325
Ashia,F,100,2324,0,2324
Chadrick,M,100,0,2324,2324
Kizzy,F,99,2312,12,2324
Salome,F,82,1913,410,2323
Anette,F,100,2321,0,2321
Jacobo,M,100,0,2321,2321
Jazzmine,F,100,2321,0,2321
Jorja,F,100,2320,0,2320
Geovanny,M,100,0,2319,2319
Latrina,F,100,2318,0,2318
Arica,F,100,2317,0,2317
Babette,F,100,2312,5,2317
Sherwin,M,99,15,2301,2316
Morgen,F,76,1768,547,2315
Andrei,M,100,0,2314,2314
Mandie,F,100,2314,0,2314
Triniti,F,100,2314,0,2314
Arlyn,F,61,1408,905,2313
Tavaris,M,100,6,2307,2313
Tavia,F,100,2313,0,2313
Rand,M,96,83,2229,2312
Roma,F,95,2196,116,2312
Danisha,F,100,2311,0,2311
Vania,F,100,2310,0,2310
Kaidence,F,93,2140,169,2309
Kameryn,F,74,1705,604,2309
Dimitrios,M,100,0,2308,2308
Gissel,F,100,2307,0,2307
Martell,M,99,21,2286,2307
Dennie,M,85,352,1954,2306
Elda,F,100,2305,0,2305
Amyah,F,100,2303,0,2303
Jaysen,M,100,0,2303,2303
Kattie,F,100,2303,0,2303
Daja,F,100,2302,0,2302
Brittnie,F,100,2301,0,2301
Kimberely,F,100,2301,0,2301
Marek,M,100,5,2295,2300
Emme,F,100,2299,0,2299
Sarena,F,100,2298,0,2298
Jalon,M,97,74,2223,2297
Sariyah,F,100,2297,0,2297
Elba,F,99,2272,24,2296
Che,M,84,363,1932,2295
Geraldo,M,100,0,2295,2295
Siddharth,M,100,0,2295,2295
Zenobia,F,100,2295,0,2295
Christain,M,87,305,1989,2294
Malisa,F,100,2294,0,2294
Rock,M,100,0,2294,2294
Virgie,F,97,2226,66,2292
Kelci,F,100,2290,0,2290
Magnus,M,100,0,2290,2290
Kaileigh,F,100,2289,0,2289
Katey,F,100,2289,0,2289
Laronda,F,100,2289,0,2289
Tarra,F,100,2288,0,2288
Myka,F,89,2031,256,2287
Prentice,M,99,28,2259,2287
Reginal,M,100,5,2282,2287
Huey,M,100,0,2286,2286
Lezlie,F,100,2286,0,2286
Shaquana,F,100,2286,0,2286
Christos,M,100,0,2285,2285
Caylin,F,96,2197,87,2284
Melaine,F,100,2284,0,2284
Janetta,F,100,2282,0,2282
Korie,F,82,1865,416,2281
Tiffaney,F,100,2281,0,2281
Eriberto,M,100,0,2278,2278
Lakendra,F,100,2278,0,2278
Tramaine,M,75,561,1717,2278
Chava,F,100,2276,0,2276
Laisha,F,100,2275,0,2275
Latavia,F,100,2273,0,2273
Rance,M,100,0,2272,2272
Talya,F,100,2272,0,2272
Earle,M,100,0,2271,2271
Fabio,M,100,0,2271,2271
Gretta,F,100,2270,0,2270
Lashunda,F,100,2270,0,2270
Bertram,M,100,0,2269,2269
Lynell,F,69,1573,696,2269
Taliah,F,100,2269,0,2269
Yesica,F,100,2264,5,2269
Arlin,M,72,640,1628,2268
Alanis,F,100,2267,0,2267
Alexsandra,F,100,2267,0,2267
Daven,M,96,92,2174,2266
Alphonse,M,100,0,2265,2265
Beryl,F,86,1938,326,2264
Jurnee,F,100,2257,7,2264
Sacha,F,82,1862,402,2264
Kamaria,F,100,2263,0,2263
Abygail,F,100,2262,0,2262
Taran,M,75,560,1701,2261
Jajuan,M,100,11,2249,2260
Refugio,M,94,126,2134,2260
Agatha,F,100,2258,0,2258
Alianna,F,100,2258,0,2258
Berta,F,100,2258,0,2258
Yazmine,F,100,2258,0,2258
Buford,M,100,5,2252,2257
Nicklas,M,100,0,2255,2255
Alona,F,100,2254,0,2254
Beckie,F,100,2254,0,2254
Cassi,F,100,2254,0,2254
Fausto,M,100,0,2254,2254
Sanjay,M,100,0,2254,2254
Tonda,F,100,2254,0,2254
Reta,F,100,2253,0,2253
Devaughn,M,100,0,2252,2252
Hussein,M,100,0,2252,2252
Imran,M,100,0,2252,2252
Keena,F,94,2109,141,2250
Leonora,F,100,2250,0,2250
Landin,M,99,16,2233,2249
Tea,F,100,2249,0,2249
Divya,F,99,2232,16,2248
Raechel,F,100,2248,0,2248
Joie,F,91,2039,208,2247
Joella,F,100,2246,0,2246
Johna,F,100,2240,6,2246
Kollin,M,100,0,2246,2246
Hagen,M,94,138,2107,2245
Alida,F,100,2243,0,2243
Jamesha,F,100,2243,0,2243
Laurene,F,100,2243,0,2243
Lavelle,M,82,399,1844,2243
Antwain,M,100,0,2242,2242
Jennette,F,100,2242,0,2242
Neftali,M,83,380,1862,2242
Kasi,F,99,2215,26,2241
Mistie,F,100,2240,0,2240
Johnetta,F,100,2239,0,2239
Dawne,F,100,2238,0,2238
Inga,F,100,2238,0,2238
Lory,F,95,2123,115,2238
Kirstyn,F,100,2237,0,2237
Brissa,F,100,2236,0,2236
Greer,F,85,1908,327,2235
Maxie,M,70,677,1558,2235
Melvina,F,100,2235,0,2235
Janina,F,100,2234,0,2234
Kenda,F,100,2234,0,2234
Varun,M,100,0,2233,2233
Izaak,M,100,0,2230,2230
Larkin,F,54,1212,1018,2230
Mikaila,F,100,2230,0,2230
Taelor,F,92,2057,173,2230
Amador,M,100,0,2227,2227
Jenesis,F,99,2215,12,2227
Lafayette,M,100,11,2216,2227
Lashawnda,F,100,2226,0,2226
Cianna,F,100,2224,0,2224
Teanna,F,100,2224,0,2224
Tonisha,F,100,2224,0,2224
Abriana,F,100,2223,0,2223
Haywood,M,100,0,2223,2223
Reem,F,100,2220,0,2220
Loran,M,64,803,1416,2219
Breck,M,83,380,1838,2218
Kieth,M,100,0,2218,2218
Jaela,F,100,2217,0,2217
Hyrum,M,100,0,2216,2216
Joetta,F,100,2214,0,2214
Shalom,M,66,759,1455,2214
Lachlan,M,95,104,2109,2213
Cady,F,99,2190,20,2210
Hellen,F,100,2209,0,2209
Catarina,F,100,2208,0,2208
Jamiah,F,86,1905,302,2207
Davy,M,94,124,2081,2205
Cian,M,99,22,2182,2204
Kathyrn,F,100,2203,0,2203
Mahlon,M,100,11,2192,2203
Marika,F,100,2203,0,2203
Jereme,M,100,0,2202,2202
Ramone,M,99,12,2190,2202
Ambar,F,100,2196,5,2201
Coltin,M,100,0,2201,2201
Demonte,M,100,0,2201,2201
Eder,M,100,0,2201,2201
Prudence,F,100,2201,0,2201
Dontay,M,100,0,2200,2200
Charline,F,100,2199,0,2199
Cicely,F,100,2199,0,2199
Eliyahu,M,100,0,2199,2199
Chynna,F,100,2198,0,2198
Ramses,M,100,0,2198,2198
Kacee,F,91,2003,194,2197
Odis,M,100,0,2197,2197
Bayley,F,80,1761,435,2196
Danniel,M,92,186,2010,2196
Lashon,F,70,1534,662,2196
Anja,F,100,2193,0,2193
Candance,F,100,2191,0,2191
Damen,M,100,0,2191,2191
Vernice,F,93,2027,164,2191
Saanvi,F,100,2189,0,2189
Synthia,F,100,2188,0,2188
Tamisha,F,100,2188,0,2188
Katrice,F,100,2187,0,2187
Lillyana,F,100,2187,0,2187
Tennille,F,99,2172,15,2187
Zavion,M,100,0,2187,2187
Kathaleen,F,100,2186,0,2186
Thatcher,M,100,0,2185,2185
Demetrio,M,100,0,2183,2183
Daryle,M,95,104,2076,2180
Said,M,100,0,2180,2180
Sal,M,100,0,2180,2180
Somer,F,100,2180,0,2180
Arika,F,100,2179,0,2179
Christiane,F,100,2173,6,2179
Daylin,M,58,916,1263,2179
Emi,F,100,2179,0,2179
Mikeal,M,99,19,2160,2179
Carma,F,100,2178,0,2178
Otha,M,93,157,2020,2177
Jazzmin,F,100,2176,0,2176
Niesha,F,100,2176,0,2176
Tamyra,F,100,2176,0,2176
Devona,F,100,2175,0,2175
Jae,M,55,985,1190,2175
Mychal,M,88,265,1909,2174
Dwane,M,100,0,2173,2173
Rosaura,F,100,2173,0,2173
Leslye,F,100,2172,0,2172
Chasidy,F,100,2171,0,2171
Tari,F,98,2124,46,2170
Twana,F,100,2169,0,2169
Kevyn,M,89,235,1933,2168
Brentley,M,93,162,2004,2166
Calen,M,90,221,1945,2166
Raine,F,82,1780,385,2165
Alvina,F,100,2164,0,2164
Melodee,F,100,2164,0,2164
Rania,F,100,2160,0,2160
Nala,F,100,2159,0,2159
Nour,F,82,1779,380,2159
Keshaun,M,98,51,2106,2157
Mattison,F,91,1954,203,2157
Rashid,M,100,0,2157,2157
Isamar,F,96,2065,91,2156
Kelis,F,100,2150,6,2156
Kyran,M,94,128,2028,2156
Graeme,M,100,0,2154,2154
Zora,F,100,2149,5,2154
Elgin,M,100,0,2153,2153
Hendrix,M,94,120,2033,2153
Jaymes,M,98,40,2111,2151
Jeron,M,100,0,2151,2151
Egypt,F,92,1986,164,2150
Kierstyn,F,100,2149,0,2149
Siri,F,100,2148,0,2148
Henley,F,77,1650,497,2147
Nadya,F,100,2147,0,2147
Teegan,M,51,1055,1092,2147
Graysen,M,77,502,1644,2146
Charise,F,100,2145,0,2145
Travion,M,100,0,2145,2145
Velda,F,100,2145,0,2145
Gracen,F,73,1560,584,2144
Tobey,M,71,628,1516,2144
Deegan,M,100,0,2143,2143
Jayvion,M,100,0,2143,2143
Makiah,F,86,1833,310,2143
Margaux,F,100,2143,0,2143
Chassity,F,100,2142,0,2142
Kodie,M,55,974,1168,2142
Taurean,M,98,45,2097,2142
Daylan,M,96,84,2056,2140
Dov,M,100,0,2140,2140
Lilyan,F,100,2140,0,2140
Tahlia,F,100,2140,0,2140
Cherilyn,F,100,2139,0,2139
Justyce,F,79,1692,446,2138
Tamica,F,100,2138,0,2138
Wardell,M,100,0,2138,2138
Duwayne,M,100,0,2137,2137
Gaylon,M,93,140,1997,2137
Nariah,F,100,2137,0,2137
Porfirio,M,100,0,2134,2134
Zenaida,F,100,2134,0,2134
Ariadna,F,100,2133,0,2133
Jaila,F,100,2133,0,2133
Towanda,F,100,2132,0,2132
Briseida,F,100,2131,0,2131
Daijah,F,100,2131,0,2131
Osiris,M,65,739,1391,2130
Tequila,F,100,2130,0,2130
Gwenyth,F,100,2129,0,2129
Khalia,F,100,2122,7,2129
Willem,M,100,0,2128,2128
Bernita,F,100,2126,0,2126
Zephaniah,M,88,254,1872,2126
Raekwon,M,100,6,2119,2125
Corbyn,M,87,272,1850,2122
Jairus,M,100,0,2122,2122
Loree,F,100,2121,0,2121
Allisson,F,100,2120,0,2120
Davie,M,84,330,1790,2120
Jenine,F,100,2120,0,2120
Rebbecca,F,100,2120,0,2120
Andree,F,60,1264,855,2119
Zoya,F,100,2115,0,2115
Amariah,F,100,2114,0,2114
Jalin,M,78,460,1654,2114
Adair,M,57,905,1208,2113
Andrey,M,95,100,2013,2113
Musa,M,100,0,2113,2113
Catelyn,F,100,2112,0,2112
Janya,F,100,2112,0,2112
Jeanmarie,F,100,2112,0,2112
Aryeh,M,100,0,2111,2111
Aura,F,100,2111,0,2111
Arik,M,100,0,2110,2110
Esequiel,M,100,0,2110,2110
Javian,M,100,6,2104,2110
Carrol,F,60,1258,851,2109
Courtnie,F,100,2109,0,2109
Tavis,M,100,6,2103,2109
Youssef,M,100,0,2109,2109
Armaan,M,100,0,2108,2108
Mckay,M,86,287,1821,2108
Gracey,F,100,2107,0,2107
Idris,M,100,10,2097,2107
Nautica,F,98,2056,50,2106
Ragan,F,82,1736,370,2106
Faigy,F,100,2105,0,2105
Kamiyah,F,100,2104,0,2104
Perri,F,95,1989,114,2103
Shemar,M,100,6,2097,2103
Ariyah,F,100,2101,0,2101
Shedrick,M,100,0,2101,2101
Donavin,M,100,0,2100,2100
Lazarus,M,100,0,2099,2099
Avril,F,100,2092,5,2097
Deedra,F,100,2097,0,2097
Lindsy,F,100,2096,0,2096
Massimo,M,100,0,2096,2096
Quincey,M,76,511,1585,2096
Gitty,F,100,2095,0,2095
Jamilah,F,99,2078,16,2094
Marlys,F,100,2094,0,2094
Isadora,F,100,2093,0,2093
Lilyann,F,100,2093,0,2093
Zach,M,100,0,2091,2091
Porsche,F,100,2090,0,2090
Ara,F,59,1224,864,2088
Ranae,F,100,2087,0,2087
Tyran,M,97,56,2031,2087
Felica,F,100,2086,0,2086
Jeshua,M,100,5,2081,2086
Kaniya,F,100,2086,0,2086
Bianka,F,100,2085,0,2085
Kirra,F,100,2085,0,2085
Luci,F,100,2085,0,2085
Harmoni,F,100,2083,0,2083
Jarad,M,100,0,2083,2083
Jadin,M,69,643,1438,2081
Sebrina,F,100,2080,0,2080
Waverly,F,60,1253,827,2080
Lyman,M,100,0,2079,2079
Osman,M,100,0,2078,2078
Gisel,F,100,2077,0,2077
Izaac,M,100,0,2077,2077
Mariya,F,100,2077,0,2077
Yash,M,100,0,2076,2076
Nile,M,89,219,1856,2075
Sharen,F,100,2075,0,2075
Meri,F,100,2074,0,2074
Geronimo,M,100,0,2073,2073
Heide,F,100,2073,0,2073
Marivel,F,100,2073,0,2073
Sandie,F,100,2068,5,2073
Stephania,F,100,2073,0,2073
Jannet,F,100,2072,0,2072
Krissy,F,100,2072,0,2072
Crew,M,100,0,2070,2070
Juliane,F,100,2070,0,2070
Love,F,86,1783,287,2070
Malea,F,100,2070,0,2070
Tatiyana,F,100,2070,0,2070
Dwan,M,57,883,1186,2069
Kerwin,M,100,0,2069,2069
Lawana,F,100,2069,0,2069
Robinson,M,100,0,2069,2069
Kyah,F,99,2041,27,2068
Meera,F,100,2068,0,2068
Peri,F,100,2056,10,2066
Samaya,F,100,2065,0,2065
Zhane,F,88,1817,248,2065
Arissa,F,100,2064,0,2064
Citlalli,F,100,2064,0,2064
Josephina,F,100,2064,0,2064
Madaline,F,100,2064,0,2064
Derrik,M,100,0,2063,2063
Seanna,F,100,2063,0,2063
Raelene,F,100,2062,0,2062
Xenia,F,100,2062,0,2062
Braedyn,M,88,250,1811,2061
Myia,F,100,2061,0,2061
Rylen,M,83,356,1705,2061
Suri,F,100,2061,0,2061
Shannen,F,93,1910,150,2060
Cristie,F,100,2059,0,2059
Amayah,F,100,2058,0,2058
Marah,F,100,2057,0,2057
Takisha,F,100,2057,0,2057
Arlie,M,78,451,1605,2056
Lashaun,F,62,1269,787,2056
Makyla,F,100,2055,0,2055
Shala,F,100,2055,0,2055
Taylin,F,83,1705,350,2055
Javin,M,100,5,2049,2054
Samone,F,100,2049,5,2054
Ariyanna,F,100,2053,0,2053
Ashten,F,53,1085,968,2053
Dayle,F,74,1516,537,2053
Olen,M,100,0,2053,2053
Hampton,M,96,76,1976,2052
Khristopher,M,100,0,2050,2050
Maddux,M,94,122,1928,2050
Karime,F,100,2049,0,2049
Latina,F,100,2049,0,2049
Nicol,F,99,2020,28,2048
Passion,F,100,2048,0,2048
Coretta,F,100,2047,0,2047
Coen,M,100,0,2046,2046
Glendon,M,100,0,2046,2046
Romel,M,100,0,2046,2046
Kateri,F,100,2045,0,2045
Lillyanna,F,100,2045,0,2045
Nevada,F,69,1409,636,2045
Ashlei,F,100,2044,0,2044
Macayla,F,100,2044,0,2044
Apollo,M,100,0,2043,2043
Aram,M,99,27,2016,2043
Gorge,M,100,0,2043,2043
San,F,74,1513,530,2043
Donielle,F,96,1950,91,2041
Mahmoud,M,100,0,2039,2039
Arion,M,72,574,1464,2038
Korbyn,M,82,361,1677,2038
Taneisha,F,100,2038,0,2038
Teodoro,M,100,0,2038,2038
Ariadne,F,100,2037,0,2037
Cataleya,F,100,2037,0,2037
Denna,F,100,2037,0,2037
Giulia,F,100,2036,0,2036
Julienne,F,98,2004,32,2036
Shai,F,54,1095,941,2036
Audree,F,100,2032,0,2032
Dannette,F,100,2032,0,2032
Richmond,M,100,0,2032,2032
Corrin,F,95,1933,98,2031
Santa,F,100,2021,10,2031
Jamell,M,96,75,1955,2030
Charleston,M,86,274,1755,2029
Dior,F,71,1431,598,2029
Ciana,F,100,2028,0,2028
Kipp,M,100,5,2023,2028
Reena,F,100,2028,0,2028
Shanya,F,100,2028,0,2028
Joeseph,M,100,0,2027,2027
Kaeli,F,100,2027,0,2027
Shamya,F,100,2027,0,2027
Kamora,F,100,2026,0,2026
Layna,F,100,2026,0,2026
Ransom,M,100,5,2021,2026
Newton,M,100,0,2025,2025
Serene,F,100,2025,0,2025
Maycee,F,100,2024,0,2024
Niyah,F,100,2024,0,2024
Sammuel,M,100,0,2024,2024
Allissa,F,100,2023,0,2023
Gianluca,M,100,0,2022,2022
Maylee,F,100,2022,0,2022
Cinnamon,F,100,2021,0,2021
Kaydee,F,100,2021,0,2021
Artemio,M,100,0,2020,2020
Jaedon,M,98,33,1987,2020
Minh,M,87,261,1759,2020
Nana,F,68,1367,653,2020
Sharyl,F,100,2020,0,2020
Blessing,F,93,1878,141,2019
Lynelle,F,100,2019,0,2019
Cheree,F,100,2018,0,2018
Christene,F,100,2018,0,2018
Dorsey,M,84,323,1695,2018
Ellianna,F,100,2018,0,2018
Tamira,F,100,2018,0,2018
Corissa,F,100,2016,0,2016
Kaycie,F,100,2016,0,2016
Temperance,F,100,2016,0,2016
Abbigale,F,100,2015,0,2015
Tyreek,M,100,0,2015,2015
Arionna,F,100,2014,0,2014
Nazir,M,100,0,2013,2013
Wynn,M,71,589,1424,2013
Kassi,F,100,2012,0,2012
Micha,F,54,1086,926,2012
Rosalva,F,100,2012,0,2012
Chesney,F,94,1895,116,2011
Damond,M,100,5,2006,2011
Talisa,F,100,2011,0,2011
Mathieu,M,100,0,2010,2010
Tyrek,M,100,0,2009,2009
Ariela,F,100,2008,0,2008
Dewitt,M,100,0,2008,2008
Preslee,F,98,1973,35,2008
Chancellor,M,100,0,2007,2007
Kendric,M,100,0,2007,2007
Maxton,M,100,0,2007,2007
Rosana,F,100,2007,0,2007
Kedrick,M,100,0,2006,2006
Lessie,F,91,1827,179,2006
Kenzi,F,99,1985,20,2005
Zyaire,M,78,432,1573,2005
Aman,M,92,161,1843,2004
Michaella,F,100,2003,0,2003
Darcey,F,95,1908,94,2002
Kannon,M,98,40,1962,2002
Andrae,M,98,41,1960,2001
Emmalynn,F,100,2001,0,2001
Alpha,M,59,813,1187,2000
Cayson,M,98,31,1969,2000
Anai,F,100,1999,0,1999
Marylin,F,100,1999,0,1999
Wendie,F,100,1999,0,1999
Indira,F,100,1997,0,1997
Miquel,M,95,92,1905,1997
Randle,M,100,7,1990,1997
Detra,F,100,1996,0,1996
Rebekka,F,100,1996,0,1996
Kooper,M,92,160,1834,1994
Audry,F,97,1935,58,1993
Jori,F,93,1856,137,1993
Jesiah,M,96,85,1907,1992
Delila,F,100,1991,0,1991
Kamil,M,80,404,1585,1989
Michela,F,100,1989,0,1989
Baltazar,M,100,0,1988,1988
Daleyza,F,100,1988,0,1988
Manda,F,100,1988,0,1988
Anel,F,87,1737,249,1986
Avani,F,99,1969,17,1986
Ilona,F,100,1986,0,1986
Kalel,M,100,0,1986,1986
Sampson,M,100,0,1985,1985
Elli,F,99,1967,17,1984
Taleah,F,100,1984,0,1984
Jenee,F,100,1983,0,1983
Juelz,M,96,81,1901,1982
Markeith,M,100,0,1982,1982
Yanet,F,100,1982,0,1982
Zakaria,M,82,351,1631,1982
Carolee,F,100,1981,0,1981
Kalena,F,100,1981,0,1981
Mecca,F,93,1833,148,1981
Colson,M,100,0,1980,1980
Tova,F,100,1980,0,1980
Bradon,M,100,0,1979,1979
Camelia,F,100,1979,0,1979
Bode,M,100,0,1978,1978
Joziah,M,100,5,1973,1978
Jaelin,M,57,851,1126,1977
Tyasia,F,100,1977,0,1977
Vita,F,100,1977,0,1977
Devora,F,100,1976,0,1976
January,F,100,1976,0,1976
Pepper,F,91,1804,172,1976
Latarsha,F,100,1975,0,1975
Mazie,F,100,1974,0,1974
Sanjana,F,100,1974,0,1974
Delinda,F,100,1973,0,1973
Jashawn,M,98,34,1938,1972
Lavinia,F,100,1972,0,1972
Maury,M,88,240,1732,1972
Akash,M,100,0,1971,1971
Alonna,F,100,1970,0,1970
Cassy,F,100,1970,0,1970
Filiberto,M,100,0,1970,1970
Olyvia,F,100,1969,0,1969
Johnmichael,M,100,0,1968,1968
Mikki,F,99,1957,11,1968
Breona,F,100,1967,0,1967
Shaylynn,F,100,1967,0,1967
Cormac,M,100,0,1966,1966
Sherika,F,100,1966,0,1966
Ayan,M,72,554,1411,1965
Jacinto,M,100,0,1965,1965
Sabrena,F,100,1965,0,1965
Cienna,F,100,1964,0,1964
Hakim,M,100,0,1964,1964
Sherwood,M,100,0,1964,1964
Leisha,F,100,1963,0,1963
Waymon,M,100,0,1963,1963
Kalista,F,100,1962,0,1962
Jaymee,F,99,1938,23,1961
Shaniece,F,100,1960,0,1960
Syreeta,F,100,1960,0,1960
Santo,M,100,0,1959,1959
Carleton,M,100,0,1957,1957
Levar,M,100,9,1948,1957
Pooja,F,100,1957,0,1957
Takia,F,100,1957,0,1957
Kaily,F,100,1956,0,1956
Beck,M,100,0,1955,1955
Brayton,M,99,22,1933,1955
Gema,F,100,1955,0,1955
Hayward,M,100,0,1955,1955
Jarren,M,99,10,1945,1955
Lakin,F,84,1642,313,1955
Tanaya,F,100,1955,0,1955
Zoraida,F,100,1955,0,1955
Contessa,F,100,1954,0,1954
Landan,M,100,5,1949,1954
Thane,M,100,0,1954,1954
Boden,M,100,0,1953,1953
Coreen,F,100,1952,0,1952
Shalyn,F,100,1952,0,1952
Antwone,M,100,0,1950,1950
Marquetta,F,100,1950,0,1950
Shaylyn,F,100,1950,0,1950
Kyana,F,100,1949,0,1949
Marshawn,M,96,78,1871,1949
Wilber,M,100,0,1949,1949
Dickie,M,96,73,1875,1948
Glynis,F,99,1938,10,1948
Nils,M,100,0,1948,1948
Danni,F,96,1875,72,1947
Gabino,M,100,0,1947,1947
Wayland,M,100,0,1947,1947
Adnan,M,100,0,1946,1946
Peighton,F,97,1884,62,1946
Sammantha,F,100,1946,0,1946
Cheryll,F,100,1944,0,1944
Riana,F,100,1944,0,1944
Emoni,F,95,1846,97,1943
Babyboy,M,100,0,1942,1942
Marlowe,F,59,1142,800,1942
Barrie,F,68,1326,615,1941
Cyle,M,99,15,1925,1940
Shiann,F,100,1939,0,1939
Conley,M,89,219,1718,1937
Aanya,F,100,1936,0,1936
Faviola,F,100,1936,0,1936
Johathan,M,100,0,1935,1935
Taurus,M,96,84,1851,1935
Viktor,M,100,0,1934,1934
Yakov,M,100,0,1934,1934
Amarie,F,80,1549,384,1933
Abbi,F,100,1932,0,1932
Corliss,F,96,1864,68,1932
Dajah,F,100,1925,7,1932
Joscelyn,F,100,1930,0,1930
Kyrsten,F,100,1930,0,1930
Shawnta,F,94,1812,118,1930
Charolette,F,100,1929,0,1929
Pierson,M,98,34,1895,1929
Taraji,F,97,1879,50,1929
Giles,M,100,0,1928,1928
Honor,F,79,1530,398,1928
Florentino,M,100,0,1927,1927
Zahir,M,100,7,1920,1927
Anh,F,69,1337,589,1926
Beyonce,F,100,1926,0,1926
Jina,F,100,1926,0,1926
Markayla,F,100,1925,0,1925
Roque,M,100,0,1925,1925
Dynasty,F,100,1924,0,1924
Richardo,M,100,0,1924,1924
Lura,F,100,1923,0,1923
Vihaan,M,100,0,1923,1923
Jermain,M,100,0,1921,1921
Kyli,F,100,1921,0,1921
Lake,M,86,261,1659,1920
Baila,F,100,1919,0,1919
Brysen,M,100,6,1913,1919
Anyssa,F,100,1918,0,1918
Ilan,M,99,27,1891,1918
Briggs,M,100,6,1911,1917
Lawerence,M,100,0,1917,1917
Melyssa,F,100,1917,0,1917
Mose,M,100,0,1917,1917
Diandra,F,100,1916,0,1916
Janea,F,100,1916,0,1916
Malaika,F,100,1916,0,1916
Jaquez,M,100,0,1915,1915
Vianney,F,100,1915,0,1915
Dann,F,54,1032,882,1914
Dafne,F,100,1913,0,1913
Kirkland,M,99,12,1901,1913
Aysia,F,100,1912,0,1912
Ryen,M,59,786,1126,1912
Ambria,F,100,1911,0,1911
Sahar,F,99,1888,23,1911
Susann,F,100,1910,0,1910
September,F,100,1909,0,1909
Tatyanna,F,100,1909,0,1909
Tyre,M,97,50,1859,1909
Caelyn,F,100,1903,5,1908
Kaylani,F,100,1908,0,1908
Lael,F,71,1362,545,1907
Yonatan,M,100,0,1907,1907
Osiel,M,100,0,1906,1906
Callista,F,100,1905,0,1905
Kohen,M,99,18,1887,1905
Regena,F,100,1905,0,1905
Jianna,F,100,1904,0,1904
Karlyn,F,100,1896,7,1903
Suellen,F,100,1903,0,1903
Esau,M,100,0,1902,1902
Emir,M,100,0,1901,1901
Indigo,F,82,1551,350,1901
Pyper,F,100,1901,0,1901
Kerrigan,F,96,1833,67,1900
Neely,F,96,1815,85,1900
Darold,M,100,0,1899,1899
Hardy,M,100,0,1899,1899
Jenica,F,100,1898,0,1898
Iona,F,100,1892,5,1897
Jacorey,M,100,0,1897,1897
Lakiesha,F,100,1897,0,1897
Maylin,F,100,1897,0,1897
Pascual,M,100,0,1895,1895
Graydon,M,100,0,1894,1894
Kamiya,F,100,1894,0,1894
Ravyn,F,99,1880,14,1894
Boyce,M,100,5,1888,1893
Jamaya,F,100,1893,0,1893
Stormi,F,100,1893,0,1893
Angelyn,F,100,1892,0,1892
Aramis,M,91,171,1721,1892
Jarrad,M,100,0,1892,1892
Klayton,M,100,0,1892,1892
Jala,F,100,1891,0,1891
Marykate,F,100,1891,0,1891
Talmadge,M,100,0,1890,1890
Letisha,F,100,1889,0,1889
Smith,M,96,78,1811,1889
Wilburn,M,100,0,1889,1889
Arnaldo,M,100,0,1888,1888
Franz,M,100,0,1887,1887
Kellyn,F,93,1751,136,1887
Baxter,M,100,0,1884,1884
Blain,M,99,17,1867,1884
Keosha,F,100,1884,0,1884
Titan,M,100,0,1884,1884
Tamekia,F,100,1883,0,1883
Tamesha,F,100,1883,0,1883
Tehya,F,100,1882,0,1882
Shawana,F,100,1881,0,1881
Blas,M,100,0,1880,1880
Rosalynn,F,100,1880,0,1880
Ewan,M,100,0,1879,1879
Reynold,M,100,0,1878,1878
Britny,F,100,1877,0,1877
Italia,F,100,1877,0,1877
Karyme,F,100,1877,0,1877
Noam,M,89,201,1676,1877
Tesla,F,98,1835,42,1877
Melissia,F,100,1876,0,1876
Tawni,F,100,1876,0,1876
Tobie,F,64,1193,683,1876
Randie,F,75,1403,472,1875
Saray,F,100,1875,0,1875
Falon,F,96,1801,73,1874
Hanah,F,100,1874,0,1874
Shanequa,F,100,1874,0,1874
Nubia,F,100,1873,0,1873
Imogene,F,100,1872,0,1872
Raj,M,100,0,1872,1872
Dovid,M,100,0,1871,1871
Jann,F,93,1743,127,1870
Nerissa,F,100,1867,0,1867
Tarek,M,100,0,1867,1867
Gaylene,F,100,1866,0,1866
Kenney,M,100,5,1861,1866
Kiernan,M,73,511,1355,1866
Lavina,F,100,1866,0,1866
Lovell,M,95,97,1768,1865
Deeanna,F,100,1864,0,1864
Patrina,F,100,1862,0,1862
Dev,M,100,0,1861,1861
Marcelina,F,100,1861,0,1861
Natisha,F,100,1861,0,1861
Viktoria,F,100,1861,0,1861
Monae,F,100,1860,0,1860
Sunday,F,98,1828,32,1860
Jansen,M,89,209,1650,1859
Aren,M,82,326,1531,1857
Silvana,F,100,1855,0,1855
Mackenzi,F,99,1843,11,1854
Marquette,M,65,647,1207,1854
Rashon,M,94,118,1736,1854
Rayanna,F,100,1854,0,1854
Desirea,F,100,1853,0,1853
Joell,F,53,978,875,1853
Dymond,F,96,1781,71,1852
Emmaleigh,F,100,1852,0,1852
Taja,F,98,1824,28,1852
Zella,F,100,1852,0,1852
Dia,F,94,1745,106,1851
Jacklynn,F,100,1851,0,1851
Tala,F,100,1851,0,1851
Armoni,F,61,1131,719,1850
Eusebio,M,100,0,1849,1849
Kaine,M,100,0,1849,1849
Myriah,F,100,1849,0,1849
Eldridge,M,100,0,1847,1847
Geary,M,100,0,1847,1847
Karleen,F,100,1847,0,1847
Tyreese,M,97,49,1798,1847
Deyanira,F,100,1846,0,1846
Maryn,F,100,1846,0,1846
Takiyah,F,100,1846,0,1846
Aleesha,F,100,1844,0,1844
Jovita,F,100,1844,0,1844
Oskar,M,100,0,1844,1844
Sharleen,F,100,1844,0,1844
Gaetano,M,100,0,1843,1843
Haydn,M,82,326,1517,1843
Felisa,F,100,1842,0,1842
Jazelle,F,100,1842,0,1842
Jona,F,84,1540,302,1842
Yadiel,M,100,0,1842,1842
Mayah,F,100,1841,0,1841
Ryon,M,99,12,1829,1841
Shekinah,F,100,1841,0,1841
Aide,F,100,1840,0,1840
Jerrick,M,100,0,1839,1839
Shenika,F,100,1839,0,1839
An,F,54,986,852,1838
Terran,M,70,544,1294,1838
Nicholle,F,100,1837,0,1837
Malek,M,100,6,1830,1836
Elizebeth,F,100,1835,0,1835
Josalyn,F,100,1835,0,1835
Jovana,F,100,1835,0,1835
Rosamaria,F,100,1834,0,1834
Adriano,M,100,0,1833,1833
Dempsey,M,89,199,1634,1833
Araya,F,100,1832,0,1832
Leyton,M,89,200,1632,1832
Nino,M,99,11,1820,1831
Naim,M,100,0,1829,1829
Tyisha,F,100,1829,0,1829
Natividad,F,52,954,874,1828
Kiefer,M,100,0,1826,1826
Lawanna,F,100,1826,0,1826
Robbi,F,83,1514,312,1826
Seana,F,100,1826,0,1826
Carys,F,100,1824,0,1824
Baileigh,F,100,1823,0,1823
Janise,F,100,1823,0,1823
Sunni,F,99,1812,11,1823
Kailah,F,100,1822,0,1822
Mick,M,100,0,1822,1822
Angelle,F,100,1818,0,1818
Lavar,M,99,11,1807,1818
Renay,F,99,1794,24,1818
Shanti,F,92,1677,140,1817
Tambra,F,100,1817,0,1817
Aerial,F,100,1809,6,1815
Asya,F,100,1813,0,1813
Audrea,F,100,1813,0,1813
Willian,M,100,5,1808,1813
Ayva,F,100,1811,0,1811
Brando,M,100,0,1811,1811
Cassey,F,91,1656,155,1811
Dmitri,M,100,0,1811,1811
Merrie,F,100,1811,0,1811
Silvestre,M,100,0,1810,1810
Boone,M,100,0,1809,1809
Haidyn,F,74,1330,479,1809
Marya,F,100,1808,0,1808
Maryah,F,100,1808,0,1808
Walton,M,100,0,1808,1808
Akil,M,100,0,1807,1807
Alvis,M,97,61,1746,1807
Camellia,F,100,1807,0,1807
Doran,M,97,50,1756,1806
Milani,F,100,1806,0,1806
Creed,M,100,0,1805,1805
Kellyann,F,100,1805,0,1805
Nika,F,100,1800,5,1805
Ansel,M,100,0,1804,1804
Benjiman,M,100,0,1804,1804
Elie,M,87,238,1566,1804
Latrisha,F,100,1804,0,1804
Molli,F,100,1804,0,1804
Tesha,F,100,1804,0,1804
Jihad,M,100,5,1798,1803
Colbie,F,83,1498,304,1802
Dain,M,100,0,1802,1802
Kylin,M,52,857,944,1801
Long,M,100,0,1801,1801
Rohit,M,100,0,1801,1801
Bently,M,96,68,1732,1800
Cathey,F,100,1800,0,1800
Rakeem,M,100,0,1800,1800
Alyna,F,100,1799,0,1799
Yulisa,F,100,1799,0,1799
Drema,F,100,1798,0,1798
Eliel,M,100,0,1798,1798
Latashia,F,100,1798,0,1798
Zebulon,M,100,0,1798,1798
Candra,F,100,1797,0,1797
Cher,F,94,1687,110,1797
Cletus,M,100,0,1796,1796
Jesslyn,F,100,1796,0,1796
Price,M,99,24,1772,1796
Adelaida,F,100,1795,0,1795
Cardell,M,100,0,1795,1795
Demitrius,M,99,11,1784,1795
Jolyn,F,100,1795,0,1795
Zipporah,F,100,1795,0,1795
Anayeli,F,100,1794,0,1794
Dyan,F,97,1733,61,1794
Tyren,M,100,5,1789,1794
Jennica,F,100,1793,0,1793
Blade,M,100,0,1792,1792
Buster,M,100,0,1792,1792
Delfina,F,100,1792,0,1792
Diedra,F,100,1791,0,1791
Gabrial,M,85,264,1527,1791
Gaston,M,100,0,1791,1791
Clover,F,99,1778,11,1789
Dedric,M,99,20,1769,1789
Maris,F,91,1627,162,1789
Eleanore,F,100,1788,0,1788
Ilse,F,100,1788,0,1788
Marilu,F,100,1787,0,1787
Rosina,F,100,1786,0,1786
Lisamarie,F,100,1785,0,1785
Lydell,M,100,0,1785,1785
Aubrielle,F,100,1784,0,1784
Kalei,F,91,1623,161,1784
Miriah,F,100,1784,0,1784
Ammar,M,100,0,1783,1783
Florencio,M,100,0,1783,1783
Keaira,F,100,1783,0,1783
Brinda,F,100,1781,0,1781
Fantasia,F,100,1781,0,1781
Lucila,F,100,1781,0,1781
Regenia,F,100,1781,0,1781
Shaunte,F,95,1693,88,1781
Karry,F,67,1194,586,1780
Lillyan,F,100,1780,0,1780
Tavian,M,100,0,1780,1780
Zelma,F,100,1780,0,1780
Lashawna,F,100,1779,0,1779
Kaleena,F,100,1778,0,1778
Kennard,M,100,0,1778,1778
Christ,M,97,47,1730,1777
Faris,M,99,10,1767,1777
Francheska,F,100,1777,0,1777
Saad,M,100,0,1777,1777
Stephane,F,62,1109,668,1777
Tj,M,99,10,1767,1777
Kezia,F,100,1776,0,1776
Brianda,F,100,1770,5,1775
Ariya,F,98,1744,30,1774
Rollin,M,100,0,1774,1774
Vianca,F,100,1774,0,1774
Glinda,F,100,1773,0,1773
Rani,F,90,1600,173,1773
Wayde,M,100,0,1773,1773
Coraline,F,100,1772,0,1772
Crysta,F,100,1771,0,1771
Dezirae,F,100,1771,0,1771
Eman,F,91,1613,157,1770
Anakin,M,100,0,1769,1769
Domenica,F,100,1769,0,1769
Keilani,F,100,1768,0,1768
Wolfgang,M,100,0,1768,1768
Krystian,M,73,469,1298,1767
Kylar,M,70,530,1236,1766
Sheilah,F,100,1765,0,1765
Kobi,M,68,561,1203,1764
Ronell,M,83,300,1464,1764
Sherrod,M,100,0,1762,1762
Tyce,M,100,0,1762,1762
Arline,F,100,1761,0,1761
Arnetta,F,100,1761,0,1761
Cloey,F,100,1761,0,1761
Harmon,M,99,11,1750,1761
Erie,M,89,198,1562,1760
Kayleb,M,100,0,1760,1760
Valeri,F,100,1760,0,1760
Ishan,M,100,0,1759,1759
Jet,M,97,48,1710,1758
Leatha,F,100,1758,0,1758
Tashina,F,100,1758,0,1758
Burl,M,100,0,1757,1757
Shaniah,F,100,1757,0,1757
Ubaldo,M,100,0,1756,1756
Amparo,F,100,1748,7,1755
Hortencia,F,100,1754,0,1754
Nolen,M,100,5,1749,1754
Kareen,F,58,1024,729,1753
Marius,M,100,0,1753,1753
Jad,M,100,0,1752,1752
Judie,F,100,1752,0,1752
Kamran,M,99,10,1742,1752
Kanesha,F,100,1752,0,1752
Deondra,F,77,1341,410,1751
Nickolaus,M,100,0,1751,1751
Rosann,F,100,1750,0,1750
Andreana,F,100,1749,0,1749
Hayli,F,100,1749,0,1749
Lucious,M,100,0,1749,1749
Jerrad,M,100,0,1748,1748
Rayvon,M,97,61,1687,1748
Alen,M,100,0,1747,1747
Brooklin,F,100,1742,5,1747
Rolf,M,100,0,1747,1747
Johny,M,100,0,1746,1746
Lakyn,F,98,1709,37,1746
Delaine,F,94,1632,113,1745
Sharie,F,100,1745,0,1745
Desarae,F,100,1744,0,1744
Shalanda,F,100,1744,0,1744
Laurin,F,90,1568,175,1743
Mckenzi,F,100,1743,0,1743
Angely,F,100,1742,0,1742
Donato,M,100,0,1742,1742
Dusti,F,99,1733,9,1742
Marli,F,100,1742,0,1742
Lynwood,M,100,0,1741,1741
Steffany,F,100,1741,0,1741
Vonnie,F,93,1614,127,1741
Yahya,M,100,6,1735,1741
Akiva,M,93,114,1626,1740
Poppy,F,100,1740,0,1740
Rheanna,F,100,1740,0,1740
Markie,F,82,1434,305,1739
Nohemi,F,100,1739,0,1739
Shandi,F,100,1739,0,1739
Justis,M,78,384,1353,1737
Stefania,F,100,1737,0,1737
Mickel,M,97,47,1689,1736
Calandra,F,100,1735,0,1735
Cam,M,80,339,1396,1735
Calleigh,F,100,1734,0,1734
Gearld,M,100,5,1729,1734
Carolyne,F,100,1733,0,1733
Dyana,F,100,1733,0,1733
Gwyn,F,96,1659,74,1733
Jailynn,F,97,1689,44,1733
Jimi,M,65,611,1122,1733
Mickayla,F,100,1733,0,1733
Nilsa,F,100,1733,0,1733
Tayden,M,91,150,1583,1733
Anselmo,M,100,0,1732,1732
Carsten,M,100,0,1732,1732
Mariaelena,F,100,1732,0,1732
Seven,M,70,527,1205,1732
Elouise,F,100,1731,0,1731
Keonna,F,100,1731,0,1731
Amaria,F,100,1725,5,1730
Demitri,M,99,23,1707,1730
Babygirl,F,100,1723,6,1729
Jahir,M,100,0,1729,1729
Trevis,M,99,10,1719,1729
Alene,F,100,1728,0,1728
Neida,F,100,1728,0,1728
Arwen,F,100,1727,0,1727
Jeanelle,F,100,1727,0,1727
Parth,M,100,0,1727,1727
Young,M,73,461,1266,1727
Koren,F,88,1514,212,1726
Mendel,M,100,0,1726,1726
Mikell,M,75,429,1297,1726
Rori,F,99,1709,17,1726
Xitlali,F,100,1726,0,1726
Paden,M,90,179,1546,1725
Avion,M,84,275,1449,1724
Estephanie,F,100,1724,0,1724
Thanh,M,62,650,1074,1724
Demarius,M,100,0,1723,1723
Finnley,M,62,650,1073,1723
Keysha,F,100,1722,0,1722
Adaline,F,100,1721,0,1721
Antoni,M,100,5,1716,1721
Ajani,M,90,172,1548,1720
Ameera,F,100,1720,0,1720
Cleve,M,100,0,1718,1718
Muhammed,M,100,0,1718,1718
Wilda,F,100,1718,0,1718
Arsenio,M,100,0,1717,1717
Roderic,M,100,0,1717,1717
Isacc,M,100,0,1716,1716
Nahla,F,100,1716,0,1716
Adelia,F,100,1714,0,1714
Amerie,F,100,1713,0,1713
Jacen,M,100,0,1713,1713
Analicia,F,100,1712,0,1712
Caeden,M,98,29,1683,1712
Celso,M,100,0,1712,1712
Miki,F,96,1639,73,1712
Dashiell,M,99,11,1700,1711
Kena,F,99,1700,11,1711
Tyshaun,M,100,5,1705,1710
Amberlee,F,100,1709,0,1709
Dietrich,M,91,149,1559,1708
Maisha,F,100,1708,0,1708
Yovani,M,99,16,1692,1708
Dalen,M,99,16,1691,1707
Guinevere,F,100,1707,0,1707
Jenice,F,100,1707,0,1707
Jiselle,F,100,1707,0,1707
Chelsee,F,100,1706,0,1706
Cinthya,F,100,1706,0,1706
Kaylon,M,63,635,1071,1706
Maceo,M,100,0,1705,1705
Kaylei,F,100,1704,0,1704
Tyrique,M,100,0,1704,1704
Cedar,M,56,750,951,1701
Gerrit,M,100,0,1701,1701
Kyrah,F,100,1701,0,1701
Umar,M,100,0,1701,1701
Desiray,F,100,1700,0,1700
Emili,F,100,1700,0,1700
Lasonya,F,100,1700,0,1700
Leeland,M,99,10,1690,1700
Flint,M,100,0,1699,1699
Kyanna,F,100,1699,0,1699
Shaylin,F,99,1689,10,1699
Elden,M,100,0,1698,1698
Tam,M,53,805,893,1698
Xavion,M,100,0,1698,1698
Jonell,F,88,1490,207,1697
Katilyn,F,100,1697,0,1697
Rasheeda,F,99,1687,10,1697
Servando,M,100,0,1697,1697
Alexie,F,85,1440,256,1696
Nyree,F,91,1542,154,1696
Roddy,M,100,0,1696,1696
Conan,M,100,0,1695,1695
Dustan,M,100,0,1695,1695
Raeanne,F,100,1695,0,1695
Baily,F,75,1277,417,1694
Emerie,F,99,1684,10,1694
Darris,M,99,19,1674,1693
Amity,F,100,1692,0,1692
Garren,M,99,17,1675,1692
Jadah,F,100,1692,0,1692
Malique,M,99,11,1681,1692
Najah,F,98,1659,33,1692
Leilany,F,100,1691,0,1691
Elizabet,F,100,1690,0,1690
Markanthony,M,100,0,1690,1690
Sven,M,100,0,1690,1690
Shanique,F,100,1689,0,1689
Angelie,F,100,1688,0,1688
Dontavious,M,100,0,1688,1688
Koda,M,91,144,1544,1688
Katharina,F,100,1687,0,1687
Jennyfer,F,100,1686,0,1686
Sanjuana,F,100,1686,0,1686
Skip,M,100,0,1686,1686
Taylen,M,59,689,997,1686
Aharon,M,100,0,1685,1685
Canon,M,99,24,1661,1685
Gisell,F,100,1685,0,1685
Ashwin,M,100,0,1684,1684
Britnee,F,100,1684,0,1684
Fayth,F,100,1684,0,1684
Phillis,F,100,1684,0,1684
Cosette,F,100,1683,0,1683
Stephine,F,100,1683,0,1683
Kainoa,M,98,27,1655,1682
Karisma,F,100,1682,0,1682
Abdulrahman,M,100,0,1681,1681
Lizzette,F,100,1681,0,1681
Adel,M,64,603,1077,1680
Kaira,F,100,1680,0,1680
Kimball,M,92,140,1539,1679
Breeana,F,100,1678,0,1678
Cameo,F,88,1472,206,1678
Penney,F,100,1678,0,1678
Shonta,F,96,1604,74,1678
Zahara,F,100,1678,0,1678
Billi,F,100,1671,5,1676
Cayleigh,F,100,1676,0,1676
Dominica,F,100,1676,0,1676
Maryelizabeth,F,100,1676,0,1676
Vishal,M,100,0,1676,1676
Marlow,M,70,503,1172,1675
Nels,M,100,0,1674,1674
Ricci,M,51,826,848,1674
Yana,F,100,1673,0,1673
Aime,F,98,1643,29,1672
Aston,M,92,129,1543,1672
Caridad,F,100,1672,0,1672
Issa,M,80,332,1340,1672
Laramie,M,57,725,947,1672
Payden,M,67,557,1115,1672
Karlos,M,100,0,1671,1671
Jacqualine,F,100,1670,0,1670
Kennth,M,100,0,1670,1670
Cherelle,F,100,1669,0,1669
Devion,M,98,26,1643,1669
Jeanene,F,100,1669,0,1669
Adamari,F,100,1668,0,1668
Demetrious,M,97,57,1611,1668
Lamonica,F,100,1662,6,1668
Landis,M,86,234,1434,1668
Shakayla,F,100,1668,0,1668
Sueann,F,100,1668,0,1668
Tynisha,F,100,1668,0,1668
Kyren,M,96,66,1601,1667
Macario,M,100,0,1667,1667
Cordero,M,99,9,1657,1666
Sharmaine,F,100,1660,5,1665
Bari,F,93,1553,111,1664
Lakenya,F,100,1664,0,1664
Lamya,F,100,1664,0,1664
Randon,M,99,10,1653,1663
Anayah,F,100,1662,0,1662
Casper,M,100,0,1662,1662
Ebonee,F,100,1662,0,1662
Kilee,F,100,1661,0,1661
Nayla,F,100,1661,0,1661
Olympia,F,100,1661,0,1661
Syncere,M,77,375,1286,1661
Cecilio,M,100,0,1660,1660
Rafe,M,100,0,1660,1660
Vivek,M,100,0,1660,1660
Amee,F,100,1659,0,1659
Dixon,M,100,0,1659,1659
Zia,F,89,1481,178,1659
Milania,F,100,1658,0,1658
Odette,F,100,1658,0,1658
Amiee,F,100,1657,0,1657
Kimi,F,95,1570,87,1657
Deane,M,66,567,1088,1655
Diedre,F,100,1655,0,1655
Hadlee,F,99,1645,10,1655
Janelly,F,100,1655,0,1655
Shamus,M,100,0,1655,1655
Cally,F,100,1654,0,1654
Nancie,F,100,1654,0,1654
Osmar,M,100,0,1654,1654
Tashawn,M,83,273,1381,1654
Jens,M,100,0,1653,1653
Konstantinos,M,100,0,1653,1653
Cameran,M,53,781,871,1652
Quran,M,98,34,1618,1652
Alexavier,M,100,0,1651,1651
Cort,M,100,0,1651,1651
Elisheva,F,100,1650,0,1650
Harmonie,F,100,1650,0,1650
Ieshia,F,100,1650,0,1650
Romy,F,90,1483,167,1650
Briona,F,100,1649,0,1649
Quin,M,79,350,1299,1649
Shamari,F,58,953,695,1648
Aj,M,99,17,1630,1647
Alston,M,99,16,1631,1647
Durrell,M,100,0,1647,1647
Kelsee,F,100,1647,0,1647
Khaled,M,100,0,1647,1647
Torry,M,86,236,1411,1647
Abran,M,100,0,1644,1644
Asma,F,100,1644,0,1644
Isael,M,100,0,1644,1644
Joye,F,100,1644,0,1644
Phaedra,F,100,1644,0,1644
Adella,F,100,1643,0,1643
Anaiah,F,99,1631,12,1643
Finnian,M,100,0,1643,1643
Kaelan,M,77,380,1263,1643
Destanie,F,100,1642,0,1642
Sanya,F,100,1642,0,1642
Asiah,F,91,1492,149,1641
Columbus,M,100,0,1641,1641
Enedina,F,100,1641,0,1641
Gladis,F,100,1640,0,1640
Keya,F,100,1640,0,1640
Prentiss,M,96,60,1580,1640
Emelyn,F,100,1639,0,1639
Jadelyn,F,100,1639,0,1639
Brodrick,M,100,0,1638,1638
Lauralee,F,100,1638,0,1638
Whittney,F,100,1633,5,1638
Samanta,F,100,1637,0,1637
Jarius,M,100,0,1636,1636
Lannie,M,64,588,1048,1636
Maryssa,F,100,1635,0,1635
Modesto,M,100,0,1635,1635
Nakayla,F,100,1635,0,1635
Petrina,F,100,1635,0,1635
Awilda,F,100,1634,0,1634
Filip,M,100,0,1633,1633
Lajuan,M,64,596,1037,1633
Naila,F,100,1633,0,1633
Rafaela,F,100,1633,0,1633
Stacee,F,100,1633,0,1633
Tyrin,M,99,11,1622,1633
Joette,F,100,1632,0,1632
Krisha,F,100,1632,0,1632
Krystyna,F,100,1632,0,1632
Sinai,F,90,1475,157,1632
Haileigh,F,100,1631,0,1631
Una,F,100,1631,0,1631
Cliffton,M,100,0,1630,1630
Shaan,M,100,0,1630,1630
Tal,M,69,500,1130,1630
Yocheved,F,100,1630,0,1630
Kolin,M,100,0,1629,1629
Marquan,M,100,0,1629,1629
Lakita,F,100,1628,0,1628
Rome,M,95,89,1539,1628
Lanna,F,100,1627,0,1627
Delmer,M,100,0,1626,1626
Jameka,F,100,1626,0,1626
Rainey,F,87,1416,210,1626
Emiley,F,100,1625,0,1625
Benicio,M,100,0,1624,1624
Delena,F,100,1624,0,1624
Jeanpaul,M,100,0,1624,1624
Jhon,M,100,0,1624,1624
Heber,M,100,0,1623,1623
Shaunda,F,100,1623,0,1623
Nakiya,F,100,1617,5,1622
Gatlin,M,100,0,1621,1621
Danell,F,76,1234,386,1620
Kylene,F,100,1620,0,1620
Mylah,F,100,1620,0,1620
Baldemar,M,100,0,1619,1619
Brittnay,F,100,1619,0,1619
Darryn,M,98,39,1580,1619
Marchelle,F,100,1619,0,1619
Andriana,F,100,1617,0,1617
Elayne,F,100,1616,0,1616
Kase,M,100,0,1616,1616
Ashante,F,89,1443,172,1615
Bracha,F,100,1615,0,1615
Symphony,F,100,1615,0,1615
Tenzin,M,56,705,910,1615
Amauri,M,70,481,1133,1614
Consuela,F,100,1614,0,1614
Zayd,M,100,0,1614,1614
Dagoberto,M,100,0,1612,1612
Jashua,M,100,0,1612,1612
Lisandro,M,100,5,1607,1612
Skylee,F,100,1612,0,1612
Suzannah,F,100,1612,0,1612
Yaretzy,F,100,1612,0,1612
Chasen,M,100,0,1611,1611
Dajon,M,96,70,1541,1611
Anand,M,100,0,1610,1610
Cord,M,100,0,1609,1609
Eian,M,100,0,1608,1608
Elio,M,100,0,1608,1608
Esai,M,100,0,1608,1608
Grisel,F,100,1601,7,1608
Rudolfo,M,100,0,1608,1608
Talen,M,97,44,1564,1608
Jomar,M,100,0,1607,1607
Tino,M,100,0,1607,1607
Aleyah,F,100,1606,0,1606
Gabriell,F,79,1263,343,1606
Lainie,F,100,1606,0,1606
Jacari,M,96,68,1537,1605
Rochell,F,96,1548,57,1605
Vanity,F,100,1605,0,1605
Alexius,F,93,1492,112,1604
Alonza,M,100,6,1598,1604
Josias,M,100,0,1604,1604
Leatrice,F,100,1604,0,1604
Shamara,F,100,1604,0,1604
Akia,F,94,1514,89,1603
Ananda,F,96,1532,71,1603
Skylynn,F,100,1603,0,1603
Courtnee,F,100,1594,8,1602
Lyndi,F,100,1602,0,1602
Brooklynne,F,100,1601,0,1601
Chenoa,F,100,1600,0,1600
Jasleen,F,100,1600,0,1600
Claribel,F,100,1599,0,1599
Emmerson,F,88,1400,199,1599
Kalob,M,100,0,1599,1599
Ozzie,M,95,77,1522,1599
Zamir,M,100,0,1597,1597
Alexzandria,F,100,1596,0,1596
Klara,F,100,1596,0,1596
Lorianne,F,100,1596,0,1596
Merideth,F,100,1596,0,1596
Laith,M,100,0,1595,1595
Shia,M,60,641,954,1595
Shyanna,F,100,1595,0,1595
Thurston,M,100,0,1594,1594
Crawford,M,99,13,1580,1593
Romello,M,100,0,1593,1593
Iran,M,74,408,1184,1592
Matilde,F,96,1532,60,1592
Priyanka,F,100,1592,0,1592
Elisia,F,100,1591,0,1591
Lorine,F,100,1591,0,1591
Taren,F,73,1154,437,1591
Azure,F,88,1405,185,1590
Hester,F,98,1563,27,1590
Chayce,M,84,251,1338,1589
Jerron,M,100,0,1589,1589
Keyara,F,100,1589,0,1589
Leeroy,M,100,0,1589,1589
Lyndell,M,77,363,1226,1589
Dessie,F,97,1538,50,1588
Arley,M,75,400,1187,1587
Genie,F,100,1580,6,1586
Liesl,F,100,1586,0,1586
Tanvi,F,100,1586,0,1586
Zaina,F,100,1586,0,1586
Zulma,F,100,1586,0,1586
Huy,M,100,0,1585,1585
Beatrix,F,100,1584,0,1584
Corby,M,81,303,1281,1584
Markia,F,100,1584,0,1584
Pietro,M,100,0,1584,1584
Cristiano,M,100,0,1583,1583
Kayne,M,99,15,1568,1583
Marcial,M,100,0,1583,1583
Zakia,F,99,1567,16,1583
Feliciano,M,100,0,1582,1582
Linh,F,87,1369,213,1582
Sahana,F,100,1582,0,1582
Teal,F,88,1389,193,1582
Cherlyn,F,100,1581,0,1581
Kathern,F,100,1580,0,1580
Cayce,F,70,1107,472,1579
Gwenda,F,100,1578,0,1578
Latoyia,F,100,1578,0,1578
Shantae,F,100,1572,6,1578
Faisal,M,100,0,1577,1577
Jamarius,M,100,0,1577,1577
Raylynn,F,99,1558,19,1577
Rylin,F,60,941,635,1576
Anaiya,F,100,1575,0,1575
Cheyann,F,100,1575,0,1575
Gidget,F,100,1575,0,1575
Jubilee,F,100,1569,6,1575
Norine,F,100,1575,0,1575
Sania,F,100,1575,0,1575
Yasir,M,100,0,1574,1574
Enos,M,100,0,1573,1573
Kaysen,M,85,231,1342,1573
Mekayla,F,100,1573,0,1573
Antonino,M,100,0,1572,1572
Devonna,F,100,1572,0,1572
Pansy,F,100,1572,0,1572
Tamiya,F,100,1571,0,1571
Tavin,M,99,23,1547,1570
Bethel,F,89,1402,167,1569
Kaniyah,F,100,1569,0,1569
Camie,F,100,1568,0,1568
Eliazar,M,100,0,1568,1568
Jaslynn,F,100,1567,0,1567
Persephone,F,100,1567,0,1567
Garnett,M,79,331,1235,1566
Kyley,F,95,1490,76,1566
Nickey,M,80,311,1255,1566
Sparkle,F,100,1566,0,1566
Pauletta,F,100,1565,0,1565
Demian,M,99,14,1550,1564
Jahlil,M,100,0,1564,1564
Lillyann,F,100,1564,0,1564
Raeanna,F,100,1564,0,1564
Abhinav,M,100,0,1563,1563
Jethro,M,100,0,1563,1563
Shemeka,F,100,1563,0,1563
Steele,M,99,21,1542,1563
Telly,M,95,82,1481,1563
Lucus,M,100,0,1562,1562
Fatoumata,F,100,1561,0,1561
Kiyah,F,100,1561,0,1561
Nyssa,F,100,1561,0,1561
Leyna,F,100,1560,0,1560
Venice,F,93,1456,104,1560
Jacquez,M,100,0,1559,1559
Yehoshua,M,100,0,1559,1559
Zacharia,M,99,22,1537,1559
Zoee,F,100,1559,0,1559
Atlas,M,98,34,1524,1558
Dakari,M,94,90,1468,1558
Milly,F,100,1558,0,1558
Armin,M,100,0,1556,1556
Marylynn,F,100,1556,0,1556
Gaynell,F,100,1555,0,1555
Janely,F,100,1555,0,1555
Jani,F,95,1476,79,1555
Vikram,M,100,0,1555,1555
Jerell,M,100,5,1549,1554
Lashae,F,100,1554,0,1554
Baleigh,F,100,1553,0,1553
Julieanne,F,100,1553,0,1553
Lisandra,F,100,1553,0,1553
Macee,F,100,1553,0,1553
Rebeccah,F,100,1553,0,1553
Tyeisha,F,100,1553,0,1553
Hanan,F,94,1456,96,1552
Maleek,M,100,0,1552,1552
Migel,M,100,0,1552,1552
Alane,F,100,1551,0,1551
Javaris,M,100,0,1551,1551
Johannes,M,100,0,1551,1551
Noemy,F,100,1551,0,1551
Adara,F,100,1550,0,1550
Cortland,M,98,32,1518,1550
Jerred,M,100,0,1550,1550
Maksim,M,100,0,1550,1550
Melania,F,100,1550,0,1550
Myisha,F,100,1550,0,1550
Pamelia,F,100,1550,0,1550
Shenita,F,100,1550,0,1550
Siara,F,100,1550,0,1550
Ayush,M,100,0,1549,1549
Destry,M,91,145,1404,1549
Laure,F,100,1549,0,1549
Nery,M,83,267,1281,1548
Nikolaos,M,100,0,1548,1548
Treasa,F,100,1548,0,1548
Viki,F,100,1548,0,1548
Azriel,M,74,397,1150,1547
Brienna,F,100,1547,0,1547
Demari,M,89,175,1372,1547
Jahmir,M,100,0,1547,1547
Rony,M,100,0,1547,1547
Joya,F,100,1546,0,1546
Kiona,F,100,1546,0,1546
Bailie,F,100,1545,0,1545
Mariajose,F,100,1545,0,1545
Annah,F,100,1544,0,1544
Melton,M,100,0,1544,1544
Alethia,F,100,1543,0,1543
Guillermina,F,100,1543,0,1543
Lucile,F,100,1543,0,1543
Mattea,F,100,1543,0,1543
Devonne,F,58,893,649,1542
Kobie,M,85,238,1304,1542
Ruthanne,F,100,1542,0,1542
Dawayne,M,100,0,1541,1541
Esha,F,100,1541,0,1541
Lauro,M,100,0,1541,1541
Maricella,F,100,1541,0,1541
La,F,81,1251,289,1540
Launa,F,100,1540,0,1540
Stafford,M,100,0,1540,1540
Toi,F,97,1487,53,1540
Windell,M,99,11,1529,1540
Laquanda,F,100,1539,0,1539
Michala,F,100,1539,0,1539
Rebekkah,F,100,1539,0,1539
Leron,M,100,0,1538,1538
Aislynn,F,100,1536,0,1536
Ena,F,100,1536,0,1536
Shade,F,54,836,700,1536
Quanisha,F,100,1535,0,1535
Tameika,F,100,1535,0,1535
Celestina,F,100,1534,0,1534
Gricelda,F,100,1534,0,1534
Medina,F,100,1534,0,1534
Niklas,M,100,0,1534,1534
Rowland,M,100,0,1534,1534
Verenice,F,100,1534,0,1534
Amon,M,100,0,1533,1533
Briann,F,99,1512,20,1532
Sandro,M,100,0,1532,1532
Geena,F,100,1531,0,1531
Herminia,F,100,1531,0,1531
Janita,F,100,1531,0,1531
Levy,M,99,22,1509,1531
Criselda,F,100,1530,0,1530
Mischa,F,88,1350,180,1530
Brylie,F,100,1524,5,1529
Maja,F,100,1529,0,1529
Xena,F,100,1529,0,1529
Isobel,F,100,1528,0,1528
Marygrace,F,100,1528,0,1528
Kohl,M,100,0,1527,1527
Marisha,F,100,1527,0,1527
Roshan,M,92,118,1409,1527
Aniston,F,99,1507,19,1526
Jerrel,M,100,5,1521,1526
Neena,F,100,1526,0,1526
Shaelynn,F,100,1526,0,1526
Taha,M,100,0,1526,1526
Berlin,F,71,1086,439,1525
Jessee,M,81,297,1228,1525
Kamara,F,99,1513,12,1525
Shayan,M,96,58,1467,1525
Abigael,F,100,1519,5,1524
Fidencio,M,100,0,1524,1524
Karely,F,100,1524,0,1524
Rayyan,M,93,100,1424,1524
Hadleigh,F,100,1523,0,1523
Jeremi,M,97,44,1479,1523
Jayquan,M,100,0,1522,1522
Salman,M,100,0,1522,1522
Savon,M,96,66,1456,1522
Shereen,F,100,1522,0,1522
Sulema,F,100,1522,0,1522
Joely,F,100,1521,0,1521
Nahum,M,100,0,1521,1521
Stefon,M,100,0,1521,1521
Izzabella,F,100,1520,0,1520
Kendel,F,51,772,748,1520
Lanell,F,77,1171,349,1520
Taneka,F,100,1519,0,1519
Aaryn,F,61,926,592,1518
Georgetta,F,100,1518,0,1518
Laraine,F,100,1518,0,1518
Loreal,F,100,1518,0,1518
Vernetta,F,100,1518,0,1518
Adler,M,91,131,1386,1517
Rupert,M,100,0,1517,1517
Santina,F,100,1517,0,1517
Armida,F,100,1516,0,1516
Gamaliel,M,100,0,1516,1516
Ivelisse,F,100,1516,0,1516
Mahala,F,100,1516,0,1516
Philomena,F,100,1516,0,1516
Rahsaan,M,100,6,1510,1516
Keasia,F,100,1515,0,1515
Malayah,F,100,1515,0,1515
Sena,F,92,1389,126,1515
Ameerah,F,100,1514,0,1514
Kerin,F,83,1262,252,1514
Martel,M,99,10,1504,1514
Maximino,M,100,0,1514,1514
Alaric,M,100,0,1513,1513
Delfino,M,100,0,1513,1513
Efrem,M,100,0,1513,1513
Elmo,M,100,0,1513,1513
Zola,F,100,1513,0,1513
Anniston,F,100,1512,0,1512
Brayson,M,100,0,1512,1512
Desteny,F,100,1512,0,1512
Mylie,F,100,1512,0,1512
Sailor,F,85,1282,229,1511
Taytum,F,88,1327,184,1511
Tommi,F,99,1495,16,1511
Erynn,F,100,1510,0,1510
Ladawn,F,100,1510,0,1510
Nyesha,F,100,1510,0,1510
Donetta,F,100,1509,0,1509
Lettie,F,100,1509,0,1509
Sherree,F,100,1509,0,1509
Garnet,F,64,966,542,1508
Kallen,M,82,269,1239,1508
Male,M,100,0,1508,1508
Chole,F,100,1507,0,1507
Janella,F,100,1507,0,1507
Damita,F,100,1506,0,1506
Celestino,M,100,0,1505,1505
Sherice,F,100,1505,0,1505
Khalilah,F,100,1503,0,1503
Lasandra,F,100,1503,0,1503
Milla,F,100,1503,0,1503
Raizy,F,100,1503,0,1503
Shanee,F,100,1503,0,1503
Ambrosia,F,100,1502,0,1502
Ayman,M,98,28,1474,1502
Josslyn,F,100,1502,0,1502
Tinsley,F,98,1470,32,1502
Catlin,F,70,1055,446,1501
Dondre,M,100,0,1501,1501
Dyanna,F,100,1501,0,1501
Marbella,F,100,1501,0,1501
Mariama,F,100,1501,0,1501
Tandy,F,75,1119,382,1501
Akshay,M,100,0,1500,1500
Kelan,M,100,0,1500,1500
Rigo,M,100,0,1500,1500
Kejuan,M,100,0,1499,1499
Maliya,F,100,1499,0,1499
Safiya,F,100,1499,0,1499
Terresa,F,100,1499,0,1499
Cammy,F,100,1498,0,1498
Drue,M,59,616,882,1498
Jesseca,F,100,1498,0,1498
Rashonda,F,100,1498,0,1498
Achilles,M,100,0,1497,1497
Emeline,F,100,1497,0,1497
Griffen,M,100,0,1497,1497
Jennefer,F,100,1497,0,1497
Joceline,F,100,1497,0,1497
Nabil,M,97,49,1448,1497
Emmit,M,100,0,1496,1496
Mccoy,M,98,26,1470,1496
Garfield,M,100,0,1495,1495
Violette,F,100,1495,0,1495
Ceara,F,100,1494,0,1494
Eladio,M,100,0,1494,1494
Jaison,M,100,0,1494,1494
Mykah,F,61,915,579,1494
Yaseen,M,100,0,1494,1494
Om,M,100,0,1493,1493
Oran,M,100,0,1493,1493
Riki,F,72,1078,415,1493
Shanaya,F,100,1493,0,1493
Ciro,M,100,0,1492,1492
Freedom,F,65,976,516,1492
Johnette,F,100,1492,0,1492
Ares,M,97,39,1452,1491
Anglea,F,100,1489,0,1489
Berkeley,F,68,1014,475,1489
Dashon,M,98,33,1456,1489
Kasha,F,100,1488,0,1488
Adreanna,F,100,1487,0,1487
Jama,F,96,1421,66,1487
Maha,F,100,1487,0,1487
Sumer,F,100,1487,0,1487
Yasin,M,100,0,1487,1487
Roan,M,92,115,1371,1486
Celene,F,100,1485,0,1485
Chesley,M,62,563,922,1485
Geoffery,M,100,0,1485,1485
Jenette,F,100,1485,0,1485
Shawnte,F,93,1383,102,1485
Dorie,F,100,1479,5,1484
Jonpaul,M,100,0,1484,1484
Lawrance,M,100,0,1484,1484
Uziel,M,100,0,1484,1484
Yoselyn,F,100,1484,0,1484
Aarush,M,100,0,1483,1483
Zaden,M,100,0,1483,1483
Alistair,M,100,0,1482,1482
Nisa,F,100,1481,0,1481
Kasia,F,100,1480,0,1480
Kemberly,F,100,1480,0,1480
Mayer,M,100,5,1475,1480
Torian,M,85,220,1260,1480
Delta,F,97,1434,45,1479
Shatara,F,100,1479,0,1479
Tamir,M,97,45,1434,1479
Juanpablo,M,100,0,1478,1478
Melodi,F,100,1478,0,1478
Alexcia,F,100,1477,0,1477
Alizabeth,F,100,1477,0,1477
Mahdi,M,100,0,1477,1477
Sammi,F,97,1427,50,1477
Khamari,M,78,332,1144,1476
Milford,M,100,0,1476,1476
Waleed,M,100,0,1476,1476
Izak,M,100,0,1475,1475
Liyah,F,100,1475,0,1475
Teryn,F,84,1234,241,1475
Jamaica,F,98,1442,32,1474
Anas,M,100,0,1473,1473
Antonina,F,100,1473,0,1473
Naeem,M,100,0,1473,1473
Oziel,M,100,0,1473,1473
Rodriquez,M,100,0,1473,1473
Trysten,M,81,285,1188,1473
Detrick,M,98,25,1447,1472
Donal,M,100,5,1467,1472
Shantal,F,100,1472,0,1472
Shaya,M,51,727,745,1472
Geoff,M,100,0,1471,1471
Ona,F,100,1471,0,1471
Daryll,M,99,11,1459,1470
Kym,F,88,1297,173,1470
Tirzah,F,100,1470,0,1470
Kenadie,F,100,1468,0,1468
Jonathen,M,100,0,1466,1466
Lindell,M,86,205,1261,1466
Makeda,F,100,1466,0,1466
Maryanna,F,100,1466,0,1466
Hansel,M,100,0,1465,1465
Normand,M,100,0,1465,1465
Denese,F,100,1464,0,1464
Kamarion,M,100,6,1458,1464
Keiara,F,100,1464,0,1464
Serafina,F,100,1464,0,1464
Taunya,F,100,1464,0,1464
Corbett,M,100,0,1463,1463
Joline,F,100,1462,0,1462
Zana,F,100,1462,0,1462
Annastasia,F,100,1461,0,1461
Channel,F,100,1461,0,1461
Kaedyn,M,63,537,924,1461
Anali,F,100,1460,0,1460
Hadi,M,100,0,1460,1460
Lyndsie,F,100,1460,0,1460
Marna,F,100,1459,0,1459
Shanise,F,100,1459,0,1459
Sharice,F,100,1459,0,1459
Akhil,M,100,0,1458,1458
Iyonna,F,100,1458,0,1458
Skylah,F,100,1458,0,1458
Alessa,F,100,1457,0,1457
Carver,M,100,0,1457,1457
Breauna,F,100,1456,0,1456
Hayle,F,100,1456,0,1456
Tadd,M,100,0,1456,1456
Aminata,F,100,1455,0,1455
Billiejo,F,100,1455,0,1455
Cate,F,100,1455,0,1455
Jakai,M,90,141,1314,1455
Sunnie,F,99,1445,10,1455
Drayton,M,100,0,1454,1454
Emelie,F,100,1454,0,1454
Shemika,F,100,1454,0,1454
Sima,F,100,1454,0,1454
Analy,F,100,1453,0,1453
Loryn,F,100,1453,0,1453
Teddi,F,100,1453,0,1453
Wendall,M,100,6,1447,1453
Daunte,M,100,0,1452,1452
Dede,F,100,1452,0,1452
Jalyssa,F,100,1452,0,1452
Nikkia,F,99,1440,12,1452
Sherell,F,100,1452,0,1452
Webster,M,100,0,1452,1452
Ashlynne,F,100,1451,0,1451
Kaliah,F,100,1451,0,1451
Britteny,F,100,1450,0,1450
Deb,F,100,1450,0,1450
Grayce,F,100,1450,0,1450
Dereon,M,76,345,1104,1449
Stephannie,F,100,1449,0,1449
Carmon,F,75,1080,368,1448
Chloee,F,100,1448,0,1448
Mychael,M,84,237,1210,1447
Porscha,F,100,1447,0,1447
Clancy,M,69,453,993,1446
Dathan,M,100,0,1446,1446
Arlan,M,100,0,1445,1445
Marinda,F,100,1445,0,1445
Delaina,F,100,1444,0,1444
West,M,100,0,1444,1444
Alexsis,F,87,1253,190,1443
Derron,M,100,0,1443,1443
Londa,F,100,1443,0,1443
Raychel,F,100,1443,0,1443
Xitlaly,F,100,1443,0,1443
Jennings,M,93,94,1348,1442
Candido,M,100,0,1441,1441
Damonte,M,100,0,1441,1441
Mallori,F,100,1441,0,1441
Armen,M,100,0,1440,1440
Maude,F,100,1440,0,1440
Tiago,M,100,0,1440,1440
Zacharias,M,100,0,1440,1440
Garet,M,100,0,1439,1439
Jadan,M,76,343,1096,1439
Marrissa,F,100,1439,0,1439
Tonette,F,100,1439,0,1439
Jarek,M,100,0,1438,1438
Malky,F,100,1438,0,1438
Tenesha,F,100,1438,0,1438
Zuriel,M,85,219,1219,1438
Ammie,F,100,1437,0,1437
Tray,M,100,0,1437,1437
Neriah,F,99,1416,20,1436
Farris,M,88,174,1261,1435
Shaindy,F,100,1435,0,1435
Skyy,F,93,1328,107,1435
Claira,F,100,1434,0,1434
Mahalia,F,100,1434,0,1434
Marcoantonio,M,100,0,1434,1434
Montel,M,100,0,1434,1434
Aamir,M,100,6,1427,1433
Payson,M,58,596,837,1433
Rilynn,F,97,1393,40,1433
Vic,M,100,0,1433,1433
Jaziel,M,98,35,1397,1432
Samari,F,68,967,465,1432
Alford,M,100,0,1431,1431
Blaize,M,89,154,1277,1431
Cassia,F,100,1431,0,1431
Jailen,M,81,275,1156,1431
Joannie,F,100,1431,0,1431
Dayla,F,100,1430,0,1430
Ezell,M,98,22,1408,1430
Nader,M,100,0,1430,1430
Nissa,F,100,1430,0,1430
Terrion,M,92,111,1319,1430
Chaney,F,73,1037,392,1429
Ahmir,M,100,5,1423,1428
Diona,F,100,1428,0,1428
Karren,F,100,1428,0,1428
Kylea,F,100,1428,0,1428
Joao,M,100,0,1427,1427
Neville,M,100,0,1427,1427
Jerardo,M,100,0,1425,1425
Neymar,M,100,5,1420,1425
Lauran,F,100,1424,0,1424
Kenadee,F,100,1423,0,1423
Temple,F,76,1083,340,1423
Lajuana,F,100,1422,0,1422
Rayann,F,100,1417,5,1422
Daulton,M,100,0,1421,1421
Jeryl,F,60,855,566,1421
Lashaunda,F,100,1421,0,1421
Rasheen,M,93,95,1326,1421
Tyjuan,M,100,0,1421,1421
Jamall,M,100,0,1420,1420
Nelida,F,100,1420,0,1420
Shera,F,100,1420,0,1420
Chistopher,M,100,0,1419,1419
Darious,M,100,0,1419,1419
Jayshawn,M,100,0,1419,1419
Kinlee,F,100,1419,0,1419
Marjory,F,100,1419,0,1419
Temeka,F,100,1414,5,1419
Djuan,M,100,7,1411,1418
Jannah,F,100,1418,0,1418
Lynnea,F,100,1418,0,1418
Dalvin,M,100,0,1417,1417
Jaydyn,M,55,639,778,1417
Lisset,F,100,1417,0,1417
Zacchaeus,M,100,0,1417,1417
Zeb,M,100,0,1417,1417
Anushka,F,100,1416,0,1416
Cameren,M,85,211,1205,1416
Raoul,M,100,0,1416,1416
Giovany,M,100,0,1415,1415
Shanay,F,100,1415,0,1415
Tallulah,F,100,1415,0,1415
Vijay,M,100,0,1415,1415
Azalia,F,100,1414,0,1414
Chayton,M,100,6,1408,1414
Clive,M,100,0,1414,1414
Jene,F,87,1225,189,1414
Latifah,F,100,1414,0,1414
Rahim,M,100,0,1414,1414
Salim,M,100,0,1414,1414
Adora,F,100,1413,0,1413
Jarron,M,100,0,1413,1413
Kennady,F,100,1413,0,1413
Keonte,M,96,55,1358,1413
Micahel,M,100,0,1413,1413
Neda,F,100,1413,0,1413
Christianne,F,100,1412,0,1412
Shamia,F,100,1412,0,1412
Allena,F,100,1411,0,1411
Coley,M,84,230,1181,1411
Jacee,F,98,1383,28,1411
Adley,F,81,1149,261,1410
Debroah,F,100,1410,0,1410
Jaidan,M,60,557,853,1410
Shamira,F,100,1410,0,1410
Tisa,F,100,1410,0,1410
Avalyn,F,100,1409,0,1409
Candelario,M,100,0,1409,1409
Maisy,F,100,1409,0,1409
Micheala,F,100,1409,0,1409
Aleida,F,100,1408,0,1408
Conrado,M,100,0,1408,1408
Hipolito,M,100,0,1408,1408
Jeronimo,M,100,0,1408,1408
Perrin,M,75,355,1053,1408
Talyn,F,52,731,676,1407
Caylie,F,100,1406,0,1406
Cheyanna,F,100,1406,0,1406
Leandre,M,99,15,1391,1406
Terrica,F,100,1406,0,1406
Jayci,F,100,1405,0,1405
Kloey,F,100,1405,0,1405
Romero,M,100,0,1405,1405
Shalynn,F,100,1405,0,1405
Simcha,M,87,185,1220,1405
Duran,M,100,0,1404,1404
Geovany,M,100,0,1404,1404
Jareth,M,98,32,1372,1404
Kadijah,F,100,1404,0,1404
Shawanna,F,100,1404,0,1404
Katrena,F,100,1403,0,1403
Lovie,F,88,1228,175,1403
Myasia,F,100,1403,0,1403
Nakeisha,F,100,1403,0,1403
Ronisha,F,100,1403,0,1403
Adena,F,100,1402,0,1402
Marysol,F,100,1402,0,1402
Sera,F,100,1402,0,1402
Candelaria,F,100,1401,0,1401
Derric,M,100,0,1401,1401
Eitan,M,100,0,1401,1401
Lyssa,F,100,1401,0,1401
Milagro,F,98,1375,26,1401
Sheyenne,F,100,1401,0,1401
Ciaran,M,98,30,1369,1399
Jaelen,M,85,210,1189,1399
Kaydin,M,66,480,919,1399
Shardae,F,100,1399,0,1399
Willam,M,100,0,1399,1399
Zakiyah,F,100,1399,0,1399
Analee,F,100,1398,0,1398
Arcelia,F,100,1398,0,1398
Henrik,M,100,0,1398,1398
Kennon,M,99,20,1378,1398
Kordell,M,100,0,1398,1398
Steffen,M,100,0,1398,1398
Cass,M,91,121,1276,1397
Jahaira,F,100,1397,0,1397
Adolphus,M,100,0,1396,1396
Cambree,F,100,1396,0,1396
Denzil,M,100,0,1396,1396
Karalyn,F,100,1396,0,1396
Marino,M,100,0,1396,1396
Jarid,M,100,0,1395,1395
Novella,F,100,1395,0,1395
Sedric,M,100,0,1395,1395
Valente,M,100,0,1395,1395
Veronique,F,100,1395,0,1395
Aly,F,63,883,511,1394
Latara,F,100,1394,0,1394
Hermelinda,F,100,1392,0,1392
Jaina,F,100,1392,0,1392
Kennadi,F,100,1392,0,1392
Athan,M,100,0,1391,1391
Tyriq,M,100,0,1391,1391
Delonte,M,100,0,1390,1390
Evalynn,F,100,1389,0,1389
Mckinzie,F,100,1389,0,1389
Marilou,F,100,1388,0,1388
Marquell,M,99,19,1369,1388
Ramel,M,100,0,1388,1388
Terah,F,97,1345,43,1388
Brynley,F,100,1387,0,1387
Hiba,F,100,1387,0,1387
Natanael,M,100,0,1387,1387
Octavious,M,100,5,1382,1387
Pascal,M,100,6,1380,1386
Alaysha,F,100,1385,0,1385
Genia,F,100,1385,0,1385
Nyomi,F,100,1385,0,1385
Christena,F,100,1384,0,1384
Irie,F,82,1133,251,1384
Oswald,M,100,0,1384,1384
Arriana,F,100,1382,0,1382
Dijon,M,95,69,1313,1382
Madelynne,F,100,1382,0,1382
Camari,M,60,559,822,1381
Charita,F,100,1381,0,1381
Darry,M,100,0,1381,1381
Donelle,F,77,1065,316,1381
Janean,F,100,1381,0,1381
Saleem,M,100,0,1381,1381
Tinley,F,100,1381,0,1381
Courtenay,F,83,1151,229,1380
Loy,M,81,256,1124,1380
Jamika,F,100,1379,0,1379
Jawan,M,99,12,1367,1379
Melannie,F,100,1379,0,1379
Naimah,F,100,1379,0,1379
Annaleigh,F,100,1378,0,1378
Elon,M,72,379,999,1378
Tandra,F,100,1378,0,1378
Teague,M,98,32,1346,1378
Jiovanni,M,100,0,1377,1377
Kekoa,M,98,22,1355,1377
Melita,F,100,1377,0,1377
Tru,F,53,731,646,1377
Yehudis,F,100,1377,0,1377
Antwaun,M,100,5,1371,1376
Jerika,F,100,1376,0,1376
Naomy,F,100,1376,0,1376
Ysabella,F,100,1376,0,1376
Amada,F,100,1375,0,1375
Denim,M,76,333,1042,1375
Alphonzo,M,100,0,1374,1374
Arnita,F,100,1374,0,1374
Harland,M,100,0,1374,1374
Riccardo,M,100,0,1374,1374
Shakera,F,100,1374,0,1374
Shylah,F,100,1374,0,1374
Amberlyn,F,100,1373,0,1373
Jamieson,M,94,78,1295,1373
Kalib,M,100,0,1373,1373
Keandra,F,99,1363,10,1373
Adelita,F,100,1372,0,1372
Shannah,F,100,1372,0,1372
Takara,F,100,1372,0,1372
Tuan,M,100,0,1372,1372
Daelyn,F,69,946,425,1371
Darcel,F,90,1240,131,1371
Gaylord,M,100,0,1371,1371
Itzayana,F,100,1371,0,1371
Lakeesha,F,100,1370,0,1370
Analiese,F,100,1369,0,1369
Caine,M,100,0,1369,1369
Tausha,F,100,1369,0,1369
Alasia,F,100,1368,0,1368
Azael,M,100,0,1368,1368
Lovely,F,100,1368,0,1368
Mea,F,100,1368,0,1368
Anay,F,54,745,622,1367
Anjel,M,72,376,991,1367
Dimas,M,100,0,1367,1367
Gaylen,M,82,246,1121,1367
Jones,M,100,0,1366,1366
Jonmichael,M,100,0,1366,1366
Kamrin,M,70,416,950,1366
Marwa,F,100,1366,0,1366
Phineas,M,100,0,1366,1366
Stevi,F,100,1366,0,1366
Xavi,M,100,6,1360,1366
Dea,F,100,1360,5,1365
Dezarae,F,100,1365,0,1365
Ellena,F,100,1365,0,1365
Lorretta,F,100,1365,0,1365
Notnamed,M,53,643,722,1365
Safa,F,100,1365,0,1365
Sandee,F,100,1365,0,1365
Taven,M,97,47,1318,1365
Bryden,M,98,23,1341,1364
Destine,F,87,1184,180,1364
Elam,M,100,0,1364,1364
Lynna,F,100,1364,0,1364
Saeed,M,100,0,1364,1364
Tereasa,F,100,1364,0,1364
Jariel,M,97,39,1324,1363
Jonte,M,83,226,1137,1363
Sascha,F,76,1038,325,1363
Adell,F,77,1046,316,1362
Francois,M,100,5,1357,1362
Keirra,F,100,1362,0,1362
Ashby,M,56,605,756,1361
Jacquetta,F,100,1361,0,1361
Josefa,F,100,1361,0,1361
Sable,F,100,1361,0,1361
Shirlee,F,100,1361,0,1361
Natacha,F,100,1360,0,1360
Saif,M,100,0,1360,1360
Godfrey,M,100,0,1359,1359
Jospeh,M,100,0,1359,1359
Tylee,F,76,1037,322,1359
Briannah,F,100,1358,0,1358
Danthony,M,100,0,1358,1358
Mykal,M,76,326,1032,1358
Grayden,M,100,0,1357,1357
Julieanna,F,100,1357,0,1357
Wyman,M,100,0,1357,1357
Zoila,F,100,1357,0,1357
Alysse,F,100,1356,0,1356
Aziza,F,100,1356,0,1356
Erykah,F,100,1356,0,1356
Eternity,F,100,1356,0,1356
Vinh,M,99,10,1346,1356
Xochilt,F,100,1356,0,1356
Axton,M,100,0,1355,1355
Breeann,F,100,1355,0,1355
Elysa,F,100,1355,0,1355
Lian,F,50,684,671,1355
Amaiya,F,100,1354,0,1354
Byran,M,100,0,1354,1354
Dionicio,M,100,0,1354,1354
Drucilla,F,100,1354,0,1354
Karrington,F,82,1105,249,1354
Loria,F,100,1354,0,1354
Saba,F,95,1285,69,1354
Kervin,M,100,0,1353,1353
Treshawn,M,100,5,1348,1353
Chancey,M,65,469,883,1352
Kandyce,F,100,1352,0,1352
Letty,F,100,1352,0,1352
Niccole,F,100,1352,0,1352
Saniah,F,100,1352,0,1352
Daphney,F,100,1351,0,1351
Deryl,M,89,144,1207,1351
Twanda,F,100,1351,0,1351
Aleya,F,100,1350,0,1350
Aneesa,F,100,1350,0,1350
Dusten,M,100,0,1350,1350
Florine,F,100,1350,0,1350
Walt,M,100,0,1350,1350
Korben,M,100,0,1349,1349
Alexandros,M,100,0,1347,1347
Chyenne,F,100,1342,5,1347
Durell,M,100,0,1347,1347
Indya,F,100,1346,0,1346
Khalif,M,100,0,1346,1346
Necole,F,100,1346,0,1346
Shamir,M,84,213,1133,1346
Alita,F,100,1345,0,1345
Amora,F,100,1345,0,1345
Angelene,F,100,1345,0,1345
Katheryne,F,100,1345,0,1345
Schyler,M,56,595,750,1345
Cailee,F,100,1344,0,1344
Kayci,F,100,1344,0,1344
Britani,F,100,1343,0,1343
Kimmie,F,90,1212,131,1343
Maryrose,F,100,1343,0,1343
Pa,F,100,1338,5,1343
Raniyah,F,100,1342,0,1342
Cavan,M,100,0,1341,1341
Darel,M,100,5,1336,1341
Jacolby,M,99,15,1326,1341
Lark,F,93,1241,100,1341
Marylee,F,100,1341,0,1341
Sharell,F,99,1325,16,1341
Daisey,F,100,1340,0,1340
Omega,F,74,988,352,1340
Sedona,F,100,1340,0,1340
Quadir,M,100,0,1339,1339
Samer,M,100,5,1334,1339
Gala,F,100,1338,0,1338
Indiana,F,52,694,644,1338
Renzo,M,100,0,1338,1338
Tammera,F,100,1338,0,1338
Tesa,F,100,1338,0,1338
Velia,F,100,1338,0,1338
Allene,F,100,1337,0,1337
Benji,M,96,47,1290,1337
Jhonny,M,100,0,1337,1337
Taylee,F,100,1337,0,1337
Dayvon,M,100,0,1336,1336
Gaspar,M,100,0,1336,1336
Jin,M,73,359,977,1336
Tijuana,F,100,1336,0,1336
Eron,M,90,134,1201,1335
Keiana,F,100,1335,0,1335
Kensington,F,96,1277,58,1335
Bertrand,M,100,0,1334,1334
Lawton,M,100,0,1334,1334
Sid,M,100,0,1334,1334
Anyah,F,100,1333,0,1333
Elisabet,F,100,1333,0,1333
Michaele,F,98,1312,21,1333
Sharhonda,F,100,1333,0,1333
Jayse,M,98,23,1309,1332
Regine,F,100,1332,0,1332
Shriya,F,100,1332,0,1332
Breyanna,F,100,1331,0,1331
Kiyana,F,100,1331,0,1331
Obie,M,100,0,1331,1331
Rashelle,F,100,1331,0,1331
Skylor,M,73,358,973,1331
Sneha,F,100,1331,0,1331
Deziree,F,100,1330,0,1330
Kathey,F,100,1330,0,1330
Keirsten,F,100,1330,0,1330
Allisa,F,100,1329,0,1329
Bryar,M,82,233,1096,1329
Kandra,F,100,1329,0,1329
Ranee,F,100,1329,0,1329
Teah,F,100,1329,0,1329
Giorgio,M,100,0,1328,1328
Henderson,M,100,0,1328,1328
Ricco,M,100,0,1328,1328
Tillman,M,100,0,1328,1328
Yoana,F,100,1328,0,1328
Javontae,M,100,0,1327,1327
Twanna,F,100,1327,0,1327
Tytiana,F,100,1327,0,1327
Sixto,M,100,0,1326,1326
Watson,M,100,0,1326,1326
Betzaida,F,100,1325,0,1325
Olivier,M,100,5,1320,1325
Baruch,M,100,0,1324,1324
Davi,M,67,439,885,1324
Denali,F,72,956,368,1324
Adrina,F,100,1323,0,1323
Cyndy,F,100,1323,0,1323
Jamere,M,98,22,1301,1323
Vivianne,F,100,1323,0,1323
Zarah,F,100,1323,0,1323
Atreyu,M,100,0,1322,1322
Deserae,F,100,1322,0,1322
Karima,F,100,1322,0,1322
Shenna,F,100,1322,0,1322
Shiv,M,100,0,1322,1322
Derreck,M,100,0,1321,1321
Abbe,F,100,1320,0,1320
Alaa,F,71,939,381,1320
Elodie,F,100,1320,0,1320
Keelie,F,100,1320,0,1320
Briauna,F,100,1319,0,1319
Johnell,M,79,278,1041,1319
Lemar,M,100,0,1319,1319
Meleah,F,100,1318,0,1318
Winford,M,100,0,1318,1318
Ardis,F,70,921,396,1317
Charlena,F,100,1317,0,1317
Kamilla,F,100,1317,0,1317
Llewellyn,M,98,30,1287,1317
Mikaylah,F,100,1317,0,1317
Roby,M,98,29,1288,1317
Tynesha,F,100,1317,0,1317
Adalia,F,100,1316,0,1316
Michayla,F,100,1316,0,1316
Steffan,M,100,0,1316,1316
Darek,M,100,0,1315,1315
Makia,F,98,1292,23,1315
Narciso,M,100,0,1315,1315
Phuong,F,79,1033,282,1315
Vann,M,98,24,1291,1315
Devine,M,52,627,687,1314
Ivon,F,79,1038,276,1314
Lilibeth,F,100,1314,0,1314
Marquisha,F,100,1314,0,1314
Thania,F,100,1314,0,1314
Broden,M,100,0,1313,1313
Deniz,M,54,601,712,1313
Rachal,F,100,1313,0,1313
Sharilyn,F,100,1313,0,1313
Tysen,M,99,10,1303,1313
Illiana,F,100,1312,0,1312
Thompson,M,100,0,1312,1312
Cera,F,100,1311,0,1311
Deysi,F,100,1311,0,1311
Gerold,M,100,0,1311,1311
Javeon,M,100,0,1311,1311
Shirl,F,94,1231,80,1311
Thais,F,100,1311,0,1311
Tiernan,M,87,175,1136,1311
Adalee,F,100,1310,0,1310
Darryle,M,100,0,1310,1310
Katelynne,F,100,1310,0,1310
Linn,F,50,657,653,1310
Shalon,F,90,1180,130,1310
Zakery,M,100,0,1310,1310
Rion,M,84,213,1096,1309
Taneshia,F,100,1309,0,1309
Fox,M,99,7,1301,1308
Junius,M,100,0,1308,1308
Karlton,M,100,0,1308,1308
Keilah,F,100,1308,0,1308
Michaelle,F,100,1308,0,1308
Carlyle,M,89,140,1167,1307
Fabiana,F,100,1307,0,1307
Wende,F,100,1307,0,1307
Christpher,M,100,0,1305,1305
Evander,M,100,0,1305,1305
Kinslee,F,100,1305,0,1305
Halima,F,100,1304,0,1304
Theodis,M,100,0,1304,1304
Drayden,M,100,0,1303,1303
Graci,F,100,1303,0,1303
Takoda,M,92,100,1203,1303
Darlyn,F,98,1281,21,1302
Granville,M,100,0,1302,1302
Harlem,M,75,320,982,1302
Yamil,M,95,64,1238,1302
Abdirahman,M,100,0,1301,1301
Bao,M,55,579,722,1301
Donnetta,F,100,1301,0,1301
Ren,M,87,170,1131,1301
Tama,F,100,1295,6,1301
Vasilios,M,100,0,1301,1301
Crispin,M,100,5,1295,1300
Evyn,F,54,698,602,1300
Samar,F,61,794,506,1300
Sheronda,F,100,1300,0,1300
Diante,M,98,20,1279,1299
Edrick,M,100,0,1299,1299
Emari,F,55,709,590,1299
Georgene,F,100,1299,0,1299
Marcanthony,M,100,0,1299,1299
Samirah,F,100,1299,0,1299
Jahiem,M,100,0,1298,1298
Leopold,M,100,0,1298,1298
Naftali,M,100,0,1298,1298
Willette,F,100,1298,0,1298
Atiya,F,100,1297,0,1297
Boaz,M,100,0,1297,1297
Davontae,M,100,0,1297,1297
Eartha,F,100,1292,5,1297
Eliott,M,100,0,1297,1297
Etienne,M,94,81,1216,1297
Eulalia,F,100,1297,0,1297
Lynetta,F,100,1297,0,1297
Raye,F,90,1166,131,1297
Sayra,F,100,1297,0,1297
Cipriano,M,100,0,1296,1296
Markeisha,F,100,1296,0,1296
Vanita,F,100,1296,0,1296
Charlyn,F,100,1295,0,1295
Graig,M,100,0,1295,1295
Jaymi,F,100,1290,5,1295
Lillia,F,100,1295,0,1295
Sharika,F,100,1295,0,1295
Tahir,M,100,0,1295,1295
Zenia,F,100,1295,0,1295
Delane,F,53,685,609,1294
Marly,F,100,1289,5,1294
Jakobi,M,98,29,1264,1293
Kaison,M,100,5,1288,1293
Yaquelin,F,100,1293,0,1293
Zayda,F,100,1293,0,1293
Derrion,M,97,45,1247,1292
Jamario,M,100,0,1292,1292
Katherina,F,100,1292,0,1292
Tamarah,F,100,1292,0,1292
Tiona,F,100,1292,0,1292
Doretta,F,100,1291,0,1291
Ky,M,91,111,1180,1291
Laiken,F,86,1114,177,1291
Danesha,F,100,1290,0,1290
Logen,M,88,152,1138,1290
Rosalio,M,100,5,1285,1290
Tiffini,F,100,1290,0,1290
Yadhira,F,100,1290,0,1290
Christon,M,82,231,1058,1289
Daymon,M,100,0,1289,1289
Keylee,F,100,1289,0,1289
Lenna,F,100,1289,0,1289
Dava,F,100,1288,0,1288
Errick,M,100,0,1288,1288
Javien,M,100,0,1288,1288
Lonzo,M,100,0,1288,1288
Thai,M,86,184,1104,1288
Annabeth,F,100,1287,0,1287
Georgeann,F,100,1287,0,1287
Kalan,M,82,237,1050,1287
Alyshia,F,100,1286,0,1286
Camry,F,91,1166,120,1286
Diondre,M,100,0,1286,1286
Jamaine,M,99,16,1270,1286
Gustav,M,100,0,1285,1285
Kanye,M,98,24,1261,1285
Alexzandra,F,100,1284,0,1284
Evaristo,M,100,0,1284,1284
Lida,F,100,1284,0,1284
Lin,F,62,793,491,1284
Rommel,M,100,0,1284,1284
Anela,F,100,1283,0,1283
Edgard,M,100,0,1283,1283
Female,F,100,1278,5,1283
Taelyn,F,94,1208,75,1283
Arrianna,F,100,1282,0,1282
Drusilla,F,100,1281,0,1281
Eleanora,F,100,1281,0,1281
Jayven,M,100,0,1281,1281
Treveon,M,100,0,1281,1281
Zaylee,F,100,1281,0,1281
Aleia,F,100,1280,0,1280
Jaidon,M,95,65,1215,1280
Keondre,M,100,0,1280,1280
Kimmy,F,78,1004,276,1280
Marlaina,F,100,1280,0,1280
Quan,M,97,39,1241,1280
Roshawn,M,67,422,858,1280
Tyrik,M,100,0,1280,1280
Alaura,F,100,1279,0,1279
Jamarr,M,100,0,1279,1279
Jessyca,F,100,1279,0,1279
Keiry,F,100,1279,0,1279
Laurette,F,100,1279,0,1279
Tressie,F,100,1279,0,1279
Reign,F,66,846,432,1278
Jadarius,M,100,0,1277,1277
Kaydance,F,100,1277,0,1277
Vanna,F,95,1218,59,1277
Batsheva,F,100,1276,0,1276
Darice,F,99,1263,13,1276
Makenzy,F,100,1276,0,1276
Nathon,M,100,0,1276,1276
Giacomo,M,100,0,1275,1275
Sharae,F,100,1275,0,1275
Thresa,F,100,1275,0,1275
Briseyda,F,100,1274,0,1274
Damarius,M,100,0,1274,1274
Hafsa,F,100,1274,0,1274
Jackelin,F,100,1274,0,1274
Johnathen,M,100,0,1274,1274
Jathan,M,100,0,1273,1273
Kina,F,100,1273,0,1273
Lavonna,F,100,1273,0,1273
Zak,M,100,0,1273,1273
Arlena,F,100,1272,0,1272
Bernabe,M,100,0,1272,1272
Izabela,F,100,1272,0,1272
Leda,F,100,1272,0,1272
Sai,M,76,308,964,1272
Tanis,F,63,798,474,1272
Verdell,M,55,568,704,1272
Arlinda,F,100,1271,0,1271
Irish,F,92,1169,102,1271
Jermel,M,100,5,1266,1271
Kolt,M,100,0,1271,1271
Waldo,M,100,0,1271,1271
Golden,M,68,411,859,1270
Julene,F,100,1270,0,1270
Shantay,F,100,1270,0,1270
Verne,M,94,77,1193,1270
Arnell,M,74,331,938,1269
Donisha,F,100,1269,0,1269
Gavino,M,100,0,1269,1269
Mykala,F,100,1269,0,1269
Slater,M,100,0,1269,1269
Winfield,M,100,0,1269,1269
Elyjah,M,100,0,1268,1268
Jamichael,M,100,0,1268,1268
Kyrstin,F,100,1268,0,1268
Maryalice,F,100,1268,0,1268
Raquan,M,100,0,1268,1268
Tyshon,M,99,11,1257,1268
Ronica,F,100,1267,0,1267
Stevenson,M,100,0,1267,1267
Kenlee,F,97,1226,40,1266
Meah,F,100,1266,0,1266
Neo,M,100,0,1266,1266
Yamile,F,100,1266,0,1266
Zabrina,F,100,1266,0,1266
Calie,F,100,1265,0,1265
Race,M,100,0,1265,1265
Silver,F,82,1033,232,1265
Wonda,F,100,1265,0,1265
Karyl,F,100,1264,0,1264
Le,F,63,793,471,1264
Nijah,F,89,1122,142,1264
Solange,F,100,1264,0,1264
Yancey,M,97,34,1230,1264
Angle,F,90,1138,125,1263
Danasia,F,100,1263,0,1263
Issiah,M,100,0,1263,1263
Naquan,M,100,0,1262,1262
Paulino,M,100,0,1262,1262
Toniann,F,100,1262,0,1262
True,M,57,541,721,1262
Anabell,F,100,1261,0,1261
Eliud,M,100,0,1261,1261
Phebe,F,100,1261,0,1261
My,F,81,1021,239,1260
Tyreke,M,100,0,1260,1260
Chas,M,100,5,1254,1259
Corben,M,100,0,1259,1259
Daysi,F,100,1259,0,1259
Elexus,F,100,1259,0,1259
Gissell,F,100,1259,0,1259
Marvel,M,54,584,675,1259
Ajah,F,100,1258,0,1258
Avigail,F,100,1258,0,1258
Brienne,F,100,1253,5,1258
Kalisha,F,100,1258,0,1258
Jesika,F,100,1257,0,1257
Kambria,F,100,1257,0,1257
Khai,M,84,197,1059,1256
Theressa,F,100,1256,0,1256
Isaih,M,100,0,1255,1255
Leighanne,F,100,1255,0,1255
Marquese,M,100,0,1255,1255
Raynaldo,M,100,0,1255,1255
Sumaya,F,100,1255,0,1255
December,F,100,1254,0,1254
Elwin,M,100,0,1254,1254
Kally,F,100,1249,5,1254
Teara,F,100,1254,0,1254
Amilia,F,100,1253,0,1253
Bridgit,F,100,1253,0,1253
Rapheal,M,100,0,1252,1252
Alica,F,100,1251,0,1251
Angele,F,100,1251,0,1251
Chazz,M,98,29,1222,1251
Preslie,F,100,1251,0,1251
Yanely,F,100,1251,0,1251
Carmello,M,100,0,1250,1250
Eduard,M,100,0,1250,1250
Naudia,F,100,1250,0,1250
Efraim,M,100,0,1249,1249
Jaziah,M,53,587,662,1249
Vashti,F,100,1249,0,1249
Adiel,M,93,82,1166,1248
Ailani,F,100,1248,0,1248
Azia,F,100,1248,0,1248
Dasean,M,100,0,1248,1248
Derian,M,90,130,1118,1248
Malory,F,100,1248,0,1248
Monisha,F,100,1248,0,1248
Tou,M,100,0,1248,1248
Everleigh,F,100,1247,0,1247
Ladon,M,80,253,994,1247
Samarah,F,100,1247,0,1247
Abbigayle,F,100,1246,0,1246
Arun,M,100,0,1246,1246
Brina,F,100,1241,5,1246
Kareena,F,100,1246,0,1246
Tillie,F,100,1246,0,1246
Avary,F,93,1160,85,1245
Darlena,F,100,1245,0,1245
Fischer,M,100,0,1245,1245
Mcarthur,M,100,0,1245,1245
Bethanne,F,100,1244,0,1244
Kemari,M,72,344,900,1244
Jc,M,97,32,1211,1243
Khristina,F,100,1243,0,1243
Kristeen,F,100,1243,0,1243
Raena,F,100,1243,0,1243
Chaise,M,74,318,924,1242
Kavya,F,100,1236,6,1242
Zayra,F,100,1242,0,1242
Romell,M,98,22,1219,1241
Sianna,F,100,1241,0,1241
Delina,F,100,1240,0,1240
Deseree,F,100,1240,0,1240
Isaura,F,100,1240,0,1240
Teisha,F,100,1240,0,1240
Zayla,F,100,1240,0,1240
Hartley,F,64,787,452,1239
Kathia,F,100,1239,0,1239
Yechiel,M,100,0,1239,1239
Arne,M,100,0,1238,1238
Gennaro,M,100,0,1238,1238
Larita,F,100,1238,0,1238
Serafin,M,100,0,1238,1238
Aiesha,F,100,1237,0,1237
Aila,F,100,1237,0,1237
Betsey,F,100,1237,0,1237
Cutter,M,100,0,1237,1237
Edsel,M,100,0,1237,1237
Glynda,F,100,1237,0,1237
Hala,F,100,1237,0,1237
Antuan,M,100,0,1236,1236
Belva,F,100,1236,0,1236
Dasani,F,74,912,324,1236
Hashim,M,100,0,1236,1236
Kaytlynn,F,100,1236,0,1236
Keane,M,100,0,1236,1236
Lakayla,F,100,1236,0,1236
Laquinta,F,98,1209,27,1236
Makaylee,F,100,1236,0,1236
Nicholette,F,100,1236,0,1236
Roselynn,F,100,1236,0,1236
Kailen,F,52,638,597,1235
Margarette,F,100,1235,0,1235
Yecenia,F,100,1230,5,1235
Emry,F,70,865,369,1234
Frederica,F,100,1234,0,1234
Lanisha,F,100,1234,0,1234
Lochlan,M,98,21,1213,1234
Loralee,F,100,1234,0,1234
Serge,M,100,0,1234,1234
Alejandrina,F,100,1233,0,1233
Eris,F,75,925,308,1233
Linnie,F,78,966,267,1233
Lionell,M,100,0,1233,1233
Ninfa,F,100,1233,0,1233
Asad,M,100,0,1232,1232
Darryll,M,100,0,1232,1232
Davante,M,100,0,1232,1232
Delora,F,100,1232,0,1232
Kendyll,F,98,1213,19,1232
Lynden,M,69,383,849,1232
Nam,M,100,0,1232,1232
Pearline,F,100,1232,0,1232
Halen,M,64,445,786,1231
Joslin,F,99,1221,10,1231
Solana,F,100,1231,0,1231
Bess,F,100,1230,0,1230
Bobbijo,F,100,1230,0,1230
Madelene,F,100,1230,0,1230
Nicolai,M,100,0,1230,1230
Paiton,F,88,1077,153,1230
Rush,M,100,0,1230,1230
Shaunta,F,97,1193,37,1230
Augusto,M,100,0,1229,1229
Rosaline,F,100,1229,0,1229
Theadore,M,100,0,1229,1229
Akeelah,F,100,1228,0,1228
Shondra,F,100,1228,0,1228
Sir,M,100,0,1228,1228
Wayman,M,100,0,1228,1228
Anastacio,M,100,0,1227,1227
Kriston,F,59,720,507,1227
Reegan,F,79,964,263,1227
Romaine,F,61,754,473,1227
Sinead,F,100,1227,0,1227
Halli,F,100,1226,0,1226
Rasheem,M,100,0,1226,1226
Shannel,F,100,1226,0,1226
Shivam,M,100,0,1226,1226
Syeda,F,100,1226,0,1226
Trinitee,F,100,1226,0,1226
Ennis,M,98,28,1197,1225
Ferris,M,90,126,1099,1225
Jeane,F,100,1225,0,1225
Jia,F,83,1011,214,1225
Justo,M,100,0,1225,1225
Lakeysha,F,100,1225,0,1225
Shawne,F,65,796,429,1225
Silverio,M,100,0,1225,1225
Lebron,M,100,0,1224,1224
Nicollette,F,100,1224,0,1224
Valinda,F,100,1224,0,1224
Jalia,F,100,1223,0,1223
Nidhi,F,100,1223,0,1223
Treyson,M,100,0,1223,1223
Brittan,F,64,787,435,1222
Niall,M,100,0,1222,1222
Thao,F,84,1030,192,1222
Cavin,M,100,0,1221,1221
Jetta,F,100,1221,0,1221
Kailie,F,100,1221,0,1221
Keelin,F,78,956,265,1221
Kimbra,F,100,1221,0,1221
Naja,F,100,1215,6,1221
Emmanuelle,F,78,954,266,1220
Kaeleigh,F,100,1220,0,1220
Tona,F,100,1220,0,1220
Charmayne,F,100,1219,0,1219
Kamar,M,98,19,1200,1219
Kimberle,F,100,1219,0,1219
Maddix,M,87,160,1059,1219
Masyn,M,70,366,852,1218
Caressa,F,100,1217,0,1217
Obadiah,M,100,0,1217,1217
Torre,M,67,403,814,1217
Zayn,M,99,11,1206,1217
Dayshawn,M,100,5,1211,1216
Naomie,F,100,1216,0,1216
Zada,F,100,1216,0,1216
Brinlee,F,100,1215,0,1215
Felicita,F,100,1215,0,1215
Kinzie,F,100,1215,0,1215
Avian,M,79,260,954,1214
Darick,M,100,0,1214,1214
Edythe,F,100,1214,0,1214
Victory,F,69,840,374,1214
Aarya,F,78,950,263,1213
Delainey,F,100,1213,0,1213
Theophilus,M,100,0,1213,1213
Tryston,M,99,10,1203,1213
Brendyn,M,100,0,1212,1212
Ethyn,M,100,0,1212,1212
Irina,F,100,1212,0,1212
Jackqueline,F,100,1212,0,1212
Adyn,M,91,114,1097,1211
Lakeya,F,100,1211,0,1211
Lorissa,F,100,1211,0,1211
Cherryl,F,100,1210,0,1210
Juaquin,M,100,0,1210,1210
Sharri,F,100,1210,0,1210
Akayla,F,100,1209,0,1209
Meta,F,100,1209,0,1209
Mickael,M,99,11,1198,1209
Trudie,F,100,1209,0,1209
Donella,F,100,1208,0,1208
Jakiya,F,100,1208,0,1208
Rylynn,F,96,1156,52,1208
Cadyn,M,70,360,847,1207
Edan,M,88,148,1059,1207
Ela,F,100,1207,0,1207
Francie,F,100,1207,0,1207
Kenadi,F,100,1207,0,1207
Lue,F,77,927,280,1207
Callahan,M,67,394,812,1206
Dyllon,M,100,0,1206,1206
Seraphina,F,100,1206,0,1206
Jennine,F,100,1205,0,1205
Sharod,M,100,0,1205,1205
Aarron,M,100,0,1204,1204
Aundra,M,70,366,838,1204
Hawa,F,100,1204,0,1204
Kamia,F,100,1204,0,1204
Merrilee,F,100,1204,0,1204
Antron,M,100,0,1203,1203
Aislyn,F,100,1202,0,1202
Brigit,F,100,1202,0,1202
Cj,M,90,126,1076,1202
Jazlene,F,100,1202,0,1202
Meyer,M,96,45,1157,1202
Shakita,F,100,1202,0,1202
Vannesa,F,100,1202,0,1202
Rima,F,100,1201,0,1201
Delon,M,97,38,1162,1200
Kunal,M,100,0,1200,1200
Shireen,F,100,1200,0,1200
Tanasia,F,100,1199,0,1199
Deangela,F,100,1198,0,1198
Tayshaun,M,99,10,1188,1198
Amaia,F,100,1197,0,1197
Daniya,F,100,1197,0,1197
Dalene,F,100,1196,0,1196
Evelia,F,100,1196,0,1196
Tywan,M,99,15,1181,1196
Avalynn,F,100,1195,0,1195
Louanne,F,100,1195,0,1195
Margarett,F,100,1195,0,1195
Tamarra,F,100,1195,0,1195
Annalyse,F,100,1194,0,1194
Axl,M,100,0,1194,1194
Gracee,F,100,1194,0,1194
Korin,F,93,1109,85,1194
Lambert,M,100,0,1194,1194
Oneal,M,100,0,1194,1194
Camillia,F,100,1193,0,1193
Jarrid,M,100,0,1193,1193
Shamiya,F,100,1193,0,1193
Tayvon,M,100,0,1193,1193
Harlen,M,99,9,1183,1192
Jabril,M,100,0,1192,1192
Aleyna,F,100,1191,0,1191
Andreina,F,99,1185,6,1191
Tarin,F,74,881,310,1191
Ahsley,F,100,1190,0,1190
Amaree,M,57,511,679,1190
Hobert,M,100,0,1190,1190
Lizbet,F,100,1190,0,1190
Merlyn,F,52,617,573,1190
Timber,F,68,804,386,1190
Alyx,F,89,1063,126,1189
Dorine,F,100,1189,0,1189
Karmyn,F,100,1189,0,1189
Marielena,F,100,1189,0,1189
Shealyn,F,100,1189,0,1189
Ansh,M,100,0,1188,1188
Aspyn,F,100,1183,5,1188
Geovani,M,100,0,1188,1188
Marvis,M,62,447,741,1188
Talaya,F,100,1188,0,1188
Crystle,F,100,1187,0,1187
Jameer,M,100,0,1187,1187
Noella,F,100,1187,0,1187
Shain,M,98,26,1161,1187
Teddie,M,55,534,653,1187
Bryna,F,100,1186,0,1186
Kanika,F,100,1186,0,1186
Naseem,M,80,237,949,1186
Shela,F,100,1186,0,1186
Yuki,F,63,749,437,1186
Aine,F,100,1185,0,1185
Collier,M,93,80,1105,1185
Dodie,F,100,1185,0,1185
Angeli,F,100,1184,0,1184
Araseli,F,100,1184,0,1184
Laryssa,F,100,1184,0,1184
Shaine,M,81,222,962,1184
Adilyn,F,100,1183,0,1183
Armondo,M,100,0,1183,1183
Mesha,F,100,1183,0,1183
Renetta,F,100,1183,0,1183
Shifra,F,100,1183,0,1183
Christinia,F,100,1182,0,1182
Daneen,F,100,1182,0,1182
Daneil,M,97,32,1150,1182
Meagen,F,100,1182,0,1182
Naisha,F,100,1182,0,1182
Saxon,M,91,107,1075,1182
Telisha,F,100,1182,0,1182
Trentin,M,100,0,1182,1182
Zaniah,F,100,1182,0,1182
Aundre,M,100,0,1181,1181
Cairo,M,88,147,1034,1181
Denzell,M,100,0,1181,1181
Dominga,F,100,1181,0,1181
Ebone,F,100,1181,0,1181
Anfernee,M,100,0,1180,1180
Kailin,F,89,1050,130,1180
Kaysha,F,100,1180,0,1180
Niamh,F,100,1180,0,1180
Onyx,M,63,442,738,1180
Anyla,F,100,1179,0,1179
Sigrid,F,100,1179,0,1179
Juventino,M,100,0,1178,1178
Lisabeth,F,100,1178,0,1178
Rubie,F,100,1178,0,1178
Chere,F,100,1177,0,1177
Lacresha,F,100,1177,0,1177
Reco,M,100,0,1177,1177
Robynn,F,100,1176,0,1176
Rosy,F,100,1176,0,1176
Vinnie,M,56,519,657,1176
Anijah,F,100,1175,0,1175
Benigno,M,100,0,1175,1175
Jiya,F,100,1175,0,1175
Koa,M,89,124,1051,1175
Ravin,F,80,938,237,1175
Sina,F,64,755,420,1175
Alyana,F,100,1174,0,1174
Mitzie,F,100,1174,0,1174
Bibiana,F,100,1173,0,1173
Kabir,M,100,0,1173,1173
Morghan,F,100,1168,5,1173
Tyonna,F,100,1173,0,1173
Derry,M,93,87,1085,1172
Farhan,M,100,0,1172,1172
Jerrett,M,100,0,1172,1172
Jeslyn,F,100,1172,0,1172
Renate,F,100,1172,0,1172
Sachin,M,100,0,1172,1172
Addilynn,F,100,1171,0,1171
Angelee,F,100,1171,0,1171
Breasia,F,100,1171,0,1171
Makinley,F,100,1171,0,1171
Sabino,M,100,0,1171,1171
Ameen,M,100,0,1170,1170
Cambrie,F,100,1170,0,1170
Deshun,M,97,40,1130,1170
Rashell,F,100,1170,0,1170
Tiare,F,100,1170,0,1170
Kamie,F,100,1169,0,1169
Rivers,M,65,409,760,1169
Damir,M,100,0,1168,1168
Jenson,M,98,27,1141,1168
Jeriah,M,80,236,932,1168
Laela,F,100,1168,0,1168
Rivky,F,100,1168,0,1168
Adi,F,59,686,481,1167
Easter,F,100,1167,0,1167
Jarom,M,100,0,1167,1167
Jelena,F,100,1167,0,1167
Jeraldine,F,100,1167,0,1167
Lavette,F,100,1167,0,1167
Samiah,F,100,1167,0,1167
Gardner,M,100,5,1161,1166
Gennifer,F,100,1166,0,1166
Huda,F,100,1166,0,1166
Imogen,F,100,1166,0,1166
Jaide,F,100,1166,0,1166
Nikisha,F,100,1166,0,1166
Pavel,M,100,0,1166,1166
Virgilio,M,100,0,1166,1166
Anamarie,F,100,1165,0,1165
Damone,M,100,0,1165,1165
Kenleigh,F,100,1165,0,1165
Vina,F,100,1165,0,1165
Dany,M,90,111,1053,1164
Norene,F,100,1164,0,1164
Taquan,M,100,0,1164,1164
Haris,M,100,0,1163,1163
Luisangel,M,100,0,1163,1163
Lynae,F,100,1163,0,1163
Rayleigh,F,100,1163,0,1163
Roshanda,F,100,1163,0,1163
Lyrik,F,62,722,440,1162
Nneka,F,100,1162,0,1162
Hindy,F,100,1161,0,1161
Mihir,M,100,0,1161,1161
Naiya,F,100,1161,0,1161
Bonni,F,100,1160,0,1160
Cleon,M,100,0,1160,1160
Desmon,M,100,0,1160,1160
Garvin,M,100,0,1160,1160
Harriette,F,100,1160,0,1160
Calder,M,98,20,1139,1159
Duston,M,100,0,1159,1159
Mycah,F,58,667,492,1159
Rogan,M,96,42,1117,1159
Tinamarie,F,100,1159,0,1159
Anahy,F,100,1158,0,1158
Merari,F,99,1142,16,1158
Morganne,F,100,1158,0,1158
Bennet,M,97,29,1128,1157
Cornelious,M,100,0,1156,1156
De,M,53,539,617,1156
Dyamond,F,99,1146,10,1156
Howell,M,100,0,1156,1156
Jessiah,M,84,181,975,1156
Kortni,F,100,1156,0,1156
Lizett,F,100,1156,0,1156
Ric,M,100,0,1156,1156
Ardell,M,71,337,818,1155
Bartley,M,100,0,1155,1155
Carlita,F,100,1155,0,1155
Dyson,M,100,5,1150,1155
Keshon,M,96,48,1107,1155
Sharlyn,F,100,1155,0,1155
Davonta,M,100,0,1154,1154
Dovie,F,100,1154,0,1154
Kamala,F,100,1154,0,1154
Mamadou,M,100,0,1154,1154
Rhylee,F,89,1025,129,1154
Sarrah,F,100,1154,0,1154
Toshia,F,100,1154,0,1154
Zaine,M,99,16,1138,1154
Genoveva,F,100,1152,0,1152
Hagan,M,91,109,1043,1152
Jacobe,M,100,0,1152,1152
Laurinda,F,100,1152,0,1152
Shawntel,F,99,1135,17,1152
Signe,F,100,1152,0,1152
Basilio,M,100,0,1151,1151
Joby,M,94,68,1083,1151
Rashaan,M,98,28,1123,1151
Rashaud,M,100,0,1151,1151
Sarabeth,F,100,1151,0,1151
Britain,M,55,522,628,1150
Debera,F,100,1150,0,1150
Sakina,F,100,1150,0,1150
Issabella,F,100,1149,0,1149
Season,F,100,1149,0,1149
Toriano,M,100,0,1149,1149
Emilly,F,100,1148,0,1148
Geremy,M,100,0,1148,1148
Jakira,F,100,1148,0,1148
Lecia,F,100,1148,0,1148
Lulu,F,100,1148,0,1148
Martavious,M,100,0,1148,1148
Tangie,F,100,1148,0,1148
Terina,F,100,1148,0,1148
Uma,F,100,1148,0,1148
Amer,M,99,12,1135,1147
Greysen,M,88,135,1012,1147
Jonie,F,100,1147,0,1147
Mena,F,87,1002,145,1147
Nicoletta,F,100,1147,0,1147
Tashara,F,100,1147,0,1147
Amna,F,100,1146,0,1146
Anirudh,M,100,0,1146,1146
Jalene,F,94,1079,67,1146
Marquitta,F,100,1146,0,1146
Mitzy,F,100,1146,0,1146
Teaira,F,100,1145,0,1145
Tinisha,F,100,1145,0,1145
Adarius,M,100,0,1144,1144
Jun,M,93,84,1060,1144
Kamaya,F,100,1144,0,1144
Addalyn,F,100,1143,0,1143
Auburn,F,83,947,196,1143
Christion,M,99,17,1126,1143
Dash,M,99,11,1132,1143
Jakeb,M,100,0,1143,1143
Joshlyn,F,100,1138,5,1143
Ronney,M,100,0,1143,1143
Tien,M,60,455,688,1143
Jaimi,F,100,1142,0,1142
Kofi,M,100,5,1137,1142
Lanaya,F,100,1142,0,1142
Mariko,F,99,1136,6,1142
Sakura,F,100,1142,0,1142
Annissa,F,100,1141,0,1141
Brande,F,100,1141,0,1141
Connell,M,100,0,1141,1141
Jovie,F,100,1141,0,1141
Kolbe,M,97,37,1104,1141
Theda,F,100,1141,0,1141
Alexxis,F,99,1134,6,1140
Bernetta,F,100,1140,0,1140
Jahmal,M,100,0,1140,1140
Yeshua,M,100,0,1140,1140
Briahna,F,100,1139,0,1139
Diesel,M,100,0,1139,1139
Dondi,M,67,375,764,1139
Genny,F,100,1139,0,1139
Jazz,M,59,465,674,1139
Melaney,F,100,1139,0,1139
Raniya,F,100,1139,0,1139
Shirleen,F,100,1139,0,1139
Jahari,M,91,108,1030,1138
Lexington,F,61,696,442,1138
Tiffney,F,100,1138,0,1138
Briza,F,100,1137,0,1137
Malakhi,M,100,0,1137,1137
Minda,F,100,1137,0,1137
Nima,M,80,225,912,1137
Cherice,F,100,1136,0,1136
Jakia,F,100,1136,0,1136
Meena,F,99,1124,12,1136
Naveen,M,78,249,887,1136
Prisha,F,100,1136,0,1136
Camrin,M,81,215,920,1135
Decarlos,M,100,0,1135,1135
Imanol,M,100,0,1135,1135
Krislyn,F,100,1135,0,1135
Markisha,F,100,1135,0,1135
Jazzlynn,F,100,1134,0,1134
Sheryll,F,100,1134,0,1134
Anil,M,100,0,1133,1133
Damya,F,100,1133,0,1133
Hogan,M,100,0,1133,1133
Jonnathan,M,100,0,1133,1133
Kahlan,F,99,1118,15,1133
Tayshawn,M,100,0,1133,1133
Kenrick,M,100,0,1132,1132
Sione,M,99,6,1126,1132
Wynne,F,92,1038,94,1132
Evita,F,100,1131,0,1131
Deirdra,F,100,1130,0,1130
Jireh,F,52,587,543,1130
Karthik,M,100,0,1130,1130
Lanora,F,100,1130,0,1130
Shanea,F,100,1130,0,1130
Addelyn,F,100,1129,0,1129
Aziz,M,100,0,1129,1129
Courteney,F,100,1124,5,1129
Treston,M,100,0,1129,1129
Xavian,M,100,0,1129,1129
Denyse,F,100,1128,0,1128
Dujuan,M,100,0,1128,1128
Jameelah,F,100,1128,0,1128
Jamy,F,66,745,383,1128
Kamisha,F,100,1128,0,1128
Melena,F,100,1128,0,1128
Nazareth,M,60,448,680,1128
Neill,M,100,0,1128,1128
Queenie,F,100,1128,0,1128
Ulisses,M,100,0,1128,1128
Aldair,M,100,0,1127,1127
Eleana,F,100,1127,0,1127
Eryka,F,100,1127,0,1127
Jonni,F,100,1122,5,1127
Jorje,M,100,0,1127,1127
Yamilex,F,100,1127,0,1127
Zakiyyah,F,100,1127,0,1127
Bevin,F,89,1004,122,1126
Lorina,F,100,1126,0,1126
Corrinne,F,100,1125,0,1125
Dolan,M,100,0,1125,1125
Francina,F,100,1125,0,1125
Gavriel,M,100,5,1120,1125
Golda,F,100,1125,0,1125
Jamelle,M,68,364,761,1125
Michaelangelo,M,100,0,1125,1125
Rayanne,F,100,1125,0,1125
Damario,M,100,0,1124,1124
Dorien,M,94,64,1060,1124
Ehren,M,98,17,1107,1124
Gisella,F,100,1124,0,1124
Inger,F,100,1124,0,1124
Kennedie,F,100,1124,0,1124
Korinne,F,100,1124,0,1124
Maurine,F,100,1124,0,1124
Reema,F,100,1124,0,1124
Cassady,F,92,1036,87,1123
Emmi,F,100,1123,0,1123
Kerra,F,100,1123,0,1123
Shamel,M,86,155,968,1123
Silvio,M,100,0,1123,1123
Amaury,M,100,5,1117,1122
Irena,F,100,1122,0,1122
Shakyra,F,100,1122,0,1122
Arizona,F,91,1019,102,1121
Destani,F,100,1121,0,1121
Eugenie,F,100,1121,0,1121
Kenyata,F,73,820,301,1121
Kimiko,F,100,1121,0,1121
Amairani,F,100,1120,0,1120
Aranza,F,100,1120,0,1120
Jaydah,F,100,1120,0,1120
Laurice,F,92,1028,92,1120
Malerie,F,100,1120,0,1120
Deona,F,100,1119,0,1119
Kaitlan,F,100,1119,0,1119
Keondra,F,98,1102,17,1119
Keva,F,100,1119,0,1119
Wendel,M,100,0,1119,1119
Zen,M,88,137,982,1119
Idella,F,100,1118,0,1118
Ozzy,M,100,0,1118,1118
Shomari,M,94,71,1047,1118
Starlene,F,100,1118,0,1118
Zacary,M,100,0,1118,1118
Aleksandr,M,100,0,1117,1117
Dorthea,F,100,1117,0,1117
Jeffory,M,100,0,1117,1117
Marque,M,87,140,977,1117
Shavonda,F,100,1117,0,1117
Alicea,F,100,1116,0,1116
Amor,F,81,907,209,1116
Correy,M,96,46,1070,1116
Emileigh,F,100,1116,0,1116
Lavonte,M,99,11,1105,1116
Mignon,F,100,1116,0,1116
Taegan,F,73,820,296,1116
Calin,M,80,223,892,1115
Raeleigh,F,100,1115,0,1115
Bryer,M,93,75,1039,1114
Keenen,M,100,0,1114,1114
Bliss,F,98,1086,27,1113
Daniyah,F,100,1113,0,1113
Errin,F,76,842,271,1113
Jalaya,F,100,1113,0,1113
Loyal,M,93,76,1037,1113
Niah,F,100,1113,0,1113
Tyronne,M,100,0,1113,1113
Aliyana,F,100,1112,0,1112
Garold,M,100,0,1112,1112
Jasson,M,100,0,1112,1112
Mattias,M,100,0,1112,1112
Ryanna,F,100,1112,0,1112
Serita,F,100,1112,0,1112
Toria,F,100,1112,0,1112
Aisling,F,100,1111,0,1111
Auden,M,72,313,798,1111
Demarkus,M,100,0,1111,1111
Emeli,F,100,1111,0,1111
Mackayla,F,100,1111,0,1111
Adilynn,F,100,1110,0,1110
Calliope,F,100,1110,0,1110
Dream,F,93,1029,81,1110
Panagiotis,M,100,0,1110,1110
Aleksandar,M,100,0,1109,1109
Flossie,F,100,1109,0,1109
Francene,F,100,1109,0,1109
Karel,F,63,702,407,1109
Marylyn,F,100,1109,0,1109
Tait,M,99,16,1093,1109
Yonathan,M,100,0,1109,1109
Adil,M,100,0,1108,1108
Chantay,F,100,1108,0,1108
Keifer,M,100,0,1108,1108
Kemper,M,90,114,994,1108
Kionna,F,100,1108,0,1108
Mariza,F,100,1108,0,1108
Werner,M,100,0,1108,1108
Chelsa,F,100,1107,0,1107
Nereyda,F,100,1107,0,1107
Noland,M,100,0,1107,1107
Ocie,M,74,287,820,1107
Tab,M,100,0,1107,1107
Adrean,M,63,405,701,1106
Rennie,M,60,437,669,1106
Wesly,M,100,0,1106,1106
Arnie,M,99,16,1089,1105
Bakari,M,100,0,1105,1105
Kamesha,F,100,1105,0,1105
Sultan,M,100,0,1105,1105
Asante,M,80,218,886,1104
Cache,M,59,458,646,1104
Domanic,M,99,11,1093,1104
Keeli,F,100,1104,0,1104
Kennan,M,96,48,1056,1104
Ladarrius,M,100,0,1104,1104
Linzy,F,81,892,212,1104
Mishelle,F,100,1104,0,1104
Nadiya,F,100,1104,0,1104
Saydee,F,100,1104,0,1104
Sonali,F,100,1104,0,1104
Wilder,M,97,31,1073,1104
Chaka,F,76,841,262,1103
Eliyah,F,64,706,397,1103
Marena,F,100,1103,0,1103
Candise,F,100,1102,0,1102
Dwyane,M,100,0,1102,1102
Luanna,F,100,1102,0,1102
Mairead,F,100,1102,0,1102
Mattew,M,100,0,1102,1102
Claud,M,100,0,1101,1101
Denia,F,100,1101,0,1101
Macon,M,88,129,972,1101
Jestin,M,100,0,1100,1100
Mikey,M,100,0,1100,1100
Zakkary,M,100,0,1100,1100
Zariya,F,100,1100,0,1100
Chari,F,100,1099,0,1099
Izel,F,79,865,234,1099
Jashaun,M,100,0,1099,1099
Judge,M,100,0,1099,1099
Nikayla,F,100,1099,0,1099
Raizel,F,100,1099,0,1099
Suzana,F,100,1099,0,1099
Bernardino,M,100,0,1098,1098
Jennell,F,100,1098,0,1098
Cornelio,M,100,0,1097,1097
Telisa,F,100,1097,0,1097
Jacory,M,100,0,1096,1096
Lashondra,F,100,1096,0,1096
Rayce,M,99,11,1085,1096
Calum,M,100,0,1095,1095
Kesean,M,100,0,1095,1095
Khushi,F,100,1095,0,1095
Robie,M,71,319,776,1095
Seema,F,100,1095,0,1095
Sheba,F,100,1095,0,1095
Sierrah,F,100,1095,0,1095
Chloie,F,100,1094,0,1094
Juvenal,M,100,0,1094,1094
Martinez,M,97,29,1065,1094
Rashel,F,100,1094,0,1094
Rufino,M,100,0,1094,1094
Tempest,F,100,1094,0,1094
Alaine,F,100,1093,0,1093
Andru,M,100,0,1093,1093
Cayley,F,100,1093,0,1093
Jessey,M,75,270,823,1093
Laynie,F,100,1093,0,1093
Melanee,F,100,1093,0,1093
Carlena,F,100,1092,0,1092
Dalyn,M,67,361,731,1092
Gustave,M,100,0,1092,1092
Lamia,F,100,1092,0,1092
Tyeshia,F,100,1092,0,1092
Sherril,F,99,1076,15,1091
Donaven,M,100,0,1090,1090
Eathan,M,100,0,1090,1090
Laird,M,100,0,1090,1090
Ravon,M,76,264,826,1090
Zakariya,M,97,36,1054,1090
Casimir,M,100,0,1089,1089
Christoher,M,100,0,1089,1089
Channon,F,67,729,359,1088
Genelle,F,100,1088,0,1088
Jorie,F,99,1074,14,1088
Marlina,F,100,1088,0,1088
Payne,M,99,11,1077,1088
Rakim,M,100,0,1088,1088
Rayquan,M,100,0,1088,1088
Shantia,F,100,1088,0,1088
Shonte,F,93,1008,80,1088
Thuy,F,98,1071,17,1088
Coltyn,M,100,0,1087,1087
Jannelle,F,100,1087,0,1087
Kennie,M,83,187,900,1087
Myeisha,F,100,1087,0,1087
Akasha,F,100,1086,0,1086
Baker,M,96,41,1045,1086
Branda,F,100,1086,0,1086
Kenith,M,100,0,1086,1086
Lynnae,F,100,1086,0,1086
Jamaria,F,97,1048,37,1085
Kaysie,F,100,1085,0,1085
Ramond,M,100,0,1085,1085
Tajuana,F,100,1085,0,1085
Tracye,F,100,1080,5,1085
Dandrea,F,84,910,174,1084
Gwenn,F,100,1084,0,1084
Jahzara,F,100,1084,0,1084
Sadia,F,100,1084,0,1084
Shepherd,M,100,5,1079,1084
Yariel,M,99,10,1074,1084
Alyza,F,100,1083,0,1083
Amberlynn,F,100,1083,0,1083
Kalil,M,100,0,1083,1083
Larson,M,97,37,1046,1083
Mehki,M,100,0,1083,1083
Pricila,F,100,1083,0,1083
Rollie,M,100,0,1083,1083
Zaynab,F,100,1083,0,1083
Christop,M,100,0,1082,1082
Kiarah,F,100,1082,0,1082
Nicolaus,M,100,0,1082,1082
Heba,F,100,1081,0,1081
Jerrid,M,100,0,1081,1081
Mei,F,100,1081,0,1081
Tayah,F,100,1081,0,1081
Verlin,M,98,17,1064,1081
Barret,M,100,5,1075,1080
Jennafer,F,100,1080,0,1080
Caila,F,100,1079,0,1079
Ioannis,M,100,0,1079,1079
Jeneen,F,100,1079,0,1079
Suzi,F,100,1079,0,1079
Terryl,M,55,489,590,1079
Kolbie,F,68,738,340,1078
Lavada,F,100,1078,0,1078
Abdullahi,M,100,0,1077,1077
Breyana,F,100,1077,0,1077
Dakarai,M,98,18,1059,1077
Katana,F,100,1077,0,1077
Martika,F,100,1077,0,1077
Alexsander,M,100,0,1076,1076
Barrington,M,100,0,1076,1076
Jelisa,F,100,1076,0,1076
Yalonda,F,100,1076,0,1076
Yulanda,F,100,1076,0,1076
Arial,F,100,1075,0,1075
Arieanna,F,100,1075,0,1075
Aubriella,F,100,1075,0,1075
Casi,F,100,1075,0,1075
Herminio,M,100,0,1075,1075
Jakiyah,F,100,1075,0,1075
Carlina,F,100,1074,0,1074
Jazmen,F,100,1069,5,1074
Marcey,F,100,1074,0,1074
Truett,M,100,0,1074,1074
Vittoria,F,100,1074,0,1074
Josemanuel,M,100,0,1073,1073
Shalee,F,100,1073,0,1073
Teagen,M,51,522,551,1073
Parish,M,75,268,804,1072
Burnell,M,93,80,991,1071
Curley,M,88,124,947,1071
Deborha,F,100,1071,0,1071
Larue,M,57,462,609,1071
Londynn,F,100,1071,0,1071
Zofia,F,100,1071,0,1071
Abdallah,M,100,0,1070,1070
Endia,F,100,1070,0,1070
Filomena,F,100,1070,0,1070
Ginamarie,F,100,1070,0,1070
Venetia,F,100,1070,0,1070
Chauncy,M,97,33,1036,1069
Cosmo,M,100,0,1069,1069
Roshonda,F,100,1069,0,1069
Tarrah,F,100,1069,0,1069
Athanasios,M,100,0,1068,1068
Vy,F,97,1031,37,1068
Levern,M,87,140,927,1067
Moesha,F,100,1067,0,1067
Teonna,F,100,1067,0,1067
Teya,F,100,1067,0,1067
Bunny,F,98,1043,23,1066
Garner,M,99,13,1053,1066
Joselynn,F,100,1066,0,1066
Joshue,M,100,0,1066,1066
Mace,M,100,0,1066,1066
Maycie,F,100,1066,0,1066
Susy,F,100,1066,0,1066
Asael,M,100,0,1065,1065
Curran,M,97,30,1035,1065
Shakur,M,99,9,1056,1065
Cherisse,F,100,1064,0,1064
Garin,M,100,0,1064,1064
Hussain,M,100,0,1064,1064
Kelson,M,100,0,1064,1064
Maeghan,F,100,1064,0,1064
Michella,F,100,1064,0,1064
Viet,M,99,11,1053,1064
Lorry,F,90,957,106,1063
Vasiliki,F,100,1063,0,1063
Aoife,F,100,1062,0,1062
Eyan,M,100,0,1062,1062
Janasia,F,100,1062,0,1062
Joli,F,100,1062,0,1062
Marleny,F,100,1062,0,1062
Rosaria,F,100,1062,0,1062
Cyan,F,86,909,152,1061
Lenin,M,100,5,1056,1061
Nyle,M,98,25,1036,1061
Rudolf,M,100,0,1061,1061
Suanne,F,100,1061,0,1061
Aloysius,M,100,0,1060,1060
Chan,M,80,212,848,1060
Cleopatra,F,100,1060,0,1060
Iziah,M,100,0,1060,1060
Karizma,F,100,1060,0,1060
Lashana,F,100,1060,0,1060
Maija,F,100,1060,0,1060
Wendolyn,F,100,1055,5,1060
Yuna,F,100,1060,0,1060
Analeigh,F,100,1059,0,1059
Joselyne,F,100,1059,0,1059
Tesia,F,100,1059,0,1059
Hallee,F,100,1058,0,1058
Nayelli,F,100,1058,0,1058
Neomi,F,100,1058,0,1058
Vernard,M,100,0,1058,1058
Wellington,M,100,0,1058,1058
Zeth,M,100,0,1058,1058
Carlito,M,100,0,1057,1057
Collen,M,55,471,586,1057
Fredia,F,100,1057,0,1057
Gerome,M,100,0,1057,1057
Journi,F,100,1057,0,1057
Karine,F,100,1057,0,1057
Latoshia,F,100,1057,0,1057
Mackenzy,F,89,938,119,1057
Nataleigh,F,100,1057,0,1057
Syrus,M,100,0,1057,1057
Casondra,F,100,1056,0,1056
Davia,F,100,1056,0,1056
Deniece,F,100,1056,0,1056
Gaby,F,98,1030,26,1056
Jamilla,F,100,1056,0,1056
Keitha,F,100,1056,0,1056
Montie,M,81,200,856,1056
Tailor,F,85,900,156,1056
Charon,F,80,840,215,1055
Loralei,F,100,1055,0,1055
Mateusz,M,100,0,1055,1055
Sora,F,86,907,148,1055
Sylvan,M,95,48,1007,1055
Tejas,M,100,0,1055,1055
Vinay,M,100,0,1055,1055
Delvon,M,100,0,1054,1054
Jordann,F,95,1000,54,1054
Jr,M,100,0,1054,1054
Matheus,M,100,0,1054,1054
Shaela,F,100,1054,0,1054
Terria,F,100,1054,0,1054
Jennelle,F,100,1053,0,1053
Lesha,F,100,1053,0,1053
Rhiana,F,100,1053,0,1053
Zacharie,M,100,0,1053,1053
Zackariah,M,100,0,1053,1053
Kathrin,F,100,1052,0,1052
Catheryn,F,100,1051,0,1051
Chirstopher,M,100,0,1051,1051
Cuauhtemoc,M,100,0,1051,1051
Devynn,F,82,867,184,1051
Kristianna,F,100,1051,0,1051
Phylis,F,100,1051,0,1051
Tedd,M,100,0,1051,1051
Carlye,F,100,1050,0,1050
Eligio,M,100,0,1050,1050
Liya,F,100,1050,0,1050
Marrisa,F,100,1050,0,1050
Nakesha,F,100,1050,0,1050
Riva,F,100,1050,0,1050
Xavior,M,100,0,1050,1050
Devina,F,100,1049,0,1049
Jerone,M,100,0,1049,1049
Jonette,F,100,1049,0,1049
Deadra,F,100,1048,0,1048
Desaray,F,100,1048,0,1048
Jazzmyn,F,100,1048,0,1048
Kaelee,F,100,1048,0,1048
Lamon,M,100,0,1048,1048
Leshawn,M,70,312,736,1048
Nivea,F,100,1048,0,1048
Takeisha,F,100,1048,0,1048
Adryan,M,85,157,890,1047
Caitlan,F,100,1047,0,1047
Lilyanne,F,100,1047,0,1047
Matthews,M,100,0,1047,1047
Ameena,F,100,1046,0,1046
Breckin,M,88,128,918,1046
Janyla,F,100,1046,0,1046
Makya,F,91,956,90,1046
Shareef,M,100,0,1046,1046
Tahira,F,100,1046,0,1046
Evelyne,F,100,1045,0,1045
Lashelle,F,100,1045,0,1045
Linnette,F,100,1045,0,1045
Tiyana,F,100,1045,0,1045
Alyanna,F,100,1044,0,1044
Haydon,M,94,59,985,1044
Jacquie,F,100,1044,0,1044
Jaxsen,M,99,6,1038,1044
Oliva,F,100,1044,0,1044
Rahman,M,100,0,1044,1044
Monalisa,F,100,1043,0,1043
Raisa,F,100,1043,0,1043
Sharina,F,100,1043,0,1043
Chantz,M,100,0,1042,1042
Coralee,F,100,1042,0,1042
Hamzah,M,100,0,1042,1042
Janese,F,100,1042,0,1042
Jeralyn,F,100,1042,0,1042
Karalee,F,100,1042,0,1042
Patrisha,F,100,1042,0,1042
Thayne,M,100,0,1042,1042
Thomasine,F,100,1042,0,1042
Yenifer,F,100,1042,0,1042
Ziva,F,100,1042,0,1042
Elder,M,100,0,1041,1041
Klaire,F,100,1041,0,1041
Payge,F,100,1041,0,1041
Prescott,M,100,5,1036,1041
Yashica,F,100,1041,0,1041
Abbas,M,100,0,1040,1040
Kandie,F,100,1040,0,1040
Shreyas,M,100,0,1040,1040
Tiffiney,F,100,1040,0,1040
Zuleika,F,100,1040,0,1040
Halo,F,87,906,133,1039
Robbyn,F,100,1039,0,1039
Addy,F,98,1022,16,1038
Clarisse,F,100,1038,0,1038
Dyani,F,99,1028,10,1038
Cherita,F,100,1037,0,1037
Curry,M,92,85,952,1037
Daris,M,87,136,901,1037
Eamonn,M,100,0,1037,1037
Edric,M,100,0,1037,1037
Lindi,F,100,1037,0,1037
Nicolo,M,100,0,1037,1037
Chi,F,56,576,460,1036
Conway,M,100,0,1036,1036
Demar,M,100,0,1036,1036
Guido,M,100,0,1036,1036
Jakoby,M,100,0,1036,1036
Siya,F,100,1036,0,1036
Ulices,M,100,0,1036,1036
Aishah,F,100,1035,0,1035
Kitana,F,100,1035,0,1035
Lyndsi,F,100,1035,0,1035
Brodey,M,100,0,1034,1034
Davien,M,100,0,1034,1034
Jd,M,97,30,1004,1034
Brandice,F,100,1033,0,1033
Hiedi,F,100,1033,0,1033
Kimberlin,F,100,1033,0,1033
Lasha,F,100,1033,0,1033
Maricarmen,F,100,1033,0,1033
Melaina,F,100,1033,0,1033
Terica,F,100,1033,0,1033
Aracelis,F,100,1032,0,1032
Dierdre,F,100,1032,0,1032
Kashawn,M,92,78,954,1032
Saraya,F,100,1032,0,1032
Emiliana,F,100,1031,0,1031
Epifanio,M,100,0,1031,1031
Shaheed,M,100,0,1031,1031
Wynona,F,100,1031,0,1031
Adah,F,100,1030,0,1030
Bryanne,F,100,1030,0,1030
Daemon,M,100,0,1030,1030
Despina,F,100,1030,0,1030
Fitzgerald,M,100,0,1030,1030
Nariyah,F,100,1030,0,1030
Neisha,F,100,1030,0,1030
Sanders,M,99,6,1024,1030
Shakir,M,99,10,1020,1030
Mekenzie,F,100,1029,0,1029
Tenika,F,100,1029,0,1029
Christoph,M,100,0,1028,1028
Rhona,F,100,1028,0,1028
Elke,F,100,1027,0,1027
Emalie,F,100,1027,0,1027
Martie,F,81,833,194,1027
Aaniyah,F,100,1026,0,1026
Harrell,M,100,0,1026,1026
Willaim,M,100,0,1026,1026
Blima,F,100,1025,0,1025
Chason,M,100,0,1025,1025
Kamani,F,55,563,462,1025
Kinleigh,F,100,1025,0,1025
Markese,M,100,0,1025,1025
Asiya,F,100,1024,0,1024
Hanson,M,100,0,1024,1024
Kendria,F,100,1024,0,1024
Lyndee,F,100,1024,0,1024
Naia,F,100,1024,0,1024
Sela,F,100,1024,0,1024
Aaralyn,F,100,1023,0,1023
Jarel,M,99,6,1017,1023
Little,M,86,144,879,1023
Exavier,M,100,0,1022,1022
Leeah,F,100,1022,0,1022
Minna,F,100,1022,0,1022
Nella,F,100,1022,0,1022
Roya,F,100,1022,0,1022
Ayonna,F,100,1021,0,1021
Benjamine,M,100,0,1021,1021
Bram,M,100,0,1021,1021
Kawika,M,100,0,1021,1021
Mykenzie,F,100,1021,0,1021
Rexford,M,100,0,1021,1021
Shaw,M,97,35,986,1021
Yves,M,97,26,995,1021
Amoni,F,87,892,128,1020
Braxtyn,M,80,206,814,1020
Cristo,M,100,0,1020,1020
Inaya,F,100,1020,0,1020
Lawren,F,94,961,59,1020
Mylan,M,72,288,732,1020
Tkeyah,F,100,1020,0,1020
Alexei,M,90,100,919,1019
Beatris,F,100,1019,0,1019
Jule,F,64,650,369,1019
Kile,M,100,0,1019,1019
Lateisha,F,100,1019,0,1019
Liset,F,100,1019,0,1019
Malayna,F,100,1019,0,1019
Mykaela,F,100,1019,0,1019
Nakiyah,F,100,1019,0,1019
Novalee,F,100,1019,0,1019
Raelee,F,100,1019,0,1019
Shila,F,100,1019,0,1019
Zinnia,F,100,1019,0,1019
Hennessy,F,96,979,39,1018
Kage,M,100,0,1018,1018
Nacole,F,100,1018,0,1018
Oneida,F,100,1018,0,1018
Violetta,F,100,1018,0,1018
Damein,M,100,0,1017,1017
Nadja,F,100,1017,0,1017
Quintina,F,100,1017,0,1017
Anny,F,100,1016,0,1016
Dallen,M,100,0,1016,1016
Laurent,M,100,0,1016,1016
Marvell,M,97,30,986,1016
Mccall,F,93,942,74,1016
Nadeen,F,100,1016,0,1016
Maida,F,100,1015,0,1015
Montreal,M,100,0,1015,1015
Saphira,F,100,1015,0,1015
Aleeyah,F,100,1014,0,1014
Augustina,F,100,1014,0,1014
Cayman,M,75,250,764,1014
Eveline,F,100,1014,0,1014
Ivie,F,98,998,16,1014
Kambree,F,100,1014,0,1014
Kaneisha,F,100,1014,0,1014
Katharyn,F,100,1014,0,1014
Sherelle,F,100,1014,0,1014
Zeinab,F,100,1014,0,1014
Bethani,F,100,1013,0,1013
Brita,F,100,1013,0,1013
Carmina,F,100,1013,0,1013
Cheyne,M,89,115,898,1013
Dejanae,F,100,1013,0,1013
Eoin,M,100,0,1013,1013
Kerrin,F,99,1003,10,1013
Kyrin,M,89,112,901,1013
Ashlan,F,97,978,34,1012
Chanse,M,98,16,996,1012
Dory,F,88,893,119,1012
Early,M,92,82,930,1012
Kamiah,F,100,1012,0,1012
Aayden,M,100,5,1006,1011
Addisen,F,99,1005,6,1011
Ahtziri,F,100,1011,0,1011
Beronica,F,100,1011,0,1011
Donnette,F,100,1011,0,1011
Sicily,F,100,1011,0,1011
Thornton,M,100,0,1011,1011
Aaliya,F,100,1010,0,1010
Kirsti,F,100,1010,0,1010
Reda,F,78,792,218,1010
Sinclair,M,72,287,723,1010
Timia,F,100,1010,0,1010
Bobbiejo,F,100,1009,0,1009
Glennis,F,72,726,283,1009
Katrin,F,100,1009,0,1009
Rebel,F,54,549,460,1009
Zac,M,100,0,1009,1009
Bladimir,M,100,0,1008,1008
Darnel,M,95,50,958,1008
Lan,F,74,748,260,1008
Meisha,F,100,1008,0,1008
Saleh,M,100,0,1008,1008
Anusha,F,100,1007,0,1007
Laya,F,100,1007,0,1007
Taira,F,100,1007,0,1007
Terisa,F,100,1007,0,1007
Americo,M,100,0,1006,1006
Coco,F,100,1006,0,1006
Corinthia,F,100,1006,0,1006
Cree,F,70,704,302,1006
Deontay,M,100,0,1006,1006
Donivan,M,100,0,1006,1006
Lonnell,M,100,0,1006,1006
Manal,F,100,1006,0,1006
Morton,M,100,0,1006,1006
Tamaya,F,100,1006,0,1006
Timika,F,100,1006,0,1006
Catrice,F,100,1005,0,1005
Jamillah,F,100,1005,0,1005
Jeanpierre,M,100,0,1005,1005
Jonae,F,100,1005,0,1005
Krystel,F,100,1005,0,1005
Magdalen,F,100,1005,0,1005
Aeris,F,100,1004,0,1004
Ahuva,F,100,1004,0,1004
Henna,F,100,1004,0,1004
Ignatius,M,100,0,1004,1004
Antwoine,M,100,0,1003,1003
Belia,F,100,1003,0,1003
Chrissie,F,100,1003,0,1003
Christien,M,86,136,867,1003
Jozlyn,F,100,1003,0,1003
Kiani,F,97,973,30,1003
Navaeh,F,100,1003,0,1003
Tylen,M,99,10,993,1003
Delwin,M,100,0,1002,1002
Kanyon,M,92,81,921,1002
Meliza,F,100,1002,0,1002
Nadir,M,100,0,1002,1002
Rito,M,100,0,1002,1002
Carlisa,F,100,1001,0,1001
Jamira,F,100,1001,0,1001
Vianna,F,100,1001,0,1001
Dallis,F,55,552,448,1000
Han,F,50,501,499,1000
Leonna,F,100,1000,0,1000
Safia,F,100,1000,0,1000
Timeka,F,100,1000,0,1000
Treven,M,100,0,1000,1000
Aaren,M,72,282,717,999
Izabell,F,100,999,0,999
Jariah,F,84,839,160,999
Khiry,M,99,7,992,999
Laynee,F,100,999,0,999
Shakeria,F,100,999,0,999
Trystin,M,72,276,723,999
Allee,F,100,998,0,998
Ammy,F,100,998,0,998
Cindie,F,100,998,0,998
Markesha,F,100,998,0,998
Saida,F,100,998,0,998
Andreya,F,100,997,0,997
Bayron,M,100,0,997,997
Delani,F,98,982,15,997
Frantz,M,100,0,997,997
Deklan,M,100,0,996,996
Dorris,F,79,790,206,996
Jaunita,F,100,996,0,996
Navya,F,100,996,0,996
Sholom,M,100,0,996,996
Shruti,F,100,996,0,996
Kyna,F,100,995,0,995
Raja,M,68,316,679,995
Saralyn,F,100,995,0,995
Tadeo,M,100,0,995,995
Adriann,F,90,896,98,994
Alfonza,M,100,0,994,994
Caliyah,F,100,994,0,994
Chloey,F,100,994,0,994
Dagan,M,99,10,984,994
Eason,M,100,0,994,994
Elsy,F,100,994,0,994
Marshell,F,64,636,358,994
Rasheda,F,100,994,0,994
Tytianna,F,100,994,0,994
Bretton,M,100,0,993,993
Destyni,F,100,993,0,993
Gracia,F,100,993,0,993
Lashell,F,100,993,0,993
Micheline,F,100,993,0,993
Nuvia,F,100,993,0,993
Sagar,M,100,0,993,993
Usman,M,100,0,993,993
Braxten,M,99,5,987,992
Brevin,M,100,0,992,992
Daira,F,100,992,0,992
Tali,F,95,938,54,992
Ashlen,F,99,978,13,991
Christyn,F,99,985,6,991
Ibraheem,M,100,0,991,991
Journie,F,99,985,6,991
Maddex,M,98,19,972,991
Memory,F,100,991,0,991
Vallerie,F,100,991,0,991
Zayna,F,100,991,0,991
Alika,M,54,456,534,990
Ezekial,M,100,0,990,990
Jarin,M,97,33,957,990
Jonthan,M,100,0,990,990
Kansas,F,95,937,53,990
Presleigh,F,100,990,0,990
Ramya,F,100,990,0,990
Rudi,M,64,357,633,990
Takiya,F,100,990,0,990
Wisdom,F,54,533,457,990
Angelea,F,100,989,0,989
Hung,M,100,0,989,989
Joseangel,M,100,0,989,989
Mellanie,F,100,989,0,989
Miabella,F,100,989,0,989
Theresia,F,100,989,0,989
Camisha,F,100,988,0,988
Donnamarie,F,100,988,0,988
Fabrizio,M,100,0,988,988
Gwynne,F,100,988,0,988
Kem,M,64,353,635,988
Kush,M,100,0,988,988
Nannie,F,100,988,0,988
Abimael,M,100,0,987,987
Japheth,M,100,0,987,987
Karianne,F,100,986,0,986
Keela,F,100,986,0,986
Kenesha,F,100,986,0,986
Keontae,M,97,27,959,986
Reginia,F,100,986,0,986
Anakaren,F,100,985,0,985
Gracy,F,100,985,0,985
Jolanda,F,100,985,0,985
Kolleen,F,100,985,0,985
Nasser,M,100,0,985,985
Steffani,F,100,985,0,985
Alvino,M,100,0,984,984
Alysson,F,100,984,0,984
Dalena,F,100,984,0,984
Kelcy,F,93,918,66,984
Lashun,F,69,677,307,984
Raynell,F,57,560,424,984
Tylon,M,100,0,984,984
Zuleyka,F,100,984,0,984
Amando,M,86,134,849,983
Deloise,F,100,983,0,983
Emilyn,F,100,983,0,983
Lashundra,F,100,983,0,983
Mataya,F,100,983,0,983
Sharolyn,F,100,983,0,983
Traveon,M,100,0,983,983
Vaughan,M,99,7,976,983
Takayla,F,100,982,0,982
Tomasa,F,100,982,0,982
Bijan,M,97,29,952,981
Cleophus,M,100,0,981,981
Erikka,F,100,981,0,981
Teresia,F,100,981,0,981
Tevon,M,100,0,981,981
Vesta,F,100,981,0,981
Wanita,F,100,981,0,981
Denielle,F,100,980,0,980
Freddrick,M,100,0,980,980
Kaydon,M,92,80,900,980
Shayden,M,75,246,734,980
Toccara,F,99,966,14,980
Wil,M,100,0,980,980
Gildardo,M,100,0,979,979
Keyan,M,99,7,972,979
Meegan,F,100,979,0,979
Taylon,M,85,150,829,979
Aleeah,F,100,978,0,978
Benjaman,M,100,0,978,978
Johndavid,M,100,0,978,978
Raylen,M,62,374,604,978
Serjio,M,100,0,978,978
Sharde,F,100,978,0,978
Caralyn,F,100,977,0,977
Hedy,F,100,977,0,977
Jolena,F,100,977,0,977
Kadee,F,100,977,0,977
Shaundra,F,100,977,0,977
Takesha,F,100,977,0,977
Brantlee,M,86,140,836,976
Danyale,F,95,926,50,976
Domonick,M,100,0,976,976
Alyah,F,100,975,0,975
Sherise,F,100,975,0,975
Aaryan,M,99,6,968,974
Brunilda,F,100,974,0,974
Lucianna,F,100,974,0,974
Tira,F,100,974,0,974
Abdulaziz,M,100,0,973,973
Brieana,F,100,973,0,973
Crimson,F,78,759,214,973
Garey,M,100,0,973,973
Mareli,F,100,972,0,972
Resa,F,100,972,0,972
Stasia,F,100,972,0,972
Wilhelm,M,100,0,972,972
Alvie,M,98,24,947,971
Dailyn,F,77,751,220,971
Fulton,M,100,0,971,971
Megha,F,100,971,0,971
Zephyr,M,82,177,794,971
Leighanna,F,100,970,0,970
Sariya,F,100,970,0,970
Sunil,M,100,0,970,970
Fahad,M,100,0,969,969
Kristene,F,100,969,0,969
Lindsie,F,100,969,0,969
Linton,M,100,0,969,969
Aleasha,F,100,968,0,968
Keir,M,93,64,904,968
Michaelene,F,100,968,0,968
Rayleen,F,100,968,0,968
Anica,F,100,967,0,967
Avarie,F,100,967,0,967
Humza,M,100,0,967,967
Nykia,F,100,967,0,967
Aleczander,M,100,0,966,966
Brently,M,98,18,948,966
Katara,F,100,966,0,966
Marice,M,67,319,647,966
Mckinsey,F,98,944,22,966
Natan,M,100,0,966,966
Renda,F,100,966,0,966
Shalena,F,100,966,0,966
Shelita,F,100,966,0,966
Carlisle,M,66,325,640,965
Denisa,F,100,965,0,965
Gardenia,F,100,965,0,965
Aixa,F,100,964,0,964
Bayli,F,100,964,0,964
Celinda,F,100,964,0,964
Jaydn,M,62,370,594,964
Josilyn,F,100,964,0,964
Liah,F,100,964,0,964
Neve,F,100,964,0,964
Ori,M,90,98,866,964
Phyliss,F,100,964,0,964
Sander,M,92,79,885,964
Tenia,F,100,964,0,964
Braydan,M,99,10,953,963
Daivd,M,100,0,963,963
Keianna,F,100,963,0,963
Trang,F,99,955,8,963
Xaiver,M,100,0,963,963
Ahmari,M,70,292,670,962
Betina,F,100,962,0,962
Charmain,F,100,962,0,962
Cyrstal,F,100,962,0,962
Kaisha,F,100,962,0,962
Milinda,F,100,962,0,962
Alicen,F,100,961,0,961
Eda,F,100,961,0,961
Gwendolynn,F,100,961,0,961
Keriann,F,100,961,0,961
Leya,F,100,961,0,961
Lynsie,F,100,961,0,961
Sia,F,99,956,5,961
Ansleigh,F,100,960,0,960
Delisha,F,100,960,0,960
Dillard,M,100,0,960,960
Janyah,F,100,960,0,960
Kawana,F,100,960,0,960
Lashandra,F,100,960,0,960
Tasneem,F,100,960,0,960
Tifany,F,100,960,0,960
Blayke,M,61,375,584,959
Charletta,F,100,959,0,959
Hadyn,M,54,439,520,959
Ottis,M,100,0,959,959
Britnie,F,100,958,0,958
Georgine,F,100,958,0,958
Hillel,M,100,0,958,958
Jontae,M,81,179,779,958
Zadie,F,100,958,0,958
Diamonique,F,100,957,0,957
Estrellita,F,100,957,0,957
Nahomi,F,100,957,0,957
Yusra,F,100,957,0,957
Haile,F,82,782,174,956
Jaheem,M,100,0,956,956
Jerson,M,100,0,956,956
Jobe,M,100,0,956,956
Rawan,F,100,956,0,956
Tonnie,F,60,572,384,956
Trinette,F,100,956,0,956
Braylan,M,95,44,911,955
Denine,F,100,955,0,955
Irelyn,F,100,955,0,955
Neysa,F,100,955,0,955
Rondal,M,100,0,955,955
Tamiyah,F,100,955,0,955
Tenille,F,100,955,0,955
Vincenza,F,100,955,0,955
Yulonda,F,100,955,0,955
Alixandra,F,100,954,0,954
Lisbet,F,100,954,0,954
Teia,F,100,954,0,954
Veer,M,100,0,954,954
Carrissa,F,100,953,0,953
Cherylann,F,100,953,0,953
Dwana,F,100,953,0,953
Mikyla,F,100,953,0,953
Mischelle,F,100,953,0,953
Nevan,M,99,5,948,953
Siani,F,100,953,0,953
Suraj,M,100,0,953,953
Vittorio,M,100,0,953,953
Cesia,F,100,952,0,952
Damar,M,99,5,947,952
Donette,F,100,952,0,952
Fallyn,F,100,952,0,952
Florinda,F,100,952,0,952
Fredericka,F,100,952,0,952
Melea,F,100,952,0,952
Michial,M,100,0,952,952
Aleeya,F,100,951,0,951
Anaiyah,F,100,951,0,951
Audri,F,100,951,0,951
Blossom,F,100,951,0,951
Dekota,M,75,239,712,951
Eliah,M,71,272,679,951
Eugena,F,100,951,0,951
Giulianna,F,100,951,0,951
Maleigha,F,100,951,0,951
Rashan,M,93,66,885,951
Shella,F,100,951,0,951
Talina,F,100,951,0,951
Yulianna,F,100,951,0,951
Antonietta,F,100,950,0,950
Jafet,M,100,0,950,950
Kyleen,F,100,950,0,950
Marijo,F,100,950,0,950
Celest,F,100,949,0,949
Gadiel,M,100,0,949,949
Irasema,F,100,949,0,949
Aayush,M,100,0,948,948
Lev,M,99,13,935,948
Abiel,M,98,23,924,947
Adisyn,F,100,947,0,947
Shamekia,F,100,947,0,947
Adian,M,100,0,946,946
Jabria,F,100,946,0,946
Keron,M,92,71,875,946
Laquesha,F,100,946,0,946
Lenwood,M,100,0,946,946
Zachry,M,100,0,946,946
Brenner,M,99,5,940,945
Jenay,F,99,940,5,945
Jerard,M,100,0,945,945
Julietta,F,100,945,0,945
Kirsty,F,100,945,0,945
Malvin,M,100,0,945,945
Mathis,M,100,0,945,945
Nhi,F,100,945,0,945
Zita,F,100,945,0,945
Inara,F,100,944,0,944
Jawad,M,100,0,944,944
Malikah,F,92,868,76,944
Teana,F,100,944,0,944
Amrita,F,100,943,0,943
Dontavius,M,100,0,943,943
Elijiah,M,100,0,943,943
Kerby,M,87,122,821,943
Surya,M,76,231,712,943
Abriella,F,100,942,0,942
Avia,F,100,942,0,942
Legacy,F,81,761,181,942
Nycole,F,100,942,0,942
Donzell,M,99,5,936,941
Kassidi,F,100,941,0,941
Carlette,F,100,940,0,940
Evangelia,F,100,940,0,940
Gearldine,F,100,940,0,940
Sherese,F,100,940,0,940
Africa,F,100,939,0,939
Carrigan,F,99,929,10,939
Laquetta,F,100,939,0,939
Phong,M,99,5,934,939
Rehan,M,99,6,933,939
Stevens,M,100,0,939,939
Teo,M,100,0,939,939
Ermelinda,F,100,938,0,938
Garen,M,99,7,931,938
Karra,F,100,938,0,938
Mali,F,96,905,33,938
Maliha,F,100,938,0,938
Vi,F,87,813,125,938
Aleyda,F,100,937,0,937
Coralie,F,100,937,0,937
Ileen,F,100,937,0,937
Jeffrie,M,94,55,882,937
Khaliyah,F,100,937,0,937
Lotus,F,96,901,36,937
Radhika,F,100,937,0,937
Takira,F,100,937,0,937
Tameeka,F,100,937,0,937
Terris,M,85,138,799,937
Andrez,M,100,0,936,936
Deitra,F,100,936,0,936
Erskine,M,100,0,936,936
Ruger,M,100,0,936,936
Shameeka,F,100,936,0,936
Albin,M,100,0,935,935
Brilee,F,98,917,18,935
Kishan,M,100,0,935,935
Kong,M,100,0,935,935
Zaki,M,100,0,935,935
Doria,F,100,934,0,934
Durand,M,100,0,934,934
Gussie,F,87,812,122,934
Roshni,F,100,934,0,934
Tani,F,99,929,5,934
Welton,M,100,0,934,934
Yitty,F,100,934,0,934
Ysabel,F,97,905,29,934
Zeus,M,100,0,934,934
Ladell,M,83,162,771,933
Letisia,F,100,933,0,933
Melvyn,M,100,0,933,933
Niels,M,100,0,933,933
Tavarus,M,100,0,933,933
Teron,M,100,0,933,933
Catie,F,100,932,0,932
Courtni,F,100,932,0,932
Libbie,F,100,932,0,932
Monette,F,100,932,0,932
Rodriguez,M,99,5,927,932
Terrin,M,58,394,538,932
Leasia,F,100,931,0,931
Mckenzy,F,97,901,30,931
Padraic,M,100,0,931,931
Raylin,F,74,689,242,931
Sanaya,F,100,931,0,931
Yitzchak,M,100,0,931,931
Gavan,M,100,0,930,930
Levin,M,100,0,930,930
Lindley,F,79,734,196,930
Patton,M,94,55,875,930
Rasheedah,F,100,930,0,930
Yocelin,F,100,930,0,930
Zyan,M,73,251,679,930
Delroy,M,100,0,929,929
Eldred,M,100,0,929,929
Fara,F,100,929,0,929
Khaliah,F,100,929,0,929
Lillith,F,100,929,0,929
Lynzie,F,100,929,0,929
Malana,F,100,929,0,929
Rea,F,98,912,17,929
Sidra,F,100,929,0,929
Soloman,M,100,0,929,929
Tremain,M,100,0,929,929
Evangelos,M,100,0,928,928
Fiorella,F,100,928,0,928
Ione,F,100,928,0,928
Khali,F,52,478,450,928
Selvin,M,100,0,928,928
Derion,M,95,49,878,927
Kassondra,F,100,927,0,927
Kayvon,M,100,0,927,927
Meira,F,100,927,0,927
Nabeel,M,100,0,927,927
Tyrice,M,97,29,898,927
Amadeo,M,100,0,926,926
Damara,F,100,926,0,926
Franki,F,92,853,73,926
Keilan,M,95,43,883,926
Kruz,M,98,22,904,926
Theodor,M,100,0,926,926
Yelena,F,100,926,0,926
Alon,M,97,24,901,925
Arianny,F,100,925,0,925
Avon,M,72,255,670,925
Birdie,F,100,925,0,925
Chara,F,100,925,0,925
Cherly,F,100,925,0,925
Emalyn,F,100,925,0,925
Jenevieve,F,100,925,0,925
Kendale,M,94,55,870,925
Lanetta,F,100,925,0,925
Maritsa,F,100,925,0,925
Patryk,M,100,0,925,925
Tiger,M,96,35,890,925
Andon,M,100,0,924,924
Brinkley,F,96,891,33,924
Jerusha,F,100,924,0,924
Kadarius,M,100,0,924,924
Kylon,M,100,0,924,924
Roslynn,F,100,924,0,924
Saskia,F,100,924,0,924
Sona,F,100,924,0,924
Susette,F,100,924,0,924
Amairany,F,100,923,0,923
Briant,M,100,0,923,923
Khamani,M,66,310,613,923
Loretha,F,100,923,0,923
Sumner,M,79,190,733,923
Cashton,M,100,0,922,922
Deserie,F,100,922,0,922
Gill,M,95,44,878,922
Jalan,M,92,70,852,922
Jasmina,F,100,922,0,922
Jayleigh,F,100,922,0,922
Kiandra,F,100,922,0,922
Leasa,F,100,922,0,922
Shaylene,F,100,922,0,922
Shepard,M,99,5,917,922
Huston,M,100,0,921,921
Kiki,F,97,896,25,921
Nichola,F,86,794,127,921
Trevan,M,100,0,921,921
Amiracle,F,100,920,0,920
Egan,M,95,49,871,920
Fredricka,F,100,920,0,920
Garon,M,100,0,920,920
Lexa,F,100,920,0,920
Sandeep,M,88,115,805,920
Sayuri,F,100,920,0,920
Florencia,F,100,919,0,919
Sakinah,F,100,919,0,919
Tahnee,F,100,919,0,919
Tayvion,M,100,0,919,919
Addysen,F,100,918,0,918
Dutch,M,100,0,918,918
Jakyra,F,100,918,0,918
Jemima,F,100,918,0,918
Jhonatan,M,100,0,918,918
Joelene,F,100,918,0,918
Maliek,M,100,0,918,918
Meara,F,100,918,0,918
Ronette,F,100,918,0,918
Saoirse,F,100,918,0,918
Shauntel,F,99,908,10,918
Zaneta,F,100,918,0,918
Cosme,M,100,0,917,917
Lakeitha,F,100,917,0,917
Mallie,F,93,856,61,917
Genise,F,100,916,0,916
Heston,M,100,0,916,916
Kevion,M,99,5,911,916
Madisson,F,100,916,0,916
Rajan,M,100,0,916,916
Kaitlynne,F,100,915,0,915
Kalissa,F,100,915,0,915
Lailani,F,100,915,0,915
Mickeal,M,100,0,915,915
Amalie,F,100,914,0,914
Ardith,F,99,909,5,914
Jayveon,M,100,0,914,914
Kendarius,M,100,0,914,914
Lekisha,F,100,914,0,914
Tajah,F,92,838,76,914
Vernie,M,65,321,593,914
Brailyn,F,75,687,226,913
Eriana,F,100,913,0,913
Genessis,F,100,913,0,913
Holt,M,100,0,913,913
Jaynie,F,100,913,0,913
Jazlin,F,100,913,0,913
Jeancarlos,M,100,0,913,913
Kersten,F,100,913,0,913
Leonela,F,100,913,0,913
Nicolina,F,100,913,0,913
Romelia,F,100,913,0,913
Shanetta,F,100,913,0,913
Zavian,M,100,0,913,913
Ainslee,F,100,912,0,912
Denee,F,100,912,0,912
Erianna,F,100,912,0,912
Janisha,F,100,912,0,912
Ka,F,86,781,131,912
Keneth,M,100,0,912,912
Melisha,F,100,912,0,912
Orianna,F,100,912,0,912
Rozlyn,F,100,912,0,912
Dartagnan,M,100,0,911,911
Gittel,F,100,911,0,911
Khang,M,100,0,911,911
Temika,F,100,911,0,911
Alesa,F,100,910,0,910
Baylen,M,88,109,801,910
Davonna,F,100,910,0,910
Kamri,F,100,910,0,910
Kizzie,F,100,910,0,910
Larenzo,M,100,0,910,910
Myeshia,F,100,910,0,910
Oneil,M,100,0,910,910
Sibyl,F,100,910,0,910
Carolanne,F,100,909,0,909
Emeri,F,95,861,48,909
Jancarlos,M,100,0,909,909
Janson,M,100,0,909,909
Justino,M,100,0,909,909
Marqus,M,100,0,909,909
Miko,F,51,465,444,909
Story,F,94,859,50,909
Abrahan,M,100,0,908,908
Italy,F,100,908,0,908
Jaykob,M,100,0,908,908
Montrel,M,100,0,908,908
Terrilyn,F,100,908,0,908
Andrianna,F,100,907,0,907
Darya,F,100,907,0,907
Dontez,M,100,0,907,907
Dustie,F,99,896,11,907
Jasiel,M,93,66,841,907
Krystine,F,100,907,0,907
Triana,F,100,907,0,907
Denesha,F,100,906,0,906
Keagen,M,98,22,884,906
Shareen,F,100,906,0,906
Zayvion,M,100,0,906,906
Chayla,F,100,905,0,905
Falisha,F,100,905,0,905
Gwendalyn,F,100,905,0,905
Rebbeca,F,100,905,0,905
Carline,F,100,904,0,904
Sonji,F,100,904,0,904
Thien,M,97,29,875,904
Zade,M,99,12,892,904
Alley,F,100,903,0,903
Annita,F,100,903,0,903
Divina,F,100,903,0,903
Harli,F,100,903,0,903
Kreg,M,100,0,903,903
Lorita,F,100,903,0,903
Natasia,F,100,903,0,903
Teon,M,98,15,888,903
Christeen,F,100,902,0,902
Deaundre,M,100,0,902,902
Donyell,M,56,398,504,902
Juanito,M,100,0,902,902
Kavion,M,100,0,902,902
Mayrin,F,100,902,0,902
Cozette,F,100,901,0,901
Lary,M,100,0,901,901
Mykia,F,100,901,0,901
Natascha,F,100,901,0,901
Nida,F,100,901,0,901
Parnell,M,100,0,901,901
Pearson,M,94,50,851,901
Shandon,M,80,184,717,901
Sonnie,F,57,516,385,901
Adreana,F,100,900,0,900
Edin,M,93,59,841,900
Georgann,F,100,900,0,900
Lanesha,F,100,900,0,900
Zaylen,M,98,20,880,900
Cristhian,M,100,0,899,899
Gianfranco,M,100,0,899,899
Kriss,M,60,362,537,899
Shianna,F,100,899,0,899
Tashawna,F,100,899,0,899
Vanetta,F,100,899,0,899
Adalie,F,100,898,0,898
Aurea,F,100,898,0,898
Jamier,M,100,0,898,898
Kilian,M,98,21,877,898
Laree,F,100,898,0,898
Nadiyah,F,100,898,0,898
Rayshaun,M,100,0,898,898
Starlet,F,100,898,0,898
Amarah,F,100,897,0,897
Andraya,F,100,897,0,897
Jamara,F,95,852,45,897
Karishma,F,100,897,0,897
Malynda,F,100,897,0,897
Rise,F,99,892,5,897
Sanchez,M,98,17,880,897
Jozef,M,100,0,896,896
Moishe,M,100,0,896,896
Sabria,F,100,896,0,896
Shakara,F,100,896,0,896
Shelbey,F,100,896,0,896
Timberly,F,100,896,0,896
Jalena,F,100,895,0,895
Janaye,F,100,895,0,895
Lilla,F,100,895,0,895
Lovina,F,100,895,0,895
Meghana,F,100,895,0,895
Octavian,M,100,0,895,895
Shadi,M,73,240,655,895
Aislin,F,100,894,0,894
Damia,F,100,894,0,894
Jorel,M,100,0,894,894
Keyaira,F,100,894,0,894
Lacretia,F,100,894,0,894
Meloney,F,100,894,0,894
Mikalah,F,100,894,0,894
Rafeal,M,100,0,894,894
Berlinda,F,100,893,0,893
Keelyn,F,78,700,193,893
Leiah,F,100,893,0,893
Linley,F,99,882,11,893
Sheryle,F,100,893,0,893
Tysean,M,100,0,893,893
Aksel,M,100,0,892,892
Caileigh,F,100,892,0,892
Cydnee,F,100,892,0,892
Dashia,F,100,892,0,892
Jamyah,F,100,892,0,892
Kristle,F,100,892,0,892
Mileena,F,100,892,0,892
Enya,F,100,891,0,891
Helaine,F,100,891,0,891
Kela,F,100,891,0,891
Rama,F,78,698,193,891
Calley,F,100,890,0,890
Dezaray,F,100,890,0,890
Griffith,M,100,0,890,890
Jabez,M,100,0,890,890
Lashea,F,100,890,0,890
Krissa,F,100,889,0,889
Murry,M,99,5,884,889
Agustina,F,100,888,0,888
Caidence,F,91,811,77,888
Konnie,F,100,888,0,888
Laurance,M,99,5,883,888
Savina,F,100,888,0,888
Vanda,F,100,888,0,888
Hasani,M,99,11,876,887
Jahleel,M,100,0,887,887
Jailah,F,100,887,0,887
Karyssa,F,100,887,0,887
Kloie,F,100,887,0,887
Mandee,F,100,887,0,887
Quade,M,100,0,887,887
Sharese,F,100,887,0,887
Talena,F,100,887,0,887
Danah,F,100,886,0,886
Eryk,M,100,0,886,886
Irelynn,F,100,886,0,886
Kaelen,M,65,314,572,886
Khloee,F,100,886,0,886
Romario,M,100,0,886,886
Ambra,F,100,885,0,885
Celesta,F,100,885,0,885
Esdras,M,100,0,885,885
Giovonni,M,100,0,885,885
Jadelynn,F,100,885,0,885
Jahaziel,M,100,0,885,885
Nevaeha,F,100,885,0,885
Seirra,F,100,885,0,885
Enmanuel,M,100,0,884,884
Hazen,M,98,20,864,884
Jemal,M,100,0,884,884
Lenita,F,100,884,0,884
Rylea,F,100,884,0,884
Aayan,M,100,0,883,883
Gennie,F,98,867,16,883
Nawal,F,100,883,0,883
Tyrome,M,100,0,883,883
Ventura,M,91,81,802,883
Vivaan,M,100,0,883,883
Chico,M,100,0,882,882
Cordarius,M,100,0,882,882
Deborrah,F,100,882,0,882
Derin,M,86,126,756,882
Emaleigh,F,100,882,0,882
Emy,F,100,882,0,882
Georgiann,F,100,882,0,882
Lenette,F,100,882,0,882
Rayana,F,100,882,0,882
Sherly,F,100,882,0,882
Zebadiah,M,100,0,882,882
Aeden,M,99,7,874,881
Catarino,M,100,0,881,881
Darah,F,100,881,0,881
Tayton,M,98,21,860,881
Tenaya,F,100,881,0,881
Bev,F,100,880,0,880
Braydin,M,99,11,869,880
Collyn,M,81,167,713,880
Dylen,M,98,16,864,880
Jeanice,F,100,880,0,880
Kadi,F,100,880,0,880
Kylia,F,100,880,0,880
Nashawn,M,94,53,827,880
Selwyn,M,99,5,875,880
Wells,M,97,29,851,880
Abra,F,100,879,0,879
Damoni,M,72,242,637,879
Derald,M,100,0,879,879
Keilyn,F,81,716,163,879
Klaudia,F,100,879,0,879
Kyia,F,100,879,0,879
Nicholes,M,100,0,879,879
Otoniel,M,100,0,879,879
Rossana,F,100,879,0,879
Andee,F,100,878,0,878
Bobette,F,100,878,0,878
Corena,F,100,878,0,878
Giavonna,F,100,878,0,878
Isadore,M,99,9,869,878
Jevin,M,100,0,878,878
Lillianne,F,100,878,0,878
Mariely,F,100,878,0,878
Marline,F,100,878,0,878
Monserrath,F,100,878,0,878
Rashod,M,100,0,878,878
Aakash,M,100,0,877,877
Alandra,F,100,877,0,877
Allisyn,F,100,877,0,877
Authur,M,100,0,877,877
Darnisha,F,100,877,0,877
General,M,100,0,877,877
Jonothan,M,100,0,877,877
Kacper,M,100,0,877,877
Lacinda,F,100,877,0,877
Tawna,F,100,877,0,877
Arath,M,100,0,876,876
Coryn,F,100,876,0,876
Jamela,F,100,876,0,876
Maelyn,F,100,876,0,876
Retta,F,100,876,0,876
Ryden,M,96,32,844,876
Sonjia,F,100,876,0,876
Clovis,M,92,71,804,875
Katiana,F,100,875,0,875
Lore,F,100,875,0,875
Maegen,F,100,875,0,875
Muna,F,100,875,0,875
Raziel,M,98,18,857,875
Ronal,M,100,0,875,875
Sahasra,F,100,875,0,875
Betzy,F,100,874,0,874
Fabricio,M,100,0,874,874
Kasondra,F,100,874,0,874
Kylei,F,100,874,0,874
Lamarion,M,100,0,874,874
Pebbles,F,100,874,0,874
Remona,F,100,874,0,874
Ryu,M,100,0,874,874
Tayna,F,100,874,0,874
Hosanna,F,100,873,0,873
Hurley,M,95,44,829,873
Keiran,M,84,136,737,873
Shadae,F,100,873,0,873
Shaquanna,F,100,873,0,873
Sharman,F,97,850,23,873
Verona,F,100,873,0,873
Kedric,M,100,0,872,872
Kynleigh,F,100,872,0,872
Mariafernanda,F,100,872,0,872
Rider,M,100,0,872,872
Tifani,F,100,872,0,872
Aeryn,F,97,848,23,871
Alonda,F,100,871,0,871
Ashish,M,100,0,871,871
Brylan,M,92,67,804,871
Iverson,M,99,6,865,871
Kenric,M,100,0,871,871
Orson,M,100,0,871,871
Shun,M,97,30,841,871
Subrina,F,100,871,0,871
Tawnie,F,100,871,0,871
Cornel,M,100,0,870,870
Makaya,F,100,870,0,870
Tyann,F,100,870,0,870
Arelis,F,100,869,0,869
Arla,F,100,869,0,869
Benjie,M,96,31,838,869
Frazier,M,100,0,869,869
Gionni,M,95,47,822,869
Rivkah,F,100,869,0,869
Shawntae,F,98,854,15,869
Shyheim,M,100,0,869,869
Stratton,M,99,11,858,869
Ailene,F,100,868,0,868
Brison,M,100,0,868,868
Buffie,F,100,868,0,868
Demaris,F,68,590,278,868
Jibril,M,100,0,868,868
Link,M,100,0,868,868
Shanan,F,86,745,123,868
Brayleigh,F,100,867,0,867
Ernst,M,100,0,867,867
Kayana,F,100,867,0,867
Keyera,F,100,867,0,867
Montanna,F,97,839,28,867
Nastassia,F,100,867,0,867
Uri,M,97,30,837,867
Zarina,F,100,867,0,867
Aleeza,F,100,866,0,866
Braedan,M,100,0,866,866
Cidney,F,98,849,17,866
Fanta,F,100,866,0,866
Haneen,F,100,866,0,866
Vernessa,F,100,866,0,866
Vishnu,M,100,0,866,866
Xzavion,M,100,0,866,866
Allisha,F,100,865,0,865
Chyann,F,100,865,0,865
Derricka,F,100,865,0,865
Jayanna,F,100,865,0,865
Kila,F,99,860,5,865
Michiel,M,99,5,860,865
Oksana,F,100,865,0,865
Porcha,F,100,865,0,865
Quianna,F,100,865,0,865
Tarrance,M,100,0,865,865
Anneke,F,100,864,0,864
Benaiah,M,100,0,864,864
Cortnie,F,100,864,0,864
Dameion,M,100,0,864,864
Dieter,M,100,0,864,864
Jacquelene,F,100,864,0,864
Jenaya,F,100,864,0,864
Mauri,F,88,763,101,864
Merilee,F,100,864,0,864
Nadira,F,100,864,0,864
Randolf,M,100,0,864,864
Yousif,M,100,0,864,864
Avelina,F,100,863,0,863
Bernell,M,84,138,725,863
Bonifacio,M,100,0,863,863
Brynleigh,F,100,863,0,863
Jodene,F,100,863,0,863
Neela,F,100,863,0,863
Shalisa,F,100,863,0,863
Shulem,M,100,0,863,863
Zakari,M,86,117,746,863
Carra,F,100,862,0,862
Catherin,F,100,862,0,862
Emonie,F,98,848,14,862
Channa,F,99,856,5,861
Chanta,F,100,861,0,861
Jentry,F,73,625,236,861
Montavious,M,100,0,861,861
Nekia,F,94,811,50,861
Ramie,F,73,630,231,861
Teryl,F,73,627,234,861
Cartier,M,86,118,742,860
Clem,M,100,0,860,860
Dessa,F,100,860,0,860
Gibran,M,100,0,860,860
Kassy,F,100,860,0,860
Khary,M,100,0,860,860
Nathaneal,M,100,0,860,860
Pieter,M,100,0,860,860
Rabecca,F,100,860,0,860
Rya,F,98,841,19,860
Adams,M,100,0,859,859
Eneida,F,100,859,0,859
Enjoli,F,100,859,0,859
Eros,M,100,0,859,859
Jayana,F,100,859,0,859
Marketta,F,100,859,0,859
Cindee,F,100,858,0,858
Jerid,M,100,0,858,858
Kanon,M,84,139,719,858
Kayanna,F,100,858,0,858
Leamon,M,100,0,858,858
Renna,F,100,858,0,858
Ridley,M,66,291,567,858
Zykeria,F,100,858,0,858
Constantino,M,100,0,857,857
Daevon,M,100,0,857,857
Eulalio,M,100,0,857,857
Girard,M,100,0,857,857
Jalayah,F,100,857,0,857
Layan,F,100,857,0,857
Rockie,M,94,53,804,857
Shadow,M,53,399,458,857
Wiliam,M,100,0,857,857
Yohana,F,100,857,0,857
Abriel,F,67,573,283,856
Anastasios,M,100,0,856,856
Argenis,M,100,0,856,856
Danetta,F,100,856,0,856
Marica,F,100,856,0,856
Ayisha,F,100,855,0,855
Carry,F,74,629,226,855
Dimitrius,M,100,0,855,855
Laural,F,100,855,0,855
Nancee,F,100,855,0,855
Taiwan,M,92,71,784,855
Tora,F,97,829,26,855
Alyiah,F,100,854,0,854
Ander,M,100,0,854,854
Anslee,F,100,854,0,854
Caidyn,M,59,354,500,854
Keiona,F,100,854,0,854
Rayburn,M,100,0,854,854
Antwane,M,100,0,853,853
Chavis,M,100,0,853,853
Jannell,F,100,853,0,853
Shellee,F,100,853,0,853
Tonika,F,100,853,0,853
Tysha,F,100,853,0,853
Aliesha,F,100,852,0,852
Kelia,F,100,852,0,852
Madlyn,F,100,852,0,852
Olaf,M,100,0,852,852
Philippa,F,100,852,0,852
Shontae,F,99,842,10,852
Albino,M,100,0,851,851
Bryonna,F,100,851,0,851
Cintia,F,100,851,0,851
Dagny,F,100,851,0,851
Erickson,M,100,0,851,851
Jarrel,M,100,0,851,851
Josi,F,100,851,0,851
Laury,F,97,823,28,851
Malachai,M,100,0,851,851
Priscella,F,100,851,0,851
Jacqui,F,98,837,13,850
Kaleo,M,100,0,850,850
Kalon,M,98,17,833,850
Lew,M,99,10,840,850
Meriah,F,100,850,0,850
Nehemias,M,100,0,850,850
Shaylah,F,100,850,0,850
Timonthy,M,100,0,850,850
Tonita,F,100,850,0,850
Avinash,M,100,0,849,849
Calvert,M,100,0,849,849
Devron,M,100,0,849,849
Fredi,M,96,34,815,849
Gretel,F,100,849,0,849
Juanjose,M,100,0,849,849
Kaiser,M,100,0,849,849
Keshav,M,100,0,849,849
Leeza,F,100,849,0,849
Tahirah,F,100,849,0,849
Tallon,M,100,0,849,849
Vinny,M,100,0,849,849
Weslee,M,88,98,751,849
Ahna,F,100,848,0,848
Cadance,F,99,843,5,848
Cherrelle,F,100,848,0,848
Jock,M,100,0,848,848
Lateef,M,100,0,848,848
Shalene,F,100,848,0,848
Apolinar,M,100,0,847,847
Jelissa,F,100,847,0,847
Jolinda,F,100,847,0,847
Kiyan,M,97,28,819,847
Matthieu,M,100,0,847,847
Mikenna,F,100,847,0,847
Raudel,M,100,0,847,847
Herb,M,100,0,846,846
Mackensie,F,99,841,5,846
Tashana,F,100,846,0,846
Alayla,F,100,845,0,845
Jovi,F,69,586,259,845
Marijane,F,100,845,0,845
Roshelle,F,100,845,0,845
Teona,F,100,845,0,845
Gypsy,F,100,844,0,844
Sekou,M,100,0,844,844
Andreanna,F,100,843,0,843
Annett,F,100,843,0,843
Dionisio,M,100,0,843,843
Jaryn,M,60,334,509,843
Lynlee,F,100,843,0,843
Myleigh,F,100,843,0,843
Rayonna,F,100,843,0,843
Shandy,F,86,728,115,843
Asim,M,100,0,842,842
Emiko,F,99,837,5,842
Falyn,F,100,842,0,842
Alya,F,100,841,0,841
Arick,M,100,0,841,841
Ariona,F,100,841,0,841
Beverlee,F,100,841,0,841
Breyden,M,100,0,841,841
Eshan,M,100,0,841,841
Jamye,F,99,829,12,841
Jaydee,F,56,472,369,841
Ryane,F,93,783,58,841
Sonora,F,100,841,0,841
Toy,F,64,535,306,841
Daphine,F,100,840,0,840
Izaya,M,100,0,840,840
Julyssa,F,100,840,0,840
Kammie,F,100,840,0,840
Ladd,M,100,0,840,840
Niel,M,100,0,840,840
Paradise,F,100,840,0,840
Ripley,F,76,637,203,840
Santanna,F,93,785,55,840
Shatoya,F,100,840,0,840
Shyan,F,96,805,35,840
Yasmina,F,100,840,0,840
Alexes,F,83,700,139,839
Arletha,F,100,839,0,839
Briseis,F,100,839,0,839
Manisha,F,100,839,0,839
Marwan,M,100,0,839,839
Sulaiman,M,100,0,839,839
Tequilla,F,100,839,0,839
Thaddaeus,M,100,0,839,839
Vivica,F,100,839,0,839
Anuj,M,100,0,838,838
Chelse,F,100,838,0,838
Goldy,F,100,838,0,838
Katerine,F,100,838,0,838
Romana,F,100,838,0,838
Tasheena,F,100,838,0,838
Tiffeny,F,100,838,0,838
Tiffiany,F,100,838,0,838
Youlanda,F,100,838,0,838
Anise,F,100,837,0,837
Daiana,F,100,837,0,837
Kymberlee,F,100,837,0,837
Shameika,F,100,837,0,837
Zamya,F,100,837,0,837
Ellee,F,100,836,0,836
Aziyah,F,97,808,27,835
Caris,F,100,835,0,835
Ilyas,M,100,0,835,835
Isidoro,M,100,0,835,835
Reaghan,F,100,835,0,835
Ronak,M,99,6,829,835
Serinity,F,100,835,0,835
Treena,F,100,835,0,835
Vonetta,F,100,835,0,835
Willia,F,58,485,350,835
Christiaan,M,100,0,834,834
Rockey,M,100,0,834,834
Arien,M,55,375,458,833
Ianna,F,100,833,0,833
Kaylor,F,64,536,297,833
Kiri,F,100,833,0,833
Leviticus,M,100,0,833,833
Marcellous,M,100,0,833,833
Mykell,M,70,248,585,833
Nija,F,98,814,19,833
Orval,M,100,0,833,833
Spence,M,100,0,833,833
Yevette,F,100,833,0,833
Adrionna,F,100,832,0,832
Elyana,F,100,832,0,832
Maelynn,F,100,832,0,832
Markis,M,100,0,832,832
Marycatherine,F,100,832,0,832
Rayn,M,56,367,465,832
Reiley,F,64,530,302,832
Yazan,M,100,0,832,832
Aleen,F,100,831,0,831
Corinthian,M,78,185,646,831
Farren,F,69,572,259,831
Katryna,F,100,831,0,831
Kyden,M,97,23,808,831
Midori,F,100,831,0,831
Pearce,M,99,12,819,831
Wednesday,F,100,831,0,831
Aarna,F,100,830,0,830
Corene,F,100,830,0,830
Jaileen,F,100,830,0,830
Victoriano,M,100,0,830,830
Audria,F,100,829,0,829
Davidson,M,100,0,829,829
Makenzee,F,100,829,0,829
Mazen,M,100,0,829,829
Niasia,F,100,829,0,829
Nikkole,F,100,829,0,829
Ramey,M,58,348,481,829
Waymond,M,100,0,829,829
Breyonna,F,100,828,0,828
Georgios,M,100,0,828,828
Ibn,M,100,0,828,828
Jakeem,M,100,0,828,828
Jizelle,F,100,828,0,828
Kashif,M,100,0,828,828
Kierston,F,98,815,13,828
Klaus,M,100,0,828,828
Mirta,F,100,828,0,828
Odelia,F,100,828,0,828
Rianne,F,100,828,0,828
Stockton,M,100,0,828,828
Asiyah,F,96,796,31,827
Bronte,F,98,809,18,827
Ilda,F,100,827,0,827
Linkin,M,100,0,827,827
Lorien,F,100,827,0,827
Shariah,F,100,827,0,827
Triton,M,100,0,827,827
Anthoni,M,100,0,826,826
Osama,M,100,0,826,826
Shanette,F,100,826,0,826
Taylan,M,69,255,571,826
Arminda,F,100,825,0,825
Destanee,F,100,825,0,825
Lucina,F,100,825,0,825
Rees,M,88,101,724,825
Tytus,M,100,0,825,825
Camile,F,100,824,0,824
Eisley,F,98,809,15,824
Georgeanna,F,100,824,0,824
Germain,M,95,42,782,824
Helga,F,100,824,0,824
Jashon,M,99,6,818,824
Jasmaine,F,99,818,6,824
Marciano,M,100,0,824,824
Yvonna,F,100,824,0,824
Daytona,F,74,605,218,823
Sada,F,100,823,0,823
Taniah,F,100,823,0,823
Armanda,F,100,822,0,822
Chimere,F,99,817,5,822
Clarance,M,100,0,822,822
Gregor,M,100,0,822,822
Haili,F,100,822,0,822
Lari,F,95,784,38,822
Liesel,F,100,822,0,822
Roddrick,M,100,0,822,822
Sheneka,F,100,822,0,822
Stavros,M,100,0,822,822
Cailynn,F,100,821,0,821
Christelle,F,100,821,0,821
Demon,M,100,0,821,821
Ellsworth,M,100,0,821,821
Neila,F,100,821,0,821
Velinda,F,100,821,0,821
Amyra,F,100,820,0,820
Hinda,F,100,820,0,820
Loyce,F,83,677,143,820
Macklin,M,100,0,820,820
Raygan,F,95,780,40,820
Terre,F,89,733,87,820
Zharia,F,100,820,0,820
Apolonio,M,100,0,819,819
Dayra,F,100,819,0,819
Emmily,F,100,819,0,819
Evolet,F,100,819,0,819
Horatio,M,100,0,819,819
Ledger,M,100,0,819,819
Mikenzie,F,100,819,0,819
Reily,M,61,323,496,819
Zahira,F,100,819,0,819
Cortni,F,100,818,0,818
Mahi,F,98,803,15,818
Zamari,M,66,282,536,818
Ailin,F,99,812,5,817
Desha,F,99,812,5,817
Dmarcus,M,100,0,817,817
Ginette,F,100,817,0,817
Jamecia,F,100,817,0,817
Katja,F,100,817,0,817
Katty,F,100,817,0,817
Kensey,F,99,812,5,817
Olan,M,100,0,817,817
Sharan,F,94,764,53,817
Tarell,M,100,0,817,817
Yolande,F,100,817,0,817
Radley,M,97,24,792,816
Aziah,F,66,534,281,815
Enola,F,100,815,0,815
Jerilynn,F,100,815,0,815
Lucrecia,F,100,815,0,815
Nailea,F,100,815,0,815
Reza,M,100,0,815,815
Brandis,F,90,730,84,814
Dawan,M,96,35,779,814
Jamyra,F,100,814,0,814
Jaxx,M,100,0,814,814
Kendrell,M,98,18,796,814
Malani,F,100,814,0,814
Silvano,M,100,0,814,814
Yousuf,M,100,0,814,814
Abilene,F,100,813,0,813
Anasia,F,100,813,0,813
Candee,F,100,813,0,813
Devone,M,85,118,695,813
Enoc,M,100,0,813,813
Iqra,F,100,813,0,813
Lenise,F,100,813,0,813
Marykay,F,100,813,0,813
Taffy,F,100,813,0,813
Thersa,F,100,813,0,813
Tzipora,F,100,813,0,813
Amrit,M,58,338,474,812
Kaija,F,100,812,0,812
Lania,F,100,812,0,812
Omayra,F,100,812,0,812
Ontario,M,100,0,812,812
Sydne,F,100,812,0,812
Elija,M,100,0,811,811
Flavia,F,100,811,0,811
Gerhard,M,100,0,811,811
Idaly,F,100,811,0,811
Javis,M,99,5,806,811
Kaidan,M,93,59,752,811
Karee,F,90,731,80,811
Mariska,F,100,811,0,811
Parisa,F,100,811,0,811
Puja,F,100,811,0,811
Ramy,M,100,0,811,811
Atlee,M,79,173,637,810
Ayub,M,100,0,810,810
Dade,M,100,0,810,810
Latrese,F,100,810,0,810
Latroy,M,100,0,810,810
Maxime,M,94,50,760,810
Valen,M,63,301,509,810
Ahren,M,100,0,809,809
Devany,F,100,809,0,809
Eowyn,F,100,809,0,809
Isak,M,100,0,809,809
Jasir,M,100,0,809,809
Markos,M,100,0,809,809
Oona,F,100,809,0,809
Rowyn,F,78,631,178,809
Talmage,M,100,0,809,809
Thu,F,99,804,5,809
Virgina,F,100,809,0,809
Amaryllis,F,100,808,0,808
Donia,F,100,808,0,808
Eilene,F,100,808,0,808
Javonna,F,100,808,0,808
Kenyan,M,99,10,798,808
Sabian,M,97,21,787,808
Boruch,M,100,0,807,807
Carolin,F,100,807,0,807
Manning,M,96,32,775,807
Mikelle,F,98,790,17,807
Niara,F,100,807,0,807
Nieves,F,62,503,304,807
Antjuan,M,100,0,806,806
Britten,M,59,332,474,806
Carah,F,100,806,0,806
Jacori,M,99,12,794,806
Jerrilyn,F,100,806,0,806
Kirah,F,100,806,0,806
Lashanna,F,100,806,0,806
Maudie,F,100,806,0,806
Nikol,F,100,806,0,806
Tamaria,F,100,806,0,806
Zarek,M,100,0,806,806
Abbagail,F,100,805,0,805
Arash,M,100,0,805,805
Cai,M,73,220,585,805
Conni,F,100,805,0,805
Idalis,F,100,805,0,805
Janalee,F,100,805,0,805
Jenea,F,100,805,0,805
Kristofor,M,100,0,805,805
Lanee,F,100,805,0,805
Myracle,F,100,805,0,805
Nakeya,F,100,805,0,805
Agapito,M,100,0,804,804
Demetruis,M,99,5,799,804
Ellisa,F,100,804,0,804
Graceann,F,100,804,0,804
Jeanluc,M,100,0,804,804
Katerin,F,100,804,0,804
Keyli,F,100,804,0,804
Sy,M,100,0,804,804
Trevaughn,M,100,0,804,804
Alda,F,100,803,0,803
Faythe,F,100,803,0,803
Jawaun,M,100,0,803,803
Marceline,F,100,803,0,803
Ouida,F,100,803,0,803
Tarina,F,100,803,0,803
Yelitza,F,100,803,0,803
Brailey,F,99,797,5,802
Breena,F,100,802,0,802
Donica,F,100,802,0,802
Furman,M,100,0,802,802
Genevie,F,100,802,0,802
Javaughn,M,100,0,802,802
Milah,F,100,802,0,802
Nadirah,F,100,802,0,802
Neko,M,79,169,633,802
Raghav,M,100,0,802,802
Vashon,M,91,69,733,802
Akshara,F,100,801,0,801
Danise,F,100,801,0,801
Jamica,F,100,801,0,801
Jazleen,F,100,801,0,801
Jenilee,F,100,801,0,801
Kam,M,53,380,421,801
Lukus,M,100,0,801,801
Macarthur,M,100,0,801,801
Santonio,M,100,0,801,801
Trequan,M,100,0,801,801
Elmore,M,100,0,800,800
Faiga,F,100,800,0,800
Kamau,M,100,0,800,800
Steffon,M,100,0,800,800
Teela,F,100,800,0,800
Westen,M,100,0,800,800
Yisrael,M,100,0,800,800
Fenton,M,100,0,799,799
Jannifer,F,100,799,0,799
Jewels,F,100,799,0,799
Leyah,F,100,799,0,799
Librado,M,100,0,799,799
Radames,M,100,0,799,799
Shavonna,F,100,799,0,799
Tedra,F,100,799,0,799
Tywon,M,100,0,799,799
Eureka,F,99,793,5,798
Ieisha,F,100,798,0,798
Jilian,F,100,798,0,798
Keigan,M,87,100,698,798
Shree,F,98,785,13,798
Westyn,M,95,37,761,798
Yocelyn,F,100,798,0,798
Zona,F,100,798,0,798
Cerenity,F,100,797,0,797
Deliah,F,100,797,0,797
Jasean,M,100,0,797,797
Kolbi,F,71,562,235,797
Lainee,F,100,797,0,797
Louvenia,F,100,797,0,797
Manfred,M,100,0,797,797
Megann,F,100,797,0,797
Reghan,F,100,797,0,797
Shakirah,F,100,797,0,797
Sherina,F,100,797,0,797
Sian,F,93,742,55,797
Talin,M,62,299,498,797
Avni,F,100,796,0,796
Barak,M,100,0,796,796
Christia,F,90,714,82,796
Mackinzie,F,98,781,15,796
Mylinda,F,100,796,0,796
Rajiv,M,100,0,796,796
Sharday,F,100,796,0,796
Trinidy,F,96,763,33,796
Varsha,F,100,796,0,796
Anesha,F,100,795,0,795
Binyomin,M,100,0,795,795
Danitza,F,100,795,0,795
Eston,M,100,0,795,795
Jacqualyn,F,100,795,0,795
Jaliah,F,99,789,6,795
Javonta,M,100,0,795,795
Ozell,M,92,67,728,795
Shareka,F,100,795,0,795
Chavez,M,99,8,786,794
Khyree,M,99,10,784,794
Lariah,F,100,794,0,794
Maxfield,M,100,0,794,794
Michelangelo,M,100,0,794,794
Saverio,M,100,0,794,794
Anneka,F,100,793,0,793
Cross,M,100,0,793,793
Darielle,F,100,793,0,793
Georganna,F,100,793,0,793
Hieu,M,96,28,765,793
Krysti,F,100,793,0,793
Mathilda,F,100,793,0,793
Sherida,F,100,793,0,793
Annalyn,F,100,792,0,792
Bela,F,64,506,286,792
Haylea,F,100,792,0,792
Jamelia,F,100,792,0,792
Johnthan,M,100,0,792,792
Lakendrick,M,100,0,792,792
Rainy,F,100,792,0,792
Severo,M,100,0,792,792
Tennyson,M,78,171,621,792
Trayton,M,100,0,792,792
Cayleb,M,100,0,791,791
Diamante,M,70,237,554,791
Keylin,F,71,564,227,791
Prescilla,F,100,791,0,791
Zahria,F,100,791,0,791
Benard,M,100,0,790,790
Cashmere,F,68,537,253,790
Doni,F,83,656,134,790
Frederico,M,100,0,790,790
Jameria,F,100,790,0,790
Janyce,F,100,790,0,790
Nicco,M,99,5,785,790
Rozanne,F,100,790,0,790
Shontel,F,98,771,19,790
Terrick,M,100,0,790,790
Timoteo,M,100,0,790,790
Darianna,F,100,789,0,789
Kimo,M,100,0,789,789
Kinzley,F,100,789,0,789
Lorenz,M,100,0,789,789
Marlisa,F,100,789,0,789
Marnita,F,100,789,0,789
Rayfield,M,100,0,789,789
Cassidi,F,100,788,0,788
Duy,M,100,0,788,788
Jeancarlo,M,100,0,788,788
Madolyn,F,100,788,0,788
Manya,F,100,788,0,788
Troi,F,85,673,115,788
Breah,F,100,787,0,787
Chenelle,F,100,787,0,787
Darrah,F,100,787,0,787
Delany,F,100,787,0,787
Javari,M,100,0,787,787
Abria,F,100,786,0,786
Alexas,F,100,786,0,786
Asheley,F,100,786,0,786
Dorrie,F,100,786,0,786
Erron,M,98,15,771,786
Jamarian,M,99,6,780,786
Karmin,F,100,786,0,786
Laren,F,65,513,273,786
Nohely,F,100,786,0,786
Oceana,F,100,786,0,786
Terrace,M,86,107,679,786
Yaneth,F,100,786,0,786
Arcadio,M,100,0,785,785
Avry,F,51,403,382,785
Chioma,F,100,785,0,785
Ikaika,M,100,0,785,785
Ilianna,F,100,785,0,785
Kerianne,F,100,785,0,785
Khaleesi,F,100,785,0,785
Lekeisha,F,100,785,0,785
Markee,M,86,110,675,785
Rida,F,95,742,43,785
Taija,F,100,785,0,785
Towana,F,100,785,0,785
Aaliah,F,100,784,0,784
Avrie,F,99,774,10,784
Caraline,F,100,784,0,784
Dock,M,100,0,784,784
Garron,M,100,0,784,784
Kean,M,100,0,784,784
Lady,F,100,784,0,784
Lynzee,F,100,784,0,784
Makinzie,F,100,784,0,784
Raffaele,M,100,0,784,784
Zakai,M,99,5,779,784
Caylen,F,67,525,258,783
Caysen,M,96,34,749,783
Eren,M,81,145,638,783
Felita,F,100,783,0,783
Ferrell,M,99,5,778,783
Florian,M,100,0,783,783
Mardi,F,99,777,6,783
Shakiya,F,100,783,0,783
Soham,M,100,0,783,783
Thayer,M,93,51,732,783
Argelia,F,100,782,0,782
Cage,M,100,0,782,782
Carmin,F,97,757,25,782
Cristiana,F,100,782,0,782
Dimitra,F,100,782,0,782
Era,F,100,782,0,782
Karyna,F,100,782,0,782
Khyla,F,100,782,0,782
Rhian,F,88,685,97,782
Siana,F,100,782,0,782
Zenon,M,100,0,782,782
Erna,F,100,781,0,781
Hoang,M,93,51,730,781
Kariann,F,100,781,0,781
Kerrington,F,79,619,162,781
Madge,F,100,781,0,781
Myrtis,F,100,781,0,781
Ossie,M,66,267,514,781
Teigan,F,59,460,321,781
Albertha,F,100,780,0,780
Alizae,F,99,775,5,780
Brenten,M,100,0,780,780
Estephany,F,100,780,0,780
Jonetta,F,100,780,0,780
Alayne,F,100,779,0,779
Amadeus,M,100,0,779,779
Bucky,M,100,0,779,779
Devontay,M,100,0,779,779
Jacobie,M,97,22,757,779
Jahmari,M,100,0,779,779
Joachim,M,100,0,779,779
Rainer,M,99,10,769,779
Sachi,F,100,779,0,779
Sanvi,F,100,779,0,779
Saya,F,100,779,0,779
Shaune,M,57,335,444,779
Tyrelle,M,98,16,763,779
Brenan,M,100,0,778,778
Cloie,F,100,778,0,778
Electra,F,100,778,0,778
Kalah,F,100,778,0,778
Laroy,M,100,0,778,778
Luvenia,F,100,778,0,778
Morgyn,F,100,778,0,778
Tammey,F,100,778,0,778
Tawnee,F,100,778,0,778
Trini,F,71,549,229,778
Anyia,F,100,777,0,777
Kathrina,F,100,777,0,777
Kylynn,F,98,764,13,777
Mayela,F,100,777,0,777
Abisai,M,98,13,763,776
Aneesh,M,100,0,776,776
Arther,M,100,0,776,776
Helaina,F,100,776,0,776
Lindsi,F,100,776,0,776
Montell,M,100,0,776,776
Bricen,M,100,0,775,775
Glendora,F,100,775,0,775
Jayonna,F,100,775,0,775
Karrah,F,100,775,0,775
Madina,F,100,775,0,775
Taniesha,F,100,775,0,775
Tarrence,M,100,0,775,775
Tymir,M,100,0,775,775
Yohan,M,100,0,775,775
Amadou,M,100,0,774,774
Derrius,M,100,0,774,774
Iola,F,100,774,0,774
Katisha,F,100,774,0,774
Lavetta,F,100,774,0,774
Lux,F,80,621,153,774
Madigan,F,100,774,0,774
Renardo,M,98,12,762,774
Vayda,F,100,774,0,774
Darran,M,100,0,773,773
Erendira,F,100,773,0,773
Evalina,F,100,773,0,773
Jaquarius,M,100,0,773,773
Jarely,F,100,773,0,773
Jhonathan,M,100,0,773,773
Karlo,M,100,0,773,773
Nyjah,F,67,515,258,773
Ronesha,F,100,773,0,773
Tonny,M,100,0,773,773
Wendee,F,100,773,0,773
Ariell,F,99,767,5,772
Branton,M,100,0,772,772
Bryston,M,100,0,772,772
Casaundra,F,100,772,0,772
Dayami,F,100,772,0,772
Khayla,F,100,772,0,772
Maddisyn,F,100,772,0,772
Pasha,F,64,493,279,772
Rilyn,F,89,688,84,772
Tirrell,M,98,13,759,772
Lorilee,F,100,771,0,771
Marne,F,99,766,5,771
Marymargaret,F,100,771,0,771
Alesandra,F,100,770,0,770
Kaeley,F,100,770,0,770
Kalaya,F,100,770,0,770
Kareema,F,100,770,0,770
Keiko,F,100,770,0,770
Nahomy,F,100,770,0,770
Nikkita,F,100,770,0,770
Teaghan,F,93,717,53,770
Jamiel,M,98,19,750,769
Karilyn,F,100,769,0,769
Kavita,F,100,769,0,769
Ondrea,F,100,769,0,769
Ranya,F,100,769,0,769
Winslow,M,90,76,693,769
Yakira,F,100,769,0,769
Adem,M,100,0,768,768
Adrienna,F,100,768,0,768
Alessio,M,100,0,768,768
Camerin,M,69,236,532,768
Kemp,M,100,0,768,768
Wenda,F,100,768,0,768
Alahna,F,100,767,0,767
Cirilo,M,100,0,767,767
Kieara,F,100,766,0,766
Michelina,F,100,766,0,766
Natale,M,52,371,395,766
Raheim,M,100,0,766,766
Annalynn,F,100,765,0,765
Destynee,F,100,765,0,765
Felicitas,F,100,765,0,765
Jara,F,100,765,0,765
Khaleel,M,100,0,765,765
Kiely,F,100,765,0,765
Lavonia,F,100,765,0,765
Lynnsey,F,100,765,0,765
Marquice,M,100,0,765,765
Nadene,F,100,765,0,765
Ronit,M,57,327,438,765
Aaleyah,F,100,764,0,764
Amera,F,100,764,0,764
Arlis,M,79,161,603,764
Ash,M,97,26,738,764
Colene,F,100,764,0,764
Fatou,F,100,764,0,764
Haskell,M,100,0,764,764
Kahlia,F,100,764,0,764
Katrine,F,100,764,0,764
Oryan,M,100,0,764,764
Sarahy,F,100,764,0,764
Stasha,F,100,764,0,764
Vu,M,100,0,764,764
Charlesetta,F,100,763,0,763
Chelcie,F,100,763,0,763
Elyas,M,100,0,763,763
Evamarie,F,100,763,0,763
Jaycen,M,99,5,758,763
Kadynce,F,99,757,6,763
Keylan,M,94,43,720,763
Laquana,F,100,763,0,763
Maysen,F,57,434,329,763
Rodd,M,100,0,763,763
Tor,M,100,0,763,763
Akram,M,100,0,762,762
Ankit,M,100,0,762,762
Briyana,F,100,762,0,762
Hayven,F,81,619,143,762
July,F,83,629,133,762
Lysette,F,100,762,0,762
Roselle,F,100,762,0,762
Tinesha,F,100,762,0,762
Zachari,M,100,0,762,762
Benzion,M,100,0,761,761
Elzie,M,99,7,754,761
Gaia,F,100,761,0,761
Jaidah,F,100,761,0,761
Marlayna,F,100,761,0,761
Maylene,F,100,761,0,761
Ovidio,M,100,0,761,761
Shunta,F,96,732,29,761
Ulyses,M,100,0,761,761
Verena,F,100,761,0,761
Arlet,F,100,760,0,760
Carlota,F,100,760,0,760
Chrystian,M,91,70,690,760
Dylann,F,72,546,214,760
Jamauri,M,99,11,749,760
Kortnie,F,100,760,0,760
Shyra,F,100,760,0,760
Tionne,F,89,680,80,760
Trung,M,100,0,760,760
Zyion,M,83,131,629,760
Farid,M,100,0,759,759
Haroon,M,100,0,759,759
Jacklin,F,100,759,0,759
Kyesha,F,100,759,0,759
Prisila,F,100,759,0,759
Senaida,F,100,759,0,759
Shalini,F,100,759,0,759
Shilah,F,100,759,0,759
Yoseline,F,100,759,0,759
Archibald,M,100,0,758,758
Cheston,M,100,0,758,758
Erina,F,100,758,0,758
Jannett,F,100,758,0,758
Jerico,M,99,8,750,758
Kaitlen,F,100,758,0,758
Mckinlee,F,100,758,0,758
Mehdi,M,100,0,758,758
Quintavious,M,100,0,758,758
Rhiley,F,71,535,223,758
Travell,M,100,0,758,758
Yisel,F,100,758,0,758
Acie,M,97,22,735,757
Alekzander,M,100,0,757,757
Cherese,F,100,757,0,757
Donnita,F,100,757,0,757
Javarius,M,100,0,757,757
Jefrey,M,100,0,757,757
Larnell,M,100,0,757,757
Lysa,F,100,757,0,757
Arly,F,95,715,41,756
Dung,M,62,287,469,756
Kadance,F,98,739,17,756
Pinchas,M,100,0,756,756
Tarrell,M,99,11,745,756
Traven,M,100,0,756,756
Yanni,M,78,168,588,756
Belynda,F,100,755,0,755
Claudie,M,61,297,458,755
Emmanuella,F,100,755,0,755
Kemani,F,54,406,349,755
Lyna,F,100,755,0,755
Maher,M,100,0,755,755
Nigeria,F,100,755,0,755
Sabryna,F,100,755,0,755
Caroll,F,67,506,248,754
Catherina,F,100,754,0,754
Decker,M,99,5,749,754
Romie,M,71,219,535,754
Tish,F,100,754,0,754
Abhishek,M,100,0,753,753
Amiel,M,93,51,702,753
Isra,F,100,753,0,753
Jordanna,F,100,753,0,753
Lanya,F,100,753,0,753
Leondra,F,99,748,5,753
Maizie,F,100,753,0,753
Melana,F,100,753,0,753
Shamyra,F,100,753,0,753
Shanese,F,100,753,0,753
Tearra,F,100,753,0,753
Coleson,M,100,0,752,752
Faustina,F,100,752,0,752
Jozie,F,100,752,0,752
Kelin,M,59,310,442,752
Lataya,F,100,752,0,752
Laysha,F,100,752,0,752
Mariaguadalupe,F,100,752,0,752
Philipp,M,100,0,752,752
Raquelle,F,100,752,0,752
Samyra,F,100,752,0,752
Taliya,F,100,752,0,752
Amilcar,M,100,0,751,751
Baldomero,M,100,0,751,751
Camara,F,89,670,81,751
Jabriel,M,100,0,751,751
Jerimy,M,100,0,751,751
Keldrick,M,100,0,751,751
Lilliann,F,100,751,0,751
Richele,F,100,751,0,751
Sandor,M,100,0,751,751
Thimothy,M,100,0,751,751
Zyair,M,88,89,662,751
Brit,M,81,145,605,750
Chrisopher,M,100,0,750,750
Davaughn,M,100,0,750,750
Delynn,F,91,680,70,750
Heyward,M,100,0,750,750
Josua,M,100,0,750,750
Kaely,F,100,750,0,750
Kearra,F,100,750,0,750
Keeton,M,100,0,750,750
Shamaya,F,100,750,0,750
Shawnette,F,100,750,0,750
Antwuan,M,100,0,749,749
Aylah,F,100,749,0,749
Conchita,F,100,749,0,749
Hilarie,F,100,749,0,749
Janika,F,100,749,0,749
Jaryd,M,100,0,749,749
Kamauri,M,69,235,514,749
Kenedi,F,100,749,0,749
Tya,F,100,749,0,749
Walid,M,100,0,749,749
Alfredia,F,100,748,0,748
Amisha,F,100,748,0,748
Amory,F,51,384,364,748
Camdon,M,100,0,748,748
Daiquan,M,100,0,748,748
Jamese,F,100,748,0,748
Malikai,M,100,0,748,748
Nicholus,M,100,0,748,748
Porche,F,100,748,0,748
Tabbatha,F,100,748,0,748
Zooey,F,100,748,0,748
Antonie,M,99,6,741,747
Brittini,F,100,747,0,747
Camela,F,100,747,0,747
Dorina,F,100,747,0,747
Eboney,F,100,747,0,747
Jaquetta,F,100,747,0,747
Kristena,F,100,747,0,747
Mallary,F,100,747,0,747
Nicholai,M,100,0,747,747
Talor,F,74,551,196,747
Alissia,F,100,746,0,746
Allanah,F,100,746,0,746
Blayze,M,97,26,720,746
Breelyn,F,100,746,0,746
Caedmon,M,100,0,746,746
Catelynn,F,100,746,0,746
Cesilia,F,100,746,0,746
Charlsie,F,100,746,0,746
Kace,M,98,13,733,746
Keala,F,97,724,22,746
Keishawn,M,92,63,683,746
Maggi,F,100,746,0,746
Maliki,M,100,0,746,746
Sha,F,84,624,122,746
Shamon,M,81,140,606,746
Stryker,M,100,0,746,746
Tylin,M,75,186,560,746
Britanny,F,100,745,0,745
Jawon,M,99,5,740,745
Loghan,M,52,355,390,745
Rishabh,M,100,0,745,745
Sherra,F,100,745,0,745
Stefen,M,100,0,745,745
Tex,M,100,0,745,745
Trixie,F,100,745,0,745
Braylyn,F,58,430,314,744
Daegan,M,94,43,701,744
Daequan,M,100,0,744,744
Davide,M,100,0,744,744
Laszlo,M,100,0,744,744
Marlan,M,98,14,730,744
Mele,F,100,744,0,744
Sharay,F,99,739,5,744
Alastair,M,100,0,743,743
Dezmon,M,100,0,743,743
Hadassa,F,100,743,0,743
Kourtni,F,100,743,0,743
Talea,F,100,743,0,743
Thadeus,M,100,0,743,743
Andera,F,98,724,18,742
Braylynn,F,90,668,74,742
Cheyene,F,97,720,22,742
Derryl,M,100,0,742,742
Jencarlos,M,100,0,742,742
Joselito,M,100,0,742,742
Lorenda,F,100,742,0,742
Maraya,F,100,742,0,742
Norwood,M,100,0,742,742
Pryce,M,96,29,713,742
Shaka,M,81,142,600,742
Shant,M,100,0,742,742
Ajanae,F,100,741,0,741
Antonios,M,100,0,741,741
Arabelle,F,100,741,0,741
Beaux,M,93,54,687,741
Deni,F,81,603,138,741
Felipa,F,100,741,0,741
Jiana,F,100,741,0,741
Keyra,F,100,741,0,741
Risha,F,100,741,0,741
Tyvon,M,100,0,741,741
Dresden,M,79,159,581,740
Jaquavious,M,100,0,740,740
Marry,F,100,740,0,740
Mikela,F,100,740,0,740
Treavor,M,100,0,740,740
Aarin,M,60,296,443,739
Alexanderia,F,100,739,0,739
Deaven,M,75,183,556,739
Ellyana,F,100,739,0,739
Fransico,M,100,0,739,739
Jayvin,M,100,0,739,739
Jedd,M,100,0,739,739
Jenika,F,100,739,0,739
Kymber,F,100,739,0,739
Merilyn,F,100,739,0,739
Saphire,F,100,739,0,739
Shatavia,F,100,739,0,739
Tanea,F,100,739,0,739
Amr,M,100,0,738,738
Gunther,M,100,0,738,738
Jamilet,F,100,738,0,738
Jayvian,M,100,0,738,738
Loki,M,96,26,712,738
Marilin,F,100,738,0,738
Monta,M,60,296,442,738
Morgann,F,100,738,0,738
Naveah,F,100,738,0,738
Ronnette,F,100,738,0,738
Trapper,M,100,0,738,738
Atara,F,100,737,0,737
Aundria,F,100,737,0,737
Brittiany,F,100,737,0,737
Castiel,M,99,10,727,737
Delphia,F,100,737,0,737
Nitya,F,99,732,5,737
Sejal,F,100,737,0,737
Sharelle,F,100,737,0,737
Calissa,F,100,736,0,736
Kamea,F,100,736,0,736
Kaseem,M,100,0,736,736
Klint,M,100,0,736,736
Reya,F,100,736,0,736
Treshaun,M,99,5,731,736
Washington,M,100,0,736,736
Delayna,F,100,735,0,735
Elodia,F,100,735,0,735
Emmah,F,100,735,0,735
Kanani,F,99,730,5,735
Kathe,F,100,735,0,735
Usher,M,100,0,735,735
Aubreigh,F,100,734,0,734
Avante,M,95,38,696,734
Bashir,M,100,0,734,734
Deleon,M,98,14,720,734
Hendrick,M,100,0,734,734
Sherre,F,100,734,0,734
Aeriel,F,100,733,0,733
Ahron,M,100,0,733,733
Charice,F,100,733,0,733
Charmane,F,100,733,0,733
Jaquita,F,100,733,0,733
Kamry,F,98,717,16,733
Mikail,M,98,15,718,733
Nicholis,M,100,0,733,733
Diallo,M,99,5,727,732
Kaleen,F,100,732,0,732
Kavan,M,100,0,732,732
Khia,F,100,732,0,732
Lashauna,F,100,732,0,732
Lennard,M,100,0,732,732
Malaina,F,100,732,0,732
Marshay,F,99,727,5,732
Palma,F,100,732,0,732
Reis,M,87,96,636,732
Tiyanna,F,100,732,0,732
Zachory,M,100,0,732,732
Dyann,F,100,731,0,731
Jeannetta,F,100,731,0,731
Kaori,F,94,687,44,731
Laporsha,F,100,731,0,731
Lenae,F,100,731,0,731
Lyda,F,100,731,0,731
Miryam,F,100,731,0,731
Selin,F,100,731,0,731
Tamer,M,100,0,731,731
Tarun,M,100,0,731,731
Thorin,M,100,0,731,731
Yale,M,100,0,731,731
Yoseph,M,100,0,731,731
Ysidro,M,100,0,731,731
Arianah,F,100,730,0,730
Bertina,F,100,730,0,730
Darl,M,98,13,717,730
Delylah,F,100,730,0,730
Dinora,F,100,730,0,730
Halina,F,100,730,0,730
Jaxxon,M,100,0,730,730
Jessalynn,F,100,730,0,730
Renisha,F,100,730,0,730
Georganne,F,100,729,0,729
Kiaya,F,100,729,0,729
Luan,M,55,329,400,729
Shawntay,F,95,694,35,729
Ashraf,M,100,0,728,728
Bronwen,F,100,728,0,728
Cathlene,F,100,728,0,728
Domanick,M,100,0,728,728
Oma,F,98,713,15,728
Saron,F,82,595,133,728
Shakeem,M,100,0,728,728
Carlis,M,79,151,576,727
Ekaterina,F,100,727,0,727
Elimelech,M,100,0,727,727
Farley,M,99,10,717,727
Ginna,F,100,727,0,727
Kashton,M,100,0,727,727
Malarie,F,100,727,0,727
Penina,F,100,727,0,727
Sheyanne,F,100,727,0,727
Tyus,M,100,0,727,727
Chavon,F,92,671,55,726
Deontre,M,100,0,726,726
Domenique,F,74,539,187,726
Evert,M,100,0,726,726
Hollyn,F,100,726,0,726
Kearstin,F,100,726,0,726
Narissa,F,100,726,0,726
Nefertiti,F,100,726,0,726
Shailyn,F,100,726,0,726
Amaan,M,100,0,725,725
Ames,M,100,0,725,725
Caira,F,100,725,0,725
Clarinda,F,100,725,0,725
Daeshawn,M,99,5,720,725
Derrel,M,100,0,725,725
Hermione,F,100,725,0,725
Jacqlyn,F,100,725,0,725
Jameshia,F,100,725,0,725
Jermal,M,100,0,725,725
Lanelle,F,100,725,0,725
Tarryn,F,99,715,10,725
Venecia,F,100,725,0,725
Abigal,F,100,724,0,724
Amyia,F,100,724,0,724
Edilberto,M,100,0,724,724
Kallista,F,100,724,0,724
Karlin,F,55,400,324,724
Laurissa,F,100,724,0,724
Marshaun,M,100,0,724,724
Morrison,M,95,37,687,724
Sherene,F,100,724,0,724
Wali,M,100,0,724,724
Aarika,F,100,723,0,723
Camaron,M,93,52,671,723
Dawnmarie,F,100,723,0,723
Elyce,F,100,723,0,723
Graciella,F,100,723,0,723
Janiel,M,74,187,536,723
Jinny,F,100,723,0,723
Kellianne,F,100,723,0,723
Kimaya,F,100,723,0,723
Majesty,F,79,572,151,723
Malori,F,100,723,0,723
Zamarion,M,100,0,723,723
Abbygale,F,100,722,0,722
Aquila,F,92,665,57,722
Jera,F,100,722,0,722
Johanne,F,100,722,0,722
Keleigh,F,100,722,0,722
Maryan,F,100,722,0,722
Oaklee,F,82,594,128,722
Aristotle,M,100,0,721,721
Athina,F,100,721,0,721
Brena,F,100,721,0,721
Durwood,M,100,0,721,721
Glenwood,M,100,0,721,721
Haya,F,100,721,0,721
Iram,M,87,97,624,721
Maiah,F,100,721,0,721
Mavrick,M,100,0,721,721
Wolf,M,100,0,721,721
Andersen,M,79,148,572,720
Betsabe,F,100,720,0,720
Kathren,F,100,720,0,720
Korrie,F,96,690,30,720
Nava,F,100,720,0,720
Tonna,F,100,720,0,720
Yurem,M,100,0,720,720
Avital,F,100,719,0,719
Deryk,M,100,0,719,719
Eithan,M,100,0,719,719
Giovana,F,100,719,0,719
Jalani,M,61,281,438,719
Jaleen,M,52,344,375,719
Janira,F,100,719,0,719
Jolisa,F,100,719,0,719
Kalene,F,100,719,0,719
Kou,M,95,33,686,719
Kwesi,M,100,0,719,719
Mackenzee,F,100,719,0,719
Talib,M,100,0,719,719
Adalina,F,100,718,0,718
Blue,M,72,200,518,718
Deagan,M,100,0,718,718
Delmas,M,100,0,718,718
Elona,F,100,718,0,718
Jayline,F,99,713,5,718
Shakeya,F,100,718,0,718
Ziad,M,100,0,718,718
Aldon,M,100,0,717,717
Amere,M,83,125,592,717
Artemis,F,85,609,108,717
Calob,M,100,0,717,717
Christoffer,M,100,0,717,717
Daphnie,F,100,717,0,717
Evy,F,100,717,0,717
Lillee,F,100,717,0,717
Tacy,F,100,717,0,717
Conlan,M,100,0,716,716
Eber,M,100,0,716,716
Mechele,F,100,716,0,716
Newell,M,100,0,716,716
Yannick,M,100,0,716,716
Zyler,M,100,0,716,716
Alanda,F,100,715,0,715
Auriel,F,94,673,42,715
Bionca,F,100,715,0,715
Calyn,F,90,645,70,715
Cheyenna,F,100,715,0,715
Hamid,M,100,0,715,715
Macyn,F,88,628,87,715
Qasim,M,100,0,715,715
Sherill,F,98,704,11,715
Verla,F,100,715,0,715
Addam,M,100,0,714,714
Charlise,F,100,714,0,714
Ethaniel,M,100,0,714,714
Maddyson,F,100,714,0,714
Nicodemus,M,100,0,714,714
Sun,F,60,429,285,714
Yer,F,80,572,142,714
Airam,F,88,631,82,713
Amen,M,65,247,466,713
Bergen,F,57,403,310,713
Betsaida,F,100,713,0,713
Carmelina,F,100,713,0,713
Cyrena,F,100,713,0,713
Elmira,F,100,713,0,713
Kerriann,F,100,713,0,713
Kiva,F,97,689,24,713
Nicholos,M,100,0,713,713
Peterson,M,100,0,713,713
Amore,F,83,592,120,712
Cadie,F,100,712,0,712
Chancelor,M,100,0,712,712
Devra,F,100,712,0,712
Gerrod,M,100,0,712,712
Lalita,F,100,712,0,712
Orlanda,M,71,207,505,712
Torrin,M,88,89,623,712
Algernon,M,100,0,711,711
Dyanne,F,100,711,0,711
Eriq,M,100,0,711,711
Jermy,M,100,0,711,711
Kenyada,F,79,565,146,711
Krystyn,F,100,711,0,711
Lizandro,M,100,0,711,711
Mckensie,F,100,711,0,711
Nilah,F,100,711,0,711
Rabia,F,100,711,0,711
Kama,F,100,710,0,710
Marge,F,100,710,0,710
Mikkel,M,97,24,686,710
Polina,F,100,710,0,710
Quang,M,100,0,710,710
Rayshon,M,100,0,710,710
Renada,F,100,710,0,710
Zaya,F,99,700,10,710
Adama,F,60,423,286,709
Aiza,F,100,709,0,709
Davita,F,100,709,0,709
Daymond,M,100,0,709,709
Ilsa,F,100,709,0,709
Ilyssa,F,100,709,0,709
Jameela,F,100,709,0,709
Kana,F,97,691,18,709
Keera,F,100,709,0,709
Reyli,M,98,13,696,709
Teairra,F,100,709,0,709
Tomekia,F,100,709,0,709
Velva,F,100,709,0,709
Brieann,F,100,708,0,708
Jamarious,M,100,0,708,708
Jessamyn,F,99,703,5,708
Marvella,F,100,708,0,708
Towanna,F,100,708,0,708
Yu,F,51,359,349,708
Zuleyma,F,100,708,0,708
Aleaha,F,100,707,0,707
Angelisa,F,100,707,0,707
Cesario,M,100,0,707,707
Kristyna,F,100,707,0,707
Matilyn,F,100,707,0,707
Nikkie,F,100,707,0,707
Obinna,M,100,0,707,707
Raeven,F,100,707,0,707
Elani,F,100,706,0,706
Jakyla,F,100,706,0,706
Joseantonio,M,100,0,706,706
Langdon,M,99,10,696,706
Mckenzee,F,100,706,0,706
Mysti,F,100,706,0,706
Deseray,F,100,705,0,705
Gerrie,F,99,699,6,705
Keasha,F,100,705,0,705
Latifa,F,100,705,0,705
Shirelle,F,100,705,0,705
Taria,F,96,679,26,705
Cypress,F,58,409,295,704
Edvin,M,100,0,704,704
Jemel,M,100,0,704,704
Kailan,F,59,417,287,704
Maelee,F,100,704,0,704
Niomi,F,100,704,0,704
Saquan,M,99,7,697,704
Sully,M,59,292,412,704
Bradey,M,99,9,694,703
Derrian,M,87,88,615,703
Jenai,F,100,703,0,703
Kaile,F,97,681,22,703
Marily,F,100,703,0,703
Mirabelle,F,100,703,0,703
Shanteria,F,100,703,0,703
Sheniqua,F,100,703,0,703
Arieana,F,100,702,0,702
Danille,F,100,702,0,702
Ellia,F,100,702,0,702
Emelin,F,100,702,0,702
Kendalyn,F,100,702,0,702
Lanier,M,88,82,620,702
Licia,F,100,702,0,702
Makeba,F,100,702,0,702
Mariellen,F,100,702,0,702
Martavius,M,100,0,702,702
Nori,F,97,680,22,702
Peaches,F,100,702,0,702
Yan,M,88,83,619,702
Cheron,F,86,602,99,701
Edd,M,100,0,701,701
Georgianne,F,100,701,0,701
Gwynn,F,96,670,31,701
Kathya,F,100,701,0,701
Shealynn,F,100,701,0,701
Stephone,M,100,0,701,701
Suhani,F,100,701,0,701
Trishia,F,100,701,0,701
Anisah,F,100,700,0,700
Collene,F,100,700,0,700
Hernando,M,100,0,700,700
Ixchel,F,100,700,0,700
Jaritza,F,100,700,0,700
Jermane,M,100,0,700,700
Koy,M,95,34,666,700
Nandini,F,100,700,0,700
Allyse,F,100,699,0,699
Anthonie,M,100,0,699,699
Bladen,M,100,0,699,699
Boe,M,99,7,692,699
Dillen,M,92,55,644,699
Gwenevere,F,100,699,0,699
Ilia,F,87,607,92,699
Juanmanuel,M,100,0,699,699
Kalyssa,F,100,699,0,699
Leota,F,100,699,0,699
Sherley,F,100,699,0,699
Tabbitha,F,100,699,0,699
Traevon,M,100,0,699,699
Tyiesha,F,100,699,0,699
Yobani,M,100,0,699,699
Adrea,F,100,698,0,698
Alyxandra,F,100,698,0,698
Briyanna,F,100,698,0,698
Chardae,F,100,698,0,698
Esteven,M,100,0,698,698
Ibrahima,M,100,0,698,698
Jamille,F,63,438,260,698
Laurine,F,100,698,0,698
Leandrew,M,100,0,698,698
Piotr,M,100,0,698,698
Sahra,F,100,698,0,698
Sissy,F,100,698,0,698
Tyrece,M,100,0,698,698
Aerin,F,98,681,16,697
Avram,M,100,0,697,697
Drexel,M,100,0,697,697
Marykatherine,F,100,697,0,697
Nessa,F,100,697,0,697
Oral,M,98,11,686,697
Siarra,F,100,697,0,697
Tameca,F,100,697,0,697
Verity,F,100,697,0,697
Cyndee,F,100,696,0,696
Hermon,M,95,36,660,696
Jeremyah,M,100,0,696,696
Lundyn,F,99,690,6,696
Nikos,M,100,0,696,696
Sherlene,F,100,696,0,696
Tayana,F,100,696,0,696
Amena,F,100,695,0,695
Derell,M,100,0,695,695
Earvin,M,100,0,695,695
Elysha,F,96,669,26,695
Kamela,F,100,695,0,695
Landy,M,67,227,468,695
Lavaughn,M,79,149,546,695
Laylani,F,100,695,0,695
Menno,M,100,0,695,695
Naida,F,100,695,0,695
Ninette,F,100,695,0,695
Rashanda,F,100,695,0,695
Sharona,F,100,695,0,695
Tully,M,94,40,655,695
Adysen,F,100,694,0,694
Charle,M,83,115,579,694
Daeja,F,100,694,0,694
Jamisha,F,100,694,0,694
Katheleen,F,100,694,0,694
Natassia,F,100,694,0,694
Nayomi,F,100,694,0,694
Paetyn,F,98,683,11,694
Shauntae,F,99,689,5,694
Somaya,F,100,694,0,694
Brendin,M,100,0,693,693
Corri,F,96,666,27,693
Diondra,F,99,688,5,693
Emmarie,F,100,693,0,693
Haylei,F,100,693,0,693
Hollee,F,100,693,0,693
Jadie,F,98,682,11,693
Janyia,F,100,693,0,693
Koral,F,100,693,0,693
Taelynn,F,100,693,0,693
Verda,F,100,693,0,693
Yarel,F,76,530,163,693
Annamae,F,100,692,0,692
Ector,M,100,0,692,692
Jamahl,M,100,0,692,692
Jarryd,M,100,0,692,692
Navin,M,100,0,692,692
Naydelin,F,100,692,0,692
Urban,M,100,0,692,692
Zebulun,M,100,0,692,692
Ashland,F,84,581,110,691
Camella,F,100,691,0,691
Carita,F,100,691,0,691
Fadi,M,100,0,691,691
Jeaneen,F,100,691,0,691
Laikyn,F,100,691,0,691
Laquitta,F,100,691,0,691
Lilee,F,100,691,0,691
Maryfrances,F,100,691,0,691
Naliyah,F,100,691,0,691
Shaquanda,F,100,691,0,691
Tanay,M,54,317,374,691
Aiko,F,100,690,0,690
Demetrick,M,100,0,690,690
Didier,M,100,0,690,690
Jayton,M,100,0,690,690
Latrece,F,100,690,0,690
Lipa,M,100,0,690,690
Stevon,M,100,0,690,690
Trenity,F,97,667,23,690
Able,M,100,0,689,689
Allicia,F,100,689,0,689
Anthea,F,100,689,0,689
Demonta,M,100,0,689,689
Emberly,F,100,689,0,689
Ilyana,F,100,689,0,689
Natia,F,100,689,0,689
Sherlin,F,100,689,0,689
Arletta,F,100,688,0,688
Dewanna,F,100,688,0,688
Elston,M,100,0,688,688
Ngoc,F,92,634,54,688
Raigan,F,100,688,0,688
Tamari,F,66,454,234,688
Wm,M,100,0,688,688
Zacarias,M,100,0,688,688
Brockton,M,100,0,687,687
Lillyanne,F,100,687,0,687
Massiel,F,100,687,0,687
Quanesha,F,100,687,0,687
Seleste,F,100,687,0,687
Alexandr,M,56,301,385,686
Avin,M,93,48,638,686
Bj,M,99,5,681,686
Harmonee,F,100,686,0,686
Lavender,F,100,686,0,686
Marcee,F,100,686,0,686
Pacey,M,72,192,494,686
Reynolds,M,97,23,663,686
Salah,M,91,59,627,686
Aran,M,96,27,658,685
Asmaa,F,100,685,0,685
Blakeley,F,86,589,96,685
Dawud,M,100,0,685,685
Deandria,F,100,685,0,685
Josselin,F,100,685,0,685
Kalem,M,100,0,685,685
Khanh,M,57,293,392,685
Kimberleigh,F,100,685,0,685
Ruperto,M,100,0,685,685
Shoshanna,F,100,685,0,685
Skyelar,F,77,529,156,685
Zowie,F,100,685,0,685
Asusena,F,100,684,0,684
Danie,M,68,216,468,684
Daysia,F,100,684,0,684
Jonita,F,100,684,0,684
Knowledge,M,99,10,674,684
Latonja,F,100,684,0,684
Otilia,F,100,684,0,684
Ryah,F,100,684,0,684
Vander,M,100,0,684,684
Yalitza,F,100,684,0,684
Aadi,M,98,16,667,683
Aishwarya,F,100,683,0,683
Havana,F,100,683,0,683
Jabbar,M,100,0,683,683
Jaquon,M,100,0,683,683
Jenean,F,100,683,0,683
Kailea,F,100,683,0,683
Kaylia,F,100,683,0,683
Kelcee,F,100,683,0,683
Kynnedi,F,100,683,0,683
Oshea,M,94,44,639,683
Raffi,M,100,0,683,683
Rajesh,M,100,0,683,683
Sarahann,F,100,683,0,683
Skipper,M,100,0,683,683
Toren,M,99,6,677,683
Caelin,F,57,386,296,682
Crystel,F,100,682,0,682
Denard,M,100,0,682,682
Denette,F,100,682,0,682
Dylin,M,84,111,571,682
Jaylie,F,100,682,0,682
Kaven,M,100,0,682,682
Kimberlynn,F,100,682,0,682
Lateshia,F,100,682,0,682
Megen,F,100,682,0,682
Nandi,F,100,682,0,682
Taft,M,100,0,682,682
Taysha,F,100,682,0,682
Tedrick,M,100,0,682,682
Whisper,F,100,682,0,682
Xandria,F,100,682,0,682
Breyon,M,86,95,586,681
Cerise,F,100,681,0,681
Donnel,M,93,47,634,681
Heavyn,F,100,681,0,681
Jeriel,M,100,0,681,681
Jlynn,F,91,622,59,681
Katarzyna,F,100,681,0,681
Neri,M,79,146,535,681
Skylyn,F,100,681,0,681
Donovin,M,100,0,680,680
Kendon,M,100,0,680,680
Lexia,F,100,680,0,680
Nasya,F,100,680,0,680
Terren,M,75,169,511,680
Aryah,F,100,679,0,679
Bobbye,F,99,674,5,679
Brodi,M,82,124,555,679
Christapher,M,100,0,679,679
Cisco,M,100,0,679,679
Daryan,M,62,260,419,679
Delante,M,100,0,679,679
Elizbeth,F,100,679,0,679
Gweneth,F,100,679,0,679
Jalessa,F,100,679,0,679
Kahla,F,100,679,0,679
Leandrea,F,99,674,5,679
Lennis,M,84,109,570,679
Liseth,F,100,679,0,679
Maizy,F,100,679,0,679
Raylon,M,100,0,679,679
Shantavia,F,100,679,0,679
Taylynn,F,100,679,0,679
Trevyn,M,100,0,679,679
Zaynah,F,100,679,0,679
Aicha,F,100,678,0,678
Courtlyn,F,99,668,10,678
Daimon,M,100,0,678,678
Danella,F,100,678,0,678
Jahi,M,100,0,678,678
Klay,M,100,0,678,678
Mikia,F,100,678,0,678
Nichols,M,100,0,678,678
Rockwell,M,100,0,678,678
Sadee,F,100,678,0,678
Sharry,F,100,678,0,678
Vedant,M,100,0,678,678
Fatema,F,100,677,0,677
Gabby,F,98,661,16,677
Lafonda,F,100,677,0,677
Lamond,M,100,0,677,677
Lucienne,F,100,677,0,677
Merlene,F,100,677,0,677
Saria,F,100,677,0,677
Shawndra,F,100,677,0,677
Acadia,F,100,676,0,676
Bronx,M,99,5,671,676
Carlon,M,86,98,578,676
Edyn,F,90,608,68,676
Faiza,F,100,676,0,676
Farron,M,84,109,567,676
Herbie,M,100,0,676,676
Jodell,F,100,676,0,676
Mollee,F,100,676,0,676
Rahma,F,100,676,0,676
Ramiyah,F,100,676,0,676
Stepanie,F,100,676,0,676
Sylvana,F,100,676,0,676
Zari,F,99,666,10,676
Ariannah,F,100,675,0,675
Coletta,F,100,675,0,675
Jaynee,F,100,675,0,675
Kataleya,F,100,675,0,675
Kerrick,M,100,0,675,675
Makyah,F,94,632,43,675
Malin,F,77,522,153,675
Quenten,M,100,0,675,675
Shermaine,F,74,502,173,675
Tameria,F,100,675,0,675
Tomasz,M,100,0,675,675
Aidee,F,100,674,0,674
Dajanae,F,100,674,0,674
Kenard,M,100,0,674,674
Melodye,F,100,674,0,674
Serra,F,100,674,0,674
Zania,F,100,674,0,674
Alizah,F,99,668,5,673
Ameenah,F,100,673,0,673
Bertie,F,94,630,43,673
Daesha,F,100,673,0,673
Danessa,F,100,673,0,673
Desaree,F,100,673,0,673
Jeanett,F,100,673,0,673
Marketa,F,100,673,0,673
Seferino,M,100,0,673,673
Shadia,F,100,673,0,673
Termaine,M,98,13,660,673
Valda,F,100,673,0,673
Waylan,M,100,0,673,673
Berlyn,F,100,672,0,672
Elijha,M,100,0,672,672
Genell,F,100,672,0,672
Harlon,M,100,0,672,672
Kimble,M,66,226,446,672
Kyria,F,100,672,0,672
Lavera,F,100,672,0,672
Manon,F,99,667,5,672
Medha,F,100,672,0,672
Murad,M,100,0,672,672
Myiah,F,100,672,0,672
Sohan,M,100,0,672,672
Tereza,F,100,672,0,672
Tran,F,82,549,123,672
Yasser,M,100,0,672,672
Brocha,F,100,671,0,671
Corynn,F,100,671,0,671
Daneisha,F,100,671,0,671
Emaan,F,96,644,27,671
Kaliya,F,100,671,0,671
Kelechi,M,66,225,446,671
Kenzo,M,100,0,671,671
Lekesha,F,100,671,0,671
Darcell,F,76,506,164,670
Devi,F,100,670,0,670
Elizah,F,55,368,302,670
Harleen,F,100,670,0,670
Hendrik,M,100,0,670,670
Jamonte,M,100,0,670,670
Makhia,F,100,670,0,670
Nyoka,F,100,670,0,670
Silvester,M,100,0,670,670
Averee,F,96,644,25,669
Carrieann,F,100,669,0,669
Daun,F,98,657,12,669
Dayquan,M,100,0,669,669
Djuana,F,100,669,0,669
Kodey,M,98,11,658,669
Mi,F,100,669,0,669
Navid,M,96,26,643,669
Rylei,F,93,623,46,669
Trinton,M,100,0,669,669
Aneesah,F,100,668,0,668
Anylah,F,100,668,0,668
Aolani,F,100,668,0,668
Dalon,M,100,0,668,668
Deva,F,98,657,11,668
Keary,M,84,104,564,668
Laverna,F,100,668,0,668
Niccolo,M,100,0,668,668
Payal,F,100,668,0,668
Saleen,F,100,668,0,668
Sebastion,M,100,0,668,668
Shakina,F,100,668,0,668
Taralyn,F,100,668,0,668
Tela,F,99,661,7,668
Bastian,M,100,0,667,667
Damarco,M,100,0,667,667
Jayon,M,100,0,667,667
Linsay,F,100,667,0,667
Mahayla,F,100,667,0,667
Meya,F,100,667,0,667
Miangel,F,100,667,0,667
Nichele,F,100,667,0,667
Ram,M,100,0,667,667
Ronetta,F,100,667,0,667
Tamiah,F,100,667,0,667
Tyrie,M,94,41,626,667
Zebedee,M,100,0,667,667
Bee,M,79,137,529,666
Darriel,M,77,154,512,666
Lugene,F,58,385,281,666
Moussa,M,100,0,666,666
October,F,100,666,0,666
Svetlana,F,100,666,0,666
Tammye,F,100,666,0,666
Tanzania,F,100,666,0,666
Taylore,F,100,666,0,666
Tyriek,M,100,0,666,666
Aalyiah,F,100,665,0,665
Carlisha,F,100,665,0,665
Dandra,F,91,605,60,665
Jamaree,M,99,5,660,665
Kelliann,F,100,665,0,665
Kyasia,F,100,665,0,665
Layden,M,94,41,624,665
Marriah,F,100,665,0,665
Melchor,M,100,0,665,665
Reyansh,M,100,0,665,665
Teasha,F,100,665,0,665
Tynan,M,100,0,665,665
Aleana,F,100,664,0,664
Banks,M,100,0,664,664
Brittanee,F,100,664,0,664
Caralee,F,100,664,0,664
Jadeyn,F,94,626,38,664
Javonne,F,55,362,302,664
Laray,M,52,319,345,664
Neta,F,100,664,0,664
Rajon,M,100,0,664,664
Shaley,F,100,664,0,664
Andromeda,F,100,663,0,663
Brandilyn,F,100,663,0,663
Clarita,F,100,663,0,663
Dewanda,F,100,663,0,663
Emersen,F,94,620,43,663
Leonie,F,100,663,0,663
Nelia,F,100,663,0,663
Pamla,F,100,663,0,663
Radha,F,100,663,0,663
Sharlotte,F,100,663,0,663
Theotis,M,100,0,663,663
Zahraa,F,100,663,0,663
Ankur,M,100,0,662,662
Brieanne,F,100,662,0,662
Erroll,M,100,0,662,662
Kimya,F,100,662,0,662
Mitchelle,F,76,502,160,662
Morelia,F,100,662,0,662
Pamula,F,100,662,0,662
Teasia,F,100,662,0,662
Basya,F,100,661,0,661
Dj,M,98,13,648,661
Estee,F,99,656,5,661
Evann,M,55,297,364,661
Faheem,M,100,0,661,661
Galvin,M,100,0,661,661
Gaurav,M,100,0,661,661
Jawuan,M,100,0,661,661
Kesia,F,100,661,0,661
Lyanna,F,100,661,0,661
Mahki,M,100,0,661,661
Manolo,M,100,0,661,661
Maynor,M,100,0,661,661
Prestyn,M,81,127,534,661
Reana,F,100,661,0,661
Tashaun,M,95,36,625,661
Trajan,M,100,0,661,661
Avelino,M,100,0,660,660
Azra,F,98,648,12,660
Genice,F,100,660,0,660
Georgeanne,F,100,660,0,660
Jannine,F,100,660,0,660
Kao,M,63,244,416,660
Leen,F,100,660,0,660
Mayla,F,100,660,0,660
Neema,F,61,404,256,660
Ramzi,M,99,5,655,660
Sabella,F,100,660,0,660
Sharone,F,77,510,150,660
Shyam,M,100,0,660,660
Spiro,M,100,0,660,660
Aubre,F,98,644,15,659
Ebenezer,M,98,16,643,659
Erek,M,100,0,659,659
Ilya,M,88,77,582,659
Johnatan,M,100,0,659,659
Jubal,M,100,0,659,659
Kateland,F,100,659,0,659
Kiyanna,F,100,659,0,659
Pessy,F,100,659,0,659
Ronita,F,100,659,0,659
Shirin,F,100,659,0,659
Zoltan,M,100,0,659,659
Breeze,F,95,625,33,658
Jacquelynne,F,100,658,0,658
Jerick,M,100,0,658,658
Keefe,M,100,0,658,658
Kendahl,F,93,609,49,658
Ludwig,M,100,0,658,658
Margeaux,F,100,658,0,658
Samad,M,100,0,658,658
Sang,M,93,47,611,658
Vena,F,100,658,0,658
Abdurrahman,M,100,0,657,657
Cassidee,F,100,657,0,657
Earlie,M,77,149,508,657
Graycen,F,70,459,198,657
Keithan,M,100,0,657,657
Koryn,F,100,657,0,657
Kourtnie,F,100,657,0,657
Lean,F,91,597,60,657
Lorelle,F,100,657,0,657
Shontell,F,99,651,6,657
Terryn,F,73,478,179,657
Tziporah,F,100,657,0,657
Andrena,F,100,656,0,656
Dawnette,F,100,656,0,656
Dayonna,F,100,656,0,656
Edy,M,73,174,482,656
Kemarion,M,100,0,656,656
Neyda,F,100,656,0,656
Saleena,F,100,656,0,656
Thierry,M,97,21,635,656
Xavien,M,100,0,656,656
Chirag,M,100,0,655,655
Danaya,F,100,655,0,655
Demetrus,M,97,22,633,655
Dupree,M,100,0,655,655
Ezrah,M,78,141,514,655
Joellyn,F,100,655,0,655
Kammy,F,100,655,0,655
Kennia,F,100,655,0,655
Maryjean,F,100,655,0,655
Pollyanna,F,100,655,0,655
Recardo,M,100,0,655,655
Renell,F,76,500,155,655
Wenona,F,100,655,0,655
Aniela,F,100,654,0,654
Brihanna,F,100,654,0,654
Colyn,M,98,10,644,654
Elysse,F,100,654,0,654
Ishani,F,100,654,0,654
Kiyomi,F,100,654,0,654
Lindon,M,100,0,654,654
Quashawn,M,99,5,649,654
Timi,F,99,649,5,654
Valene,F,100,654,0,654
Wynette,F,100,654,0,654
Amarilis,F,100,653,0,653
Arnette,F,96,625,28,653
Fraidy,F,100,653,0,653
Kelleen,F,100,653,0,653
Krystopher,M,100,0,653,653
Robyne,F,100,653,0,653
Addalynn,F,100,652,0,652
Coltan,M,100,0,652,652
Dacota,M,73,177,475,652
Donesha,F,100,652,0,652
Geroge,M,100,0,652,652
Jionni,M,98,11,641,652
Kaimana,M,92,54,598,652
Kensie,F,100,652,0,652
Keyton,M,100,0,652,652
Maleia,F,100,652,0,652
Marybel,F,100,652,0,652
Myiesha,F,100,652,0,652
Tanae,F,100,652,0,652
Yalanda,F,100,652,0,652
Yoni,M,97,20,632,652
Alicyn,F,100,651,0,651
Amyiah,F,100,651,0,651
Cleta,F,100,651,0,651
Daliyah,F,100,651,0,651
Falicia,F,100,651,0,651
Jamesia,F,100,651,0,651
Ligia,F,100,651,0,651
Mordecai,M,100,0,651,651
Quaid,M,100,0,651,651
Raylyn,F,95,618,33,651
Reeve,M,81,126,525,651
Shylee,F,100,651,0,651
Tavarius,M,100,0,651,651
Truitt,M,100,0,651,651
Twilla,F,100,651,0,651
Avari,F,89,579,71,650
Carlissa,F,100,650,0,650
Chanie,F,100,650,0,650
Chrissa,F,100,650,0,650
Genavieve,F,100,650,0,650
Gregoria,F,100,650,0,650
Jolina,F,100,650,0,650
Jourdyn,F,82,533,117,650
Kortnee,F,100,650,0,650
Loralie,F,100,650,0,650
Lysandra,F,100,650,0,650
Phillips,M,100,0,650,650
Siomara,F,100,650,0,650
Trenda,F,100,650,0,650
Alizay,F,99,644,5,649
Amey,F,96,622,27,649
Brixton,M,89,69,580,649
Cheng,M,94,38,611,649
Hobart,M,100,0,649,649
Jakeria,F,100,649,0,649
Kynslee,F,100,649,0,649
Lenell,M,69,198,451,649
Leylani,F,100,649,0,649
Raegen,F,100,649,0,649
Tamora,F,100,649,0,649
Avonlea,F,100,648,0,648
Clarise,F,100,648,0,648
Darbi,F,100,648,0,648
Elif,F,100,648,0,648
Epiphany,F,100,648,0,648
Kalley,F,100,648,0,648
Khoa,M,100,0,648,648
Lavita,F,100,648,0,648
Layken,F,87,565,83,648
Padraig,M,100,0,648,648
Sharia,F,100,648,0,648
Sherica,F,100,648,0,648
Tabor,M,87,82,566,648
Tarren,M,65,230,418,648
Zakariah,M,89,71,577,648
Anastazia,F,100,647,0,647
Crystalyn,F,100,647,0,647
Dezire,F,100,647,0,647
Elson,M,100,0,647,647
Fatma,F,100,647,0,647
Geoffry,M,100,0,647,647
Igor,M,100,0,647,647
Jalesa,F,100,647,0,647
Juliano,M,100,0,647,647
Kassia,F,100,647,0,647
Rebeckah,F,100,647,0,647
Richy,M,100,0,647,647
Rut,F,100,647,0,647
Sheli,F,100,647,0,647
Tiani,F,100,647,0,647
Denasia,F,100,646,0,646
Derrin,M,100,0,646,646
Maire,F,100,646,0,646
Teofilo,M,100,0,646,646
Valdemar,M,100,0,646,646
Yassin,M,98,13,633,646
Chany,F,100,645,0,645
Darlin,F,94,608,37,645
Eshaan,M,100,0,645,645
Kenta,M,99,5,640,645
Latishia,F,100,645,0,645
Martino,M,100,0,645,645
Rasean,M,100,0,645,645
Sharise,F,100,645,0,645
Shylo,F,84,544,101,645
Charlynn,F,100,644,0,644
Charnell,F,100,644,0,644
Darling,F,100,644,0,644
Jaelah,F,100,644,0,644
Kenn,M,100,0,644,644
Kentavious,M,100,0,644,644
Persia,F,100,644,0,644
Reatha,F,100,644,0,644
Riann,F,100,644,0,644
Izac,M,100,0,643,643
Lynley,F,100,643,0,643
Reef,M,98,12,631,643
Sheria,F,100,643,0,643
Tamieka,F,100,643,0,643
Tempestt,F,100,643,0,643
Vaishnavi,F,100,643,0,643
Zamiyah,F,100,643,0,643
Angelise,F,100,642,0,642
Eesha,F,100,642,0,642
Gery,M,100,0,642,642
Johnae,F,100,642,0,642
Kapri,F,98,632,10,642
Kassey,F,99,637,5,642
Kyleah,F,100,642,0,642
Nirvana,F,100,642,0,642
Zully,F,100,642,0,642
Brooklyne,F,100,641,0,641
Dacoda,M,82,116,525,641
Dayon,M,98,11,630,641
Enriqueta,F,100,641,0,641
Esta,F,100,641,0,641
Gerilyn,F,100,641,0,641
Hisham,M,100,0,641,641
Jesusita,F,100,641,0,641
Laniah,F,100,641,0,641
Makel,M,93,48,593,641
Pamila,F,100,641,0,641
Reesa,F,100,641,0,641
Reuven,M,100,0,641,641
Sharrie,F,100,641,0,641
Tajuan,M,99,7,634,641
Akemi,F,99,635,5,640
Berenise,F,100,640,0,640
Christobal,M,100,0,640,640
Deshawna,F,100,640,0,640
Ellyse,F,100,640,0,640
Eran,M,86,87,553,640
Indra,F,96,615,25,640
Jamileth,F,100,640,0,640
Kelyn,F,60,384,256,640
Regino,M,100,0,640,640
Sarkis,M,100,0,640,640
Shaheem,M,100,0,640,640
Takeya,F,100,640,0,640
Taveon,M,100,0,640,640
Terrah,F,100,640,0,640
Westly,M,100,0,640,640
Yanelly,F,100,640,0,640
Aadhya,F,100,639,0,639
Aleesa,F,100,639,0,639
Anglia,F,100,639,0,639
Ayda,F,100,639,0,639
Denelle,F,99,633,6,639
Derica,F,100,639,0,639
Geovanna,F,100,639,0,639
Jeanell,F,100,639,0,639
Jennipher,F,100,639,0,639
Linzie,F,85,545,94,639
Marit,F,100,639,0,639
Ruel,M,100,0,639,639
Shalimar,F,99,634,5,639
Tevita,M,100,0,639,639
Azlynn,F,100,638,0,638
Balinda,F,100,638,0,638
Brantly,M,99,5,633,638
Giancarlos,M,100,0,638,638
Nathanel,M,100,0,638,638
Shadonna,F,100,638,0,638
Telia,F,100,638,0,638
Tykeria,F,100,638,0,638
Zuleima,F,100,638,0,638
Aili,F,100,637,0,637
Bohdan,M,100,0,637,637
Bralyn,M,61,251,386,637
Breckyn,F,79,505,132,637
Chardonnay,F,100,637,0,637
Jehu,M,100,0,637,637
Jenavieve,F,100,637,0,637
Kea,F,100,637,0,637
Nataya,F,100,637,0,637
Rasha,F,94,600,37,637
Talha,M,100,0,637,637
Terika,F,100,637,0,637
Adham,M,100,0,636,636
Benuel,M,100,0,636,636
Cainan,M,100,0,636,636
Cammi,F,100,636,0,636
Gionna,F,100,636,0,636
Jamilyn,F,100,636,0,636
Jeramey,M,100,0,636,636
Kaelie,F,100,636,0,636
Kamyah,F,100,636,0,636
Reanne,F,100,636,0,636
Abhiram,M,100,0,635,635
Armonie,F,74,472,163,635
Corinn,F,100,635,0,635
Demarko,M,100,0,635,635
Emarie,F,100,635,0,635
Kirin,F,55,351,284,635
Lakiya,F,100,635,0,635
Marquavious,M,100,0,635,635
Mirabella,F,100,635,0,635
Mylene,F,100,635,0,635
Shatia,F,100,635,0,635
Zahid,M,100,0,635,635
Andrina,F,100,634,0,634
Beautiful,F,100,634,0,634
Breaunna,F,100,634,0,634
Jeneva,F,100,634,0,634
Luzmaria,F,100,634,0,634
Montoya,F,82,520,114,634
Omid,M,100,0,634,634
Alauna,F,100,633,0,633
Arav,M,100,0,633,633
Cristel,F,100,633,0,633
Daviana,F,100,633,0,633
Elyza,F,100,633,0,633
Hanif,M,100,0,633,633
Jennalee,F,100,633,0,633
Keyshaun,M,100,0,633,633
Khara,F,100,633,0,633
Kourtnee,F,100,633,0,633
Maurissa,F,100,633,0,633
Micael,M,100,0,633,633
Mickenzie,F,93,589,44,633
Prisilla,F,100,633,0,633
Trenna,F,100,633,0,633
Undra,M,88,75,558,633
Ahlam,F,100,632,0,632
Ambre,F,100,632,0,632
Annisa,F,100,632,0,632
Corryn,F,100,632,0,632
Damiya,F,100,632,0,632
Elspeth,F,100,632,0,632
Jalicia,F,100,632,0,632
Jaspreet,F,60,380,252,632
Marguerita,F,100,632,0,632
Tajh,M,100,0,632,632
Tawnia,F,100,632,0,632
Teja,F,88,559,73,632
Zayan,M,100,0,632,632
Adrion,M,100,0,631,631
Barclay,M,96,24,607,631
Bethaney,F,100,631,0,631
Donovon,M,100,0,631,631
Katee,F,100,631,0,631
Kevonte,M,100,0,631,631
Komal,F,100,631,0,631
Naythan,M,100,0,631,631
Shiree,F,100,631,0,631
Sonda,F,100,631,0,631
Albaro,M,100,0,630,630
Jantzen,M,98,14,616,630
Jezreel,M,76,152,478,630
Nyasha,F,100,630,0,630
Shantrell,F,98,620,10,630
Tafari,M,100,0,630,630
Yul,M,100,0,630,630
Alexy,F,55,345,284,629
Anecia,F,100,629,0,629
Constantinos,M,100,0,629,629
Hong,F,72,450,179,629
Jaleigh,F,100,629,0,629
Kani,M,75,159,470,629
Lakecia,F,100,629,0,629
Laketa,F,100,629,0,629
Leiana,F,100,629,0,629
Makalah,F,100,629,0,629
Nyia,F,99,624,5,629
Odie,M,93,43,586,629
Prentis,M,100,0,629,629
Robet,M,100,0,629,629
Romelo,M,100,0,629,629
Shakeema,F,100,629,0,629
Shaliyah,F,100,629,0,629
Sheela,F,100,629,0,629
Adrielle,F,100,628,0,628
Amil,M,63,230,398,628
Darshan,M,98,11,617,628
Jacquiline,F,100,628,0,628
Lakeith,M,100,0,628,628
Rayla,F,100,628,0,628
Rechelle,F,100,628,0,628
Tatia,F,100,628,0,628
Teyana,F,100,628,0,628
Tyna,F,100,628,0,628
Annalicia,F,100,627,0,627
Antonyo,M,100,0,627,627
Chancy,M,67,204,423,627
Daman,M,100,0,627,627
Dewan,M,97,16,611,627
Haddie,F,100,627,0,627
Infinity,F,100,627,0,627
Jayln,M,64,226,401,627
Josedejesus,M,100,0,627,627
Koltyn,M,99,5,622,627
Nakai,M,79,130,497,627
Paizley,F,100,627,0,627
Sarra,F,100,627,0,627
Shakima,F,100,627,0,627
Toma,M,75,158,469,627
Vallery,F,100,627,0,627
Abrar,F,53,330,296,626
Anmol,M,56,276,350,626
Arwa,F,100,626,0,626
Bradd,M,100,0,626,626
Brittain,M,57,272,354,626
Daijon,M,99,5,621,626
Demya,F,100,626,0,626
Elease,F,100,626,0,626
Hillery,F,78,490,136,626
Keionna,F,100,626,0,626
Kendrea,F,100,626,0,626
Mychelle,F,100,626,0,626
Pang,F,98,615,11,626
Tauna,F,100,626,0,626
Bayan,F,85,533,92,625
Emmalie,F,100,625,0,625
Hien,F,52,327,298,625
Lakshmi,F,100,625,0,625
Leea,F,100,625,0,625
Magdaleno,M,100,0,625,625
Maryhelen,F,100,625,0,625
Pippa,F,100,625,0,625
Raymone,M,100,0,625,625
Viraj,M,100,0,625,625
Zendaya,F,100,625,0,625
Alaynah,F,100,624,0,624
Damiyah,F,100,624,0,624
Emaline,F,100,624,0,624
Gianmarco,M,100,0,624,624
Jamyia,F,100,624,0,624
Javar,M,100,0,624,624
Joelyn,F,100,624,0,624
Kipton,M,100,0,624,624
Landri,F,100,624,0,624
Loida,F,100,624,0,624
Noell,F,91,566,58,624
Shenell,F,100,624,0,624
Tresha,F,100,624,0,624
Tykia,F,100,624,0,624
Alexandar,M,100,0,623,623
Ayvah,F,100,623,0,623
Cadin,M,97,16,607,623
Cezar,M,100,0,623,623
Jodeci,F,52,327,296,623
Shaurya,M,100,0,623,623
Sheana,F,100,623,0,623
Sheril,F,100,623,0,623
Tamy,F,100,623,0,623
Tyrrell,M,100,0,623,623
Alyssandra,F,100,622,0,622
Auria,F,100,622,0,622
Ave,F,100,622,0,622
Habib,M,100,0,622,622
Jolette,F,100,622,0,622
Jonica,F,100,622,0,622
Kalub,M,100,0,622,622
Koreen,F,100,622,0,622
Lemont,M,100,0,622,622
Mabry,F,94,586,36,622
Matea,F,100,622,0,622
Shaindel,F,100,622,0,622
Talesha,F,100,622,0,622
Tiphanie,F,100,622,0,622
Webb,M,100,0,622,622
Adonai,M,77,144,477,621
Ameya,F,71,438,183,621
Andrian,M,85,96,525,621
Charmin,F,100,621,0,621
Finlay,M,83,103,518,621
Isayah,M,100,0,621,621
Kieron,M,100,0,621,621
Kriste,F,100,621,0,621
Lyndsy,F,100,621,0,621
Malisha,F,100,621,0,621
Miroslava,F,100,621,0,621
Sharisse,F,100,621,0,621
Sylus,M,100,0,621,621
Tyreece,M,100,0,621,621
Christipher,M,100,0,620,620
Colston,M,100,0,620,620
Hally,F,100,620,0,620
Ivett,F,100,620,0,620
Jeremia,M,98,10,610,620
Kammi,F,100,620,0,620
Kasim,M,100,0,620,620
Khloie,F,100,620,0,620
Krew,M,100,0,620,620
Lejla,F,100,620,0,620
Malanie,F,100,620,0,620
Rema,F,100,620,0,620
Riyan,M,51,304,316,620
Sury,F,100,620,0,620
Tramell,M,100,0,620,620
Tywanna,F,100,620,0,620
Vicent,M,100,0,620,620
Xaviera,F,100,620,0,620
Arnel,M,96,22,597,619
Bear,M,100,0,619,619
Elanor,F,100,619,0,619
Jonel,M,51,301,318,619
Kimari,F,64,399,220,619
Nazario,M,100,0,619,619
Seymour,M,100,0,619,619
Tyrah,F,100,619,0,619
Chevon,F,90,555,63,618
Eniyah,F,100,618,0,618
Giuseppina,F,100,618,0,618
Islam,M,79,128,490,618
Juel,M,68,200,418,618
Larrie,M,66,210,408,618
Maribelle,F,100,618,0,618
Nnamdi,M,100,0,618,618
Richa,F,100,618,0,618
Robinette,F,100,618,0,618
Samarth,M,100,0,618,618
Sindi,F,100,618,0,618
Ved,M,100,0,618,618
Blenda,F,100,617,0,617
Cortnee,F,100,617,0,617
Dallan,M,100,0,617,617
Ginnie,F,100,617,0,617
Jaelon,M,100,0,617,617
Joane,F,100,617,0,617
Josalynn,F,100,617,0,617
Julious,M,100,0,617,617
Koltin,M,100,0,617,617
Lateefah,F,100,617,0,617
Patrik,M,100,0,617,617
Rahmel,M,100,0,617,617
Shadrach,M,100,0,617,617
Terilyn,F,100,617,0,617
Analeah,F,100,616,0,616
Annessa,F,100,616,0,616
Aquilla,F,95,588,28,616
Bea,F,100,616,0,616
Francia,F,100,616,0,616
Hortensia,F,100,616,0,616
Kalila,F,100,616,0,616
Kenzy,F,95,584,32,616
Laneisha,F,100,616,0,616
Prestin,M,100,0,616,616
Rhyder,M,93,45,571,616
Seren,F,97,596,20,616
Any,F,100,615,0,615
Caius,M,100,0,615,615
Daelynn,F,97,594,21,615
Demetre,M,98,12,603,615
Hadiya,F,100,615,0,615
Hani,M,90,61,554,615
Kileigh,F,100,615,0,615
Makensie,F,100,615,0,615
Mikhael,M,99,8,607,615
Shelsea,F,100,615,0,615
Atley,M,51,298,316,614
Charlean,F,100,614,0,614
Cobi,M,76,148,466,614
Crystina,F,100,614,0,614
Decarlo,M,100,0,614,614
Eyad,M,100,0,614,614
Kwasi,M,100,0,614,614
Lyndia,F,100,614,0,614
Margarete,F,100,614,0,614
Nickalas,M,100,0,614,614
Rayah,F,100,614,0,614
Tondra,F,100,614,0,614
Zamira,F,100,614,0,614
Aesha,F,100,613,0,613
Amel,F,52,317,296,613
Angila,F,100,613,0,613
Arisa,F,100,613,0,613
Artur,M,100,0,613,613
Ayomide,M,59,249,364,613
Bridgitte,F,100,613,0,613
Brinton,M,100,0,613,613
Daivon,M,100,0,613,613
Haydin,M,62,236,377,613
Jamarie,M,86,87,526,613
Mahir,M,100,0,613,613
Mireille,F,100,613,0,613
Nitin,M,100,0,613,613
Pheonix,M,57,262,351,613
Renne,F,90,552,61,613
Sharda,F,100,613,0,613
Starlyn,F,100,613,0,613
Tyneisha,F,100,613,0,613
Anndrea,F,100,612,0,612
Brileigh,F,100,612,0,612
Cutler,M,100,0,612,612
Dene,F,82,501,111,612
Elesha,F,100,612,0,612
Jakelin,F,100,612,0,612
Joclyn,F,100,612,0,612
Kallee,F,100,612,0,612
Maysa,F,100,612,0,612
Modesta,F,100,612,0,612
Shiva,M,59,249,363,612
Verlene,F,100,612,0,612
Zan,M,85,94,518,612
Amiri,M,82,110,501,611
Callee,F,100,611,0,611
Drevon,M,100,0,611,611
Jasmen,F,98,600,11,611
Kellin,M,86,83,528,611
Lander,M,100,0,611,611
Maleena,F,100,611,0,611
Tri,M,100,0,611,611
Yuvraj,M,100,0,611,611
Antoniette,F,100,610,0,610
Areanna,F,100,610,0,610
Ayelet,F,100,610,0,610
Billye,F,98,599,11,610
Carolynne,F,100,610,0,610
Chuckie,M,100,0,610,610
Cobey,M,100,0,610,610
Diontae,M,100,0,610,610
Therman,M,100,0,610,610
Ailey,F,100,609,0,609
Akili,M,63,225,384,609
Aleck,M,100,0,609,609
Aliviah,F,100,609,0,609
Chayanne,M,63,223,386,609
Deveon,M,100,0,609,609
Eastyn,M,60,245,364,609
Jerelyn,F,100,609,0,609
Jessilyn,F,100,609,0,609
Kagan,M,89,68,541,609
Kainen,M,100,0,609,609
Melanny,F,100,609,0,609
Samaira,F,100,609,0,609
Shaunice,F,100,609,0,609
Suann,F,100,609,0,609
Tilly,F,100,609,0,609
Alexxa,F,100,608,0,608
Bayla,F,100,608,0,608
Kesley,F,90,546,62,608
Min,M,62,233,375,608
Porshia,F,100,608,0,608
Timara,F,100,608,0,608
Yailin,F,100,608,0,608
Adryanna,F,100,607,0,607
Alisyn,F,100,607,0,607
Calee,F,100,607,0,607
Gabryella,F,100,607,0,607
Joah,M,100,0,607,607
Jordanne,F,100,607,0,607
Jossue,M,100,0,607,607
Layah,F,100,607,0,607
Lissett,F,100,607,0,607
Maddilyn,F,100,607,0,607
Maxon,M,100,0,607,607
Maygan,F,100,607,0,607
Merita,F,100,607,0,607
Natoya,F,100,607,0,607
Reagen,F,88,536,71,607
Samy,M,99,5,602,607
Tanita,F,100,607,0,607
Thom,M,100,0,607,607
Tiya,F,100,607,0,607
Tyresha,F,100,607,0,607
Adon,M,100,0,606,606
Albertina,F,100,606,0,606
Briah,F,100,606,0,606
Chaniya,F,100,606,0,606
Cicily,F,100,606,0,606
Donnis,F,57,347,259,606
Isaiha,M,100,0,606,606
Kaileb,M,100,0,606,606
Kindall,F,93,561,45,606
Kloee,F,100,606,0,606
Maliq,M,100,0,606,606
Morrigan,F,100,606,0,606
Nahshon,M,100,0,606,606
Shamica,F,100,606,0,606
Sujey,F,100,606,0,606
Tanasha,F,100,606,0,606
Taras,M,100,0,606,606
Trecia,F,100,606,0,606
Yumi,F,100,606,0,606
Zeina,F,100,606,0,606
Asley,F,100,605,0,605
Emre,M,100,0,605,605
Joeann,F,100,605,0,605
Kymora,F,100,605,0,605
Latasia,F,100,605,0,605
Lleyton,M,100,0,605,605
Nahom,M,100,0,605,605
Phillipe,M,100,0,605,605
Taniqua,F,100,605,0,605
Allysia,F,100,604,0,604
Bradi,F,100,604,0,604
Deatrice,F,100,604,0,604
Elliette,F,100,604,0,604
Eri,M,54,275,329,604
Genisis,F,100,604,0,604
Kambrie,F,100,604,0,604
Khristine,F,100,604,0,604
Olando,M,100,0,604,604
Quantez,M,100,0,604,604
Raynette,F,100,604,0,604
Shayleigh,F,100,604,0,604
Aidin,M,98,12,591,603
Alyssah,F,100,603,0,603
Ashanta,F,99,597,6,603
Dalana,F,100,603,0,603
Kajuan,M,100,0,603,603
Kamerin,M,65,210,393,603
Kimerly,F,100,603,0,603
Leanora,F,100,603,0,603
Mariea,F,100,603,0,603
Marylouise,F,100,603,0,603
Melenie,F,100,603,0,603
Najae,F,86,521,82,603
Raychelle,F,100,603,0,603
Romulo,M,100,0,603,603
Charyl,F,100,602,0,602
Chevonne,F,100,602,0,602
Danyal,M,71,176,426,602
Everest,M,93,43,559,602
Isley,F,76,457,145,602
Jakson,M,100,0,602,602
Quint,M,100,0,602,602
Revonda,F,100,602,0,602
Shequita,F,100,602,0,602
Tandi,F,100,602,0,602
Xochil,F,100,602,0,602
Allister,M,99,6,595,601
Annice,F,100,601,0,601
Antwanette,F,100,601,0,601
Bushra,F,100,601,0,601
Catlyn,F,100,601,0,601
Ellise,F,100,601,0,601
Jaythan,M,100,0,601,601
Kal,M,100,0,601,601
Kion,M,100,0,601,601
Lessly,F,100,601,0,601
Lizzet,F,100,601,0,601
Loris,F,87,525,76,601
Mylo,M,94,35,566,601
Ronelle,F,89,532,69,601
Roney,M,100,0,601,601
Samanatha,F,100,601,0,601
Sidnee,F,100,601,0,601
Sunita,F,100,601,0,601
Ceanna,F,100,600,0,600
Genea,F,100,600,0,600
Gwendolen,F,100,600,0,600
Keita,M,68,189,411,600
Kennisha,F,100,600,0,600
Roshell,F,98,588,12,600
Sabin,M,99,6,594,600
Secret,F,100,600,0,600
Sequoyah,F,72,435,165,600
Shahid,M,100,0,600,600
Truth,M,60,242,358,600
Viviane,F,100,600,0,600
Abrahm,M,100,0,599,599
Aleecia,F,100,599,0,599
Debborah,F,100,599,0,599
Ender,M,100,0,599,599
Gehrig,M,100,0,599,599
Kasyn,M,80,118,481,599
Lashan,F,85,512,87,599
Makynzie,F,100,599,0,599
Malasia,F,100,599,0,599
Marlynn,F,100,599,0,599
Quintez,M,100,0,599,599
Rifka,F,100,599,0,599
Sama,F,100,599,0,599
Sharnell,F,100,599,0,599
Shem,M,99,5,594,599
Yamila,F,100,599,0,599
Ajia,F,100,598,0,598
Philemon,M,100,0,598,598
Trevell,M,100,0,598,598
Zacheriah,M,100,0,598,598
Aristeo,M,100,0,597,597
Brittiny,F,100,597,0,597
Fabien,M,100,0,597,597
Haylen,F,83,494,103,597
Hollyann,F,100,597,0,597
Jaziyah,F,98,587,10,597
Keia,F,100,597,0,597
Lonell,M,100,0,597,597
Rodman,M,100,0,597,597
Saja,F,100,597,0,597
Valrie,F,100,597,0,597
Whitnee,F,100,597,0,597
Daric,M,100,0,596,596
Dietra,F,100,596,0,596
Kashia,F,100,596,0,596
Kiante,M,69,182,414,596
Leeana,F,100,596,0,596
Mahnoor,F,100,596,0,596
Tiffanee,F,100,596,0,596
Verlon,M,96,22,574,596
Disha,F,100,595,0,595
Dreshawn,M,100,0,595,595
Gerad,M,100,0,595,595
Jezebel,F,100,595,0,595
Symantha,F,100,595,0,595
Arrington,M,72,168,426,594
Bianey,F,100,594,0,594
Chucky,M,100,0,594,594
Demontae,M,100,0,594,594
Emylee,F,100,594,0,594
Hari,M,100,0,594,594
Shandell,F,89,526,68,594
Son,M,99,5,589,594
Starlette,F,100,594,0,594
Yovany,M,100,0,594,594
Alayjah,F,100,593,0,593
Andreia,F,100,593,0,593
Delorise,F,100,593,0,593
Harlin,M,96,23,570,593
Harsh,M,100,0,593,593
Jerrika,F,100,593,0,593
Jillene,F,100,593,0,593
Maple,F,100,593,0,593
Ronn,M,100,0,593,593
Taiya,F,100,593,0,593
Zoi,F,100,593,0,593
Aalayah,F,100,592,0,592
Doron,M,100,0,592,592
Jaivon,M,100,0,592,592
Joab,M,100,0,592,592
Kamira,F,100,592,0,592
Mala,F,100,592,0,592
Nephi,M,100,0,592,592
Rhema,F,100,592,0,592
Zoei,F,100,592,0,592
Alynna,F,100,591,0,591
Charlisa,F,100,591,0,591
Consuella,F,100,591,0,591
Dayvion,M,100,0,591,591
Demitra,F,100,591,0,591
Giovannie,M,99,6,585,591
Kennadie,F,100,591,0,591
Moise,M,100,0,591,591
Nadeem,M,100,0,591,591
Railey,F,92,543,48,591
Saadia,F,100,591,0,591
Sonal,F,100,591,0,591
Starlett,F,100,591,0,591
Aalyah,F,100,590,0,590
Aissa,F,100,590,0,590
Alainna,F,100,590,0,590
Alaiyah,F,100,590,0,590
Alejo,M,100,0,590,590
Diara,F,100,590,0,590
Elektra,F,100,590,0,590
Ellah,F,100,590,0,590
Gerren,M,94,38,552,590
Marleni,F,100,590,0,590
Onika,F,100,590,0,590
Aarushi,F,100,589,0,589
Alara,F,100,589,0,589
Connar,M,95,31,558,589
Coraima,F,100,589,0,589
Dotty,F,100,589,0,589
Fares,M,100,0,589,589
Ikea,F,98,580,9,589
Jaxyn,M,75,146,443,589
Karalynn,F,100,589,0,589
Macen,M,99,5,584,589
Peder,M,100,0,589,589
Raechelle,F,100,589,0,589
Roshunda,F,100,589,0,589
Sameera,F,100,589,0,589
Sebastiano,M,100,0,589,589
Shada,F,100,589,0,589
Vanya,F,100,589,0,589
Adamary,F,100,588,0,588
Ayala,F,100,588,0,588
Dulcie,F,100,588,0,588
Greenlee,F,100,588,0,588
Iridian,F,99,581,7,588
Lelani,F,100,588,0,588
Naiomi,F,100,588,0,588
Ruston,M,100,0,588,588
Sabreena,F,100,588,0,588
Sagan,M,56,257,331,588
Terrelle,M,94,34,554,588
Tunisia,F,100,588,0,588
Antawn,M,100,0,587,587
Arif,M,100,0,587,587
Atlanta,F,100,587,0,587
Avamarie,F,100,587,0,587
Beata,F,100,587,0,587
Bren,M,78,130,457,587
Colden,M,100,0,587,587
Darlean,F,100,587,0,587
Elishia,F,100,587,0,587
Fortino,M,100,0,587,587
Gershon,M,100,0,587,587
Gracin,M,67,196,391,587
Jamaar,M,100,0,587,587
Jamen,M,100,0,587,587
Liora,F,100,587,0,587
Lyndie,F,100,587,0,587
Sharayah,F,100,587,0,587
Willetta,F,100,587,0,587
Amberley,F,100,586,0,586
Annalie,F,100,586,0,586
Dallon,M,100,0,586,586
Danay,F,100,586,0,586
Keevin,M,100,0,586,586
Lilliam,F,100,586,0,586
Lutricia,F,100,586,0,586
Marianela,F,100,586,0,586
Misa,F,100,586,0,586
Nicanor,M,100,0,586,586
Shaheen,M,76,142,444,586
Tatanisha,F,100,586,0,586
Taylyn,F,98,575,11,586
Barbi,F,100,585,0,585
Carlynn,F,100,585,0,585
Chrystina,F,100,585,0,585
Cuyler,M,98,10,575,585
Durwin,M,100,0,585,585
Enrigue,M,100,0,585,585
Giuliano,M,100,0,585,585
Jeromie,M,100,0,585,585
Mairin,F,100,585,0,585
Makana,M,61,230,355,585
Reynard,M,100,0,585,585
Avory,F,57,335,249,584
Calan,M,97,20,564,584
Daena,F,100,584,0,584
Jakhi,M,100,0,584,584
Jerin,M,91,54,530,584
Laycee,F,100,584,0,584
Manav,M,100,0,584,584
Michelene,F,100,584,0,584
Odilia,F,100,584,0,584
Ranisha,F,100,584,0,584
Silva,F,100,584,0,584
Willene,F,100,584,0,584
Aneisha,F,100,583,0,583
Avan,M,92,48,535,583
Charlotta,F,100,583,0,583
Dacey,F,100,583,0,583
Darnella,F,100,583,0,583
Gaines,M,100,0,583,583
Hadeel,F,100,583,0,583
Harman,M,90,58,525,583
Iyla,F,100,583,0,583
Jaylinn,F,95,555,28,583
Lisseth,F,100,583,0,583
Maki,M,70,172,411,583
Pari,F,100,583,0,583
Ramin,M,100,0,583,583
Samyah,F,100,583,0,583
Tammra,F,100,583,0,583
Timothey,M,100,0,583,583
Tywana,F,100,583,0,583
Woodie,M,97,16,567,583
Daran,M,99,5,577,582
Jihan,F,92,536,46,582
Kameren,M,86,83,499,582
Karole,F,100,582,0,582
Lilianne,F,100,582,0,582
Lisaann,F,100,582,0,582
Maram,F,100,582,0,582
Marelyn,F,100,582,0,582
Natanya,F,100,582,0,582
Rozalyn,F,100,582,0,582
Sameul,M,100,0,582,582
Suzzette,F,100,582,0,582
Tan,M,98,11,571,582
Teria,F,100,582,0,582
Yen,F,93,540,42,582
Zamaria,F,100,582,0,582
Angell,F,78,453,128,581
Havyn,F,93,538,43,581
Howie,M,100,0,581,581
Lanise,F,100,581,0,581
Maresa,F,100,581,0,581
Margaretta,F,100,581,0,581
Suzzanne,F,100,581,0,581
Tyris,M,100,0,581,581
Akari,F,71,414,166,580
Aleece,F,100,580,0,580
Bobi,F,100,580,0,580
Ericca,F,100,580,0,580
Hai,M,96,21,559,580
Jesi,F,93,542,38,580
Khaleb,M,100,0,580,580
Leala,F,100,580,0,580
Mayleen,F,100,580,0,580
Arnett,M,92,48,531,579
Brette,F,98,568,11,579
Ciji,F,100,579,0,579
Davonne,M,66,198,381,579
Janica,F,100,579,0,579
Janielle,F,100,579,0,579
Kalman,M,100,0,579,579
Kanoa,M,100,0,579,579
Lamesha,F,100,579,0,579
Larena,F,100,579,0,579
Michon,F,95,550,29,579
Park,M,100,0,579,579
Peggi,F,100,579,0,579
Taevon,M,100,0,579,579
Adaya,F,100,578,0,578
Andrue,M,100,0,578,578
Geordan,M,90,55,523,578
Huong,F,100,578,0,578
Jalal,M,100,0,578,578
Kamyra,F,100,578,0,578
Luiza,F,100,578,0,578
Marchell,F,100,578,0,578
Valli,F,100,578,0,578
Aissatou,F,100,577,0,577
Aviel,M,97,19,558,577
Azeneth,F,100,577,0,577
Brystol,F,98,563,14,577
Chani,F,100,577,0,577
Cobe,M,100,0,577,577
Danne,F,78,450,127,577
Gayland,M,100,0,577,577
Jermell,M,100,0,577,577
Matan,M,100,0,577,577
Micole,F,100,577,0,577
Salvadore,M,100,0,577,577
Seanmichael,M,100,0,577,577
Shontay,F,98,567,10,577
Yechezkel,M,100,0,577,577
Cecila,F,100,576,0,576
Dadrian,M,100,0,576,576
Finnigan,M,100,0,576,576
Hina,F,100,576,0,576
Jariyah,F,98,566,10,576
Kaytie,F,100,576,0,576
Kyera,F,100,576,0,576
Ma,F,100,576,0,576
Mercades,F,100,576,0,576
Philbert,M,100,0,576,576
Rondi,F,99,569,7,576
Rudra,M,98,11,565,576
Shyenne,F,100,576,0,576
Yatziri,F,100,576,0,576
Allante,M,77,131,444,575
Cillian,M,100,0,575,575
Elonda,F,100,575,0,575
Jaeger,M,100,0,575,575
Journei,F,100,575,0,575
Kameran,M,68,186,389,575
Nikiya,F,100,575,0,575
Petros,M,100,0,575,575
Rosiland,F,100,575,0,575
Sydnei,F,100,575,0,575
Tayson,M,100,0,575,575
Zoha,F,100,575,0,575
Aryssa,F,100,574,0,574
Aseel,F,90,517,57,574
Chaundra,F,100,574,0,574
Ciani,F,100,574,0,574
Collis,M,100,0,574,574
Eunique,F,98,564,10,574
Gautam,M,100,0,574,574
Jossie,F,97,557,17,574
Jowell,M,99,5,569,574
Kymberli,F,100,574,0,574
Pascale,F,100,574,0,574
Saran,F,97,555,19,574
Shalana,F,100,574,0,574
Tilden,M,97,15,559,574
Tomica,F,100,574,0,574
Tyneshia,F,100,574,0,574
Viva,F,100,574,0,574
Analyse,F,100,573,0,573
Ashna,F,100,573,0,573
Ceirra,F,100,573,0,573
Clemmie,M,57,247,326,573
Daine,M,50,285,288,573
Darnelle,M,61,223,350,573
Ellington,M,55,259,314,573
Jaccob,M,100,0,573,573
Kimbley,F,100,573,0,573
Kristalyn,F,100,573,0,573
Roneisha,F,100,573,0,573
Shilpa,F,100,573,0,573
Aneesha,F,100,572,0,572
Anjelina,F,100,572,0,572
Annica,F,100,572,0,572
Anniyah,F,100,572,0,572
Ayannah,F,100,572,0,572
Faithe,F,100,572,0,572
Froylan,M,100,0,572,572
Hansen,M,100,0,572,572
Heith,M,100,0,572,572
Indy,F,58,329,243,572
Kaileen,F,100,572,0,572
Karam,M,100,0,572,572
Keston,M,100,0,572,572
Leidy,F,100,572,0,572
Monya,F,100,572,0,572
Piero,M,100,0,572,572
Shelbee,F,100,572,0,572
Sherrel,F,99,565,7,572
Tresean,M,100,0,572,572
Yerik,M,100,0,572,572
Kadon,M,100,0,571,571
Kayliana,F,100,571,0,571
Keshun,M,99,7,564,571
Mariadejesus,F,100,571,0,571
Rendell,M,100,0,571,571
Sayde,F,100,571,0,571
Amariana,F,100,570,0,570
Andrik,M,100,0,570,570
Briasia,F,100,570,0,570
Cydni,F,100,570,0,570
Dajour,M,96,23,547,570
Ericson,M,100,0,570,570
Jennessa,F,100,570,0,570
Lamiya,F,100,570,0,570
Marland,M,100,0,570,570
Matti,F,92,523,47,570
Rihana,F,100,570,0,570
Shelle,F,100,570,0,570
Terrika,F,100,570,0,570
Aeron,M,89,60,509,569
Akila,F,100,569,0,569
Bernardine,F,100,569,0,569
Boy,M,100,0,569,569
Brandalyn,F,100,569,0,569
Clementina,F,100,569,0,569
Deisi,F,100,569,0,569
Keniya,F,100,569,0,569
Maurilio,M,100,0,569,569
Naji,M,100,0,569,569
Nakya,F,100,569,0,569
Rj,M,100,0,569,569
Ryo,M,100,0,569,569
Sharol,F,100,569,0,569
Tashika,F,100,569,0,569
Tawney,F,100,569,0,569
Terriana,F,100,569,0,569
Unnamed,M,57,243,326,569
Yanitza,F,100,569,0,569
Yonah,M,100,0,569,569
Alfie,M,87,76,492,568
Aryonna,F,100,568,0,568
Charde,F,100,568,0,568
Cletis,M,100,0,568,568
Criss,M,83,98,470,568
Dannon,M,84,92,476,568
Divinity,F,100,568,0,568
Georges,M,100,0,568,568
Jahmel,M,100,0,568,568
Jakeline,F,100,568,0,568
Kaito,M,100,0,568,568
Lavenia,F,100,568,0,568
Lorren,F,70,398,170,568
Meka,F,100,568,0,568
Meng,M,98,13,555,568
Reginae,F,100,568,0,568
Zaidyn,M,96,24,544,568
Carmyn,F,100,567,0,567
Carola,F,100,567,0,567
Colvin,M,100,0,567,567
Dantrell,M,100,0,567,567
Denilson,M,100,0,567,567
Dillian,M,100,0,567,567
Emad,M,100,0,567,567
Fionna,F,100,567,0,567
Jalea,F,100,567,0,567
Kyri,F,63,358,209,567
Latrelle,F,59,332,235,567
Letticia,F,100,567,0,567
Mynor,M,100,0,567,567
Najma,F,100,567,0,567
Tonyia,F,100,567,0,567
Alajah,F,100,566,0,566
Alexsa,F,100,566,0,566
Avrey,F,54,308,258,566
Binyamin,M,100,0,566,566
Casimiro,M,100,0,566,566
Elwyn,M,98,10,556,566
Jeremih,M,100,0,566,566
Juandiego,M,100,0,566,566
Kisa,F,100,566,0,566
Kwabena,M,100,0,566,566
Luqman,M,100,0,566,566
Naaman,M,100,0,566,566
Olajuwon,M,100,0,566,566
Sherrita,F,100,566,0,566
Sofiya,F,100,566,0,566
Bradie,F,77,436,129,565
Brelynn,F,99,560,5,565
Duan,M,100,0,565,565
Haziel,M,99,5,560,565
Joani,F,100,565,0,565
Lei,F,96,540,25,565
Marylu,F,100,565,0,565
Mazzy,F,100,565,0,565
Natavia,F,100,565,0,565
Nyles,M,100,0,565,565
Paisleigh,F,100,565,0,565
Shariff,M,100,0,565,565
Terena,F,100,565,0,565
Toyia,F,100,565,0,565
Tynia,F,100,565,0,565
Aarion,M,76,133,431,564
Albany,F,100,564,0,564
Aralyn,F,100,564,0,564
Ayiana,F,100,564,0,564
Burley,M,100,0,564,564
Halston,M,81,108,456,564
Janan,F,98,554,10,564
Jerrald,M,100,0,564,564
Joleigh,F,100,564,0,564
Kaiyah,F,100,564,0,564
Kania,F,100,564,0,564
Lior,M,66,194,370,564
Meighan,F,100,564,0,564
Sativa,F,100,564,0,564
Tinika,F,100,564,0,564
Yehudah,M,100,0,564,564
Anden,M,100,0,563,563
Anicia,F,100,563,0,563
Chanice,F,100,563,0,563
Jerame,M,100,0,563,563
Keniyah,F,100,563,0,563
Klinton,M,100,0,563,563
Michaelyn,F,100,563,0,563
Sharion,F,100,563,0,563
Tanishia,F,100,563,0,563
Tashauna,F,100,563,0,563
Tavish,M,99,5,558,563
Vinita,F,100,563,0,563
Adaleigh,F,100,562,0,562
Ayat,F,100,562,0,562
Daveion,M,100,0,562,562
Duron,M,100,0,562,562
Georgio,M,100,0,562,562
Jasmeen,F,100,562,0,562
Maguire,M,89,63,499,562
Naeemah,F,100,562,0,562
Nizhoni,F,100,562,0,562
Placido,M,100,0,562,562
Tally,F,85,480,82,562
Titiana,F,100,562,0,562
Ziyad,M,100,0,562,562
Chrysta,F,100,561,0,561
Demitria,F,100,561,0,561
Iveth,F,100,561,0,561
Kanya,F,96,536,25,561
Koree,F,61,344,217,561
Marck,M,100,0,561,561
Marshae,F,100,561,0,561
Shaylie,F,100,561,0,561
Tyon,M,100,0,561,561
Yoanna,F,100,561,0,561
Allura,F,100,560,0,560
Analiyah,F,100,560,0,560
Atalie,F,100,560,0,560
Claiborne,M,97,17,543,560
Danee,F,100,560,0,560
Diandre,M,97,15,545,560
Eshal,F,100,560,0,560
Kellyanne,F,100,560,0,560
Lauree,F,100,560,0,560
Londell,M,100,0,560,560
Margarite,F,100,560,0,560
Nishant,M,100,0,560,560
Renny,M,89,59,501,560
Sherod,M,100,0,560,560
Tomiko,F,99,553,7,560
Warrick,M,100,0,560,560
Alayshia,F,100,559,0,559
Amonte,M,100,0,559,559
Elpidio,M,100,0,559,559
Enedelia,F,100,559,0,559
Kallan,M,51,276,283,559
Kambri,F,100,559,0,559
Lakesia,F,100,559,0,559
Lenox,M,83,95,464,559
Mayci,F,100,559,0,559
Noura,F,100,559,0,559
Tremell,M,100,0,559,559
Waylen,M,100,0,559,559
Aadya,F,100,558,0,558
Alante,M,82,101,457,558
Aurianna,F,100,558,0,558
Brier,M,65,196,362,558
Danice,F,100,558,0,558
Gerrick,M,100,0,558,558
Jessicca,F,100,558,0,558
Kaleigha,F,100,558,0,558
Karinna,F,100,558,0,558
Lourie,F,100,558,0,558
Mailyn,F,100,558,0,558
Rayhan,M,100,0,558,558
Roisin,F,100,558,0,558
Rosia,F,100,558,0,558
Teneshia,F,100,558,0,558
Verlinda,F,100,558,0,558
Zymir,M,100,0,558,558
Antwann,M,100,0,557,557
Ceaira,F,100,557,0,557
Danzel,M,100,0,557,557
Denys,F,73,409,148,557
France,F,90,501,56,557
Izrael,M,100,0,557,557
Jayro,M,100,0,557,557
Kamrynn,F,97,538,19,557
Meriam,F,100,557,0,557
Praise,F,76,425,132,557
Rinda,F,100,557,0,557
Sephora,F,100,557,0,557
Abdoulaye,M,100,0,556,556
Azrael,M,81,106,450,556
Brissia,F,100,556,0,556
Earlean,F,100,556,0,556
Jaia,F,100,556,0,556
Johnney,M,100,0,556,556
Kamber,F,100,556,0,556
Kenedy,F,96,536,20,556
Kennetha,F,100,556,0,556
Manar,F,99,551,5,556
Marjean,F,100,556,0,556
Sadi,F,99,551,5,556
Severin,M,100,0,556,556
Shaquilla,F,94,520,36,556
Syler,M,97,18,538,556
Uchenna,M,67,185,371,556
Venetta,F,100,556,0,556
Darilyn,F,100,555,0,555
Emilyann,F,100,555,0,555
Faraz,M,100,0,555,555
Honora,F,100,555,0,555
Ishika,F,100,555,0,555
Kail,M,94,36,519,555
Kaylynne,F,100,555,0,555
Kimara,F,100,555,0,555
Kodee,F,50,279,276,555
Lunden,F,58,324,231,555
Marisabel,F,100,555,0,555
Merisa,F,100,555,0,555
Spiros,M,100,0,555,555
Steward,M,100,0,555,555
Belicia,F,100,554,0,554
Cuong,M,100,0,554,554
Davone,M,97,15,539,554
Delayne,F,92,509,45,554
Demia,F,100,554,0,554
Drea,F,100,554,0,554
Dshawn,M,100,0,554,554
Glyn,M,94,31,523,554
Glynnis,F,100,554,0,554
Hershell,M,100,0,554,554
Isyss,F,100,554,0,554
Sumayyah,F,100,554,0,554
Takyra,F,100,554,0,554
Awa,F,100,553,0,553
Breannah,F,100,553,0,553
Deepak,M,100,0,553,553
Khaliq,M,100,0,553,553
Leaha,F,100,553,0,553
Meghna,F,100,553,0,553
Shamiyah,F,100,553,0,553
Taye,M,92,43,510,553
Zavien,M,100,0,553,553
Chanler,M,72,155,397,552
Creston,M,100,0,552,552
Gissele,F,100,552,0,552
Jamarkus,M,100,0,552,552
Jostin,M,100,0,552,552
Linzi,F,100,552,0,552
Manley,M,100,0,552,552
Margherita,F,100,552,0,552
Ragen,F,97,537,15,552
Rahiem,M,100,0,552,552
Shawnie,F,100,552,0,552
Su,F,95,526,26,552
Ziya,F,98,542,10,552
Berit,F,100,551,0,551
Coda,M,88,67,484,551
Corde,M,99,5,546,551
Coulter,M,100,0,551,551
Cristela,F,100,551,0,551
Dinorah,F,100,551,0,551
Jaciel,M,99,5,546,551
Katera,F,100,551,0,551
Kawanna,F,100,551,0,551
Kei,M,71,161,390,551
Madalyne,F,100,551,0,551
Narda,F,100,551,0,551
Ziyon,M,83,91,460,551
Zvi,M,100,0,551,551
Anjela,F,100,550,0,550
Aurielle,F,100,550,0,550
Brianca,F,100,550,0,550
Dharma,F,99,543,7,550
Dre,M,100,0,550,550
Floretta,F,100,550,0,550
Gianina,F,100,550,0,550
Hart,M,99,7,543,550
Jozlynn,F,100,550,0,550
Mykael,M,77,126,424,550
Nuria,F,100,550,0,550
Oluwatobi,M,75,138,412,550
Vester,M,92,46,504,550
Alaijah,F,99,544,5,549
Amye,F,100,549,0,549
Auriana,F,100,549,0,549
Daizy,F,100,549,0,549
Davianna,F,100,549,0,549
Latresa,F,100,549,0,549
Leith,M,83,92,457,549
Mackie,M,83,94,455,549
Maddalena,F,100,549,0,549
Marlea,F,100,549,0,549
Nat,M,100,0,549,549
Naveed,M,100,0,549,549
Rosalin,F,100,549,0,549
Rui,M,97,15,534,549
Shaneika,F,100,549,0,549
Spirit,F,99,544,5,549
Timm,M,100,0,549,549
Winton,M,100,0,549,549
Aimie,F,100,548,0,548
Alexiss,F,96,528,20,548
Amaiyah,F,100,548,0,548
Catriona,F,100,548,0,548
Chukwuemeka,M,100,0,548,548
Diangelo,M,100,0,548,548
Duana,F,100,548,0,548
Grabiel,M,100,0,548,548
Henrry,M,100,0,548,548
Kedra,F,100,548,0,548
Khloey,F,100,548,0,548
Kortez,M,100,0,548,548
Marshelle,F,100,548,0,548
Maurizio,M,100,0,548,548
Powell,M,100,0,548,548
Shaylen,F,94,516,32,548
Soha,F,100,548,0,548
Wesson,M,100,0,548,548
Carrisa,F,100,547,0,547
Cassandre,F,100,547,0,547
Chinyere,F,100,547,0,547
Cloyd,M,100,0,547,547
Dyland,M,100,0,547,547
Gerrard,M,100,0,547,547
Halia,F,100,547,0,547
Homar,M,100,0,547,547
Javante,M,100,0,547,547
Noami,F,100,547,0,547
Tiauna,F,100,547,0,547
Toriana,F,99,542,5,547
Tywanda,F,100,547,0,547
Akim,M,100,0,546,546
Arihanna,F,100,546,0,546
Artez,M,100,0,546,546
Davyn,M,88,68,478,546
Dennison,M,100,0,546,546
Florentina,F,100,546,0,546
Genine,F,100,546,0,546
Huxley,M,92,43,503,546
Ikenna,M,100,0,546,546
Jhett,M,100,0,546,546
Maeson,M,72,155,391,546
Nakiah,F,100,546,0,546
Nassir,M,100,0,546,546
Quanita,F,100,546,0,546
Sapna,F,100,546,0,546
Serah,F,100,546,0,546
Shalia,F,100,546,0,546
Tacara,F,100,546,0,546
Torren,M,96,22,524,546
Alyn,F,68,373,172,545
Anistyn,F,100,545,0,545
Ariele,F,100,545,0,545
Ashle,F,100,545,0,545
Avaya,F,100,545,0,545
Cindra,F,100,545,0,545
Derrica,F,100,545,0,545
Fynn,M,93,37,508,545
Hersh,M,100,0,545,545
Jadynn,F,94,511,34,545
Joyanna,F,100,545,0,545
Karimah,F,100,545,0,545
Koi,M,66,188,357,545
Kyrell,M,100,0,545,545
Makennah,F,100,545,0,545
Norvell,M,100,0,545,545
Sylar,M,96,24,521,545
Trevonte,M,100,0,545,545
Arayah,F,100,544,0,544
Citlally,F,100,544,0,544
Delorse,F,100,544,0,544
Esgar,M,100,0,544,544
Gifford,M,100,0,544,544
Ilias,M,100,0,544,544
Irlanda,F,100,544,0,544
Janece,F,100,544,0,544
Jenaro,M,100,0,544,544
Kamarie,F,70,381,163,544
Kasidy,F,100,544,0,544
Katelyne,F,100,544,0,544
Kobey,M,100,0,544,544
Lamaya,F,100,544,0,544
Leotis,M,100,0,544,544
Peyten,F,78,424,120,544
Tamila,F,100,544,0,544
Aaiden,M,100,0,543,543
Aashna,F,100,543,0,543
Alban,M,100,0,543,543
Anyiah,F,100,543,0,543
Arushi,F,100,543,0,543
Arvind,M,100,0,543,543
Damiana,F,100,543,0,543
Karman,F,95,514,29,543
Khylee,F,100,543,0,543
Leondre,M,100,0,543,543
Mariette,F,100,543,0,543
Marysa,F,100,543,0,543
Mehgan,F,100,543,0,543
Mehmet,M,100,0,543,543
Mercer,M,85,81,462,543
Rosette,F,100,543,0,543
Royale,F,55,299,244,543
Shamiah,F,100,543,0,543
Sharrod,M,100,0,543,543
Yarelis,F,100,543,0,543
Abhay,M,100,0,542,542
Abigaile,F,100,542,0,542
Aleigh,F,100,542,0,542
Annsley,F,100,542,0,542
Azlyn,F,100,542,0,542
Bevan,M,88,66,476,542
Brenley,F,96,520,22,542
Chastidy,F,100,542,0,542
Coree,F,69,376,166,542
Dominika,F,100,542,0,542
Hale,M,97,14,528,542
Michae,M,90,52,490,542
Mostafa,M,100,0,542,542
Nabila,F,100,542,0,542
Renia,F,100,542,0,542
Romi,F,93,506,36,542
Shalina,F,100,542,0,542
Soraida,F,100,542,0,542
Talicia,F,100,542,0,542
Taner,M,100,0,542,542
Yohanna,F,100,542,0,542
Alexx,M,64,194,347,541
Altagracia,F,100,541,0,541
Angelynn,F,100,541,0,541
Attila,M,100,0,541,541
Davette,F,100,541,0,541
Dawon,M,100,0,541,541
Empress,F,100,541,0,541
Indie,F,88,476,65,541
Jalisha,F,100,541,0,541
Kassidee,F,100,541,0,541
Manpreet,F,62,338,203,541
Mister,M,100,0,541,541
Nely,F,100,541,0,541
Phelan,M,88,63,478,541
Sandrea,F,100,541,0,541
Sanna,F,100,541,0,541
Tameshia,F,100,541,0,541
Tytan,M,100,0,541,541
Vernette,F,100,541,0,541
Waseem,M,100,0,541,541
Abena,F,100,540,0,540
Allysen,F,100,540,0,540
Ama,F,100,540,0,540
Belal,M,100,0,540,540
Bransen,M,100,0,540,540
Brodee,M,97,15,525,540
Chapman,M,100,0,540,540
Dulcemaria,F,100,540,0,540
Emrie,F,100,540,0,540
Jayshaun,M,100,0,540,540
Kaan,M,100,0,540,540
Karaline,F,100,540,0,540
Moya,F,100,540,0,540
Sabre,F,89,481,59,540
Shaleen,F,100,540,0,540
Tyronda,F,100,540,0,540
York,M,100,0,540,540
Alixandria,F,100,539,0,539
Constanza,F,100,539,0,539
Deetta,F,100,539,0,539
Jancarlo,M,100,0,539,539
Lasean,M,71,155,384,539
Lasondra,F,100,539,0,539
Montae,M,100,0,539,539
Najla,F,100,539,0,539
Nalleli,F,100,539,0,539
Rashun,M,97,18,521,539
Trayce,M,61,208,331,539
Turquoise,F,100,539,0,539
Zarria,F,100,539,0,539
Angi,F,100,538,0,538
Bowie,M,71,157,381,538
Colbey,M,95,28,510,538
Cricket,F,100,538,0,538
Dayson,M,100,0,538,538
Elka,F,100,538,0,538
Evanna,F,100,538,0,538
Henny,F,100,538,0,538
Jackalyn,F,100,538,0,538
Jalah,F,99,533,5,538
Leilanie,F,100,538,0,538
Liba,F,100,538,0,538
Nguyen,M,78,117,421,538
Nihal,M,83,94,444,538
Nolberto,M,100,0,538,538
Nyema,F,100,538,0,538
Sherrye,F,100,538,0,538
Shunda,F,100,538,0,538
Tiah,F,100,538,0,538
Alaia,F,100,537,0,537
Amire,M,85,83,454,537
Christophor,M,100,0,537,537
Elexa,F,100,537,0,537
Fareed,M,100,0,537,537
Fredrica,F,100,537,0,537
Gari,F,76,407,130,537
Jackey,M,94,33,504,537
Joaquim,M,100,0,537,537
Mariaisabel,F,100,537,0,537
Navy,F,84,451,86,537
Sherard,M,100,0,537,537
Syrena,F,100,537,0,537
Tarence,M,100,0,537,537
Tiny,F,93,499,38,537
Treyvion,M,100,0,537,537
Zeynep,F,100,537,0,537
Crist,M,100,0,536,536
Elois,F,100,536,0,536
Elvina,F,100,536,0,536
Iana,F,100,536,0,536
Kaja,F,100,536,0,536
Keanan,M,100,0,536,536
Lamario,M,100,0,536,536
Maree,F,100,536,0,536
Scotti,F,78,417,119,536
Sereniti,F,100,536,0,536
Shakila,F,100,536,0,536
Tashay,F,100,536,0,536
Ziyah,F,97,518,18,536
Alexyss,F,100,535,0,535
Alister,M,100,0,535,535
Amogh,M,100,0,535,535
Anvi,F,100,535,0,535
Ardella,F,100,535,0,535
Brilynn,F,99,530,5,535
Chong,M,62,204,331,535
Derius,M,100,0,535,535
Donnelle,F,56,299,236,535
Elexia,F,100,535,0,535
Irais,F,100,535,0,535
Jacelynn,F,100,535,0,535
Jaxin,M,100,0,535,535
Lannette,F,100,535,0,535
Latisa,F,100,535,0,535
Mercede,F,100,535,0,535
Nitza,F,100,535,0,535
Pheobe,F,100,535,0,535
Zakee,M,100,0,535,535
Akyra,F,100,534,0,534
Bracken,M,100,0,534,534
Cordale,M,100,0,534,534
Delwyn,M,100,0,534,534
Graden,M,100,0,534,534
Ieasha,F,100,534,0,534
Jadalyn,F,100,534,0,534
Jhoana,F,100,534,0,534
Lanay,F,100,534,0,534
Maika,F,65,348,186,534
Melida,F,100,534,0,534
Nithya,F,100,534,0,534
Ole,M,100,0,534,534
Shaena,F,100,534,0,534
Tarus,M,100,0,534,534
Teran,M,65,185,349,534
Umberto,M,100,0,534,534
Biridiana,F,100,533,0,533
Enrrique,M,100,0,533,533
Haidee,F,100,533,0,533
Hettie,F,100,533,0,533
Jaedan,M,84,83,450,533
Jayvyn,M,100,0,533,533
Keenon,M,100,0,533,533
Kenai,M,94,31,502,533
Lynzi,F,100,533,0,533
Makaio,M,100,0,533,533
Mittie,F,100,533,0,533
Saisha,F,100,533,0,533
Salli,F,100,533,0,533
Sivan,F,90,482,51,533
Veta,F,100,533,0,533
Ala,F,73,390,142,532
Ambrosio,M,100,0,532,532
Annagrace,F,100,532,0,532
Anoushka,F,100,532,0,532
Antoin,M,100,0,532,532
Avalee,F,100,532,0,532
Cambry,F,100,532,0,532
Dawana,F,100,532,0,532
Diamon,F,95,507,25,532
Grahm,M,100,0,532,532
Hoa,F,51,270,262,532
Jamirah,F,100,532,0,532
Jaun,M,100,0,532,532
Kimbery,F,100,532,0,532
Latorya,F,100,532,0,532
Mirtha,F,100,532,0,532
Nyisha,F,100,532,0,532
Orly,F,100,532,0,532
Rande,M,71,152,380,532
Stirling,M,92,41,491,532
Akela,F,100,531,0,531
Aleksa,F,91,481,50,531
Barri,F,91,484,47,531
Brittainy,F,100,531,0,531
Cyndie,F,100,531,0,531
Dorion,M,100,0,531,531
Dortha,F,100,531,0,531
Idania,F,100,531,0,531
Kennya,F,100,531,0,531
Kimberlea,F,100,531,0,531
Korri,F,99,525,6,531
Kynzie,F,100,531,0,531
Lam,M,90,53,478,531
Merinda,F,100,531,0,531
Rithvik,M,100,0,531,531
Alyxandria,F,100,530,0,530
Angelyna,F,100,530,0,530
Ashari,F,100,530,0,530
Dari,F,95,504,26,530
Dewana,F,100,530,0,530
Jabin,M,100,0,530,530
Jahvon,M,100,0,530,530
Jquan,M,100,0,530,530
Leni,F,97,515,15,530
Levell,M,100,0,530,530
Monico,M,97,17,513,530
Nathali,F,100,530,0,530
Raelin,F,100,530,0,530
Razan,F,100,530,0,530
Stephnie,F,100,530,0,530
Anjuli,F,100,529,0,529
Aristides,M,100,0,529,529
Berton,M,100,0,529,529
Dillin,M,100,0,529,529
Eliya,F,88,463,66,529
Eriel,F,88,468,61,529
Gable,M,99,6,523,529
Jannat,F,100,529,0,529
Jaslin,F,100,529,0,529
Kearsten,F,100,529,0,529
Keirstin,F,100,529,0,529
Larraine,F,100,529,0,529
Omri,M,98,10,519,529
Riane,F,99,524,5,529
Tamarion,M,100,0,529,529
Thaddius,M,100,0,529,529
Ziah,F,78,411,118,529
Chrishawn,M,91,48,480,528
Cieara,F,100,528,0,528
Cyra,F,100,528,0,528
Edwyn,M,100,0,528,528
Grayling,M,100,0,528,528
Jediah,M,100,0,528,528
Josmar,M,100,0,528,528
Kasper,M,100,0,528,528
Keneisha,F,100,528,0,528
Keyvon,M,100,0,528,528
Moria,F,100,528,0,528
Porchia,F,100,528,0,528
Taggart,M,100,0,528,528
Tayten,M,86,76,452,528
Wheeler,M,100,0,528,528
Arvid,M,100,0,527,527
Briel,F,100,527,0,527
Chriss,M,74,137,390,527
Cincere,M,80,108,419,527
Darnesha,F,100,527,0,527
Gabryelle,F,100,527,0,527
Jaquay,M,70,156,371,527
Leverne,M,67,174,353,527
Rishab,M,100,0,527,527
Tehila,F,100,527,0,527
Weylin,M,100,0,527,527
Adleigh,F,100,526,0,526
Alim,M,100,0,526,526
Arlon,M,100,0,526,526
Bernhard,M,100,0,526,526
Christle,F,100,526,0,526
Iven,M,100,0,526,526
Jacquel,F,69,363,163,526
Jahan,M,95,25,501,526
Jeric,M,100,0,526,526
Kaydan,M,76,125,401,526
Lizzeth,F,100,526,0,526
Maniyah,F,100,526,0,526
Mesa,F,100,526,0,526
November,F,100,526,0,526
Tavoris,M,100,0,526,526
Telvin,M,100,0,526,526
Breezy,F,100,525,0,525
Chaquita,F,100,525,0,525
Coralyn,F,100,525,0,525
Danton,M,100,0,525,525
Jadore,F,89,465,60,525
Jazel,F,98,514,11,525
Josseline,F,100,525,0,525
Katiria,F,100,525,0,525
Keola,M,94,31,494,525
Lareina,F,100,525,0,525
Letecia,F,100,525,0,525
Michaelanthony,M,100,0,525,525
Michail,M,100,0,525,525
Natania,F,100,525,0,525
Nivia,F,100,525,0,525
Shamaria,F,100,525,0,525
Taneesha,F,100,525,0,525
Terez,M,72,146,379,525
Yamilette,F,100,525,0,525
Antonius,M,100,0,524,524
Arius,M,93,36,488,524
Damin,M,100,0,524,524
Emmanuela,F,100,524,0,524
Juno,F,75,391,133,524
Laniece,F,100,524,0,524
Lazar,M,100,0,524,524
Manual,M,100,0,524,524
Parks,M,100,0,524,524
Paulita,F,100,524,0,524
Roselin,F,100,524,0,524
Terin,F,65,343,181,524
Yeng,M,81,98,426,524
Yuliza,F,100,524,0,524
Alys,F,100,523,0,523
Ambrielle,F,100,523,0,523
Analiz,F,100,523,0,523
Asif,M,100,0,523,523
Aziel,M,99,5,518,523
Denika,F,100,523,0,523
Jamez,M,100,0,523,523
Jaysean,M,100,0,523,523
Justyne,F,100,523,0,523
Kaetlyn,F,100,523,0,523
Kerrianne,F,100,523,0,523
Kiptyn,M,97,17,506,523
Landrie,F,100,523,0,523
Lezly,F,100,523,0,523
Londen,F,64,335,188,523
Megumi,F,100,523,0,523
Mirka,F,100,523,0,523
Myrka,F,100,523,0,523
Rainee,F,100,523,0,523
Sharena,F,100,523,0,523
Arlando,M,100,0,522,522
Ayrton,M,100,0,522,522
Carine,F,100,522,0,522
Christiano,M,100,0,522,522
Cyd,F,100,522,0,522
Demont,M,100,0,522,522
Filippo,M,100,0,522,522
Justan,M,100,0,522,522
Kawan,M,97,15,507,522
Lantz,M,100,0,522,522
Queena,F,100,522,0,522
Seann,M,99,5,517,522
Shadrick,M,100,0,522,522
Tapanga,F,100,522,0,522
Tyreik,M,100,0,522,522
Annalia,F,100,521,0,521
Author,M,100,0,521,521
Breahna,F,100,521,0,521
Deryck,M,100,0,521,521
Domanique,F,72,375,146,521
Izik,M,100,0,521,521
Jaicee,F,100,521,0,521
Janayah,F,100,521,0,521
Kellsie,F,100,521,0,521
Kenzley,F,100,521,0,521
Koran,M,98,10,511,521
Latora,F,100,521,0,521
Laurena,F,100,521,0,521
Marshon,M,97,15,506,521
Remigio,M,100,0,521,521
Rolan,M,100,0,521,521
Stacye,F,100,521,0,521
Tamarcus,M,100,0,521,521
Toribio,M,100,0,521,521
Tron,M,99,7,514,521
Zandria,F,100,521,0,521
Delmy,F,100,520,0,520
Ima,F,100,520,0,520
Jettie,F,96,498,22,520
Karmelo,M,100,0,520,520
Machell,F,100,520,0,520
Mayme,F,100,520,0,520
Shannyn,F,100,520,0,520
Sharifa,F,100,520,0,520
Sigmund,M,100,0,520,520
Taji,M,76,125,395,520
Titania,F,100,520,0,520
Vikas,M,100,0,520,520
Aisley,F,100,519,0,519
Ajla,F,100,519,0,519
Aprille,F,100,519,0,519
Arno,M,100,0,519,519
Autry,M,92,39,480,519
Calia,F,100,519,0,519
Chastin,M,76,126,393,519
Chery,F,100,519,0,519
Dyron,M,100,0,519,519
Iraida,F,100,519,0,519
Izamar,F,99,512,7,519
Kinsleigh,F,100,519,0,519
Laiba,F,100,519,0,519
Lakeia,F,100,519,0,519
Madalena,F,100,519,0,519
Meilani,F,100,519,0,519
Reymond,M,100,0,519,519
Tosh,M,100,0,519,519
Yides,F,100,519,0,519
Alleigh,F,100,518,0,518
Darcee,F,100,518,0,518
Deavion,M,63,193,325,518
Jil,F,100,518,0,518
Kaisa,F,100,518,0,518
Kee,M,98,10,508,518
Korrin,F,100,518,0,518
Nadav,M,100,0,518,518
Neftaly,M,67,170,348,518
Bina,F,100,517,0,517
Champagne,F,100,517,0,517
Eligh,M,100,0,517,517
Emelda,F,100,517,0,517
Gorden,M,100,0,517,517
Jadalynn,F,100,517,0,517
Jebediah,M,100,0,517,517
Jesusa,F,100,517,0,517
Larinda,F,100,517,0,517
Leshia,F,100,517,0,517
Luisana,F,100,517,0,517
Marlinda,F,100,517,0,517
Pavan,M,100,0,517,517
Sarafina,F,100,517,0,517
Sharene,F,100,517,0,517
Sherrilyn,F,100,517,0,517
Tevis,M,91,47,470,517
Urbano,M,100,0,517,517
Yeimi,F,100,517,0,517
Aleea,F,100,516,0,516
Annaka,F,100,516,0,516
Athony,M,100,0,516,516
Atom,M,100,0,516,516
Aylen,F,92,477,39,516
Azaan,M,100,0,516,516
Dannika,F,100,516,0,516
Jamaul,M,100,0,516,516
Jamielynn,F,100,516,0,516
Keithen,M,100,0,516,516
Rodell,M,100,0,516,516
Shalaya,F,100,516,0,516
Shirly,F,100,516,0,516
Talayah,F,100,516,0,516
Zitlaly,F,100,516,0,516
Abeer,F,97,498,17,515
Abelino,M,100,0,515,515
Ashanty,F,100,515,0,515
Aslan,M,90,50,465,515
Aydenn,M,98,8,507,515
Cherith,F,100,515,0,515
Dalan,M,100,0,515,515
Darcia,F,100,515,0,515
Dat,M,100,0,515,515
Elecia,F,100,515,0,515
Ezri,F,85,439,76,515
Holton,M,100,0,515,515
Jadrian,M,90,50,465,515
Jaedin,M,77,117,398,515
Jedadiah,M,100,0,515,515
Kaedon,M,100,0,515,515
Leone,F,71,365,150,515
Marialuisa,F,100,515,0,515
Rorie,F,99,510,5,515
Rubye,F,100,515,0,515
Satchel,M,100,0,515,515
Stephanee,F,100,515,0,515
Alexiz,F,52,265,249,514
Ayoub,M,100,0,514,514
Banesa,F,100,514,0,514
Erion,M,78,113,401,514
Kaegan,M,65,181,333,514
Krystie,F,100,514,0,514
Lelah,F,100,514,0,514
Mendi,F,100,514,0,514
Perez,M,100,0,514,514
Sylis,M,100,0,514,514
Arlett,F,100,513,0,513
Audreanna,F,100,513,0,513
Aydon,M,100,0,513,513
Brenae,F,100,513,0,513
Camri,F,100,513,0,513
Hershy,M,100,0,513,513
Iban,M,100,0,513,513
Inge,F,100,513,0,513
Mateus,M,100,0,513,513
Oleta,F,100,513,0,513
Radford,M,100,0,513,513
Talal,M,100,0,513,513
Waldemar,M,100,0,513,513
Aedyn,M,88,59,453,512
Anam,F,100,512,0,512
Breydon,M,100,0,512,512
Burnett,M,82,91,421,512
Chavonne,F,100,512,0,512
Colman,M,100,0,512,512
Constantina,F,100,512,0,512
Dorita,F,100,512,0,512
Hercules,M,100,0,512,512
Janesha,F,100,512,0,512
Jocelynne,F,100,512,0,512
Kayde,F,61,312,200,512
Kayln,F,100,512,0,512
Keno,M,100,0,512,512
Lamiyah,F,100,512,0,512
Manish,M,100,0,512,512
Maribell,F,100,512,0,512
Montrez,M,100,0,512,512
Ramonita,F,100,512,0,512
Renwick,M,100,0,512,512
Rochele,F,100,512,0,512
Teodora,F,100,512,0,512
Xaria,F,100,512,0,512
Xaviar,M,100,0,512,512
Angla,F,100,511,0,511
Anthany,M,100,0,511,511
Emmery,F,98,499,12,511
Heavenlee,F,100,511,0,511
Landa,F,100,511,0,511
Lien,F,99,505,6,511
Maurita,F,100,511,0,511
Monti,M,66,175,336,511
Tanyia,F,100,511,0,511
Wilberto,M,100,0,511,511
Binh,M,93,38,472,510
Chantae,F,100,510,0,510
Denay,F,100,510,0,510
Dillyn,M,73,139,371,510
Janique,F,100,510,0,510
Jenel,F,100,510,0,510
Mikka,F,100,510,0,510
Rainie,F,100,510,0,510
Rye,M,92,43,467,510
Shatoria,F,100,510,0,510
Caspian,M,100,0,509,509
Corvin,M,100,0,509,509
Cybil,F,100,509,0,509
Cynda,F,100,509,0,509
Elihu,M,100,0,509,509
Gabryel,M,65,176,333,509
Kendi,F,100,509,0,509
Lashanta,F,100,509,0,509
Leianna,F,100,509,0,509
Mayda,F,100,509,0,509
Meggie,F,100,509,0,509
Mikiah,F,77,393,116,509
Monic,F,100,509,0,509
Morgana,F,100,509,0,509
Percell,M,100,0,509,509
Rayaan,M,86,73,436,509
Veena,F,100,509,0,509
Vernal,M,95,24,485,509
Walden,M,100,0,509,509
Abrahim,M,100,0,508,508
Astin,M,70,151,357,508
Braidyn,M,84,83,425,508
Dannah,F,100,508,0,508
Earnie,M,98,8,500,508
Favio,M,100,0,508,508
Gaberiel,M,100,0,508,508
Jamond,M,100,0,508,508
Joshawa,M,100,0,508,508
Kairo,M,100,0,508,508
Kendle,F,64,326,182,508
Merced,M,86,69,439,508
Mirza,M,76,120,388,508
Phi,M,91,45,463,508
Pinkie,F,100,508,0,508
Robel,M,100,0,508,508
Shakeena,F,100,508,0,508
Teneka,F,100,508,0,508
Tyara,F,100,508,0,508
Zionna,F,100,508,0,508
Abdelrahman,M,100,0,507,507
Allysha,F,100,507,0,507
Avant,M,100,0,507,507
Berniece,F,100,507,0,507
Briton,M,99,5,502,507
Delene,F,100,507,0,507
Jayron,M,100,0,507,507
Kwan,M,95,27,480,507
Magdaline,F,100,507,0,507
Milca,F,100,507,0,507
Nara,F,97,490,17,507
Nikeya,F,100,507,0,507
Rika,F,100,507,0,507
Sakeena,F,100,507,0,507
Shareese,F,100,507,0,507
Steffi,F,100,507,0,507
Tasnim,F,98,497,10,507
Abdel,M,100,0,506,506
Caydon,M,100,0,506,506
Dawnelle,F,100,506,0,506
Dayja,F,100,506,0,506
Derk,M,100,0,506,506
Emmaly,F,100,506,0,506
Everlee,F,100,506,0,506
Evey,F,100,506,0,506
Fenix,M,75,124,382,506
Gerianne,F,100,506,0,506
Gillermo,M,100,0,506,506
Jenne,F,100,506,0,506
Jennifier,F,100,506,0,506
Joshlynn,F,100,506,0,506
Kayra,F,99,501,5,506
Ltanya,F,100,506,0,506
Mackinley,M,55,227,279,506
Madylin,F,100,506,0,506
Monay,F,100,506,0,506
Rosslyn,F,100,506,0,506
Salwa,F,100,506,0,506
Sharlee,F,100,506,0,506
Shenequa,F,100,506,0,506
Taia,F,100,506,0,506
Tayven,M,93,37,469,506
Vonna,F,100,506,0,506
Yaire,F,100,506,0,506
Zeta,F,100,506,0,506
Amarii,M,55,228,277,505
Ameria,F,100,505,0,505
Antoino,M,100,0,505,505
Aviv,M,82,90,415,505
Caeli,F,100,505,0,505
Cerina,F,100,505,0,505
Courtny,F,99,500,5,505
Dunia,F,100,505,0,505
Elidia,F,100,505,0,505
Gennesis,F,100,505,0,505
Glennon,M,100,0,505,505
Korrine,F,100,505,0,505
Kullen,M,100,0,505,505
Latecia,F,100,505,0,505
Lera,F,100,505,0,505
Liani,F,100,505,0,505
Merl,M,98,11,494,505
Rainier,M,100,0,505,505
Rondall,M,100,0,505,505
Rylyn,F,80,406,99,505
Selby,M,54,234,271,505
Severiano,M,100,0,505,505
Tovah,F,100,505,0,505
Yuritzi,F,100,505,0,505
Andruw,M,100,0,504,504
Anum,F,100,504,0,504
Darik,M,100,0,504,504
Davontay,M,100,0,504,504
Estefanie,F,100,504,0,504
Isrrael,M,100,0,504,504
Jestine,F,100,504,0,504
Lesslie,F,96,486,18,504
Maheen,F,99,498,6,504
Mana,F,91,457,47,504
Maretta,F,100,504,0,504
Merna,F,100,504,0,504
Pace,M,98,11,493,504
Panagiota,F,100,504,0,504
Rakia,F,100,504,0,504
Sandria,F,100,504,0,504
Sung,M,86,69,435,504
Victorya,F,100,504,0,504
Airiana,F,100,503,0,503
Arisha,F,100,503,0,503
Evelio,M,100,0,503,503
Harpreet,F,50,254,249,503
Jamerson,M,100,0,503,503
Jaylani,F,95,480,23,503
Jeniece,F,100,503,0,503
Keldon,M,100,0,503,503
Latrica,F,100,503,0,503
Rajeev,M,100,0,503,503
Ritika,F,100,503,0,503
Rosenda,F,100,503,0,503
Imaan,F,94,470,32,502
Jaeson,M,100,0,502,502
Judit,F,100,502,0,502
Keyonte,M,96,21,481,502
Langley,F,82,413,89,502
Madalynne,F,100,502,0,502
Olivea,F,100,502,0,502
Philicia,F,100,502,0,502
Quanda,F,100,502,0,502
Rica,F,100,502,0,502
Rockford,M,100,0,502,502
Roseline,F,100,502,0,502
Rutha,F,100,502,0,502
Saulo,M,100,0,502,502
Sharissa,F,100,502,0,502
Taleen,F,100,502,0,502
Verlyn,M,80,99,403,502
Antavious,M,100,0,501,501
Deatra,F,100,501,0,501
Junita,F,100,501,0,501
Keone,M,100,0,501,501
Meleny,F,100,501,0,501
Melessa,F,100,501,0,501
Moana,F,100,501,0,501
Nataley,F,100,501,0,501
Natarsha,F,100,501,0,501
Oden,M,100,0,501,501
Ryli,F,100,501,0,501
Shereka,F,100,501,0,501
Sidharth,M,100,0,501,501
Tarry,M,68,161,340,501
Tenna,F,100,501,0,501
Annaleah,F,100,500,0,500
Atiana,F,100,500,0,500
Briget,F,100,500,0,500
Ceaser,M,100,0,500,500
Cresencio,M,100,0,500,500
Damontae,M,100,0,500,500
Heydi,F,100,500,0,500
Jailin,F,59,293,207,500
Kennis,M,87,65,435,500
Kristee,F,100,500,0,500
Leonides,M,98,12,488,500
Marchello,M,100,0,500,500
Marguita,F,100,500,0,500
Mariane,F,100,500,0,500
Meosha,F,100,500,0,500
Noely,F,100,500,0,500
Precilla,F,100,500,0,500
Primitivo,M,100,0,500,500
Rooney,M,81,97,403,500
Senora,F,100,500,0,500
Winnifred,F,100,500,0,500
Xavia,F,98,489,11,500
Annel,F,100,499,0,499
Brigitta,F,100,499,0,499
Dasan,M,100,0,499,499
Eleonora,F,100,499,0,499
Feather,F,100,499,0,499
Ferman,M,100,0,499,499
Ivery,M,74,129,370,499
Janeice,F,100,499,0,499
Kaeleb,M,100,0,499,499
Maddisen,F,100,499,0,499
Mazin,M,100,0,499,499
Merrell,M,89,53,446,499
Noni,F,100,499,0,499
Shondell,M,53,237,262,499
Sterlin,M,100,0,499,499
Blayden,M,100,0,498,498
Brennah,F,100,498,0,498
Camya,F,100,498,0,498
Cherrish,F,100,498,0,498
Darra,F,100,498,0,498
Eleuterio,M,100,0,498,498
Juliza,F,100,498,0,498
Kayin,M,87,67,431,498
Lukasz,M,100,0,498,498
Manu,M,99,5,493,498
Missie,F,100,498,0,498
Parsa,M,100,0,498,498
Rondale,M,100,0,498,498
Rushil,M,100,0,498,498
Sallyann,F,100,498,0,498
Teala,F,100,498,0,498
Timesha,F,100,498,0,498
Zaryah,F,100,498,0,498
Alliana,F,100,497,0,497
Chauntel,F,100,497,0,497
Darrow,M,100,0,497,497
Donyae,M,59,206,291,497
Jannel,F,100,497,0,497
Jonda,F,100,497,0,497
Josee,F,100,497,0,497
Kaelah,F,100,497,0,497
Kenady,F,100,497,0,497
Latania,F,100,497,0,497
Mckaylee,F,100,497,0,497
Mitra,F,99,492,5,497
Shronda,F,100,497,0,497
Syria,F,100,497,0,497
Terral,M,96,20,477,497
Tylisha,F,100,497,0,497
Yezenia,F,100,497,0,497
Zeno,M,100,0,497,497
Alliah,F,100,496,0,496
Amilya,F,100,496,0,496
Carianne,F,100,496,0,496
Colm,M,100,0,496,496
Gianella,F,100,496,0,496
Kemya,F,100,496,0,496
Kiaira,F,100,496,0,496
Kittie,F,100,496,0,496
Lachandra,F,100,496,0,496
Maghan,F,100,496,0,496
Naidelyn,F,100,496,0,496
Presten,M,100,0,496,496
Rumaldo,M,100,0,496,496
Trentyn,M,100,0,496,496
Ambur,F,100,495,0,495
Aparna,F,100,495,0,495
Champ,M,100,0,495,495
Chisom,F,69,342,153,495
Daishawn,M,100,0,495,495
Donnovan,M,100,0,495,495
Ha,F,85,422,73,495
Hasaan,M,100,0,495,495
Helana,F,100,495,0,495
Jafar,M,100,0,495,495
Kalysta,F,100,495,0,495
Kayte,F,100,495,0,495
Kramer,M,99,6,489,495
Ladona,F,100,495,0,495
Lyza,F,100,495,0,495
Merton,M,100,0,495,495
Meshell,F,100,495,0,495
Shawntell,F,100,495,0,495
Vallie,F,98,485,10,495
Alias,M,100,0,494,494
Arham,M,100,0,494,494
Arlana,F,100,494,0,494
Breyona,F,100,494,0,494
Cana,F,100,494,0,494
Carisma,F,100,494,0,494
Carlen,F,87,430,64,494
Dariela,F,100,494,0,494
Janny,F,100,494,0,494
Klynn,F,100,494,0,494
Mar,F,62,305,189,494
Pharaoh,M,100,0,494,494
Samina,F,100,494,0,494
Shann,M,57,214,280,494
Vashawn,M,93,33,461,494
Yanelis,F,100,494,0,494
Aldin,M,100,0,493,493
Assata,F,100,493,0,493
Azari,F,69,342,151,493
Bettyann,F,100,493,0,493
Carston,M,100,0,493,493
Dicky,M,100,0,493,493
Haider,M,100,0,493,493
Jackquline,F,100,493,0,493
Janaiya,F,100,493,0,493
Jerren,M,100,0,493,493
Johnhenry,M,100,0,493,493
Lancelot,M,100,0,493,493
Maniya,F,100,493,0,493
Mone,F,100,493,0,493
Paytin,F,93,457,36,493
Safiyyah,F,100,493,0,493
Sequoya,F,99,488,5,493
Yahel,M,97,16,477,493
Arlington,M,96,21,471,492
Dalaney,F,100,492,0,492
Damarys,F,100,492,0,492
Dmarion,M,100,0,492,492
Jatavious,M,100,0,492,492
Kailei,F,100,492,0,492
Lanea,F,100,492,0,492
Liliane,F,100,492,0,492
Mardell,F,87,429,63,492
Marilena,F,100,492,0,492
Nafis,M,100,0,492,492
Ronika,F,100,492,0,492
Samanthia,F,100,492,0,492
Yared,M,82,87,405,492
Yeshaya,M,100,0,492,492
Alaiya,F,100,491,0,491
Atharv,M,100,0,491,491
Chai,M,63,180,311,491
Colbi,F,87,427,64,491
Daquon,M,100,0,491,491
Dennys,M,83,83,408,491
Dorena,F,100,491,0,491
Johnita,F,100,491,0,491
Kalise,F,100,491,0,491
Kayleah,F,100,491,0,491
Kerissa,F,100,491,0,491
Mahad,M,100,0,491,491
Penn,M,100,0,491,491
Sadaf,F,100,491,0,491
Sion,M,88,61,430,491
Tabytha,F,100,491,0,491
Trustin,M,100,0,491,491
Valeska,F,100,491,0,491
Zanya,F,100,491,0,491
Abella,F,100,490,0,490
Aurelius,M,100,0,490,490
Carlson,M,100,0,490,490
Dayron,M,100,0,490,490
Emina,F,100,490,0,490
Jamarri,M,100,0,490,490
Jazmynn,F,100,490,0,490
Jerre,M,64,178,312,490
Lamark,M,100,0,490,490
Latitia,F,100,490,0,490
Nosson,M,100,0,490,490
Ruvim,M,100,0,490,490
Toryn,F,50,246,244,490
Zahava,F,100,490,0,490
Angelin,F,100,489,0,489
Antwine,M,100,0,489,489
Arisbeth,F,100,489,0,489
Chrislyn,F,100,489,0,489
Christabel,F,100,489,0,489
Claretha,F,100,489,0,489
Corky,M,93,33,456,489
Danea,F,100,489,0,489
Esmerelda,F,100,489,0,489
Gila,F,100,489,0,489
Haneef,M,100,0,489,489
Jamani,M,54,225,264,489
Jerra,F,100,489,0,489
Karriem,M,99,5,484,489
Katrinia,F,100,489,0,489
Kavi,M,99,5,484,489
Leina,F,100,489,0,489
Litzi,F,100,489,0,489
Mishael,M,65,172,317,489
Newman,M,100,0,489,489
Raneem,F,100,489,0,489
Shantee,F,100,489,0,489
Telicia,F,100,489,0,489
Terriann,F,100,489,0,489
Acelynn,F,100,488,0,488
Beckey,F,100,488,0,488
Cerena,F,100,488,0,488
Daniyal,M,100,0,488,488
Davetta,F,100,488,0,488
Devika,F,100,488,0,488
Eligah,M,100,0,488,488
Emberlynn,F,100,488,0,488
Gregery,M,100,0,488,488
Jaquel,M,75,123,365,488
Jazzmen,F,100,488,0,488
Joylynn,F,100,488,0,488
Kagen,M,97,17,471,488
Lisett,F,100,488,0,488
Lynnell,F,100,488,0,488
Lynnetta,F,100,488,0,488
Marvina,F,100,488,0,488
Matty,F,94,458,30,488
Pratik,M,100,0,488,488
Quoc,M,100,0,488,488
Shanie,F,100,488,0,488
Shannell,F,100,488,0,488
Uniqua,F,100,488,0,488
Alania,F,100,487,0,487
Amayrani,F,100,487,0,487
Brynnlee,F,100,487,0,487
Caelen,M,87,61,426,487
Camrynn,F,94,457,30,487
Hira,F,100,487,0,487
Leane,F,100,487,0,487
Liann,F,100,487,0,487
Meliah,F,100,487,0,487
Mindie,F,100,487,0,487
Raymund,M,100,0,487,487
Rubina,F,100,487,0,487
Shalin,M,65,172,315,487
Shelba,F,100,487,0,487
Tierre,M,76,117,370,487
Abdias,M,100,0,486,486
Amyjo,F,100,486,0,486
Chelby,F,100,486,0,486
Dason,M,100,0,486,486
Jahmere,M,100,0,486,486
Janalyn,F,100,486,0,486
Jazzmyne,F,100,486,0,486
Kaylena,F,100,486,0,486
Kieren,M,76,118,368,486
Kyre,M,93,35,451,486
Mindee,F,100,486,0,486
Nataniel,M,100,0,486,486
Raevyn,F,100,486,0,486
Renette,F,100,486,0,486
Sadiq,M,100,0,486,486
Sigifredo,M,100,0,486,486
Skylin,F,95,462,24,486
Syble,F,100,486,0,486
Taysia,F,100,486,0,486
Uvaldo,M,100,0,486,486
Zuzanna,F,100,486,0,486
Adonna,F,100,485,0,485
Ambrea,F,100,485,0,485
Brandye,F,100,485,0,485
Brynlie,F,100,485,0,485
Devlyn,M,64,176,309,485
Faizan,M,100,0,485,485
Jeran,M,98,8,477,485
Jermon,M,100,0,485,485
Johney,M,100,0,485,485
Kaysi,F,100,485,0,485
Kern,M,100,0,485,485
Latrenda,F,100,485,0,485
Lyriq,F,89,430,55,485
Mical,M,68,155,330,485
Munir,M,100,0,485,485
Nastassja,F,100,485,0,485
Nichalos,M,100,0,485,485
Shaneice,F,100,485,0,485
Yordi,M,100,0,485,485
Zaquan,M,100,0,485,485
Zissy,F,100,485,0,485
Contina,F,100,484,0,484
Denean,F,100,484,0,484
Geanna,F,100,484,0,484
Jalina,F,100,484,0,484
Jerrin,M,97,16,468,484
Lizandra,F,100,484,0,484
Loreli,F,100,484,0,484
Pressley,F,80,387,97,484
Rolonda,F,100,484,0,484
Shady,M,60,196,288,484
Shayaan,M,100,0,484,484
Tarynn,F,100,484,0,484
Tiandra,F,100,484,0,484
Adarsh,M,100,0,483,483
Arvil,M,100,0,483,483
Blase,M,100,0,483,483
Clea,F,100,483,0,483
Cyler,M,100,0,483,483
Cyntia,F,100,483,0,483
Gurpreet,M,64,172,311,483
Hannibal,M,100,0,483,483
Jenner,M,97,15,468,483
Jennilee,F,100,483,0,483
Josemaria,M,100,0,483,483
Sandhya,F,100,483,0,483
Tatiyanna,F,100,483,0,483
Tej,M,100,0,483,483
Avelyn,F,100,482,0,482
Chidera,F,66,320,162,482
Gertie,F,100,482,0,482
Hannan,F,82,395,87,482
Jameisha,F,100,482,0,482
Jonn,M,100,0,482,482
Jozette,F,100,482,0,482
Kamyla,F,100,482,0,482
Kaneesha,F,100,482,0,482
Kimm,F,80,386,96,482
Letricia,F,100,482,0,482
Madai,F,100,482,0,482
Myria,F,100,482,0,482
Nasim,M,75,119,363,482
Richardson,M,100,0,482,482
Sarika,F,100,482,0,482
Zehra,F,100,482,0,482
Brelyn,F,92,443,38,481
Corley,F,58,281,200,481
Croix,M,100,0,481,481
Dondra,F,96,461,20,481
Fabienne,F,100,481,0,481
Gemini,F,68,325,156,481
Gregary,M,100,0,481,481
Irfan,M,100,0,481,481
Jassmine,F,100,481,0,481
Jesselyn,F,100,481,0,481
Kashmir,F,75,362,119,481
Larsen,M,77,109,372,481
Louanna,F,100,481,0,481
Maddy,F,100,481,0,481
Mallery,F,100,481,0,481
Mechell,F,100,481,0,481
Mikaella,F,100,481,0,481
Pervis,M,100,0,481,481
Ronen,M,100,0,481,481
Shellby,F,100,481,0,481
Solon,M,100,0,481,481
Zamiya,F,100,481,0,481
Zyasia,F,100,481,0,481
Ahmya,F,100,480,0,480
Alaisha,F,100,480,0,480
Ankita,F,100,480,0,480
Batya,F,100,480,0,480
Demontre,M,100,0,480,480
Evana,F,100,480,0,480
Kaylinn,F,100,480,0,480
Lameka,F,100,480,0,480
Lashaundra,F,100,480,0,480
Lenee,F,100,480,0,480
Mariadelcarmen,F,100,480,0,480
Mustapha,M,100,0,480,480
Natallie,F,100,480,0,480
Perfecto,M,100,0,480,480
Petar,M,100,0,480,480
Ramir,M,100,0,480,480
Tariah,F,100,480,0,480
Tylia,F,100,480,0,480
Aisa,F,99,474,5,479
Bartolo,M,100,0,479,479
Breya,F,100,479,0,479
Brithany,F,100,479,0,479
Daymian,M,100,0,479,479
Dimple,F,100,479,0,479
Flannery,F,100,479,0,479
Ginelle,F,100,479,0,479
Guthrie,M,100,0,479,479
Heily,F,100,479,0,479
Jayvien,M,100,0,479,479
Kindle,F,92,442,37,479
Koty,M,94,30,449,479
Lahoma,F,100,479,0,479
Lanessa,F,100,479,0,479
Tailynn,F,100,479,0,479
Tashiana,F,100,479,0,479
Threasa,F,100,479,0,479
Yakelin,F,100,479,0,479
Abegail,F,100,478,0,478
Alin,F,75,359,119,478
Aricka,F,100,478,0,478
Artisha,F,100,478,0,478
Benedetto,M,100,0,478,478
Christella,F,100,478,0,478
Dantae,M,100,0,478,478
Dashawna,F,100,478,0,478
Deepa,F,100,478,0,478
Deyon,M,98,11,467,478
Diania,F,100,478,0,478
Eydie,F,100,478,0,478
Froilan,M,100,0,478,478
Hannia,F,100,478,0,478
Jobeth,F,100,478,0,478
Kenderick,M,100,0,478,478
Kenzlee,F,100,478,0,478
Lasheena,F,100,478,0,478
Lezlee,F,100,478,0,478
Miasia,F,100,478,0,478
Oliviah,F,100,478,0,478
Selia,F,100,478,0,478
Teesha,F,100,478,0,478
Adithya,M,100,0,477,477
Aiva,F,100,477,0,477
Courtnay,F,98,467,10,477
Dashun,M,100,0,477,477
Demone,M,100,0,477,477
Denell,F,88,419,58,477
Ezzard,M,100,0,477,477
Jasey,F,99,472,5,477
Kolter,M,100,0,477,477
Lawerance,M,100,0,477,477
Merida,F,100,477,0,477
Nayelly,F,100,477,0,477
Nesha,F,100,477,0,477
Nickolus,M,100,0,477,477
Orie,M,98,10,467,477
Racine,F,99,472,5,477
Syriah,F,100,477,0,477
Tyanne,F,100,477,0,477
Xia,F,100,477,0,477
Ahsan,M,100,0,476,476
Airianna,F,100,476,0,476
Alyissa,F,100,476,0,476
Aprile,F,100,476,0,476
Arland,M,99,5,471,476
Brinn,F,97,461,15,476
Choua,F,82,390,86,476
Daneille,F,100,476,0,476
Daphane,F,100,476,0,476
Denitra,F,100,476,0,476
Ellissa,F,100,476,0,476
Gioia,F,100,476,0,476
Makoa,M,100,0,476,476
Natalyn,F,100,476,0,476
Omarr,M,100,0,476,476
Raeleen,F,100,476,0,476
Raequan,M,100,0,476,476
Sabreen,F,100,476,0,476
Shayleen,F,100,476,0,476
Sotero,M,100,0,476,476
Yashika,F,100,476,0,476
Yashira,F,100,476,0,476
Adrena,F,100,475,0,475
Annalea,F,100,475,0,475
Arina,F,100,475,0,475
Calib,M,100,0,475,475
Clairissa,F,100,475,0,475
Dagmar,F,100,475,0,475
Donavyn,M,100,0,475,475
Hanh,F,96,454,21,475
Harun,M,100,0,475,475
Hillard,M,100,0,475,475
Jacqulin,F,100,475,0,475
Jannice,F,100,475,0,475
Quantavious,M,100,0,475,475
Quetzalli,F,100,475,0,475
Shrey,M,100,0,475,475
Stanly,M,100,0,475,475
Tramel,M,100,0,475,475
Trebor,M,100,0,475,475
Trenise,F,100,475,0,475
Trisa,F,100,475,0,475
Wanya,M,96,17,458,475
Alacia,F,100,474,0,474
Brigett,F,100,474,0,474
Charlese,F,100,474,0,474
Chela,F,100,474,0,474
Daylene,F,100,474,0,474
Duffy,M,97,16,458,474
Evelynne,F,100,474,0,474
Freyja,F,100,474,0,474
Hajar,F,100,474,0,474
Latika,F,100,474,0,474
Leevi,M,100,0,474,474
Makailah,F,100,474,0,474
Maralee,F,100,474,0,474
Meredyth,F,100,474,0,474
Monigue,F,100,474,0,474
Perel,F,100,474,0,474
Raissa,F,100,474,0,474
Bibi,F,100,473,0,473
Ger,M,81,88,385,473
Habiba,F,100,473,0,473
Ivania,F,100,473,0,473
Jeimy,F,100,473,0,473
Kirstan,F,100,473,0,473
Makesha,F,100,473,0,473
Makhai,M,100,0,473,473
Mandel,M,100,0,473,473
Mart,M,100,0,473,473
Meika,F,100,473,0,473
Raysean,M,100,0,473,473
Sabas,M,100,0,473,473
Shantrice,F,100,473,0,473
Shavone,F,100,473,0,473
Shelagh,F,100,473,0,473
Zyla,F,100,473,0,473
Akbar,M,100,0,472,472
Chau,F,77,365,107,472
Dayan,M,62,180,292,472
Emanual,M,100,0,472,472
Jaymin,M,100,0,472,472
Juliett,F,100,472,0,472
Kenslee,F,100,472,0,472
Khoi,M,99,6,466,472
Majid,M,100,0,472,472
Monnie,F,71,336,136,472
Shanyia,F,100,472,0,472
Sundra,F,100,472,0,472
Adron,M,100,0,471,471
Aneta,F,100,471,0,471
Arista,F,100,471,0,471
Ashleen,F,100,471,0,471
Charnelle,F,100,471,0,471
Diamonte,M,93,32,439,471
Gloriana,F,100,471,0,471
Johnmark,M,100,0,471,471
Kadija,F,100,471,0,471
Keonta,M,86,64,407,471
Lilie,F,100,471,0,471
Marquesha,F,100,471,0,471
Neiko,M,100,0,471,471
Nolyn,M,89,53,418,471
Pearlene,F,100,471,0,471
Stori,F,100,471,0,471
Taylour,F,94,442,29,471
Abi,F,95,448,22,470
Adryana,F,100,470,0,470
Bubba,M,100,0,470,470
Daliah,F,100,470,0,470
Darina,F,100,470,0,470
Denetra,F,100,470,0,470
Graylin,M,95,22,448,470
Jimmey,M,100,0,470,470
Joanthan,M,100,0,470,470
Marcene,F,100,470,0,470
Roselia,F,100,470,0,470
Talynn,F,99,465,5,470
Waleska,F,100,470,0,470
Xaiden,M,100,0,470,470
Yovanni,M,100,0,470,470
Alura,F,100,469,0,469
Camarion,M,100,0,469,469
Chaston,M,100,0,469,469
Diva,F,100,469,0,469
Dorianne,F,100,469,0,469
Gini,F,100,469,0,469
Isom,M,100,0,469,469
Lequita,F,100,469,0,469
Lizzy,F,100,469,0,469
Marea,F,100,469,0,469
Namon,M,100,0,469,469
Raini,F,89,416,53,469
Ruthy,F,100,469,0,469
Shaleah,F,100,469,0,469
Tae,M,78,102,367,469
Teyanna,F,100,469,0,469
Amarri,M,52,225,243,468
Analyssa,F,100,468,0,468
Azariyah,F,99,463,5,468
Brystal,F,100,468,0,468
Chera,F,100,468,0,468
Chiffon,F,100,468,0,468
Corlis,F,100,468,0,468
Daya,F,100,468,0,468
Jaliya,F,100,468,0,468
Kalleigh,F,100,468,0,468
Lyllian,F,100,468,0,468
Maressa,F,100,468,0,468
Owyn,M,98,10,458,468
Saffron,F,100,468,0,468
Sesar,M,100,0,468,468
Tayte,M,79,96,372,468
Topanga,F,100,468,0,468
Wilhemina,F,100,468,0,468
Anasofia,F,100,467,0,467
Ayelen,F,100,467,0,467
Brighid,F,100,467,0,467
Deshay,F,61,284,183,467
Dewight,M,100,0,467,467
Emon,M,81,90,377,467
Fredda,F,100,467,0,467
Halbert,M,100,0,467,467
Ijeoma,F,100,467,0,467
Jasiyah,F,64,301,166,467
Jenene,F,100,467,0,467
Kainalu,M,100,0,467,467
Kamel,M,100,0,467,467
Kurstin,F,100,467,0,467
Lanika,F,100,467,0,467
Monzerrat,F,99,462,5,467
Najwa,F,100,467,0,467
Onna,F,100,467,0,467
Shenise,F,100,467,0,467
Taylah,F,100,467,0,467
Wynton,M,100,0,467,467
Alie,F,88,411,55,466
Celestial,F,100,466,0,466
Deaira,F,100,466,0,466
Digna,F,100,466,0,466
Dilyn,M,65,162,304,466
Jamale,M,100,0,466,466
Janissa,F,100,466,0,466
Kandee,F,100,466,0,466
Lashayla,F,100,466,0,466
Lotoya,F,100,466,0,466
Miana,F,100,466,0,466
Michaeline,F,100,466,0,466
Rheagan,F,100,466,0,466
Robi,F,76,356,110,466
Artem,M,100,0,465,465
Elene,F,100,465,0,465
Jahmar,M,100,0,465,465
Jaidin,M,59,189,276,465
Jamielee,F,100,465,0,465
Jenah,F,100,465,0,465
Leslieann,F,100,465,0,465
Mailee,F,100,465,0,465
Martrell,M,100,0,465,465
Miri,F,100,465,0,465
Nachman,M,100,0,465,465
Nataliya,F,100,465,0,465
Rossie,F,54,253,212,465
Uzziah,M,98,7,458,465
Viana,F,100,465,0,465
Zian,M,71,133,332,465
Akua,F,100,464,0,464
Algie,M,98,10,454,464
Almeda,F,100,464,0,464
Calah,F,100,464,0,464
Chaunte,F,100,464,0,464
Clorinda,F,100,464,0,464
Darsh,M,100,0,464,464
Deija,F,100,464,0,464
Jamilia,F,100,464,0,464
Johnisha,F,100,464,0,464
Latresha,F,100,464,0,464
Lavone,F,86,397,67,464
Maximos,M,100,0,464,464
Nikesha,F,100,464,0,464
Quintella,F,100,464,0,464
Ranesha,F,100,464,0,464
Sheralyn,F,100,464,0,464
Tatem,F,59,276,188,464
Abbott,M,96,18,445,463
Brailynn,F,97,451,12,463
Dodi,F,99,458,5,463
Durward,M,100,0,463,463
Higinio,M,100,0,463,463
Jadira,F,100,463,0,463
Kendy,F,97,447,16,463
Lesleigh,F,100,463,0,463
Lyana,F,100,463,0,463
Maribella,F,100,463,0,463
Maximillion,M,100,0,463,463
Mirel,F,100,463,0,463
Nikolette,F,100,463,0,463
Pier,F,79,364,99,463
Rickia,F,100,463,0,463
Saydie,F,100,463,0,463
Shazia,F,100,463,0,463
Tajanae,F,100,463,0,463
Tiwana,F,100,463,0,463
Yuval,M,67,154,309,463
Akiya,F,100,462,0,462
Amaru,M,100,0,462,462
Anni,F,100,462,0,462
Brucha,F,100,462,0,462
Cambri,F,100,462,0,462
Dontre,M,100,0,462,462
Erlene,F,100,462,0,462
Iriana,F,100,462,0,462
Jammy,M,72,130,332,462
Jvon,M,100,0,462,462
Kierstan,F,100,462,0,462
Ledarius,M,100,0,462,462
Marija,F,100,462,0,462
Maryclaire,F,100,462,0,462
Paeton,F,82,381,81,462
Percival,M,100,0,462,462
Shmiel,M,100,0,462,462
Yahira,F,100,462,0,462
Armandina,F,100,461,0,461
Atharva,M,100,0,461,461
Camilia,F,100,461,0,461
Cerissa,F,100,461,0,461
Cordaro,M,100,0,461,461
Dugan,M,100,0,461,461
Endy,M,97,15,446,461
Hiawatha,M,77,104,357,461
Jamine,F,70,324,137,461
Jezabel,F,100,461,0,461
Katrell,M,91,43,418,461
Kaylana,F,100,461,0,461
Ralston,M,100,0,461,461
Soila,F,100,461,0,461
Tiaira,F,100,461,0,461
Albina,F,100,460,0,460
Amery,F,83,381,79,460
Aryel,F,95,435,25,460
Jager,M,100,0,460,460
Jaira,F,100,460,0,460
Karston,M,100,0,460,460
Kierre,M,80,94,366,460
Maricel,F,100,460,0,460
Martinique,F,100,460,0,460
Necia,F,100,460,0,460
Nikkolas,M,100,0,460,460
Rajah,M,67,152,308,460
Reginold,M,100,0,460,460
Thi,F,86,397,63,460
Torrian,M,98,11,449,460
Zackory,M,100,0,460,460
Carvin,M,100,0,459,459
Fancy,F,100,459,0,459
Gordan,M,100,0,459,459
Jervon,M,100,0,459,459
Jillianne,F,100,459,0,459
Johnanthony,M,100,0,459,459
Kedar,M,100,0,459,459
Keshawna,F,100,459,0,459
Kyndell,F,91,419,40,459
Marquia,F,100,459,0,459
Mauricia,F,100,459,0,459
Osborne,M,100,0,459,459
Purnell,M,100,0,459,459
Sareena,F,100,459,0,459
Shandrea,F,100,459,0,459
Averey,F,67,307,151,458
Char,F,100,458,0,458
Cira,F,100,458,0,458
Damean,M,100,0,458,458
Drequan,M,100,0,458,458
Elza,M,51,225,233,458
Esabella,F,100,458,0,458
Jenney,F,100,458,0,458
Kelise,F,100,458,0,458
Leighla,F,100,458,0,458
Lyam,M,100,0,458,458
Merci,F,100,458,0,458
Reann,F,100,458,0,458
Tanish,M,86,66,392,458
Waynette,F,100,458,0,458
Windi,F,100,458,0,458
Aaditya,M,100,0,457,457
Apollonia,F,100,457,0,457
Aquil,M,100,0,457,457
Camesha,F,100,457,0,457
Carletha,F,100,457,0,457
Eyvonne,F,100,457,0,457
Hermes,M,100,0,457,457
Jaiya,F,100,457,0,457
Jodine,F,100,457,0,457
Kemora,F,100,457,0,457
Lakelyn,F,99,452,5,457
Madelon,F,100,457,0,457
Marykathryn,F,100,457,0,457
Maxson,M,100,0,457,457
Nykeria,F,100,457,0,457
Omero,M,100,0,457,457
Shaquetta,F,100,457,0,457
Sharra,F,100,457,0,457
Tiberius,M,100,0,457,457
Aviance,F,100,456,0,456
Biagio,M,100,0,456,456
Donel,M,93,30,426,456
Floria,F,100,456,0,456
Hadrian,M,100,0,456,456
Johnthomas,M,100,0,456,456
Josephus,M,100,0,456,456
Joycelynn,F,100,456,0,456
Korena,F,100,456,0,456
Meshach,M,100,0,456,456
Mikai,M,98,10,446,456
Nayana,F,100,456,0,456
Nunzio,M,100,0,456,456
Pixie,F,100,456,0,456
Shakela,F,100,456,0,456
Shiquita,F,100,456,0,456
Socrates,M,100,0,456,456
Thadius,M,100,0,456,456
Vladislav,M,100,0,456,456
Abree,F,100,455,0,455
Alanie,F,100,455,0,455
Anesia,F,100,455,0,455
Anina,F,100,455,0,455
Bryann,F,77,352,103,455
Daley,F,83,377,78,455
Evony,F,100,455,0,455
Francoise,F,100,455,0,455
Haydyn,M,52,220,235,455
Iyanah,F,100,455,0,455
Jahniya,F,100,455,0,455
Jemar,M,100,0,455,455
Kemon,M,100,0,455,455
Nathania,F,100,455,0,455
Ronnald,M,100,0,455,455
Samera,F,100,455,0,455
Srikar,M,100,0,455,455
Tram,F,100,455,0,455
Yaira,F,100,455,0,455
Yona,M,57,195,260,455
Yovana,F,100,455,0,455
Adlai,M,89,50,404,454
Cordae,M,99,5,449,454
Cylus,M,100,0,454,454
Edina,F,100,454,0,454
Josha,M,94,28,426,454
Kathlynn,F,100,454,0,454
Keoki,M,100,0,454,454
Lavena,F,100,454,0,454
Lynett,F,100,454,0,454
Marisella,F,100,454,0,454
Mateen,M,100,0,454,454
Miciah,F,50,228,226,454
Natoshia,F,100,454,0,454
Randol,M,100,0,454,454
Reshawn,M,91,43,411,454
Sarajane,F,100,454,0,454
Sharai,F,100,454,0,454
Shlok,M,100,0,454,454
Tamitha,F,100,454,0,454
Tashi,F,87,393,61,454
Travonte,M,100,0,454,454
Alandria,F,100,453,0,453
Anari,F,96,435,18,453
Brionne,F,97,438,15,453
Carmelia,F,100,453,0,453
Deonne,F,90,406,47,453
Donathan,M,100,0,453,453
Franciso,M,100,0,453,453
Jaice,M,81,84,369,453
Jerret,M,100,0,453,453
Lovella,F,100,453,0,453
Massiah,M,83,79,374,453
Mckynzie,F,100,453,0,453
Nainoa,M,100,0,453,453
Ranger,M,100,0,453,453
Sahir,M,100,0,453,453
Worth,M,100,0,453,453
Carlitos,M,100,0,452,452
Daphanie,F,100,452,0,452
Emree,F,100,452,0,452
Grafton,M,100,0,452,452
Izell,M,100,0,452,452
Kaidon,M,100,0,452,452
Karessa,F,100,452,0,452
Katrinka,F,100,452,0,452
Ki,M,78,98,354,452
Kodiak,M,100,0,452,452
Lashone,F,88,396,56,452
Lasonja,F,100,452,0,452
Mansi,F,100,452,0,452
Martyn,M,100,0,452,452
Mickaela,F,100,452,0,452
Myanna,F,100,452,0,452
Nygel,M,100,0,452,452
Raygen,F,90,405,47,452
Tayveon,M,100,0,452,452
Teshia,F,100,452,0,452
Zalman,M,100,0,452,452
Ahmet,M,100,0,451,451
Angelis,F,92,416,35,451
Angello,M,100,0,451,451
Ariyan,F,60,269,182,451
Arnez,M,99,5,446,451
Bobbette,F,100,451,0,451
Cookie,F,100,451,0,451
Florene,F,100,451,0,451
Gurleen,F,100,451,0,451
Jahsiah,M,100,0,451,451
Jaysa,F,100,451,0,451
Jerzie,F,100,451,0,451
Kacen,M,100,0,451,451
Kaneshia,F,100,451,0,451
Kerensa,F,100,451,0,451
Leaann,F,100,451,0,451
Malachy,M,100,0,451,451
Mishell,F,100,451,0,451
Monee,F,100,451,0,451
Nastasia,F,100,451,0,451
Paulene,F,100,451,0,451
Vidhi,F,100,451,0,451
Yomaira,F,100,451,0,451
Alyia,F,100,450,0,450
Amellia,F,100,450,0,450
Bre,F,100,450,0,450
Darey,M,100,0,450,450
Darwyn,M,100,0,450,450
Diem,F,92,413,37,450
Dorenda,F,100,450,0,450
Elane,F,100,450,0,450
Elita,F,100,450,0,450
Hailley,F,100,450,0,450
Iyona,F,100,450,0,450
Kasaundra,F,100,450,0,450
Keiley,F,100,450,0,450
Lasonia,F,100,450,0,450
Lelan,M,100,0,450,450
Magdalyn,F,100,450,0,450
Merlinda,F,100,450,0,450
Nakeshia,F,100,450,0,450
Nyeisha,F,100,450,0,450
Pinchus,M,100,0,450,450
Ranita,F,100,450,0,450
Ronold,M,100,0,450,450
Tayanna,F,100,450,0,450
Tobiah,M,100,0,450,450
Tylynn,F,91,410,40,450
Venise,F,100,450,0,450
Zeeshan,M,100,0,450,450
Alexandru,M,100,0,449,449
Alexya,F,100,449,0,449
Blimy,F,100,449,0,449
Emmylou,F,100,449,0,449
Ericia,F,100,449,0,449
Kyon,M,100,0,449,449
Laveda,F,100,449,0,449
Liem,M,100,0,449,449
Ming,M,69,141,308,449
Nachelle,F,100,449,0,449
Reyanna,F,100,449,0,449
Sebrena,F,100,449,0,449
Timur,M,100,0,449,449
Toinette,F,100,449,0,449
Truly,F,100,449,0,449
Anjana,F,100,448,0,448
Avionna,F,100,448,0,448
Bay,F,69,309,139,448
Daejah,F,100,448,0,448
Evany,F,100,448,0,448
Harini,F,100,448,0,448
Jamea,F,100,448,0,448
Lakira,F,100,448,0,448
Mouhamed,M,100,0,448,448
Ngozi,F,95,427,21,448
Rafi,M,100,0,448,448
Rossi,M,55,202,246,448
Cantrell,M,85,65,382,447
Dezerae,F,100,447,0,447
Jinger,F,100,447,0,447
Kiele,F,100,447,0,447
Leoncio,M,100,0,447,447
Loura,F,100,447,0,447
Malaysha,F,100,447,0,447
Sharlet,F,100,447,0,447
Shaul,M,100,0,447,447
Shruthi,F,100,447,0,447
Skylie,F,100,447,0,447
Tailyn,F,99,442,5,447
Tiasia,F,100,447,0,447
Yazmeen,F,100,447,0,447
Alease,F,100,446,0,446
Amorette,F,100,446,0,446
Bane,M,100,0,446,446
Bettyjo,F,100,446,0,446
Briaunna,F,100,446,0,446
Celestia,F,100,446,0,446
Dorethea,F,100,446,0,446
Dushawn,M,98,11,435,446
Herson,M,100,0,446,446
Kyndle,F,97,434,12,446
Lateesha,F,100,446,0,446
Makisha,F,100,446,0,446
Nadean,F,100,446,0,446
Rece,M,99,5,441,446
Sherena,F,100,446,0,446
Torsten,M,100,0,446,446
Tzivia,F,100,446,0,446
Zacharey,M,100,0,446,446
Zebediah,M,100,0,446,446
Alese,F,100,445,0,445
Alexah,F,100,445,0,445
Bridgid,F,100,445,0,445
Chee,M,53,209,236,445
Cymone,F,100,445,0,445
Dickey,M,100,0,445,445
Dodge,M,100,0,445,445
Donnisha,F,100,445,0,445
Hadiyah,F,100,445,0,445
Hensley,F,85,377,68,445
Hollye,F,100,445,0,445
Ioanna,F,100,445,0,445
Jari,F,62,276,169,445
Kemar,M,100,0,445,445
Krzysztof,M,100,0,445,445
Kyjuan,M,100,0,445,445
Latrecia,F,100,445,0,445
Laurynn,F,100,445,0,445
Lovetta,F,100,445,0,445
Magdiel,M,94,26,419,445
Markeese,M,100,0,445,445
Michiko,F,100,445,0,445
Midge,F,100,445,0,445
Niema,F,100,445,0,445
Nuha,F,100,445,0,445
Oumar,M,100,0,445,445
Patra,F,100,445,0,445
Shaden,M,58,185,260,445
Shauntay,F,99,439,6,445
Shreeya,F,100,445,0,445
Ainslie,F,100,444,0,444
Joshwa,M,100,0,444,444
Jujuan,M,99,5,439,444
Karna,F,99,438,6,444
Keria,F,100,444,0,444
Loring,M,95,22,422,444
Lorriane,F,100,444,0,444
Mahealani,F,100,444,0,444
Manha,F,100,444,0,444
Nickalus,M,100,0,444,444
Roben,F,71,314,130,444
Rosaleen,F,100,444,0,444
Saint,M,100,0,444,444
Sintia,F,100,444,0,444
Ailish,F,100,443,0,443
Andrews,M,100,0,443,443
Angeleah,F,100,443,0,443
Angelicia,F,100,443,0,443
Artavia,F,100,443,0,443
Bunnie,F,100,443,0,443
Dalin,M,94,27,416,443
Debie,F,100,443,0,443
Esli,F,77,339,104,443
Jeyson,M,100,0,443,443
Jorell,M,100,0,443,443
Laveta,F,100,443,0,443
Lawernce,M,100,0,443,443
Maddelyn,F,100,443,0,443
Margene,F,99,438,5,443
Michaiah,F,80,355,88,443
Nasha,F,100,443,0,443
Odyssey,F,99,438,5,443
Reiko,F,97,431,12,443
Rodric,M,100,0,443,443
Aki,M,55,199,243,442
Asucena,F,100,442,0,442
Cylas,M,100,0,442,442
Dimitris,M,100,0,442,442
Dorrian,M,93,31,411,442
Jakara,F,100,442,0,442
Jeanann,F,100,442,0,442
Jensyn,F,86,381,61,442
Jerek,M,100,0,442,442
Junie,F,99,437,5,442
Leesha,F,100,442,0,442
Nadina,F,100,442,0,442
Nomar,M,100,0,442,442
Shyloh,F,82,364,78,442
Vaibhav,M,100,0,442,442
Yamir,M,100,0,442,442
Zaccheus,M,100,0,442,442
Zakk,M,100,0,442,442
Agustine,M,100,0,441,441
Alaska,F,100,441,0,441
Alaynna,F,100,441,0,441
Amita,F,100,441,0,441
Bejamin,M,100,0,441,441
Buckley,M,100,0,441,441
Charna,F,100,441,0,441
Christo,M,100,0,441,441
Dallana,F,100,441,0,441
Emaly,F,100,441,0,441
Erving,M,100,0,441,441
Foy,M,99,5,436,441
Granger,M,100,0,441,441
Ishita,F,100,441,0,441
Johncarlos,M,100,0,441,441
Nikoli,M,100,0,441,441
Pawel,M,100,0,441,441
Reshma,F,100,441,0,441
Sherian,F,100,441,0,441
Sriram,M,100,0,441,441
Teresea,F,100,441,0,441
Toree,F,93,411,30,441
Zanna,F,100,441,0,441
Andrell,M,70,134,306,440
Annastacia,F,100,440,0,440
Briceida,F,100,440,0,440
Carron,F,78,342,98,440
Chiamaka,F,100,440,0,440
Derika,F,100,440,0,440
Eion,M,100,0,440,440
Gergory,M,100,0,440,440
Giulio,M,100,0,440,440
Graeson,M,97,15,425,440
Haedyn,F,64,282,158,440
Heron,M,99,5,435,440
Jacksen,M,100,0,440,440
Jacquan,M,100,0,440,440
Jamien,M,99,5,435,440
Jenita,F,100,440,0,440
Kaliana,F,100,440,0,440
Kamrie,F,100,440,0,440
Krystalyn,F,100,440,0,440
Lavona,F,100,440,0,440
Mckennah,F,100,440,0,440
Rheannon,F,100,440,0,440
Rielly,F,55,244,196,440
Sriya,F,100,440,0,440
Tanijah,F,100,440,0,440
Zurisadai,F,100,440,0,440
Alegandro,M,100,0,439,439
Arleigh,F,82,359,80,439
Bogdan,M,100,0,439,439
Chane,M,71,128,311,439
Degan,M,100,0,439,439
Deziray,F,100,439,0,439
Eliu,M,100,0,439,439
Hamed,M,100,0,439,439
Jadzia,F,100,439,0,439
Kaleel,M,100,0,439,439
Kemoni,F,54,238,201,439
Landree,F,99,433,6,439
Lateasha,F,100,439,0,439
Lus,F,100,439,0,439
Peg,F,100,439,0,439
Rakesh,M,100,0,439,439
Starling,M,76,106,333,439
Syniah,F,100,439,0,439
Tanda,F,100,439,0,439
Thurmond,M,100,0,439,439
Wright,M,100,0,439,439
Yanna,F,100,439,0,439
Abubakar,M,100,0,438,438
Atalia,F,100,438,0,438
Cecillia,F,100,438,0,438
Deaundra,F,73,318,120,438
Desiderio,M,100,0,438,438
Dimitry,M,100,0,438,438
Doreatha,F,100,438,0,438
Drena,F,100,438,0,438
Elyssia,F,100,438,0,438
Javarious,M,100,0,438,438
Lenda,F,100,438,0,438
Lendell,M,100,0,438,438
Linna,F,100,438,0,438
Maalik,M,100,0,438,438
Marquies,M,100,0,438,438
Muhamed,M,100,0,438,438
Riddhi,F,100,438,0,438
Seaira,F,100,438,0,438
Shanley,F,100,438,0,438
Shayn,M,100,0,438,438
Tashanna,F,100,438,0,438
Tiarah,F,100,438,0,438
Tresia,F,100,438,0,438
Tula,F,100,438,0,438
Yeni,F,100,438,0,438
Zykia,F,100,438,0,438
Ailsa,F,100,437,0,437
Athen,M,100,0,437,437
Conall,M,100,0,437,437
Geralynn,F,100,437,0,437
Getsemani,F,97,425,12,437
Jenalee,F,100,437,0,437
Jonisha,F,100,437,0,437
Keilly,F,100,437,0,437
Maisey,F,100,437,0,437
Nadiah,F,100,437,0,437
Palmira,F,100,437,0,437
Ruddy,M,99,5,432,437
Rulon,M,100,0,437,437
Tristina,F,100,437,0,437
Victorio,M,100,0,437,437
Yennifer,F,100,437,0,437
Zaara,F,100,437,0,437
Zanaya,F,100,437,0,437
Adelbert,M,100,0,436,436
Cassidie,F,100,436,0,436
Codee,M,58,185,251,436
Emmagrace,F,100,436,0,436
Gaberial,M,96,16,420,436
Imoni,F,100,436,0,436
Jaevon,M,100,0,436,436
Jakhia,F,100,436,0,436
Jamare,M,100,0,436,436
Jasia,F,99,430,6,436
Jissel,F,100,436,0,436
Krisann,F,100,436,0,436
Laderrick,M,100,0,436,436
Layth,M,100,0,436,436
Marlenne,F,100,436,0,436
Nabiha,F,100,436,0,436
Natilee,F,100,436,0,436
Pheng,M,100,0,436,436
Salima,F,100,436,0,436
Sanda,F,100,436,0,436
Shelah,F,100,436,0,436
Tighe,M,100,0,436,436
Yvetta,F,100,436,0,436
Aralynn,F,100,435,0,435
Auther,M,100,0,435,435
Charese,F,100,435,0,435
Daisia,F,100,435,0,435
Dawanna,F,100,435,0,435
Dhara,F,100,435,0,435
Dorman,M,100,0,435,435
Hadden,M,96,16,419,435
Humphrey,M,100,0,435,435
Jamaris,M,82,77,358,435
Jessejames,M,100,0,435,435
Jj,M,100,0,435,435
Kabrina,F,100,435,0,435
Kaeson,M,100,0,435,435
Krislynn,F,100,435,0,435
Madalin,F,100,435,0,435
Malick,M,100,0,435,435
Mayumi,F,100,435,0,435
Ruhi,F,100,435,0,435
Shawnice,F,100,435,0,435
Suha,F,100,435,0,435
Terril,M,87,58,377,435
Trinh,F,100,435,0,435
Tymon,M,100,0,435,435
Yuriana,F,100,435,0,435
Zalmen,M,100,0,435,435
Almira,F,100,434,0,434
Beckam,M,100,0,434,434
Emmarose,F,100,434,0,434
Erminia,F,100,434,0,434
Erol,M,100,0,434,434
Fabrice,M,100,0,434,434
Gryphon,M,100,0,434,434
Lawayne,M,98,10,424,434
Makari,M,83,72,362,434
Sabah,F,100,434,0,434
Scotlyn,F,100,434,0,434
Selenia,F,100,434,0,434
Shakema,F,100,434,0,434
Sharmon,F,98,427,7,434
Shevon,F,97,419,15,434
Taber,M,94,28,406,434
Tharon,M,97,12,422,434
Valecia,F,100,434,0,434
Yetta,F,100,434,0,434
Alcides,M,100,0,433,433
Ary,M,61,171,262,433
Bellamy,F,100,433,0,433
Breianna,F,100,433,0,433
Calysta,F,100,433,0,433
Chaun,M,97,11,422,433
Cherrell,F,100,433,0,433
Daxon,M,100,0,433,433
Deno,M,100,0,433,433
Destyne,F,100,433,0,433
Devonn,M,95,23,410,433
Donyale,F,82,354,79,433
Duaine,M,100,0,433,433
Embry,F,56,241,192,433
Emillie,F,100,433,0,433
Garion,M,100,0,433,433
Jamella,F,100,433,0,433
Jiovani,M,100,0,433,433
Kidus,M,100,0,433,433
Kimbely,F,100,433,0,433
Laquasha,F,100,433,0,433
Richey,M,100,0,433,433
Shaianne,F,100,433,0,433
Shaneeka,F,100,433,0,433
Shiane,F,100,433,0,433
Sim,M,100,0,433,433
Suraya,F,100,433,0,433
Taura,F,100,433,0,433
Theadora,F,100,433,0,433
Vivi,F,100,433,0,433
Aarti,F,100,432,0,432
Adanna,F,100,432,0,432
Aletta,F,100,432,0,432
Almeta,F,100,432,0,432
Annarose,F,100,432,0,432
Calina,F,100,432,0,432
Charee,F,100,432,0,432
Dajia,F,100,432,0,432
Dalya,F,100,432,0,432
Eliam,M,100,0,432,432
Elizabethann,F,100,432,0,432
Feliz,M,56,192,240,432
Graziella,F,100,432,0,432
Illyana,F,100,432,0,432
Jakhari,M,100,0,432,432
Kaisen,M,99,6,426,432
Kamika,F,100,432,0,432
Kinzlee,F,100,432,0,432
Kort,M,100,0,432,432
Laquandra,F,100,432,0,432
Lissete,F,100,432,0,432
Rosabella,F,100,432,0,432
Rosaisela,F,100,432,0,432
Roshaun,M,87,55,377,432
Shahd,F,100,432,0,432
Stevin,M,100,0,432,432
Tashayla,F,100,432,0,432
Taten,M,100,0,432,432
Analis,F,100,431,0,431
Arlee,F,81,347,84,431
Arlisa,F,100,431,0,431
Cheskel,M,100,0,431,431
Cobie,M,79,91,340,431
Everton,M,100,0,431,431
Ilena,F,100,431,0,431
Jousha,M,100,0,431,431
Lorette,F,100,431,0,431
Mashayla,F,100,431,0,431
Masiah,M,80,87,344,431
Netanya,F,100,431,0,431
Sharanda,F,100,431,0,431
Shenandoah,F,74,319,112,431
Sonni,F,97,416,15,431
Whitman,M,100,0,431,431
Athanasia,F,100,430,0,430
Demarquis,M,100,0,430,430
Dineen,F,100,430,0,430
Dmarco,M,100,0,430,430
Doree,F,100,430,0,430
Eila,F,100,430,0,430
Evian,F,51,220,210,430
Gerrell,M,100,0,430,430
Imad,M,100,0,430,430
Jolynne,F,100,430,0,430
Jomarie,F,99,425,5,430
Khole,F,84,361,69,430
Kiauna,F,100,430,0,430
Lizmarie,F,100,430,0,430
Marycruz,F,100,430,0,430
Mystique,F,100,430,0,430
Nirav,M,100,0,430,430
Noora,F,100,430,0,430
Rei,F,51,219,211,430
Shenelle,F,100,430,0,430
Tava,F,100,430,0,430
Teneisha,F,100,430,0,430
Zakiah,F,75,322,108,430
Anabela,F,100,429,0,429
Charelle,F,100,429,0,429
Glori,F,100,429,0,429
Jacek,M,100,0,429,429
Jamesetta,F,100,429,0,429
Josetta,F,100,429,0,429
Kellsey,F,100,429,0,429
Keng,M,100,0,429,429
Kerigan,F,100,429,0,429
Keyasia,F,100,429,0,429
Keyna,F,100,429,0,429
Lashonna,F,100,429,0,429
Miyana,F,100,429,0,429
Rosevelt,M,100,0,429,429
Shalane,F,100,429,0,429
Tajae,F,60,256,173,429
Tommaso,M,100,0,429,429
Barnard,M,100,0,428,428
Clemon,M,100,0,428,428
Copeland,M,89,49,379,428
Dow,M,100,0,428,428
Eulogio,M,100,0,428,428
Ikechukwu,M,100,0,428,428
Jamisen,M,62,162,266,428
Jericka,F,100,428,0,428
Kayonna,F,100,428,0,428
Marcin,M,100,0,428,428
Mellany,F,100,428,0,428
Sarha,F,100,428,0,428
Shakim,M,100,0,428,428
Shlome,M,100,0,428,428
Zury,F,100,428,0,428
Zya,F,100,428,0,428
Amori,F,58,247,180,427
Anesa,F,100,427,0,427
Charlet,F,100,427,0,427
Gayleen,F,100,427,0,427
Grabiela,F,100,427,0,427
Hawk,M,100,0,427,427
Jotham,M,100,0,427,427
Kimia,F,100,427,0,427
Leylah,F,100,427,0,427
Madalene,F,100,427,0,427
Maylen,F,100,427,0,427
Mikhaila,F,100,427,0,427
Renesmee,F,100,427,0,427
Safiyah,F,100,427,0,427
Tiahna,F,100,427,0,427
Tu,M,74,109,318,427
Apolonia,F,100,426,0,426
Artemus,M,100,0,426,426
Azusena,F,100,426,0,426
Brigida,F,100,426,0,426
Dedria,F,100,426,0,426
Hyun,M,61,168,258,426
Jeena,F,100,426,0,426
Loan,F,100,426,0,426
Nayelie,F,100,426,0,426
Rhylan,M,63,158,268,426
Senna,F,95,403,23,426
Shailee,F,100,426,0,426
Shina,F,100,426,0,426
Timon,M,100,0,426,426
Xandra,F,100,426,0,426
Caela,F,100,425,0,425
Camber,F,96,406,19,425
Carrick,M,100,0,425,425
Chrisann,F,100,425,0,425
Corwyn,M,100,0,425,425
Dmitriy,M,100,0,425,425
Estephania,F,100,425,0,425
Frederik,M,100,0,425,425
Graceanne,F,100,425,0,425
Javone,M,97,11,414,425
Jeovany,M,100,0,425,425
Jessyka,F,100,425,0,425
Jeston,M,100,0,425,425
Jibreel,M,100,0,425,425
Kalab,M,100,0,425,425
Keelee,F,100,425,0,425
Kellene,F,100,425,0,425
Lagina,F,100,425,0,425
Lorra,F,100,425,0,425
Mckell,F,97,412,13,425
Renesha,F,100,425,0,425
Selinda,F,100,425,0,425
Sendy,F,100,425,0,425
Shelina,F,100,425,0,425
Shian,F,99,419,6,425
Syliva,F,100,425,0,425
Trenell,M,66,144,281,425
Aidon,M,100,0,424,424
Athziri,F,100,424,0,424
Carlous,M,100,0,424,424
Christohper,M,100,0,424,424
Deavon,M,93,29,395,424
Edelmira,F,100,424,0,424
Inayah,F,100,424,0,424
Inessa,F,100,424,0,424
Isidore,M,100,0,424,424
Ladainian,M,100,0,424,424
Melayna,F,100,424,0,424
Moncia,F,100,424,0,424
Orian,M,86,58,366,424
Raeshawn,M,71,124,300,424
Railyn,F,100,424,0,424
Roxan,F,100,424,0,424
Saxton,M,100,0,424,424
Sharnice,F,100,424,0,424
Stryder,M,100,0,424,424
Tilda,F,100,424,0,424
Vanisha,F,100,424,0,424
Vianka,F,100,424,0,424
Yosselin,F,100,424,0,424
Aashi,F,100,423,0,423
Anetra,F,100,423,0,423
Artavious,M,100,0,423,423
Baylea,F,100,423,0,423
Britanie,F,100,423,0,423
Charlyne,F,100,423,0,423
Darlynn,F,100,423,0,423
Darnetta,F,100,423,0,423
Ellijah,M,100,0,423,423
Emmanual,M,100,0,423,423
Falynn,F,100,423,0,423
Jamile,M,52,204,219,423
Kaity,F,100,423,0,423
Kawanda,F,100,423,0,423
Kearston,F,99,417,6,423
Kenlie,F,100,423,0,423
Ludivina,F,100,423,0,423
Maayan,F,99,418,5,423
Mersadies,F,100,423,0,423
Obrian,M,100,0,423,423
Quamir,M,100,0,423,423
Quindarius,M,100,0,423,423
Samiha,F,100,423,0,423
Sayed,M,100,0,423,423
Shaelee,F,100,423,0,423
Shanyah,F,100,423,0,423
Stavroula,F,100,423,0,423
Trianna,F,100,423,0,423
Uzziel,M,100,0,423,423
Yolando,F,99,418,5,423
Aaliyha,F,100,422,0,422
Ahana,F,100,422,0,422
Arlean,F,100,422,0,422
Baley,F,76,319,103,422
Caeley,F,100,422,0,422
Hilliard,M,100,0,422,422
Jayd,F,75,316,106,422
Jesslynn,F,100,422,0,422
Jovonna,F,100,422,0,422
Kashmere,F,71,301,121,422
Keivon,M,100,0,422,422
Kenly,F,85,358,64,422
Krissie,F,100,422,0,422
Liisa,F,100,422,0,422
Lurdes,F,100,422,0,422
Ryken,M,99,5,417,422
Sameerah,F,100,422,0,422
Sophya,F,100,422,0,422
Stephaney,F,100,422,0,422
Taresa,F,100,422,0,422
Tarron,M,95,20,402,422
Venson,M,100,0,422,422
Verl,M,100,0,422,422
Yee,M,52,201,221,422
Anthonio,M,100,0,421,421
Atziri,F,100,421,0,421
Brydon,M,100,0,421,421
Deette,F,100,421,0,421
Issaiah,M,100,0,421,421
Jamyla,F,100,421,0,421
Jonique,F,100,421,0,421
Kayse,F,97,410,11,421
Kerstyn,F,100,421,0,421
Larenz,M,100,0,421,421
Maggy,F,100,421,0,421
Marney,F,100,421,0,421
Sabir,M,100,0,421,421
Zaylin,M,63,155,266,421
Aleina,F,100,420,0,420
Amandeep,M,56,183,237,420
Amberleigh,F,100,420,0,420
Amelya,F,100,420,0,420
Aracelia,F,100,420,0,420
Chay,M,87,54,366,420
Crissa,F,100,420,0,420
Deanie,F,98,410,10,420
Detric,M,99,5,415,420
Faiz,M,100,0,420,420
Farida,F,100,420,0,420
Gita,F,100,420,0,420
Haruka,F,100,420,0,420
Jabar,M,100,0,420,420
Kariana,F,100,420,0,420
Kevina,F,100,420,0,420
Lazaria,F,100,420,0,420
Marlissa,F,100,420,0,420
Mathilde,F,100,420,0,420
Monesha,F,100,420,0,420
Nuri,M,55,191,229,420
Orlin,M,100,0,420,420
Riggs,M,100,0,420,420
Rosilyn,F,100,420,0,420
Rossy,F,100,420,0,420
Sarenity,F,100,420,0,420
Shean,M,99,6,414,420
Tamicka,F,100,420,0,420
Terrina,F,100,420,0,420
Thang,M,98,7,413,420
Yliana,F,100,420,0,420
Amariyah,F,100,419,0,419
Atlantis,F,96,402,17,419
Axle,M,100,0,419,419
Bonnita,F,100,419,0,419
Cesare,M,100,0,419,419
Chantele,F,100,419,0,419
Dabney,F,80,334,85,419
Kelleigh,F,100,419,0,419
Kier,M,97,11,408,419
Konstantina,F,100,419,0,419
Lashona,F,100,419,0,419
Lord,M,100,0,419,419
Machaela,F,100,419,0,419
Nur,F,77,321,98,419
Saima,F,100,419,0,419
Sharaya,F,100,419,0,419
Tehani,F,100,419,0,419
Tila,F,100,419,0,419
Alysen,F,100,418,0,418
Areana,F,100,418,0,418
Ashliegh,F,100,418,0,418
Cala,F,100,418,0,418
Charlita,F,100,418,0,418
Charnae,F,100,418,0,418
Cissy,F,100,418,0,418
Daevion,M,100,0,418,418
Dakayla,F,100,418,0,418
Danel,M,65,147,271,418
Duaa,F,100,418,0,418
Emmersyn,F,100,418,0,418
Honesti,F,100,418,0,418
Kaly,F,100,418,0,418
Marche,F,98,411,7,418
Oumou,F,100,418,0,418
Rozlynn,F,100,418,0,418
Sherine,F,100,418,0,418
Takeshia,F,100,418,0,418
Tatjana,F,100,418,0,418
Zaylie,F,100,418,0,418
Abbygayle,F,100,417,0,417
Alexiah,F,100,417,0,417
Allayna,F,100,417,0,417
Braidon,M,100,0,417,417
Callia,F,100,417,0,417
Chadley,M,100,0,417,417
Gamal,M,100,0,417,417
Gauri,F,100,417,0,417
Kadan,M,98,7,410,417
Kadesha,F,100,417,0,417
Katasha,F,100,417,0,417
Kristia,F,100,417,0,417
Ladarious,M,100,0,417,417
Louden,M,100,0,417,417
Lynde,F,100,417,0,417
Mayce,F,100,417,0,417
Mkayla,F,100,417,0,417
Teretha,F,100,417,0,417
Trevian,M,100,0,417,417
Valena,F,100,417,0,417
Alexxus,F,100,416,0,416
Arrie,F,81,336,80,416
Ashira,F,100,416,0,416
Braelin,M,56,181,235,416
Caylyn,F,100,416,0,416
Conny,F,83,344,72,416
Dierra,F,100,416,0,416
Etty,F,100,416,0,416
Jeniyah,F,100,416,0,416
Jeromey,M,100,0,416,416
Kathrynn,F,100,416,0,416
Kysen,M,100,0,416,416
Lang,M,99,6,410,416
Markham,M,100,0,416,416
Modesty,F,100,416,0,416
Monifa,F,100,416,0,416
Oracio,M,100,0,416,416
Stephano,M,100,0,416,416
Tallen,M,100,0,416,416
Whitnie,F,100,416,0,416
Alydia,F,100,415,0,415
Brendalee,F,100,415,0,415
Byanca,F,100,415,0,415
Cordel,M,100,0,415,415
Dejaun,M,100,0,415,415
Derris,M,100,0,415,415
Kae,F,100,415,0,415
Kealy,F,100,415,0,415
Kiahna,F,100,415,0,415
Lynsi,F,100,415,0,415
Maryana,F,100,415,0,415
Mikaya,F,100,415,0,415
Rayetta,F,100,415,0,415
Sanjeev,M,100,0,415,415
Tedi,F,100,415,0,415
Ziare,M,80,84,331,415
Zyana,F,100,415,0,415
Aureliano,M,100,0,414,414
Bretta,F,100,414,0,414
Deiondre,M,100,0,414,414
Jarah,F,97,403,11,414
Jayah,F,100,414,0,414
Keyri,F,100,414,0,414
Larina,F,100,414,0,414
Lonie,M,50,206,208,414
Marisel,F,100,414,0,414
Megyn,F,100,414,0,414
Mela,F,100,414,0,414
Mervyn,M,100,0,414,414
Mykaila,F,100,414,0,414
Nasia,F,100,414,0,414
Nastasha,F,100,414,0,414
Rishika,F,100,414,0,414
Tracia,F,100,414,0,414
Tymere,M,100,0,414,414
Ahmani,F,85,352,61,413
Alinda,F,100,413,0,413
Angad,M,100,0,413,413
Aribella,F,100,413,0,413
Berna,F,100,413,0,413
Bray,M,97,13,400,413
Eberardo,M,100,0,413,413
Elyzabeth,F,100,413,0,413
Fae,F,100,413,0,413
Henery,M,100,0,413,413
Jackelyne,F,100,413,0,413
Jeter,M,100,0,413,413
Keilee,F,100,413,0,413
Letrice,F,100,413,0,413
Mattox,M,94,24,389,413
Sevastian,M,100,0,413,413
Sharna,F,100,413,0,413
Tallie,F,99,408,5,413
Viveca,F,100,413,0,413
Yadier,M,100,0,413,413
Amillia,F,100,412,0,412
Ashlyne,F,100,412,0,412
Delyla,F,100,412,0,412
Dereka,F,100,412,0,412
Emanuela,F,100,412,0,412
Ily,F,100,412,0,412
Jeniah,F,100,412,0,412
Jerman,M,100,0,412,412
Jhovany,M,100,0,412,412
Joia,F,100,412,0,412
Jorgen,M,100,0,412,412
Kainan,M,100,0,412,412
Kaleia,F,100,412,0,412
Kenli,F,100,412,0,412
Kennadee,F,100,412,0,412
Liat,F,100,412,0,412
Sherrice,F,100,412,0,412
Sophi,F,100,412,0,412
Tin,M,100,0,412,412
Zailey,F,100,412,0,412
Zamora,F,100,412,0,412
Analilia,F,100,411,0,411
Dannica,F,100,411,0,411
Deneisha,F,100,411,0,411
Dermot,M,100,0,411,411
Destyn,M,78,92,319,411
Dmario,M,100,0,411,411
Jakobie,M,100,0,411,411
Kayly,F,100,411,0,411
Kenza,F,100,411,0,411
Kysha,F,100,411,0,411
Labria,F,100,411,0,411
Lynnda,F,100,411,0,411
Mandeep,M,61,160,251,411
Sahib,M,99,5,406,411
Shalise,F,100,411,0,411
Terrilynn,F,100,411,0,411
Vansh,M,100,0,411,411
Vergie,F,100,411,0,411
Whitlee,F,100,411,0,411
Baleria,F,100,410,0,410
Colbert,M,100,0,410,410
Duc,M,100,0,410,410
Elvera,F,100,410,0,410
Gavon,M,100,0,410,410
Ivone,F,100,410,0,410
Jaimy,F,93,381,29,410
Jewelia,F,100,410,0,410
Josefine,F,100,410,0,410
Juliocesar,M,100,0,410,410
Kalayah,F,100,410,0,410
Krizia,F,100,410,0,410
Laurieann,F,100,410,0,410
Marinna,F,100,410,0,410
Mattilyn,F,100,410,0,410
Mikko,M,98,10,400,410
Mora,F,100,410,0,410
Nekisha,F,100,410,0,410
Patrisia,F,100,410,0,410
Pharoah,M,100,0,410,410
Ronel,M,99,6,404,410
Akina,F,100,409,0,409
Baillie,F,100,409,0,409
Bebe,F,100,409,0,409
Cleotha,M,93,28,381,409
Dalynn,F,89,365,44,409
Damaria,F,83,340,69,409
Deaja,F,100,409,0,409
Demani,M,77,95,314,409
Dickson,M,100,0,409,409
Dvonte,M,100,0,409,409
Dwanna,F,100,409,0,409
Finis,M,100,0,409,409
Jahna,F,100,409,0,409
Jalee,F,100,409,0,409
Janneth,F,100,409,0,409
Janney,F,100,409,0,409
Jazlyne,F,100,409,0,409
Julaine,F,100,409,0,409
Kendrah,F,100,409,0,409
Moniqua,F,100,409,0,409
Nyra,F,100,409,0,409
Prem,M,100,0,409,409
Quinesha,F,100,409,0,409
Rolinda,F,100,409,0,409
Shabnam,F,100,409,0,409
Shaney,F,100,409,0,409
Shanica,F,100,409,0,409
Travin,M,100,0,409,409
Vangie,F,100,409,0,409
Weslie,M,58,172,237,409
Aleem,M,100,0,408,408
Avie,F,99,402,6,408
Brianah,F,100,408,0,408
Bryen,M,100,0,408,408
Chianti,F,95,388,20,408
Crystall,F,100,408,0,408
Danta,M,98,10,398,408
Delphina,F,100,408,0,408
Elenor,F,100,408,0,408
Emmalin,F,100,408,0,408
Emya,F,100,408,0,408
Germany,F,57,231,177,408
Ji,F,61,250,158,408
Keani,F,94,383,25,408
Lacrisha,F,100,408,0,408
Laresa,F,100,408,0,408
Lisanne,F,100,408,0,408
Makylah,F,100,408,0,408
Markeshia,F,100,408,0,408
Nou,F,86,352,56,408
Orland,M,100,0,408,408
Parry,M,100,0,408,408
Shraga,M,100,0,408,408
Tabari,M,100,0,408,408
Tasheka,F,100,408,0,408
Tijuan,M,100,0,408,408
Toshiba,F,100,408,0,408
Whit,M,100,0,408,408
Ailee,F,100,407,0,407
Aleatha,F,100,407,0,407
Andrick,M,100,0,407,407
Arch,M,100,0,407,407
Blanch,F,100,407,0,407
Caio,M,100,0,407,407
Cindia,F,100,407,0,407
Davionna,F,100,407,0,407
Dravin,M,100,0,407,407
Emeka,M,96,17,390,407
Even,M,100,0,407,407
Hyman,M,100,0,407,407
Jacara,F,100,407,0,407
Jehan,F,77,315,92,407
Jevonte,M,100,0,407,407
Jullie,F,100,407,0,407
Karrigan,F,100,407,0,407
Kendrix,M,96,17,390,407
Lala,F,100,407,0,407
Levester,M,100,0,407,407
Myana,F,100,407,0,407
Randale,M,100,0,407,407
Raveen,F,100,407,0,407
Rayon,M,97,11,396,407
Sumaiya,F,100,407,0,407
Tifanie,F,100,407,0,407
Trashawn,M,93,29,378,407
Yudith,F,100,407,0,407
Aariz,M,100,0,406,406
Analaura,F,100,406,0,406
Aprill,F,100,406,0,406
Chanae,F,100,406,0,406
Eiza,F,100,406,0,406
Elanna,F,100,406,0,406
Gaynelle,F,100,406,0,406
Hadlie,F,100,406,0,406
Hanley,M,66,139,267,406
Hoda,F,100,406,0,406
Jud,M,100,0,406,406
Martisha,F,100,406,0,406
Milka,F,100,406,0,406
Paizlee,F,100,406,0,406
Sakari,F,90,366,40,406
Simmie,M,98,10,396,406
Anagha,F,100,405,0,405
Arshia,F,72,293,112,405
Atif,M,100,0,405,405
Caitrin,F,100,405,0,405
Cristoval,M,100,0,405,405
Cythia,F,100,405,0,405
Earleen,F,100,405,0,405
Emberlyn,F,100,405,0,405
Finian,M,100,0,405,405
Gaila,F,100,405,0,405
Garrin,M,100,0,405,405
Haseeb,M,100,0,405,405
Iasia,F,100,405,0,405
Jakiah,F,88,357,48,405
Kaedence,F,98,397,8,405
Kanaan,M,100,0,405,405
Karys,F,100,405,0,405
Kelisha,F,100,405,0,405
Kyliegh,F,100,405,0,405
Quavon,M,100,0,405,405
Shalita,F,100,405,0,405
Shaquila,F,100,405,0,405
Sonam,F,85,346,59,405
Tomer,M,100,0,405,405
Yaslin,F,100,405,0,405
Yoko,F,100,405,0,405
Akshaj,M,100,0,404,404
Arantza,F,100,404,0,404
Ashiya,F,100,404,0,404
Ayinde,M,100,0,404,404
Azeem,M,100,0,404,404
Calixto,M,100,0,404,404
Chanita,F,100,404,0,404
Colon,M,100,0,404,404
Guilherme,M,100,0,404,404
Hao,M,99,5,399,404
Inaaya,F,100,404,0,404
Jerremy,M,100,0,404,404
Jovante,M,100,0,404,404
Kensi,F,100,404,0,404
Lekeshia,F,100,404,0,404
Lizanne,F,100,404,0,404
Logann,F,95,382,22,404
Minor,M,100,0,404,404
Mohit,M,100,0,404,404
Nathaneil,M,100,0,404,404
Parthenia,F,100,404,0,404
Shawndell,M,64,146,258,404
Shelena,F,100,404,0,404
Stellan,M,100,0,404,404
Syerra,F,100,404,0,404
Tanga,F,100,404,0,404
Teyonna,F,100,404,0,404
Vadim,M,100,0,404,404
Viliami,M,100,0,404,404
Zaliyah,F,100,404,0,404
Ziona,F,100,404,0,404
Zitlali,F,100,404,0,404
Aadyn,M,96,16,387,403
Adalynne,F,100,403,0,403
Aishia,F,100,403,0,403
Aldrin,M,100,0,403,403
Analiah,F,100,403,0,403
Anelise,F,100,403,0,403
Braydn,M,100,0,403,403
Braylie,F,100,403,0,403
Christophr,M,100,0,403,403
Debanhi,F,100,403,0,403
Harmoney,F,100,403,0,403
Isaah,M,100,0,403,403
Jacorian,M,100,0,403,403
Jaiquan,M,100,0,403,403
Jatavia,F,100,403,0,403
Kaiah,F,100,403,0,403
Kaniah,F,100,403,0,403
Keairra,F,100,403,0,403
Makell,M,63,148,255,403
Marja,F,100,403,0,403
Michaell,M,99,5,398,403
Minette,F,100,403,0,403
Nalia,F,100,403,0,403
Saudia,F,100,403,0,403
Siddhant,M,100,0,403,403
Sole,F,100,403,0,403
Surina,F,100,403,0,403
Swati,F,100,403,0,403
Thomasena,F,100,403,0,403
Tyric,M,100,0,403,403
Abdulla,M,100,0,402,402
Advaith,M,100,0,402,402
Allexis,F,100,402,0,402
Ariyonna,F,100,402,0,402
Avigayil,F,100,402,0,402
Bradan,M,100,0,402,402
Brittania,F,100,402,0,402
Clorissa,F,100,402,0,402
Crue,M,100,0,402,402
Donika,F,100,402,0,402
Elycia,F,100,402,0,402
Espen,M,99,5,397,402
Garcia,M,91,36,366,402
Gustabo,M,100,0,402,402
Issak,M,100,0,402,402
Jakya,F,100,402,0,402
Jamian,M,100,0,402,402
Joh,M,100,0,402,402
Kadejah,F,100,402,0,402
Kaipo,M,100,0,402,402
Lorisa,F,100,402,0,402
Lya,F,100,402,0,402
Orla,F,99,396,6,402
Rahil,M,99,6,396,402
Riker,M,100,0,402,402
Sahira,F,100,402,0,402
Siham,F,100,402,0,402
Snow,F,99,396,6,402
Tais,F,100,402,0,402
Thressa,F,100,402,0,402
Toddrick,M,100,0,402,402
Torianna,F,100,402,0,402
Travaris,M,100,0,402,402
Tyleah,F,100,402,0,402
Vinton,M,100,0,402,402
Yaminah,F,100,402,0,402
Arieal,F,100,401,0,401
Arrow,M,79,84,317,401
Aymee,F,100,401,0,401
Ayumi,F,100,401,0,401
Charish,F,100,401,0,401
Cinderella,F,100,401,0,401
Crayton,M,100,0,401,401
Daryel,M,100,0,401,401
Dawnielle,F,100,401,0,401
Delissa,F,100,401,0,401
Dilon,M,100,0,401,401
Ellaina,F,100,401,0,401
Elyanna,F,100,401,0,401
Henrique,M,100,0,401,401
Kenon,M,100,0,401,401
Kijana,M,66,137,264,401
Kyndel,F,96,385,16,401
Lanai,F,100,401,0,401
Lazer,M,100,0,401,401
Lerone,M,100,0,401,401
Linde,F,100,401,0,401
Maddyn,F,95,379,22,401
Namir,M,100,0,401,401
Nura,F,100,401,0,401
Otho,M,100,0,401,401
Quintrell,M,100,0,401,401
Ritvik,M,100,0,401,401
Shatina,F,100,401,0,401
Sumayah,F,100,401,0,401
Tarvis,M,100,0,401,401
Thyra,F,100,401,0,401
Trea,M,72,112,289,401
Zondra,F,100,401,0,401
Americus,F,100,400,0,400
Amier,M,100,0,400,400
Ariann,F,98,394,6,400
Arvel,M,100,0,400,400
Ayse,F,100,400,0,400
Bienvenido,M,100,0,400,400
Chandni,F,100,400,0,400
Emmalea,F,100,400,0,400
Eniya,F,100,400,0,400
Garreth,M,100,0,400,400
Izzy,F,68,274,126,400
Ja,M,66,136,264,400
Jessamine,F,100,400,0,400
Johari,F,61,245,155,400
Kassaundra,F,100,400,0,400
Kyliee,F,100,400,0,400
Leeya,F,100,400,0,400
Lovette,F,100,400,0,400
Matheo,M,100,0,400,400
Matia,F,99,395,5,400
Raheen,M,100,0,400,400
Sanam,F,100,400,0,400
Sherria,F,100,400,0,400
Talissa,F,100,400,0,400
Terrye,F,100,400,0,400
Toan,M,100,0,400,400
Tomara,F,100,400,0,400
Trumaine,M,100,0,400,400
Vandy,M,52,193,207,400
Ying,F,65,260,140,400
Alonte,M,98,6,393,399
Andreus,M,100,0,399,399
Asani,F,77,306,93,399
Beverlyn,F,100,399,0,399
Daisie,F,100,399,0,399
Danney,M,99,5,394,399
Deandrae,M,100,0,399,399
Dericka,F,100,399,0,399
Godwin,M,100,0,399,399
Guiseppe,M,100,0,399,399
Jaquana,F,100,399,0,399
Jennalyn,F,100,399,0,399
Junious,M,100,0,399,399
Kalisa,F,100,399,0,399
Korah,F,100,399,0,399
Leida,F,100,399,0,399
Maven,M,53,186,213,399
Mylissa,F,100,399,0,399
Niklaus,M,100,0,399,399
Richrd,M,100,0,399,399
Robertson,M,100,0,399,399
Rosey,F,100,399,0,399
Samra,F,100,399,0,399
Shama,F,100,399,0,399
Tayon,M,99,5,394,399
Vaneza,F,100,399,0,399
Avonte,M,100,0,398,398
Billyjoe,M,100,0,398,398
Breton,M,100,0,398,398
Brexton,M,100,0,398,398
Crissie,F,100,398,0,398
Cru,M,100,0,398,398
Dareon,M,98,7,391,398
Diantha,F,100,398,0,398
Draco,M,100,0,398,398
Elijio,M,100,0,398,398
Elyn,F,97,387,11,398
Glennda,F,100,398,0,398
Hortense,F,100,398,0,398
Karia,F,100,398,0,398
Karron,F,60,239,159,398
Kwaku,M,100,0,398,398
Liliann,F,100,398,0,398
Lorre,F,100,398,0,398
Lorrine,F,100,398,0,398
Ly,F,70,279,119,398
Maygen,F,100,398,0,398
Merary,F,100,398,0,398
Naina,F,100,398,0,398
Paiten,F,96,383,15,398
Shakiyla,F,100,398,0,398
Solveig,F,100,398,0,398
Sulma,F,100,398,0,398
Amarachi,F,100,397,0,397
Andreah,F,100,397,0,397
Brin,F,91,360,37,397
Caleah,F,100,397,0,397
Camiyah,F,100,397,0,397
Catera,F,100,397,0,397
Chetan,M,100,0,397,397
Dezeray,F,100,397,0,397
Eythan,M,100,0,397,397
Jontavious,M,100,0,397,397
Krystan,F,100,397,0,397
Lakishia,F,100,397,0,397
Lysander,M,100,0,397,397
Majorie,F,100,397,0,397
Rainbow,F,100,397,0,397
Sayla,F,100,397,0,397
Skyleigh,F,100,397,0,397
Tarnisha,F,100,397,0,397
Virgen,F,100,397,0,397
Zedrick,M,100,0,397,397
Angelly,F,100,396,0,396
Binta,F,100,396,0,396
Blondell,F,100,396,0,396
Carmencita,F,100,396,0,396
Cayetano,M,100,0,396,396
Claressa,F,100,396,0,396
Claritza,F,100,396,0,396
Davena,F,100,396,0,396
Delray,M,100,0,396,396
Dove,F,99,391,5,396
Edlyn,F,100,396,0,396
Eudora,F,100,396,0,396
Florida,F,100,396,0,396
Gyasi,M,100,0,396,396
Heinz,M,100,0,396,396
Jaquavion,M,100,0,396,396
Johnpatrick,M,100,0,396,396
Joss,M,66,136,260,396
Kaj,M,100,0,396,396
Lavren,F,100,396,0,396
Marlane,F,100,396,0,396
Paz,F,72,286,110,396
Quest,M,98,9,387,396
Sharrell,F,100,396,0,396
Sheliah,F,100,396,0,396
Stepahnie,F,100,396,0,396
Taralynn,F,100,396,0,396
Tomasita,F,100,396,0,396
Unity,F,100,396,0,396
Venancio,M,100,0,396,396
Amariya,F,100,395,0,395
Archana,F,100,395,0,395
Betti,F,100,395,0,395
Bralynn,F,81,321,74,395
Charisa,F,100,395,0,395
Cherell,F,100,395,0,395
Curren,M,100,0,395,395
Dayani,F,100,395,0,395
Edel,M,94,22,373,395
Ensley,F,98,389,6,395
Fortunato,M,100,0,395,395
Haliegh,F,100,395,0,395
Havilah,F,100,395,0,395
Jarrin,M,100,0,395,395
Labron,M,100,0,395,395
Leonore,F,100,395,0,395
Loleta,F,100,395,0,395
Malichi,M,100,0,395,395
Meyah,F,100,395,0,395
Ralphael,M,100,0,395,395
Reo,M,99,5,390,395
See,F,100,395,0,395
Shabria,F,100,395,0,395
Sheina,F,100,395,0,395
Trampas,M,100,0,395,395
Yannis,M,74,103,292,395
Blakelee,F,95,376,18,394
Brailee,F,100,394,0,394
Brianny,F,100,394,0,394
Claudius,M,100,0,394,394
Dejohn,M,100,0,394,394
Emilea,F,100,394,0,394
Fahim,M,100,0,394,394
Jac,M,100,0,394,394
Jermichael,M,100,0,394,394
Jessup,M,100,0,394,394
Katalin,F,100,394,0,394
Keiron,M,100,0,394,394
Kota,M,94,24,370,394
Mihika,F,100,394,0,394
Mirabel,F,100,394,0,394
Miraya,F,100,394,0,394
Missael,M,100,0,394,394
Neala,F,100,394,0,394
Prachi,F,100,394,0,394
Rahel,F,100,394,0,394
Sundus,F,100,394,0,394
Tawan,M,85,60,334,394
Tres,M,99,5,389,394
Yuvia,F,100,394,0,394
Auna,F,100,393,0,393
Benyamin,M,100,0,393,393
Coni,F,100,393,0,393
Dawsyn,M,56,174,219,393
Derrill,M,100,0,393,393
Fuad,M,100,0,393,393
Havanna,F,100,393,0,393
Joshuwa,M,100,0,393,393
Juna,F,99,388,5,393
Kimberlyann,F,100,393,0,393
Lace,F,98,387,6,393
Marcine,F,100,393,0,393
Maybelle,F,100,393,0,393
Nakeia,F,100,393,0,393
Robina,F,100,393,0,393
Sueellen,F,100,393,0,393
Tion,M,96,16,377,393
Tylah,F,100,393,0,393
Bruna,F,100,392,0,392
Demir,M,100,0,392,392
Derren,M,100,0,392,392
Genessa,F,100,392,0,392
Haeley,F,100,392,0,392
Halimah,F,100,392,0,392
Hebert,M,100,0,392,392
Jailee,F,100,392,0,392
Janeli,F,100,392,0,392
Johnnetta,F,100,392,0,392
Kealani,F,100,392,0,392
Krupa,F,100,392,0,392
Liesa,F,100,392,0,392
Melik,M,100,0,392,392
Nafisa,F,100,392,0,392
Nikka,F,100,392,0,392
Shaughn,M,99,5,387,392
Shy,F,93,366,26,392
Syretta,F,100,392,0,392
Aldric,M,100,0,391,391
Asaiah,M,85,57,334,391
Ashya,F,100,391,0,391
Barnabas,M,100,0,391,391
Bradin,M,100,0,391,391
Channell,F,100,391,0,391
Cynitha,F,100,391,0,391
Darbie,F,100,391,0,391
Darlyne,F,100,391,0,391
Dymon,F,94,369,22,391
Elenora,F,100,391,0,391
Gaile,F,100,391,0,391
Genene,F,100,391,0,391
Jakori,M,99,5,386,391
Jenia,F,100,391,0,391
Jeremaih,M,100,0,391,391
Johnelle,F,97,378,13,391
Juanantonio,M,100,0,391,391
Keisa,F,100,391,0,391
Koji,M,100,0,391,391
Lariyah,F,100,391,0,391
Makaiya,F,100,391,0,391
Marolyn,F,100,391,0,391
Nani,F,100,391,0,391
Norton,M,100,0,391,391
Phenix,M,62,147,244,391
Shelisa,F,100,391,0,391
Tameisha,F,100,391,0,391
Timithy,M,100,0,391,391
Aleiah,F,100,390,0,390
Avree,F,97,379,11,390
Charron,F,87,340,50,390
Dalina,F,100,390,0,390
Ellora,F,100,390,0,390
Envy,F,99,385,5,390
Frimet,F,100,390,0,390
Helina,F,100,390,0,390
Ichael,M,100,0,390,390
Jt,M,100,0,390,390
Kahli,F,78,306,84,390
Kameelah,F,100,390,0,390
Khaila,F,100,390,0,390
Kyonna,F,100,390,0,390
Ociel,M,100,0,390,390
Quantrell,M,100,0,390,390
Rafaella,F,100,390,0,390
Ricarda,F,100,390,0,390
Sarahjane,F,100,390,0,390
Stepheny,F,100,390,0,390
Tequan,M,100,0,390,390
Anjeanette,F,100,389,0,389
Banessa,F,100,389,0,389
Brinna,F,100,389,0,389
Brittanny,F,100,389,0,389
Cartez,M,100,0,389,389
Dewon,M,100,0,389,389
Donnalee,F,100,389,0,389
Hania,F,100,389,0,389
Heidie,F,100,389,0,389
Jaymeson,M,95,18,371,389
Jone,F,95,370,19,389
Keeghan,M,80,78,311,389
Layal,F,100,389,0,389
Nakira,F,100,389,0,389
Natally,F,100,389,0,389
Pearla,F,100,389,0,389
Quintavius,M,100,0,389,389
Renelle,F,100,389,0,389
Rickard,M,100,0,389,389
Shalea,F,100,389,0,389
Tage,M,100,0,389,389
Tamsen,F,100,389,0,389
Teirra,F,100,389,0,389
Tobby,M,100,0,389,389
Treshon,M,100,0,389,389
Zoriah,F,100,389,0,389
Anaid,F,100,388,0,388
Angelette,F,100,388,0,388
Arsh,M,100,0,388,388
Caydin,M,91,36,352,388
Caylan,F,60,234,154,388
Christyna,F,100,388,0,388
Dace,M,95,18,370,388
Drenda,F,100,388,0,388
Giani,M,59,161,227,388
Glendy,F,100,388,0,388
Guiliana,F,100,388,0,388
Jahnae,F,100,388,0,388
Jameir,M,100,0,388,388
Jayshon,M,100,0,388,388
Jeneane,F,100,388,0,388
Keilana,F,100,388,0,388
Kregg,M,100,0,388,388
Lequan,M,99,5,383,388
Marico,M,100,0,388,388
Markeeta,F,100,388,0,388
Marki,F,93,359,29,388
Maurica,F,100,388,0,388
Nicolasa,F,100,388,0,388
Octaviano,M,100,0,388,388
Osualdo,M,100,0,388,388
Quintessa,F,100,388,0,388
Rogue,F,53,207,181,388
Saloni,F,100,388,0,388
Satya,F,72,279,109,388
Searra,F,100,388,0,388
Sofi,F,100,388,0,388
Afia,F,100,387,0,387
Ameir,M,100,0,387,387
Amjad,M,100,0,387,387
Ariza,F,100,387,0,387
Bostyn,F,68,262,125,387
Donyelle,F,96,372,15,387
Ellana,F,100,387,0,387
Gilford,M,100,0,387,387
Javoris,M,100,0,387,387
Keylen,M,57,166,221,387
Maddalyn,F,100,387,0,387
Olinda,F,100,387,0,387
Shakena,F,100,387,0,387
Shanai,F,100,387,0,387
Sheilla,F,100,387,0,387
Styles,M,100,0,387,387
Tinia,F,100,387,0,387
Townsend,M,100,0,387,387
Trayvion,M,100,0,387,387
Tyliyah,F,100,387,0,387
Yasemin,F,100,387,0,387
Alee,F,88,338,48,386
Aleksey,M,97,10,376,386
Angellica,F,100,386,0,386
Annelle,F,100,386,0,386
Barnett,M,100,0,386,386
Breia,F,100,386,0,386
Cailen,M,52,185,201,386
Chelsae,F,100,386,0,386
Chelsia,F,100,386,0,386
Chessa,F,100,386,0,386
Corynne,F,100,386,0,386
Eliane,F,100,386,0,386
Ibeth,F,100,386,0,386
Jaymar,M,100,0,386,386
Osmin,M,100,0,386,386
Sebastain,M,100,0,386,386
Shone,M,87,51,335,386
Tannia,F,100,386,0,386
Tashonda,F,100,386,0,386
Zubair,M,100,0,386,386
Afnan,F,83,320,65,385
Aiyden,M,100,0,385,385
Arcadia,F,100,385,0,385
Ashlye,F,100,385,0,385
Ayanah,F,100,385,0,385
Dianah,F,100,385,0,385
Dryden,M,100,0,385,385
Emelina,F,100,385,0,385
Glena,F,100,385,0,385
Illya,M,92,31,354,385
Jb,M,100,0,385,385
Kaliegh,F,100,385,0,385
Kiasia,F,100,385,0,385
Larisha,F,100,385,0,385
Patrizia,F,100,385,0,385
Paytyn,F,100,385,0,385
Rozella,F,100,385,0,385
Terressa,F,100,385,0,385
Adaly,F,100,384,0,384
Akshaya,F,100,384,0,384
Angelito,M,100,0,384,384
Antoinne,M,100,0,384,384
Arienne,F,100,384,0,384
Brylen,M,90,39,345,384
Carlus,M,97,10,374,384
Cydnie,F,100,384,0,384
Jennika,F,100,384,0,384
Jyl,F,100,384,0,384
Kristyne,F,100,384,0,384
Peace,F,84,324,60,384
Tresea,F,100,384,0,384
Ayaka,F,100,383,0,383
Caitlen,F,100,383,0,383
Cayli,F,100,383,0,383
Dmitry,M,100,0,383,383
Duval,M,100,0,383,383
Israa,F,100,383,0,383
Jalysa,F,100,383,0,383
Jamael,M,100,0,383,383
Jaxsyn,M,86,52,331,383
Jeren,M,100,0,383,383
Jesscia,F,100,383,0,383
Karlye,F,100,383,0,383
Kyshawn,M,100,0,383,383
Markeya,F,100,383,0,383
Martia,F,100,383,0,383
Mozell,F,66,251,132,383
Ronie,M,52,182,201,383
Shi,F,82,314,69,383
Sire,M,100,0,383,383
Talbert,M,100,0,383,383
Umair,M,100,0,383,383
Wallis,F,63,243,140,383
Yong,M,74,99,284,383
Aaric,M,100,0,382,382
Ahad,M,100,0,382,382
Analucia,F,100,382,0,382
Ashur,M,100,0,382,382
Cadee,F,100,382,0,382
Damaya,F,100,382,0,382
Deston,M,100,0,382,382
Dontaye,M,100,0,382,382
Eldin,M,100,0,382,382
Esperansa,F,100,382,0,382
Hang,F,100,382,0,382
Jahsir,M,100,0,382,382
Jaretzy,F,100,382,0,382
Jasimine,F,100,382,0,382
Kaytee,F,100,382,0,382
Keylon,M,100,0,382,382
Kristeena,F,100,382,0,382
Lacrecia,F,100,382,0,382
Laddie,M,99,5,377,382
Meribeth,F,100,382,0,382
Mizael,M,100,0,382,382
Olamide,F,58,223,159,382
Ousmane,M,100,0,382,382
Sathvik,M,100,0,382,382
Sheily,F,100,382,0,382
Sita,F,100,382,0,382
Sueanne,F,100,382,0,382
Thera,F,100,382,0,382
Tonnette,F,100,382,0,382
Akirah,F,100,381,0,381
Amanuel,M,100,0,381,381
Ambree,F,100,381,0,381
Antasia,F,100,381,0,381
Antionio,M,100,0,381,381
Belkis,F,100,381,0,381
Brannan,M,97,11,370,381
Caeleb,M,100,0,381,381
Cephus,M,100,0,381,381
Damika,F,100,381,0,381
Elna,F,100,381,0,381
Friedrich,M,100,0,381,381
Hermilo,M,100,0,381,381
Hughie,M,100,0,381,381
Jacilyn,F,100,381,0,381
Jeannene,F,100,381,0,381
Jian,M,96,17,364,381
Kenzington,F,100,381,0,381
Laban,M,100,0,381,381
Ladena,F,100,381,0,381
Machele,F,100,381,0,381
Malyssa,F,100,381,0,381
Mianna,F,100,381,0,381
Onita,F,100,381,0,381
Sapphira,F,100,381,0,381
Sheng,F,97,370,11,381
Synia,F,100,381,0,381
Toure,M,100,0,381,381
Wafa,F,100,381,0,381
Chasiti,F,100,380,0,380
Elazar,M,100,0,380,380
Haniya,F,100,380,0,380
Hera,F,100,380,0,380
Janathan,M,100,0,380,380
Kalif,M,100,0,380,380
Kessa,F,100,380,0,380
Lemarcus,M,100,0,380,380
Mckena,F,100,380,0,380
Mellody,F,100,380,0,380
Nason,M,100,0,380,380
Rakiya,F,100,380,0,380
Safwan,M,100,0,380,380
Takumi,M,100,0,380,380
Tarika,F,100,380,0,380
Tayonna,F,100,380,0,380
Trayon,M,100,0,380,380
Tyger,M,86,54,326,380
Tyne,F,97,367,13,380
Damary,F,100,379,0,379
Derinda,F,100,379,0,379
Ephriam,M,100,0,379,379
Genevive,F,100,379,0,379
Graycee,F,100,379,0,379
Jailine,F,100,379,0,379
Jenetta,F,100,379,0,379
Kamaree,M,66,127,252,379
Kartik,M,100,0,379,379
Kennieth,M,100,0,379,379
Letia,F,100,379,0,379
Lucerito,F,100,379,0,379
Monna,F,100,379,0,379
Pammy,F,100,379,0,379
Ronee,F,100,379,0,379
Shakiera,F,100,379,0,379
Tichina,F,100,379,0,379
Tiki,F,94,356,23,379
Tylik,M,100,0,379,379
Aubrea,F,100,378,0,378
Balin,M,100,0,378,378
Bron,M,100,0,378,378
Brylon,M,100,0,378,378
Cayle,M,65,133,245,378
Daiel,M,100,0,378,378
Dashel,M,98,6,372,378
Dorice,F,100,378,0,378
Ehab,M,100,0,378,378
Filipe,M,100,0,378,378
Genevia,F,100,378,0,378
Huntley,M,78,82,296,378
Jaelene,F,100,378,0,378
Jawana,F,100,378,0,378
Joei,F,100,378,0,378
Jovanie,M,97,11,367,378
Keili,F,100,378,0,378
Lucilla,F,100,378,0,378
Maryland,F,81,307,71,378
Nashay,F,100,378,0,378
Neoma,F,100,378,0,378
Polo,M,100,0,378,378
Presli,F,100,378,0,378
Remo,M,100,0,378,378
Reuel,M,100,0,378,378
Ricard,M,100,0,378,378
Rigel,M,99,5,373,378
Sergey,M,100,0,378,378
Tariyah,F,100,378,0,378
Tuff,M,100,0,378,378
Ysenia,F,100,378,0,378
Aahana,F,100,377,0,377
Akiko,F,100,377,0,377
Aneshia,F,100,377,0,377
Angenette,F,100,377,0,377
Cattleya,F,100,377,0,377
Caylah,F,100,377,0,377
Dalinda,F,100,377,0,377
Davine,F,75,281,96,377
Elisse,F,100,377,0,377
Feras,M,100,0,377,377
Josemiguel,M,100,0,377,377
Kenosha,F,100,377,0,377
Korinna,F,100,377,0,377
Lyvia,F,100,377,0,377
Maaz,M,100,0,377,377
Nicolaas,M,100,0,377,377
Ranelle,F,100,377,0,377
Rondy,M,100,0,377,377
Ruba,F,100,377,0,377
Rydell,M,100,0,377,377
Sharma,F,100,377,0,377
Taijah,F,100,377,0,377
Tekia,F,100,377,0,377
Zanetta,F,100,377,0,377
Adonica,F,100,376,0,376
Anjolie,F,100,376,0,376
Camiya,F,100,376,0,376
Chenita,F,100,376,0,376
Dannell,F,62,234,142,376
Denea,F,100,376,0,376
Enza,F,100,376,0,376
Jarmaine,M,100,0,376,376
Jessia,F,100,376,0,376
Joon,M,90,37,339,376
Jorgeluis,M,100,0,376,376
Kailer,M,94,21,355,376
Kalinda,F,100,376,0,376
Katelan,F,100,376,0,376
Katilynn,F,100,376,0,376
Kiari,F,91,341,35,376
Makyia,F,100,376,0,376
Marine,F,100,376,0,376
Merrily,F,100,376,0,376
Nalah,F,100,376,0,376
Ramiah,F,96,362,14,376
Rashawnda,F,100,376,0,376
Sadye,F,100,376,0,376
Shundra,F,100,376,0,376
Sohum,M,100,0,376,376
Tadarius,M,100,0,376,376
Taz,M,97,10,366,376
Azim,M,100,0,375,375
Daelin,M,86,51,324,375
Damariz,F,100,375,0,375
Deen,M,99,5,370,375
Eliora,F,100,375,0,375
Gao,F,100,375,0,375
Julieana,F,100,375,0,375
Kealey,F,100,375,0,375
Lavoris,M,57,163,212,375
Maddi,F,100,375,0,375
Marnee,F,100,375,0,375
Mir,M,100,0,375,375
Norm,M,100,0,375,375
Saman,M,69,117,258,375
Shaketa,F,100,375,0,375
Shandel,F,97,365,10,375
Siegfried,M,100,0,375,375
Tanessa,F,100,375,0,375
Treyon,M,100,0,375,375
Xzavior,M,100,0,375,375
Yunus,M,100,0,375,375
Yvan,M,99,5,370,375
Amarissa,F,100,374,0,374
Annasophia,F,100,374,0,374
Antoinetta,F,100,374,0,374
Asianna,F,100,374,0,374
Berklee,F,100,374,0,374
Carmalita,F,100,374,0,374
Clarie,F,100,374,0,374
Cylie,F,100,374,0,374
Darrious,M,100,0,374,374
Ellamae,F,100,374,0,374
Ezriel,M,100,0,374,374
Jolin,F,91,340,34,374
Laryn,F,100,374,0,374
Liyana,F,100,374,0,374
Maiyah,F,100,374,0,374
Mandisa,F,100,374,0,374
Monserat,F,100,374,0,374
Slate,M,100,0,374,374
Steel,M,100,0,374,374
Tiajuana,F,100,374,0,374
Tiffanny,F,100,374,0,374
Vicenta,F,100,374,0,374
Ziaire,M,86,54,320,374
Akisha,F,100,373,0,373
Aryelle,F,100,373,0,373
Atziry,F,100,373,0,373
Aynsley,F,100,373,0,373
Corianne,F,100,373,0,373
Doniel,M,98,7,366,373
Evaline,F,100,373,0,373
Griselle,F,100,373,0,373
Janeane,F,100,373,0,373
Kaprice,F,100,373,0,373
Keyondra,F,100,373,0,373
Korynn,F,100,373,0,373
Lindee,F,100,373,0,373
Lyanne,F,100,373,0,373
Micala,F,100,373,0,373
Myrtice,F,100,373,0,373
Quinetta,F,100,373,0,373
Rayma,F,100,373,0,373
Roanna,F,100,373,0,373
Robbert,M,100,0,373,373
Ruchi,F,100,373,0,373
Samaiya,F,100,373,0,373
Satin,F,100,373,0,373
Shadiamond,F,100,373,0,373
Sharnae,F,100,373,0,373
Shaylan,F,85,318,55,373
Shelda,F,100,373,0,373
Shneur,M,100,0,373,373
Sparrow,F,88,330,43,373
Tahisha,F,100,373,0,373
Uyen,F,100,373,0,373
Zyanna,F,100,373,0,373
Atiba,M,99,5,367,372
Audre,F,89,332,40,372
Diquan,M,100,0,372,372
Fernandez,M,100,0,372,372
Jermine,M,100,0,372,372
Keidra,F,100,372,0,372
Kona,M,69,117,255,372
Korry,M,97,12,360,372
Lamika,F,100,372,0,372
Lestat,M,100,0,372,372
Locke,M,100,0,372,372
Madasyn,F,100,372,0,372
Makalia,F,100,372,0,372
Maleka,F,100,372,0,372
Margit,F,100,372,0,372
Mayeli,F,100,372,0,372
Prisma,F,100,372,0,372
Remus,M,100,0,372,372
Renatta,F,100,372,0,372
Ridwan,M,96,15,357,372
Teylor,F,88,327,45,372
Thora,F,100,372,0,372
Yanelli,F,100,372,0,372
Ysabelle,F,100,372,0,372
Yzabella,F,100,372,0,372
Aquarius,F,63,235,136,371
Asiana,F,100,371,0,371
Burnice,M,73,101,270,371
Cayenne,F,94,347,24,371
Dannelle,F,100,371,0,371
Dewain,M,100,0,371,371
Geron,M,100,0,371,371
Gumaro,M,100,0,371,371
Jahad,M,100,0,371,371
Lynea,F,100,371,0,371
Makynna,F,100,371,0,371
Nazier,M,100,0,371,371
Niketa,F,100,371,0,371
Raynee,F,100,371,0,371
Svea,F,100,371,0,371
Taitum,F,85,316,55,371
Terrian,M,68,119,252,371
Tessia,F,100,371,0,371
Tiasha,F,100,371,0,371
Trynity,F,100,371,0,371
Yaniel,M,100,0,371,371
Zetta,F,100,371,0,371
Adelynne,F,100,370,0,370
Camrie,F,100,370,0,370
Geremiah,M,100,0,370,370
Hayat,F,100,370,0,370
Ivanka,F,100,370,0,370
Jeovanni,M,100,0,370,370
Kevontae,M,100,0,370,370
Kyaira,F,100,370,0,370
Lindie,F,100,370,0,370
Ndeye,F,100,370,0,370
Neale,M,99,5,365,370
Neeley,F,100,370,0,370
Onesimo,M,100,0,370,370
Quintarius,M,100,0,370,370
Ragina,F,100,370,0,370
Stefanos,M,100,0,370,370
Vana,F,100,370,0,370
Versie,F,98,364,6,370
Yohance,M,100,0,370,370
Amanada,F,100,369,0,369
Arjan,M,100,0,369,369
Braydyn,M,100,0,369,369
Darvis,M,100,0,369,369
Dawnell,F,100,369,0,369
Deeanne,F,100,369,0,369
Devaun,M,100,0,369,369
Dreyden,M,100,0,369,369
Ewell,M,100,0,369,369
Gaylynn,F,100,369,0,369
Jermani,F,79,293,76,369
Junaid,M,100,0,369,369
Kajal,F,100,369,0,369
Kristoff,M,100,0,369,369
Lenord,M,100,0,369,369
Purvis,M,100,0,369,369
Rashed,M,100,0,369,369
Renie,F,100,369,0,369
Shiana,F,100,369,0,369
Sruthi,F,100,369,0,369
Talana,F,100,369,0,369
Teshawn,M,93,26,343,369
Torrell,M,100,0,369,369
Yamilett,F,100,369,0,369
Zackry,M,100,0,369,369
Zamaya,F,100,369,0,369
Zonia,F,100,369,0,369
Abdoul,M,100,0,368,368
Akiyah,F,100,368,0,368
Alishba,F,100,368,0,368
Classie,F,100,368,0,368
Daniah,F,100,368,0,368
Dawit,M,100,0,368,368
Diogo,M,100,0,368,368
Emillio,M,100,0,368,368
Errica,F,100,368,0,368
Genita,F,100,368,0,368
Jabree,M,81,70,298,368
Janylah,F,100,368,0,368
Jerami,M,98,6,362,368
Jisela,F,100,368,0,368
Kord,M,100,0,368,368
Lamaria,F,100,368,0,368
Marrio,M,100,0,368,368
Nekita,F,100,368,0,368
Reginaldo,M,100,0,368,368
Rohn,M,100,0,368,368
Tere,F,98,362,6,368
Uzair,M,100,0,368,368
Winthrop,M,100,0,368,368
Yulia,F,100,368,0,368
Zedekiah,M,100,0,368,368
Adelyne,F,100,367,0,367
Cadarius,M,100,0,367,367
Caitlynne,F,100,367,0,367
Cianni,F,100,367,0,367
Emarion,M,100,0,367,367
Jevan,M,100,0,367,367
Karianna,F,100,367,0,367
Karrin,F,100,367,0,367
Lonzell,M,100,0,367,367
Mannix,M,100,0,367,367
Meher,F,99,362,5,367
Mikiyah,F,100,367,0,367
Olevia,F,100,367,0,367
Reeves,M,97,11,356,367
Taevion,M,100,0,367,367
Tamikia,F,100,367,0,367
Taneya,F,100,367,0,367
Terasa,F,100,367,0,367
Trevar,M,100,0,367,367
Yanina,F,100,367,0,367
Zeena,F,100,367,0,367
Zephan,M,100,0,367,367
Adali,F,93,342,24,366
Araina,F,100,366,0,366
Aubrei,F,100,366,0,366
Augie,M,100,0,366,366
Dangela,F,100,366,0,366
Darrol,M,100,0,366,366
Daylyn,F,53,195,171,366
Doroteo,M,100,0,366,366
Fariha,F,100,366,0,366
Grier,F,63,230,136,366
Jalecia,F,100,366,0,366
Jasma,F,100,366,0,366
Jeania,F,100,366,0,366
Jersie,F,100,366,0,366
Kennesha,F,100,366,0,366
Keyonia,F,100,366,0,366
Kyland,M,100,0,366,366
Kylor,M,99,5,361,366
Latif,M,100,0,366,366
Liliya,F,100,366,0,366
Nakyla,F,100,366,0,366
Neah,F,100,366,0,366
Percilla,F,100,366,0,366
Raiven,F,100,366,0,366
Shantina,F,100,366,0,366
Shloime,M,100,0,366,366
Sugey,F,100,366,0,366
Symon,M,97,10,356,366
Tashira,F,100,366,0,366
Wendelyn,F,100,366,0,366
Zacariah,M,99,5,361,366
Anila,F,100,365,0,365
Anmarie,F,100,365,0,365
Artavius,M,100,0,365,365
Bernette,F,100,365,0,365
Carylon,F,100,365,0,365
Catrena,F,100,365,0,365
Chika,F,92,337,28,365
Dalyla,F,100,365,0,365
Dayshaun,M,100,0,365,365
Doneisha,F,100,365,0,365
Emmely,F,100,365,0,365
Girl,F,100,365,0,365
Glendale,M,81,69,296,365
Jaceon,M,100,0,365,365
Jamire,M,100,0,365,365
Jeannett,F,100,365,0,365
Kasee,F,100,365,0,365
Maleny,F,100,365,0,365
Marten,M,100,0,365,365
Mekenna,F,100,365,0,365
Mosiah,M,100,0,365,365
Quyen,F,88,323,42,365
Samarra,F,100,365,0,365
Saprina,F,100,365,0,365
Sherif,M,100,0,365,365
Shoua,F,77,282,83,365
Skylan,F,63,230,135,365
Thorne,M,100,0,365,365
Tylene,F,100,365,0,365
Vanassa,F,100,365,0,365
Vega,F,84,308,57,365
Viggo,M,100,0,365,365
Zakira,F,100,365,0,365
Alla,F,97,354,10,364
Audreyanna,F,100,364,0,364
Brittyn,F,100,364,0,364
Calogero,M,100,0,364,364
Catelin,F,100,364,0,364
Deajah,F,100,364,0,364
Devinn,M,73,100,264,364
Diarra,F,79,286,78,364
Eldrick,M,100,0,364,364
Fredie,M,100,0,364,364
Freeda,F,100,364,0,364
Gabrianna,F,100,364,0,364
Garrette,M,100,0,364,364
Hether,F,100,364,0,364
Jaire,M,90,35,329,364
Jayma,F,100,364,0,364
Kaida,F,100,364,0,364
Keirstyn,F,100,364,0,364
Kharma,F,100,364,0,364
Lama,F,100,364,0,364
Lamanda,F,100,364,0,364
Landra,F,100,364,0,364
Livingston,M,99,5,359,364
Logun,M,100,0,364,364
Matix,M,100,0,364,364
Maybelline,F,100,364,0,364
Milee,F,100,364,0,364
Monita,F,100,364,0,364
Patria,F,100,364,0,364
Pranay,M,100,0,364,364
Raney,F,85,309,55,364
Ronnisha,F,100,364,0,364
Saydi,F,100,364,0,364
Sinjin,M,100,0,364,364
Ulanda,F,100,364,0,364
Zyonna,F,100,364,0,364
Adrieanna,F,100,363,0,363
Anntoinette,F,100,363,0,363
Anshul,M,100,0,363,363
Camia,F,100,363,0,363
Estel,M,94,20,343,363
Isaia,M,100,0,363,363
Iver,M,100,0,363,363
Iyannah,F,100,363,0,363
Jachin,M,100,0,363,363
Judea,F,79,285,78,363
Keyontae,M,96,13,350,363
Lenn,M,98,6,357,363
Levan,M,100,0,363,363
Maleik,M,100,0,363,363
Mckinnley,F,82,296,67,363
Munira,F,100,363,0,363
Natesha,F,100,363,0,363
Rakan,M,100,0,363,363
Reita,F,100,363,0,363
Rogerio,M,100,0,363,363
Scherry,F,100,363,0,363
Sharmin,F,100,363,0,363
Sheamus,M,100,0,363,363
Tarita,F,100,363,0,363
Toussaint,M,100,0,363,363
Vidya,F,100,363,0,363
Aveon,M,94,20,342,362
Brazil,F,91,329,33,362
Gasper,M,100,0,362,362
Halei,F,100,362,0,362
Janyiah,F,100,362,0,362
Jaquavius,M,100,0,362,362
Jermayne,M,100,0,362,362
Jisel,F,100,362,0,362
Kaidance,F,100,362,0,362
Lanasia,F,100,362,0,362
Lanyah,F,100,362,0,362
Leiland,M,100,0,362,362
Lonni,F,95,343,19,362
Mahima,F,100,362,0,362
Makynlee,F,100,362,0,362
Mychaela,F,100,362,0,362
Nicoli,M,88,42,320,362
Omaira,F,100,362,0,362
Redmond,M,100,0,362,362
Taressa,F,100,362,0,362
Tennessee,F,55,199,163,362
Townes,M,100,0,362,362
Vinessa,F,100,362,0,362
Aizen,M,100,0,361,361
Aleysha,F,100,361,0,361
Danyella,F,100,361,0,361
Darcelle,F,100,361,0,361
Edelmiro,M,100,0,361,361
Itati,F,100,361,0,361
Jamiee,F,100,361,0,361
Janiqua,F,100,361,0,361
Jeanny,F,100,361,0,361
Justyna,F,100,361,0,361
Kalliope,F,100,361,0,361
Kessler,M,82,65,296,361
Kherington,F,100,361,0,361
Maylynn,F,100,361,0,361
Mayo,M,92,28,333,361
Mayzie,F,100,361,0,361
Oshay,M,89,39,322,361
Saralynn,F,100,361,0,361
Seriah,F,100,361,0,361
Shailynn,F,100,361,0,361
Shellia,F,100,361,0,361
Treyden,M,100,0,361,361
Zabdiel,M,100,0,361,361
Zianna,F,100,361,0,361
Abeni,F,100,360,0,360
Abu,M,100,0,360,360
Aeriana,F,100,360,0,360
Aleda,F,100,360,0,360
Aliyanna,F,100,360,0,360
Angy,F,100,360,0,360
Ashaunti,F,100,360,0,360
Atia,F,100,360,0,360
Avaleigh,F,100,360,0,360
Bethzy,F,100,360,0,360
Clio,F,100,360,0,360
Collie,M,88,45,315,360
Devanie,F,100,360,0,360
Donoven,M,100,0,360,360
Gayl,F,100,360,0,360
Ilyse,F,100,360,0,360
Juliene,F,100,360,0,360
Kaydyn,F,51,182,178,360
Keene,M,100,0,360,360
Menucha,F,100,360,0,360
Meron,F,97,348,12,360
Mery,F,100,360,0,360
Miquela,F,100,360,0,360
Natori,F,98,354,6,360
Preeti,F,100,360,0,360
Semira,F,100,360,0,360
Shery,F,100,360,0,360
Veronda,F,100,360,0,360
Zuly,F,100,360,0,360
Aarnav,M,100,0,359,359
Aasiyah,F,100,359,0,359
Antonique,F,100,359,0,359
Brannen,M,100,0,359,359
Brentlee,M,81,67,292,359
Burgess,M,100,0,359,359
Charnita,F,100,359,0,359
Cullin,M,100,0,359,359
Dionta,M,100,0,359,359
Esaias,M,100,0,359,359
Hafsah,F,100,359,0,359
Hazael,M,100,0,359,359
Ivo,M,100,0,359,359
Jarmar,M,100,0,359,359
Jazaria,F,100,359,0,359
Jeani,F,100,359,0,359
Junia,F,100,359,0,359
Kelani,F,96,345,14,359
Kella,F,100,359,0,359
Laurita,F,100,359,0,359
Li,F,70,251,108,359
Oris,M,94,20,339,359
Quadarius,M,100,0,359,359
Renika,F,100,359,0,359
Sarayu,F,100,359,0,359
Shenia,F,100,359,0,359
Tavien,M,100,0,359,359
Tonesha,F,100,359,0,359
Trenia,F,100,359,0,359
Veron,M,100,0,359,359
Veroncia,F,100,359,0,359
Vicktoria,F,100,359,0,359
Akshar,M,100,0,358,358
Alexzandrea,F,100,358,0,358
Amaiah,F,100,358,0,358
Cristan,F,57,203,155,358
Danitra,F,100,358,0,358
Darienne,F,100,358,0,358
Donold,M,100,0,358,358
Ebelin,F,100,358,0,358
Fotini,F,100,358,0,358
Jacquelina,F,100,358,0,358
Krishan,M,100,0,358,358
Kushal,M,100,0,358,358
Kynlie,F,100,358,0,358
Maily,F,100,358,0,358
Meia,F,100,358,0,358
Myrissa,F,100,358,0,358
Nashon,M,100,0,358,358
Nyana,F,100,358,0,358
Rakiyah,F,100,358,0,358
Rasheena,F,100,358,0,358
Riddick,M,100,0,358,358
Rufina,F,100,358,0,358
Seena,F,72,259,99,358
Sheccid,F,100,358,0,358
Tamla,F,100,358,0,358
Tangee,F,100,358,0,358
Vella,F,100,358,0,358
Ziara,F,100,358,0,358
Advik,M,100,0,357,357
Allyce,F,100,357,0,357
Anastasiya,F,100,357,0,357
Bora,M,80,70,287,357
Brynnley,F,100,357,0,357
Caia,F,100,357,0,357
Clarrissa,F,100,357,0,357
Claudell,M,88,43,314,357
Demorris,M,100,0,357,357
Deyonna,F,100,357,0,357
Georgi,F,88,314,43,357
Haillie,F,100,357,0,357
Javell,M,100,0,357,357
Kamori,F,66,237,120,357
Kenyana,F,100,357,0,357
Korissa,F,100,357,0,357
Korrina,F,100,357,0,357
Lashara,F,100,357,0,357
Loyalty,F,76,271,86,357
Marionna,F,100,357,0,357
Maximilliano,M,100,0,357,357
Mikhayla,F,100,357,0,357
Narek,M,100,0,357,357
Natlie,F,100,357,0,357
Salih,M,100,0,357,357
Sanika,F,100,357,0,357
Sayge,F,83,298,59,357
Terelle,M,99,5,352,357
Timya,F,100,357,0,357
Zoraya,F,100,357,0,357
Abagale,F,100,356,0,356
Ainsleigh,F,100,356,0,356
Alfonse,M,100,0,356,356
Aniyla,F,100,356,0,356
Ashleymarie,F,100,356,0,356
Bowman,M,100,0,356,356
Breland,M,85,52,304,356
Caison,M,100,0,356,356
Desma,F,100,356,0,356
Janne,F,100,356,0,356
Khairi,M,99,5,351,356
Khylie,F,100,356,0,356
Lain,M,94,20,336,356
Mikale,M,89,39,317,356
Quartez,M,100,0,356,356
Rifky,F,100,356,0,356
Rosamond,F,100,356,0,356
Saketh,M,100,0,356,356
Saryah,F,100,356,0,356
Tycen,M,100,0,356,356
Zophia,F,100,356,0,356
Adaeze,F,100,355,0,355
Aeva,F,100,355,0,355
Ai,F,97,344,11,355
Aleesia,F,100,355,0,355
Annia,F,100,355,0,355
Damain,M,100,0,355,355
Damiano,M,100,0,355,355
Demichael,M,100,0,355,355
Dequincy,M,100,0,355,355
Infiniti,F,100,355,0,355
Jeanclaude,M,100,0,355,355
Jomo,M,100,0,355,355
Julina,F,100,355,0,355
Karisha,F,100,355,0,355
Karrissa,F,100,355,0,355
Kerilyn,F,100,355,0,355
Kutter,M,100,0,355,355
Lauralyn,F,100,355,0,355
Mahek,F,100,355,0,355
Marye,F,100,355,0,355
Maxamillion,M,100,0,355,355
Moncerrat,F,100,355,0,355
Rhianon,F,100,355,0,355
Rosco,M,100,0,355,355
Shaquala,F,100,355,0,355
Shariyah,F,100,355,0,355
Shelsy,F,100,355,0,355
Sheretta,F,100,355,0,355
Siddhartha,M,100,0,355,355
Yanique,F,100,355,0,355
Annaly,F,100,354,0,354
Bintou,F,100,354,0,354
Calab,M,100,0,354,354
Ceira,F,100,354,0,354
Chianne,F,100,354,0,354
Deaunte,M,100,0,354,354
Dontavis,M,100,0,354,354
Fionn,M,100,0,354,354
Franca,F,100,354,0,354
Graycie,F,100,354,0,354
Hamdi,F,72,254,100,354
Jermarcus,M,100,0,354,354
Joyann,F,100,354,0,354
Kareemah,F,100,354,0,354
Kenita,F,100,354,0,354
Kierah,F,100,354,0,354
Kilah,F,100,354,0,354
Kynnedy,F,100,354,0,354
Lamari,M,64,129,225,354
Lynita,F,100,354,0,354
Madilynne,F,100,354,0,354
Maleyah,F,100,354,0,354
Milburn,M,100,0,354,354
Nhu,F,100,354,0,354
Quaneisha,F,100,354,0,354
Rishaan,M,100,0,354,354
Shanisha,F,100,354,0,354
Takota,M,91,33,321,354
Teng,M,100,0,354,354
Toye,F,95,338,16,354
Trysta,F,100,354,0,354
Zanyah,F,100,354,0,354
Zohaib,M,100,0,354,354
Aariana,F,100,353,0,353
Alisandra,F,100,353,0,353
Anaisa,F,100,353,0,353
Arizbeth,F,100,353,0,353
Cassity,F,100,353,0,353
Dearius,M,100,0,353,353
Deboraha,F,100,353,0,353
Deema,F,100,353,0,353
Deniese,F,100,353,0,353
Diahann,F,100,353,0,353
Edmon,M,100,0,353,353
Hayla,F,100,353,0,353
Hiroshi,M,100,0,353,353
Julieth,F,100,353,0,353
Lexee,F,100,353,0,353
Mahlia,F,100,353,0,353
Nathyn,M,100,0,353,353
Nayelis,F,100,353,0,353
Oceanna,F,100,353,0,353
Robynne,F,100,353,0,353
Shakyla,F,100,353,0,353
Shalisha,F,100,353,0,353
Travers,M,100,0,353,353
Wei,M,78,78,275,353
Aija,F,100,352,0,352
Ame,F,100,352,0,352
Arynn,F,100,352,0,352
Budd,M,100,0,352,352
Cece,F,100,352,0,352
Djuna,F,100,352,0,352
Eimy,F,100,352,0,352
Janeisha,F,100,352,0,352
Jeniya,F,100,352,0,352
Jennavieve,F,100,352,0,352
Jeovanny,M,100,0,352,352
Kalle,F,92,325,27,352
Keeva,F,100,352,0,352
Kemuel,M,100,0,352,352
Kenzee,F,100,352,0,352
Maddilynn,F,100,352,0,352
Marqui,M,83,59,293,352
Matisse,F,55,195,157,352
Riely,M,50,175,177,352
Ruslan,M,100,0,352,352
Shanece,F,100,352,0,352
Sho,M,100,0,352,352
Szymon,M,100,0,352,352
Torris,M,99,5,347,352
Vergil,M,100,0,352,352
Alexandera,F,100,351,0,351
Apple,F,100,351,0,351
Aquiles,M,100,0,351,351
Audwin,M,100,0,351,351
Briane,F,84,296,55,351
Celicia,F,100,351,0,351
Donata,F,100,351,0,351
Felina,F,100,351,0,351
Firas,M,100,0,351,351
Fontella,F,100,351,0,351
Genette,F,100,351,0,351
Ilijah,M,100,0,351,351
Jaelle,F,100,351,0,351
Jeny,F,100,351,0,351
Karem,F,66,233,118,351
Khrystal,F,100,351,0,351
Latron,M,100,0,351,351
Lyon,M,100,0,351,351
Meliss,F,100,351,0,351
Rosena,F,100,351,0,351
Ry,M,100,0,351,351
Shaleigh,F,100,351,0,351
Shantoria,F,100,351,0,351
Shawnae,F,100,351,0,351
Trenice,F,100,351,0,351
Yuka,F,100,351,0,351
Adira,F,100,350,0,350
Adonijah,M,93,26,324,350
Aletheia,F,100,350,0,350
Bryceson,M,100,0,350,350
Caedon,M,100,0,350,350
Carolena,F,100,350,0,350
Chyla,F,100,350,0,350
Delight,F,100,350,0,350
Delonta,M,100,0,350,350
Denene,F,100,350,0,350
Edouard,M,100,0,350,350
Eliab,M,100,0,350,350
Eugina,F,100,350,0,350
Glorianna,F,100,350,0,350
Inna,F,100,350,0,350
Jennae,F,100,350,0,350
Johnston,M,100,0,350,350
Kadiatou,F,100,350,0,350
Kaidin,M,97,11,339,350
Khiara,F,100,350,0,350
Kjell,M,100,0,350,350
Kynan,M,100,0,350,350
Leydi,F,100,350,0,350
Mysha,F,100,350,0,350
Ramell,M,100,0,350,350
Rober,M,100,0,350,350
Roxi,F,100,350,0,350
Royden,M,100,0,350,350
Rusti,F,100,350,0,350
Sevyn,F,55,191,159,350
Shaday,F,100,350,0,350
Shavar,M,100,0,350,350
Siddarth,M,100,0,350,350
Trayveon,M,100,0,350,350
Viviann,F,100,350,0,350
Athalia,F,100,349,0,349
Basia,F,100,349,0,349
Caycee,F,100,349,0,349
Demaria,F,83,290,59,349
Dmari,M,100,0,349,349
Drey,M,100,0,349,349
Gregroy,M,100,0,349,349
Imara,F,100,349,0,349
Jaala,F,100,349,0,349
Jayli,F,100,349,0,349
Kohlton,M,100,0,349,349
Lashanti,F,100,349,0,349
Leslea,F,100,349,0,349
Lilybeth,F,100,349,0,349
Montavius,M,100,0,349,349
Naftuli,M,100,0,349,349
Nga,F,100,349,0,349
Rashawna,F,100,349,0,349
Rashunda,F,100,349,0,349
Shailey,F,100,349,0,349
Stevee,F,97,338,11,349
Vlad,M,100,0,349,349
Wanetta,F,100,349,0,349
Yareni,F,100,349,0,349
Allisen,F,100,348,0,348
Allycia,F,100,348,0,348
Chania,F,100,348,0,348
Dawnita,F,100,348,0,348
Emalynn,F,100,348,0,348
Ethelyn,F,100,348,0,348
Everlyn,F,100,348,0,348
Jaley,F,100,348,0,348
Jamera,F,100,348,0,348
Jessicia,F,100,348,0,348
Jovaughn,M,100,0,348,348
Kahari,M,100,0,348,348
Kajsa,F,100,348,0,348
Kvon,M,100,0,348,348
Kymari,M,60,139,209,348
Lezli,F,100,348,0,348
Mariluz,F,100,348,0,348
Mekai,M,100,0,348,348
Morrell,M,100,0,348,348
Norval,M,100,0,348,348
Orpha,F,100,348,0,348
Thunder,M,100,0,348,348
Tika,F,100,348,0,348
Xzander,M,100,0,348,348
Zakir,M,100,0,348,348
Ariauna,F,100,347,0,347
Baldwin,M,100,0,347,347
Breea,F,100,347,0,347
Darrly,M,100,0,347,347
Dearl,M,100,0,347,347
Deneshia,F,100,347,0,347
Devery,M,76,82,265,347
Filemon,M,100,0,347,347
Jamill,M,100,0,347,347
Jocilyn,F,100,347,0,347
Judas,M,100,0,347,347
Kamree,F,100,347,0,347
Kayshawn,M,100,0,347,347
Keiarra,F,100,347,0,347
Kimoni,M,59,142,205,347
Krystiana,F,100,347,0,347
Larenda,F,100,347,0,347
Mariesa,F,100,347,0,347
Mily,F,100,347,0,347
Naman,M,100,0,347,347
Oluwaseun,M,64,125,222,347
Roen,M,97,11,336,347
Skarlett,F,100,347,0,347
Solei,F,100,347,0,347
Tannor,M,100,0,347,347
Tashima,F,100,347,0,347
Wilfrido,M,100,0,347,347
Windsor,M,61,137,210,347
Ahmaad,M,100,0,346,346
Arda,M,98,6,340,346
Bassam,M,100,0,346,346
Braelon,M,100,0,346,346
Burrell,M,100,0,346,346
Chrystopher,M,100,0,346,346
Doc,M,100,0,346,346
Eathen,M,100,0,346,346
Elanie,F,100,346,0,346
Genese,F,100,346,0,346
Jairon,M,100,0,346,346
Jiovanny,M,100,0,346,346
Kaysee,F,100,346,0,346
Kyerra,F,100,346,0,346
Ladarian,M,100,0,346,346
Laquinton,M,100,0,346,346
Marquelle,M,76,84,262,346
Nazia,F,100,346,0,346
Penne,F,100,346,0,346
Samah,F,100,346,0,346
Starlynn,F,100,346,0,346
Sulayman,M,100,0,346,346
Taeler,F,99,341,5,346
Terrianna,F,100,346,0,346
Waneta,F,100,346,0,346
Wendelin,F,100,346,0,346
Yuta,M,100,0,346,346
Aulani,F,100,345,0,345
Chinedu,M,100,0,345,345
Coreena,F,100,345,0,345
Demarious,M,100,0,345,345
Jaasiel,M,100,0,345,345
Kayela,F,100,345,0,345
Latona,F,100,345,0,345
Lonn,M,100,0,345,345
Meggin,F,100,345,0,345
Olufemi,M,100,0,345,345
Raneisha,F,100,345,0,345
Shamyia,F,100,345,0,345
Sohail,M,100,0,345,345
Tashae,F,100,345,0,345
Thy,F,100,345,0,345
Tiler,M,83,59,286,345
Tommye,F,99,340,5,345
Tyrick,M,100,0,345,345
Velina,F,100,345,0,345
Zamara,F,100,345,0,345
Zyra,F,100,345,0,345
Abdulahi,M,100,0,344,344
Adien,M,100,0,344,344
Aiman,M,76,83,261,344
Anothony,M,100,0,344,344
Babatunde,M,100,0,344,344
Breeanne,F,100,344,0,344
Cherl,F,100,344,0,344
Cosimo,M,100,0,344,344
Deep,M,100,0,344,344
Haydan,M,76,84,260,344
Hervey,M,100,0,344,344
Hibah,F,100,344,0,344
Jakelyn,F,100,344,0,344
Jaskaran,M,100,0,344,344
Jen,F,79,272,72,344
Kamen,M,100,0,344,344
Karene,F,100,344,0,344
Kaz,M,100,0,344,344
Kento,M,100,0,344,344
Marlise,F,100,344,0,344
Marycarmen,F,100,344,0,344
Mee,F,100,344,0,344
Navia,F,100,344,0,344
Osha,F,78,269,75,344
Per,M,100,0,344,344
Ranell,F,82,282,62,344
Romualdo,M,100,0,344,344
Ronnetta,F,100,344,0,344
Rosi,F,100,344,0,344
Wrigley,M,60,136,208,344
Yoshua,M,100,0,344,344
Adelie,F,100,343,0,343
Alexandrya,F,100,343,0,343
Alleah,F,100,343,0,343
Annaleise,F,100,343,0,343
Ellice,F,100,343,0,343
Emmalina,F,100,343,0,343
Gwendlyn,F,100,343,0,343
Husam,M,100,0,343,343
Ihsan,M,100,0,343,343
Ita,F,100,343,0,343
Jamilex,F,100,343,0,343
Kinberly,F,100,343,0,343
Kyzer,M,100,0,343,343
Lamisha,F,100,343,0,343
Larrissa,F,100,343,0,343
Makalyn,F,100,343,0,343
Manasseh,M,99,5,338,343
Musab,M,100,0,343,343
Nashaly,F,100,343,0,343
Nayah,F,100,343,0,343
Tacarra,F,100,343,0,343
Terie,F,100,343,0,343
Terriona,F,100,343,0,343
Theodoros,M,100,0,343,343
Tzirel,F,100,343,0,343
Wess,M,100,0,343,343
Yvanna,F,100,343,0,343
Aalia,F,100,342,0,342
Aleisa,F,100,342,0,342
Avneet,F,99,337,5,342
Chelle,F,100,342,0,342
Czarina,F,100,342,0,342
Dayveon,M,100,0,342,342
Elsbeth,F,100,342,0,342
Elvie,F,62,213,129,342
Emanuelle,M,57,146,196,342
Gaylan,M,88,41,301,342
Inocencio,M,100,0,342,342
Keauna,F,100,342,0,342
Kinya,F,100,342,0,342
Lavontae,M,100,0,342,342
Maleya,F,100,342,0,342
Maricia,F,100,342,0,342
Meeka,F,100,342,0,342
Miliani,F,100,342,0,342
Moroni,M,100,0,342,342
Nishka,F,100,342,0,342
Rashidah,F,100,342,0,342
Selim,M,100,0,342,342
Sheral,F,100,342,0,342
Sophy,F,100,342,0,342
Talyah,F,100,342,0,342
Vanesha,F,100,342,0,342
Yanessa,F,100,342,0,342
Adeola,F,93,317,24,341
Alisabeth,F,100,341,0,341
Avanti,F,85,289,52,341
Brick,M,100,0,341,341
Chrisette,F,100,341,0,341
Chritopher,M,100,0,341,341
Chrystie,F,100,341,0,341
Eldora,F,100,341,0,341
Heavenleigh,F,100,341,0,341
Hesham,M,100,0,341,341
Jacquita,F,100,341,0,341
Jocob,M,100,0,341,341
Jolissa,F,100,341,0,341
Jordany,M,100,0,341,341
Kayliegh,F,100,341,0,341
Keeleigh,F,100,341,0,341
Ketan,M,100,0,341,341
Krissi,F,100,341,0,341
Melecio,M,100,0,341,341
Melika,F,100,341,0,341
Quamaine,M,100,0,341,341
Ritu,F,100,341,0,341
Royalty,F,75,257,84,341
Rozanna,F,100,341,0,341
Sayler,F,99,336,5,341
Susi,F,100,341,0,341
Tavius,M,100,0,341,341
Temitope,F,67,229,112,341
Tristain,M,97,11,330,341
Adrik,M,100,0,340,340
Aitana,F,100,340,0,340
Alexey,M,94,19,321,340
Anjelika,F,100,340,0,340
Asaad,M,100,0,340,340
Daejon,M,100,0,340,340
Danish,M,100,0,340,340
Dontarius,M,100,0,340,340
Draper,M,100,0,340,340
Dynasti,F,100,340,0,340
Erielle,F,100,340,0,340
Farrel,M,100,0,340,340
Hosie,M,100,0,340,340
Izack,M,100,0,340,340
Jaleyah,F,100,340,0,340
Janecia,F,100,340,0,340
Jazman,F,97,329,11,340
Kenyah,F,100,340,0,340
Konstantin,M,100,0,340,340
Lanice,F,100,340,0,340
Linell,F,63,215,125,340
Majd,M,97,10,330,340
Mirah,F,100,340,0,340
Naziah,F,68,231,109,340
Nhan,M,99,5,335,340
Pallavi,F,100,340,0,340
Primo,M,100,0,340,340
Quinnton,M,100,0,340,340
Sherin,F,100,340,0,340
Sylena,F,100,340,0,340
Tekisha,F,100,340,0,340
Abcde,F,100,339,0,339
Anaia,F,100,339,0,339
Antiono,M,100,0,339,339
Brecklyn,F,100,339,0,339
Brittiney,F,100,339,0,339
Casidy,F,100,339,0,339
Craige,M,100,0,339,339
Daeshaun,M,100,0,339,339
Demonica,F,100,339,0,339
Deshanna,F,100,339,0,339
Ifeoma,F,100,339,0,339
Isiaha,M,100,0,339,339
Jahn,M,100,0,339,339
Jamesmichael,M,100,0,339,339
Nissi,F,100,339,0,339
Prisca,F,100,339,0,339
Riona,F,100,339,0,339
Ronique,F,97,329,10,339
Sundae,F,100,339,0,339
Tracen,M,100,0,339,339
Ziggy,M,98,6,333,339
Zyria,F,100,339,0,339
Abdulmalik,M,100,0,338,338
Adonnis,M,100,0,338,338
Aniylah,F,100,338,0,338
Antania,F,100,338,0,338
Antrell,M,100,0,338,338
Aubreanna,F,100,338,0,338
Barbaraann,F,100,338,0,338
Breindy,F,100,338,0,338
Diamantina,F,100,338,0,338
Donye,M,75,86,252,338
Estuardo,M,100,0,338,338
Georg,M,99,5,333,338
Huck,M,100,0,338,338
Itai,M,100,0,338,338
Javid,M,100,0,338,338
Kambry,F,100,338,0,338
Keishaun,M,100,0,338,338
Keyosha,F,100,338,0,338
Keyshon,M,100,0,338,338
Lavanda,F,100,338,0,338
Loreta,F,100,338,0,338
Lorrin,F,72,244,94,338
Lyzette,F,100,338,0,338
Marixa,F,100,338,0,338
Rahn,M,100,0,338,338
Raistlin,M,100,0,338,338
Reshard,M,100,0,338,338
Roark,M,100,0,338,338
Sarae,F,100,338,0,338
Special,F,100,338,0,338
Tangi,F,100,338,0,338
Yovanny,M,100,0,338,338
Aerianna,F,100,337,0,337
Bodee,M,99,5,332,337
Deeana,F,100,337,0,337
Demesha,F,100,337,0,337
Dua,F,100,337,0,337
Einar,M,100,0,337,337
Emori,F,87,292,45,337
Erionna,F,100,337,0,337
Glade,M,100,0,337,337
Greidys,F,100,337,0,337
Jadea,F,100,337,0,337
Jaiven,M,100,0,337,337
Jasline,F,100,337,0,337
Javiel,M,100,0,337,337
Juhi,F,100,337,0,337
Kien,M,100,0,337,337
Malone,M,56,147,190,337
Matison,F,100,337,0,337
Michah,M,95,17,320,337
Orry,M,100,0,337,337
Sigourney,F,100,337,0,337
Solimar,F,100,337,0,337
Subhan,M,100,0,337,337
Tremel,M,100,0,337,337
Tyrae,M,90,35,302,337
Tyshun,M,100,0,337,337
Vitaliy,M,100,0,337,337
Yatziry,F,100,337,0,337
Abagayle,F,100,336,0,336
Ajee,F,90,301,35,336
Arelys,F,100,336,0,336
Bathsheba,F,100,336,0,336
Caedyn,M,77,77,259,336
Cearra,F,100,336,0,336
Delecia,F,100,336,0,336
Duff,M,100,0,336,336
Erric,M,100,0,336,336
Hammad,M,100,0,336,336
Jamail,M,100,0,336,336
Janisa,F,100,336,0,336
Kato,M,100,0,336,336
Khiana,F,100,336,0,336
Ladaisha,F,100,336,0,336
Lamara,F,100,336,0,336
Leiloni,F,100,336,0,336
Maimouna,F,100,336,0,336
Margurite,F,100,336,0,336
Mozella,F,100,336,0,336
Naziyah,F,100,336,0,336
Quince,M,100,0,336,336
Rizwan,M,100,0,336,336
Ryver,M,65,117,219,336
Sani,F,80,270,66,336
Schylar,F,67,225,111,336
Scotland,M,51,164,172,336
Shelbe,F,100,336,0,336
Sherl,F,100,336,0,336
Siraj,M,100,0,336,336
Tian,M,57,143,193,336
Valisa,F,100,336,0,336
Vang,M,97,11,325,336
Vivan,F,63,213,123,336
Anah,F,100,335,0,335
Aunna,F,100,335,0,335
Ceola,F,100,335,0,335
Ebrahim,M,100,0,335,335
Faryn,F,100,335,0,335
Hyacinth,F,100,335,0,335
Joannah,F,100,335,0,335
Juleen,F,100,335,0,335
Jumana,F,100,335,0,335
Kaelani,F,100,335,0,335
Klee,F,100,335,0,335
Korban,M,100,0,335,335
Latham,M,100,0,335,335
Masha,F,100,335,0,335
Memorie,F,100,335,0,335
Murl,M,97,11,324,335
Phoenyx,F,68,229,106,335
Priscillia,F,100,335,0,335
Rafiq,M,100,0,335,335
Rahmir,M,100,0,335,335
Rayona,F,100,335,0,335
Simonne,F,100,335,0,335
Yui,F,100,335,0,335
Akai,M,90,32,302,334
Analuisa,F,100,334,0,334
Angeliz,F,100,334,0,334
Avel,M,100,0,334,334
Ayshia,F,100,334,0,334
Azaiah,M,88,39,295,334
Baden,M,100,0,334,334
Bahar,F,100,334,0,334
Barth,M,100,0,334,334
Chael,M,100,0,334,334
Chue,M,99,5,329,334
Dalisa,F,100,334,0,334
Dametrius,M,100,0,334,334
Damyan,M,100,0,334,334
Daphene,F,100,334,0,334
Deshonda,F,100,334,0,334
Doriann,F,100,334,0,334
Emelly,F,100,334,0,334
Fatina,F,100,334,0,334
Fatuma,F,100,334,0,334
Gaelle,F,100,334,0,334
Hilaria,F,100,334,0,334
Iann,M,100,0,334,334
Joesiah,M,100,0,334,334
Kaleem,M,100,0,334,334
Keygan,M,97,11,323,334
Khyra,F,100,334,0,334
Lorianna,F,100,334,0,334
Mariha,F,100,334,0,334
Mikeala,F,100,334,0,334
Myleah,F,100,334,0,334
Naseer,M,100,0,334,334
Raejean,F,100,334,0,334
Ronson,M,100,0,334,334
Tremon,M,100,0,334,334
Tyria,F,98,328,6,334
Arlynn,F,93,311,22,333
Ayra,F,100,333,0,333
Baili,F,100,333,0,333
Chaddrick,M,100,0,333,333
Chanise,F,100,333,0,333
Cruze,M,100,0,333,333
Damali,F,100,333,0,333
Diannia,F,100,333,0,333
Dody,F,100,333,0,333
Gimena,F,100,333,0,333
Indica,F,100,333,0,333
Jamarrion,M,100,0,333,333
Kariah,F,100,333,0,333
Katriel,F,92,307,26,333
Kerryann,F,100,333,0,333
Lanard,M,100,0,333,333
Laquanta,F,100,333,0,333
Liston,M,100,0,333,333
Lowanda,F,100,333,0,333
Maila,F,100,333,0,333
Mailey,F,100,333,0,333
Montre,M,100,0,333,333
Olegario,M,100,0,333,333
Roselee,F,100,333,0,333
Shemekia,F,100,333,0,333
Shenae,F,100,333,0,333
Srinidhi,F,100,333,0,333
Tige,M,100,0,333,333
Vernisha,F,100,333,0,333
Vibha,F,100,333,0,333
Whitni,F,100,333,0,333
Yareth,F,64,213,120,333
Yuritzy,F,100,333,0,333
Yvett,F,100,333,0,333
Yvonda,F,100,333,0,333
Zarriah,F,100,333,0,333
Adric,M,100,0,332,332
Bauer,M,100,0,332,332
Bellarose,F,100,332,0,332
Callaway,M,51,164,168,332
Cendy,F,100,332,0,332
Creig,M,100,0,332,332
Derico,M,100,0,332,332
Elier,M,100,0,332,332
Georgena,F,100,332,0,332
Hadia,F,100,332,0,332
Holdyn,M,97,10,322,332
Ilaria,F,100,332,0,332
Jeevan,M,100,0,332,332
Jese,M,100,0,332,332
Khristy,F,100,332,0,332
Kylyn,F,82,271,61,332
Lesean,M,97,10,322,332
Malakye,M,100,0,332,332
Marizol,F,100,332,0,332
Mcclain,M,92,26,306,332
Mozelle,F,100,332,0,332
Naylea,F,100,332,0,332
Nickolai,M,100,0,332,332
Philana,F,100,332,0,332
Saliyah,F,100,332,0,332
Samayah,F,100,332,0,332
Saturnino,M,100,0,332,332
Shacara,F,100,332,0,332
Tamyah,F,100,332,0,332
Tashena,F,100,332,0,332
Tayvin,M,94,19,313,332
Tomy,M,100,0,332,332
Areej,F,100,331,0,331
Asja,F,100,331,0,331
Bentleigh,F,89,293,38,331
Berlynn,F,100,331,0,331
Bethlehem,F,100,331,0,331
Caresse,F,100,331,0,331
Cherylyn,F,100,331,0,331
Christe,F,100,331,0,331
Daylee,F,98,325,6,331
Daymien,M,100,0,331,331
Dazia,F,100,331,0,331
Deberah,F,100,331,0,331
Edi,M,93,24,307,331
Felishia,F,100,331,0,331
Fiza,F,100,331,0,331
Jabier,M,100,0,331,331
Jahnavi,F,100,331,0,331
Josafat,M,100,0,331,331
Keneshia,F,100,331,0,331
Kewan,M,100,0,331,331
Laqueta,F,100,331,0,331
Naser,M,100,0,331,331
Naysa,F,100,331,0,331
Noha,F,85,282,49,331
Shaiann,F,100,331,0,331
Tulsi,F,100,331,0,331
Tymber,F,97,320,11,331
Yuriko,F,100,331,0,331
Zyanya,F,100,331,0,331
Alexiana,F,100,330,0,330
Callyn,F,98,325,5,330
Cephas,M,100,0,330,330
Colen,M,100,0,330,330
Ediberto,M,100,0,330,330
Fayetta,F,100,330,0,330
Folasade,F,100,330,0,330
Fradel,F,100,330,0,330
Isabeau,F,100,330,0,330
Jasin,M,100,0,330,330
Jayland,M,100,0,330,330
Jeorge,M,100,0,330,330
Katryn,F,100,330,0,330
Kimyatta,F,100,330,0,330
Larrisa,F,100,330,0,330
Maxcine,F,100,330,0,330
Oleg,M,100,0,330,330
Raymona,F,100,330,0,330
Rayshun,M,100,0,330,330
Romon,M,100,0,330,330
Sharmane,F,100,330,0,330
Shontia,F,100,330,0,330
Yaser,M,100,0,330,330
Aahil,M,100,0,329,329
Addelynn,F,100,329,0,329
Askia,M,100,0,329,329
Ayodele,M,70,98,231,329
Brittin,F,66,216,113,329
Dalisha,F,100,329,0,329
Deniya,F,100,329,0,329
Dequarius,M,100,0,329,329
Estell,F,86,284,45,329
Geni,F,100,329,0,329
Hillarie,F,100,329,0,329
Hobie,M,100,0,329,329
Jayliana,F,100,329,0,329
Joretta,F,100,329,0,329
Kahlen,F,81,267,62,329
Kaylamarie,F,100,329,0,329
Kayleena,F,100,329,0,329
Leng,M,98,5,324,329
Loralyn,F,100,329,0,329
Lorn,M,100,0,329,329
Macenzie,F,100,329,0,329
Maili,F,100,329,0,329
Matina,F,100,329,0,329
Millissa,F,100,329,0,329
Myangel,F,100,329,0,329
Nazaria,F,100,329,0,329
Princesa,F,100,329,0,329
Radonna,F,100,329,0,329
Tashon,M,95,15,314,329
Tyjae,F,52,172,157,329
Vick,M,100,0,329,329
Wael,M,100,0,329,329
Abelina,F,100,328,0,328
Aissata,F,100,328,0,328
Ajai,M,50,163,165,328
Alvah,M,100,0,328,328
Ananias,M,100,0,328,328
Annis,F,100,328,0,328
Antwaine,M,100,0,328,328
Arthuro,M,100,0,328,328
Benjy,M,100,0,328,328
Bodey,M,100,0,328,328
Caelynn,F,100,328,0,328
Dawsen,M,98,5,323,328
Dezi,M,62,126,202,328
Hailea,F,100,328,0,328
Ildefonso,M,100,0,328,328
Jadden,M,91,28,300,328
Jennilyn,F,100,328,0,328
Jensine,F,100,328,0,328
Keaten,M,98,5,323,328
Kiyon,M,100,0,328,328
Lachanda,F,100,328,0,328
Loriana,F,100,328,0,328
Marrion,M,76,79,249,328
Melvia,F,100,328,0,328
Michalene,F,100,328,0,328
Myca,F,89,293,35,328
Myrah,F,100,328,0,328
Mystic,F,100,328,0,328
Naftoli,M,100,0,328,328
Nasario,M,100,0,328,328
Navi,F,80,263,65,328
Netta,F,100,328,0,328
Nikea,F,100,328,0,328
Nohemy,F,100,328,0,328
Sabriya,F,100,328,0,328
Senia,F,100,328,0,328
Shakeia,F,100,328,0,328
Shakeira,F,100,328,0,328
Zarya,F,100,328,0,328
Alainah,F,100,327,0,327
Alegra,F,100,327,0,327
Aleksei,M,96,12,315,327
Alinah,F,100,327,0,327
Almon,M,100,0,327,327
Alynn,F,100,327,0,327
Amarilys,F,100,327,0,327
Ambika,F,100,327,0,327
Anarosa,F,100,327,0,327
Canton,M,100,0,327,327
Cinque,M,100,0,327,327
Dalten,M,100,0,327,327
Danyele,F,100,327,0,327
Eviana,F,100,327,0,327
Jermie,M,100,0,327,327
Joniel,M,100,0,327,327
Joylyn,F,100,327,0,327
Kinzey,F,100,327,0,327
Lakrisha,F,100,327,0,327
Ledell,M,98,5,322,327
Leeandra,F,100,327,0,327
Nancey,F,100,327,0,327
Rilla,F,100,327,0,327
Sajid,M,100,0,327,327
Tyona,F,100,327,0,327
Anvita,F,100,326,0,326
Ashford,M,100,0,326,326
Astra,F,100,326,0,326
Audric,M,100,0,326,326
Bhavya,F,80,260,66,326
Charlea,F,100,326,0,326
Cyncere,M,65,114,212,326
Eh,M,59,134,192,326
Ellory,F,100,326,0,326
Emorie,F,100,326,0,326
Harlyn,F,72,234,92,326
Hilbert,M,100,0,326,326
Hiroki,M,100,0,326,326
Jaselyn,F,100,326,0,326
Jilliann,F,100,326,0,326
Katieann,F,100,326,0,326
Kimala,F,100,326,0,326
Kynzlee,F,100,326,0,326
Makaylin,F,100,326,0,326
Mallika,F,100,326,0,326
Meloni,F,100,326,0,326
Saadiq,M,100,0,326,326
Samyia,F,100,326,0,326
Scarleth,F,100,326,0,326
Shayanne,F,100,326,0,326
Shelene,F,100,326,0,326
Tabias,M,100,0,326,326
Tempie,F,100,326,0,326
Tonio,M,100,0,326,326
Zoran,M,100,0,326,326
Aeneas,M,100,0,325,325
Aleks,M,100,0,325,325
Ashayla,F,100,325,0,325
Brallan,M,100,0,325,325
Calynn,F,100,325,0,325
Chao,M,89,36,289,325
Chequita,F,100,325,0,325
Crystian,M,100,0,325,325
Cyanna,F,100,325,0,325
Donise,F,100,325,0,325
Elya,M,57,141,184,325
Jadrien,M,98,5,320,325
Jorian,M,90,32,293,325
Juanluis,M,100,0,325,325
Juwon,M,100,0,325,325
Keirah,F,100,325,0,325
Kennedee,F,100,325,0,325
Kostas,M,100,0,325,325
Laykin,F,97,314,11,325
Letizia,F,100,325,0,325
Lundon,F,70,228,97,325
Lynnlee,F,100,325,0,325
Macaela,F,100,325,0,325
Mahika,F,100,325,0,325
Nkosi,M,98,7,318,325
Patrece,F,100,325,0,325
Smantha,F,100,325,0,325
Taeya,F,100,325,0,325
Willena,F,100,325,0,325
Yaffa,F,100,325,0,325
Zoria,F,100,325,0,325
Aliannah,F,100,324,0,324
Arrion,M,76,79,245,324
Cabrina,F,100,324,0,324
Can,M,100,0,324,324
Celisa,F,100,324,0,324
Cortlyn,F,95,309,15,324
Cotton,M,100,0,324,324
Cylee,F,100,324,0,324
Darreon,M,100,0,324,324
Deshone,M,84,51,273,324
Fouad,M,100,0,324,324
Hasson,M,100,0,324,324
Herby,M,100,0,324,324
Izek,M,100,0,324,324
Jahira,F,100,324,0,324
Jestina,F,100,324,0,324
Lucan,M,100,0,324,324
Quinlyn,F,98,318,6,324
Quintus,M,100,0,324,324
Rosangela,F,100,324,0,324
Shericka,F,100,324,0,324
Shirell,F,100,324,0,324
Solara,F,100,324,0,324
Suleyma,F,100,324,0,324
Tene,F,100,324,0,324
Trula,F,100,324,0,324
Amesha,F,100,323,0,323
Amine,M,100,0,323,323
Angelli,F,100,323,0,323
Anija,F,100,323,0,323
Auron,M,100,0,323,323
Chae,F,54,175,148,323
Charmagne,F,100,323,0,323
Dariah,F,100,323,0,323
Elesia,F,100,323,0,323
Ezio,M,100,0,323,323
Fate,M,67,107,216,323
Hailyn,F,100,323,0,323
Hue,M,72,89,234,323
Jisselle,F,100,323,0,323
Jurgen,M,100,0,323,323
Katye,F,100,323,0,323
Khris,M,86,46,277,323
Kristianne,F,100,323,0,323
Ksenia,F,100,323,0,323
Lafe,M,100,0,323,323
Logyn,F,54,173,150,323
Mare,M,100,0,323,323
Melora,F,100,323,0,323
Nadim,M,100,0,323,323
Nairobi,F,91,293,30,323
Nance,F,100,323,0,323
Nitasha,F,100,323,0,323
Raphaela,F,100,323,0,323
Seng,M,74,84,239,323
Treyveon,M,100,0,323,323
Tylie,F,100,323,0,323
Abigayl,F,100,322,0,322
Agostino,M,100,0,322,322
Anthon,M,100,0,322,322
Baylin,M,58,136,186,322
Cecilie,F,100,322,0,322
Cheney,F,65,208,114,322
Clarity,F,100,322,0,322
Clayborn,M,100,0,322,322
Dal,M,100,0,322,322
Feliciana,F,100,322,0,322
Haille,F,100,322,0,322
Harish,M,100,0,322,322
Heinrich,M,100,0,322,322
Jodean,F,100,322,0,322
Keandrea,F,100,322,0,322
Keyarra,F,100,322,0,322
Khori,F,72,231,91,322
Kimesha,F,100,322,0,322
Kincaid,M,100,0,322,322
Marquavius,M,100,0,322,322
Miliana,F,100,322,0,322
Rhylie,F,100,322,0,322
Samhita,F,100,322,0,322
Wray,M,95,17,305,322
Alexsia,F,100,321,0,321
Andrzej,M,100,0,321,321
Annalese,F,100,321,0,321
Aqueelah,F,100,321,0,321
Caliana,F,100,321,0,321
Cherron,F,98,316,5,321
Corneilus,M,100,0,321,321
Damont,M,100,0,321,321
Daphnee,F,100,321,0,321
Delories,F,100,321,0,321
Deniyah,F,100,321,0,321
Fayette,F,96,307,14,321
Gerrad,M,100,0,321,321
Harolyn,F,100,321,0,321
Inell,F,100,321,0,321
Jacqulynn,F,100,321,0,321
Jaymz,M,100,0,321,321
Kaedin,M,98,5,316,321
Katielynn,F,100,321,0,321
Keyonta,M,68,102,219,321
Kitzia,F,100,321,0,321
Ladora,F,100,321,0,321
Larell,M,98,5,316,321
Maclain,M,98,5,316,321
Mehak,F,100,321,0,321
Neeraj,M,100,0,321,321
Nirali,F,100,321,0,321
Raelynne,F,100,321,0,321
Saralee,F,100,321,0,321
Sergei,M,100,0,321,321
Shacora,F,100,321,0,321
Shaneen,F,100,321,0,321
Tobe,M,93,24,297,321
Tonetta,F,100,321,0,321
Tyese,F,100,321,0,321
Tyheem,M,100,0,321,321
Zamar,M,100,0,321,321
Zyriah,F,100,321,0,321
Adlee,F,100,320,0,320
Adra,F,100,320,0,320
Becka,F,100,320,0,320
Bethzaida,F,100,320,0,320
Brayla,F,100,320,0,320
Briston,M,100,0,320,320
Calix,M,100,0,320,320
Dilynn,F,88,280,40,320
Elika,F,100,320,0,320
Greig,M,100,0,320,320
Illeana,F,100,320,0,320
Jaivion,M,100,0,320,320
Jenefer,F,100,320,0,320
Joley,F,100,320,0,320
Josslynn,F,100,320,0,320
Joyelle,F,100,320,0,320
Karenna,F,100,320,0,320
Kerie,F,100,320,0,320
Keryn,F,100,320,0,320
Khyler,M,84,50,270,320
Kimela,F,100,320,0,320
Knute,M,100,0,320,320
Ladana,F,100,320,0,320
Ladarion,M,100,0,320,320
Laiza,F,100,320,0,320
Lamees,F,100,320,0,320
Madhav,M,100,0,320,320
Mammie,F,100,320,0,320
Marvette,F,100,320,0,320
Maryetta,F,100,320,0,320
Matalyn,F,100,320,0,320
Mirinda,F,100,320,0,320
Nazar,M,100,0,320,320
Perl,F,100,320,0,320
Rithika,F,100,320,0,320
Rosellen,F,100,320,0,320
Sabrine,F,100,320,0,320
Satvik,M,100,0,320,320
Sequan,M,100,0,320,320
Shylynn,F,100,320,0,320
Talley,F,90,287,33,320
Thereasa,F,100,320,0,320
Acelyn,F,98,314,5,319
Aina,F,100,319,0,319
Amyrah,F,100,319,0,319
Anaiz,F,100,319,0,319
Angellina,F,100,319,0,319
Antigone,F,100,319,0,319
Ariahna,F,100,319,0,319
Ascencion,M,100,0,319,319
Baylei,F,100,319,0,319
Chantale,F,100,319,0,319
Dagen,M,92,27,292,319
Darrielle,F,100,319,0,319
Delbra,F,100,319,0,319
Haig,M,100,0,319,319
Hasini,F,100,319,0,319
Jaz,M,67,105,214,319
Jovannie,M,97,11,308,319
Kahealani,F,100,319,0,319
Kazuki,M,100,0,319,319
Kenitra,F,100,319,0,319
Loma,F,100,319,0,319
Melville,M,100,0,319,319
Naheem,M,100,0,319,319
Nathasha,F,100,319,0,319
Nikolay,M,100,0,319,319
Niraj,M,100,0,319,319
Oretha,F,100,319,0,319
Patterson,M,94,20,299,319
Rashi,F,60,190,129,319
Shashank,M,100,0,319,319
Supriya,F,100,319,0,319
Tarique,M,100,0,319,319
Tyray,M,100,0,319,319
Zelia,F,100,319,0,319
Brenen,M,100,0,318,318
Caston,M,100,0,318,318
Cheyla,F,100,318,0,318
Davan,M,75,78,240,318
Dejan,M,96,13,305,318
Delise,F,100,318,0,318
Dishon,M,100,0,318,318
Elianah,F,100,318,0,318
Erandy,F,100,318,0,318
Fraida,F,100,318,0,318
Grettel,F,100,318,0,318
Jancy,F,98,313,5,318
Jaylynne,F,100,318,0,318
Kaitlyne,F,100,318,0,318
Kalilah,F,100,318,0,318
Kemauri,M,85,49,269,318
Kentaro,M,100,0,318,318
Mayar,F,98,311,7,318
Miaya,F,100,318,0,318
Mikella,F,100,318,0,318
Nael,M,98,6,312,318
Railynn,F,100,318,0,318
Seretha,F,100,318,0,318
Syndey,F,100,318,0,318
Theola,F,100,318,0,318
Tivon,M,100,0,318,318
Zerrick,M,100,0,318,318
Aidric,M,100,0,317,317
Alissandra,F,100,317,0,317
Amenda,F,100,317,0,317
Boni,F,100,317,0,317
Camillo,M,100,0,317,317
Daralyn,F,100,317,0,317
Deronda,F,100,317,0,317
Destaney,F,100,317,0,317
Dezmen,M,100,0,317,317
Edris,M,63,116,201,317
Jadarrius,M,100,0,317,317
Jarian,M,100,0,317,317
Jasani,F,73,230,87,317
Jeziah,M,94,20,297,317
Jodeen,F,100,317,0,317
Joeanna,F,100,317,0,317
Kamdon,M,100,0,317,317
Keaghan,M,75,80,237,317
Keishla,F,100,317,0,317
Kelee,F,100,317,0,317
Kiet,M,100,0,317,317
Linzey,F,100,317,0,317
Makinna,F,100,317,0,317
Rondel,M,100,0,317,317
Shalamar,F,74,234,83,317
Shanin,F,100,317,0,317
Shell,F,62,198,119,317
Traquan,M,100,0,317,317
Yissel,F,100,317,0,317
Zakayla,F,100,317,0,317
Abir,M,71,92,224,316
Adeena,F,100,316,0,316
Aijah,F,100,316,0,316
Asiel,M,98,6,310,316
Azura,F,100,316,0,316
Carena,F,100,316,0,316
Darral,M,100,0,316,316
Deasha,F,100,316,0,316
Deisha,F,100,316,0,316
Deontray,M,100,0,316,316
Derenda,F,100,316,0,316
Dong,M,100,0,316,316
Donice,F,100,316,0,316
Fraser,M,100,0,316,316
Ivori,F,100,316,0,316
Johnrobert,M,100,0,316,316
Jonatha,M,98,5,311,316
Kaithlyn,F,100,316,0,316
Kaiulani,F,100,316,0,316
Kayelee,F,100,316,0,316
Kennidy,F,100,316,0,316
Kishawn,M,97,10,306,316
Ladasha,F,100,316,0,316
Lakyra,F,100,316,0,316
Laurelle,F,100,316,0,316
Nakoa,M,98,5,311,316
Neven,M,98,6,310,316
Niyla,F,100,316,0,316
Rinaldo,M,100,0,316,316
Shaira,F,100,316,0,316
Shayli,F,100,316,0,316
Shyane,F,100,316,0,316
Stedman,M,100,0,316,316
Suleiman,M,100,0,316,316
Trinia,F,100,316,0,316
Woodson,M,100,0,316,316
Ashleyann,F,100,315,0,315
Braddock,M,100,0,315,315
Breiana,F,100,315,0,315
Camora,F,100,315,0,315
Christropher,M,100,0,315,315
Denarius,M,100,0,315,315
Ellyanna,F,100,315,0,315
Ikeem,M,100,0,315,315
Jaymon,M,100,0,315,315
Jazalyn,F,100,315,0,315
Jermar,M,100,0,315,315
Kaaren,F,100,315,0,315
Kallyn,F,100,315,0,315
Karlynn,F,100,315,0,315
Leyda,F,100,315,0,315
Martice,M,95,15,300,315
Orestes,M,100,0,315,315
Parke,M,100,0,315,315
Pranavi,F,100,315,0,315
Puneet,M,51,155,160,315
Rozell,M,90,32,283,315
Saloma,F,100,315,0,315
Seiji,M,100,0,315,315
Sharin,F,100,315,0,315
Sheilia,F,100,315,0,315
Suni,F,100,315,0,315
Tanija,F,100,315,0,315
Tiyonna,F,100,315,0,315
Wylene,F,100,315,0,315
Yeraldin,F,100,315,0,315
Zulay,F,100,315,0,315
Alexande,M,100,0,314,314
Analissa,F,100,314,0,314
Aundrey,M,98,5,309,314
Barnaby,M,100,0,314,314
Basel,M,100,0,314,314
Dex,M,100,0,314,314
Dominico,M,100,0,314,314
Dsean,M,100,0,314,314
Emiyah,F,100,314,0,314
Essa,M,94,20,294,314
Finneas,M,100,0,314,314
Geana,F,100,314,0,314
Jackee,F,100,314,0,314
Jacquilyn,F,100,314,0,314
Jamicheal,M,100,0,314,314
Jarelle,M,100,0,314,314
Jayren,M,100,0,314,314
Jaysha,F,100,314,0,314
Jhoanna,F,100,314,0,314
Johntae,M,98,7,307,314
Kaveh,M,100,0,314,314
Kemonte,M,100,0,314,314
Keontay,M,98,5,309,314
Liban,M,100,0,314,314
Luzelena,F,100,314,0,314
Mackey,M,100,0,314,314
Marlis,F,100,314,0,314
Marybell,F,100,314,0,314
Maurie,F,80,250,64,314
Maylie,F,100,314,0,314
Mikiya,F,100,314,0,314
Natalye,F,100,314,0,314
Otilio,M,100,0,314,314
Ramzy,M,100,0,314,314
Satara,F,100,314,0,314
Senta,F,100,314,0,314
Tamyia,F,100,314,0,314
Tyrion,M,98,7,307,314
Allora,F,100,313,0,313
Belma,F,100,313,0,313
Caige,M,100,0,313,313
Chirstina,F,100,313,0,313
Chyanna,F,100,313,0,313
Clarrisa,F,100,313,0,313
Demetrie,M,95,17,296,313
Eyal,M,100,0,313,313
Galo,M,100,0,313,313
Idell,F,100,313,0,313
Ishaq,M,100,0,313,313
Ivin,M,100,0,313,313
Kathyleen,F,100,313,0,313
Katricia,F,100,313,0,313
Keyondre,M,100,0,313,313
Konstantine,M,98,6,307,313
Lavonta,M,96,11,302,313
Marsean,M,100,0,313,313
Mohsin,M,100,0,313,313
Nithin,M,100,0,313,313
Orren,M,100,0,313,313
Qadir,M,100,0,313,313
Raguel,F,100,313,0,313
Rohin,M,100,0,313,313
Saidah,F,100,313,0,313
Shakari,F,96,301,12,313
Shekia,F,100,313,0,313
Skiler,M,52,150,163,313
Adessa,F,100,312,0,312
Aleiyah,F,100,312,0,312
Antwoin,M,100,0,312,312
Anvitha,F,100,312,0,312
Areeb,M,100,0,312,312
Caidan,M,100,0,312,312
Chanin,F,96,301,11,312
Charie,F,100,312,0,312
Chasta,F,100,312,0,312
Damarian,M,100,0,312,312
Dashay,F,92,288,24,312
Kaleyah,F,100,312,0,312
Kashaun,M,100,0,312,312
Kazia,F,100,312,0,312
Keil,M,100,0,312,312
Korra,F,100,312,0,312
Laasya,F,100,312,0,312
Lennette,F,100,312,0,312
Mahina,F,100,312,0,312
Mannie,M,98,5,307,312
Milisa,F,100,312,0,312
Nayan,M,98,5,307,312
Raymondo,M,100,0,312,312
Rudolpho,M,100,0,312,312
Sevin,M,79,65,247,312
Sheresa,F,100,312,0,312
Takeria,F,100,312,0,312
Tinna,F,100,312,0,312
Treana,F,100,312,0,312
Tynika,F,100,312,0,312
Wyatte,M,100,0,312,312
Adal,M,100,0,311,311
Alany,F,100,311,0,311
Alder,M,98,6,305,311
Allia,F,100,311,0,311
Ayme,F,100,311,0,311
Belton,M,100,0,311,311
Dyane,F,100,311,0,311
Esthela,F,100,311,0,311
Esty,F,100,311,0,311
Gwyndolyn,F,100,311,0,311
Hamad,M,100,0,311,311
Harjot,M,74,82,229,311
Hudsyn,F,57,178,133,311
Jaques,M,98,5,306,311
Jordyne,F,100,311,0,311
Kaziah,F,96,300,11,311
Kunta,M,97,8,303,311
Lyndsee,F,100,311,0,311
Lyndy,F,100,311,0,311
Madie,F,100,311,0,311
Malayshia,F,100,311,0,311
Miyoshi,F,100,311,0,311
Monia,F,100,311,0,311
Noeli,F,100,311,0,311
Pharrell,M,100,0,311,311
Pratham,M,100,0,311,311
Quiara,F,100,311,0,311
Quintyn,M,100,0,311,311
Saachi,F,100,311,0,311
Shaylea,F,100,311,0,311
Summar,F,100,311,0,311
Swetha,F,100,311,0,311
Teghan,F,84,262,49,311
Tennie,F,100,311,0,311
Tirza,F,100,311,0,311
Tomisha,F,100,311,0,311
Trellis,F,72,224,87,311
Adelene,F,100,310,0,310
Arantxa,F,100,310,0,310
Arriel,F,100,310,0,310
Arwyn,F,100,310,0,310
Athziry,F,100,310,0,310
Avayah,F,100,310,0,310
Avigdor,M,100,0,310,310
Braven,M,100,0,310,310
Devani,F,100,310,0,310
Eddrick,M,100,0,310,310
Evangela,F,100,310,0,310
Guillaume,M,100,0,310,310
Gwendelyn,F,100,310,0,310
Kaydince,F,100,310,0,310
Laurisa,F,100,310,0,310
Lehman,M,100,0,310,310
Maurisio,M,100,0,310,310
Mehreen,F,100,310,0,310
Nadege,F,100,310,0,310
Nancye,F,100,310,0,310
Okey,M,100,0,310,310
Rayvin,F,98,304,6,310
Shiven,M,100,0,310,310
Taquana,F,100,310,0,310
Teila,F,100,310,0,310
Treyshawn,M,100,0,310,310
Akeyla,F,100,309,0,309
Annaclaire,F,100,309,0,309
Ayushi,F,100,309,0,309
Bless,M,51,152,157,309
Bryelle,F,100,309,0,309
Charmine,F,100,309,0,309
Correna,F,100,309,0,309
Criag,M,100,0,309,309
Danene,F,100,309,0,309
Evett,F,100,309,0,309
Giannina,F,100,309,0,309
Jenniefer,F,100,309,0,309
Jimmi,F,84,260,49,309
Jozelyn,F,100,309,0,309
Kamyia,F,100,309,0,309
Leasha,F,100,309,0,309
Leonarda,F,100,309,0,309
Lyndel,M,71,89,220,309
Makita,F,100,309,0,309
Mashell,F,100,309,0,309
Melda,F,100,309,0,309
Meshelle,F,100,309,0,309
Rahaf,F,100,309,0,309
Ranada,F,100,309,0,309
Richad,M,100,0,309,309
Rox,F,100,309,0,309
Sanah,F,100,309,0,309
Shaheer,M,100,0,309,309
Sholanda,F,100,309,0,309
Suhana,F,100,309,0,309
Teandra,F,100,309,0,309
Theodosia,F,100,309,0,309
Tomasina,F,100,309,0,309
Travious,M,100,0,309,309
Venesa,F,100,309,0,309
Yoav,M,100,0,309,309
Adonia,F,100,308,0,308
Alyssamarie,F,100,308,0,308
Analyn,F,100,308,0,308
Anastashia,F,100,308,0,308
Andrienne,F,100,308,0,308
Annali,F,100,308,0,308
Bryceton,M,100,0,308,308
Dalal,F,100,308,0,308
Idan,M,100,0,308,308
Jaelynne,F,100,308,0,308
Jaycion,M,100,0,308,308
Jemarcus,M,100,0,308,308
Jerett,M,100,0,308,308
Kayah,F,100,308,0,308
Keisy,F,100,308,0,308
Lakasha,F,100,308,0,308
Latiesha,F,100,308,0,308
Madeliene,F,100,308,0,308
Mckynlee,F,100,308,0,308
Mclean,M,96,11,297,308
Mili,F,100,308,0,308
Nikolina,F,100,308,0,308
Roper,M,100,0,308,308
Starasia,F,100,308,0,308
Tajon,M,100,0,308,308
Trejon,M,100,0,308,308
Yaw,M,100,0,308,308
Abaigeal,F,100,307,0,307
Abygale,F,100,307,0,307
Akshat,M,100,0,307,307
Alaila,F,100,307,0,307
Aniel,M,100,0,307,307
Arush,M,100,0,307,307
Ayline,F,100,307,0,307
Brendy,F,100,307,0,307
Brizeida,F,100,307,0,307
Chang,M,98,5,302,307
Cire,M,54,142,165,307
Daksh,M,100,0,307,307
Dareen,F,97,297,10,307
Delshawn,M,100,0,307,307
Deshannon,F,63,193,114,307
Hunner,M,100,0,307,307
Jaaron,M,100,0,307,307
Jossalyn,F,100,307,0,307
Lawonda,F,100,307,0,307
Linford,M,100,0,307,307
Lynsay,F,100,307,0,307
Marwin,M,100,0,307,307
Melonee,F,100,307,0,307
Neiman,M,98,5,302,307
Raed,M,100,0,307,307
Rane,M,60,124,183,307
Rhyann,F,100,307,0,307
Shah,M,98,5,302,307
Shamera,F,100,307,0,307
Shary,F,100,307,0,307
Shevonne,F,100,307,0,307
Sidnie,F,100,307,0,307
Spurgeon,M,100,0,307,307
Suhas,M,100,0,307,307
Taquisha,F,100,307,0,307
Tynetta,F,100,307,0,307
Valerio,M,100,0,307,307
Vitoria,F,100,307,0,307
Wilburt,M,100,0,307,307
Xayden,M,100,0,307,307
Aneka,F,100,306,0,306
Aniaya,F,100,306,0,306
Ayrianna,F,100,306,0,306
Brek,M,100,0,306,306
Calise,F,100,306,0,306
Cathern,F,100,306,0,306
Cullan,M,100,0,306,306
Debara,F,100,306,0,306
Dewaine,M,100,0,306,306
Ehsan,M,100,0,306,306
Erikah,F,100,306,0,306
Ernan,M,100,0,306,306
Estefana,F,100,306,0,306
Jacarri,M,100,0,306,306
Jackilyn,F,100,306,0,306
Jaselle,F,100,306,0,306
Jawanna,F,100,306,0,306
Jazell,F,100,306,0,306
Kentrel,M,100,0,306,306
Kyann,F,98,301,5,306
Lamel,M,100,0,306,306
Mahari,M,54,140,166,306
Majestic,F,68,207,99,306
Mekhai,M,100,0,306,306
Mikhaela,F,100,306,0,306
Miyanna,F,100,306,0,306
Monterio,M,100,0,306,306
Nasier,M,100,0,306,306
Quron,M,100,0,306,306
Rasul,M,100,0,306,306
Samona,F,100,306,0,306
Syriana,F,100,306,0,306
Tamryn,F,97,296,10,306
Therisa,F,100,306,0,306
Tramon,M,100,0,306,306
Traves,M,100,0,306,306
Yvonnie,F,100,306,0,306
Alwin,M,100,0,305,305
Anahita,F,100,305,0,305
Arabia,F,100,305,0,305
Arliss,M,60,121,184,305
Brisia,F,100,305,0,305
Cardin,M,92,25,280,305
Cristino,M,100,0,305,305
Edvardo,M,100,0,305,305
English,F,87,265,40,305
Haddon,M,100,0,305,305
Itzia,F,100,305,0,305
Jasman,F,85,259,46,305
Kaedan,M,98,5,300,305
Kaid,M,100,0,305,305
Keean,M,100,0,305,305
Kerem,M,100,0,305,305
Kinnick,M,98,5,300,305
Kjersten,F,100,305,0,305
Kristien,F,87,264,41,305
Lorraina,F,100,305,0,305
Lubna,F,100,305,0,305
Luisalberto,M,100,0,305,305
Magdeline,F,100,305,0,305
Manuelita,F,100,305,0,305
Marcio,M,100,0,305,305
Marella,F,100,305,0,305
Monquie,F,100,305,0,305
Perlita,F,100,305,0,305
Ruta,F,100,305,0,305
Shawntia,F,100,305,0,305
Shirlyn,F,100,305,0,305
Sony,M,87,39,266,305
Thong,M,100,0,305,305
Tidus,M,100,0,305,305
Virgle,M,100,0,305,305
Aayla,F,100,304,0,304
Addi,F,100,304,0,304
Ailany,F,100,304,0,304
Amirra,F,100,304,0,304
Aqsa,F,100,304,0,304
Arnesha,F,100,304,0,304
Carliss,F,80,243,61,304
Chavy,F,100,304,0,304
Chriselda,F,100,304,0,304
Detrice,F,100,304,0,304
Dontray,M,100,0,304,304
Gean,M,62,116,188,304
Hagop,M,100,0,304,304
Ivor,M,100,0,304,304
Janesa,F,100,304,0,304
Jobie,M,82,56,248,304
Kendre,M,79,64,240,304
Lasheka,F,100,304,0,304
Leza,F,100,304,0,304
Makinsey,F,100,304,0,304
Maralyn,F,100,304,0,304
Mayleigh,F,100,304,0,304
Mccartney,F,70,212,92,304
Minta,F,100,304,0,304
Pati,F,100,304,0,304
Raiza,F,100,304,0,304
Rhodes,M,98,7,297,304
Rosaland,F,100,304,0,304
Saori,F,100,304,0,304
Simi,F,98,298,6,304
Telena,F,100,304,0,304
Teyah,F,100,304,0,304
Tiffinie,F,100,304,0,304
Tykeem,M,100,0,304,304
Victorino,M,100,0,304,304
Yajayra,F,100,304,0,304
Yassine,M,100,0,304,304
Abid,M,100,0,303,303
Advait,M,100,0,303,303
Alenna,F,100,303,0,303
Arnisha,F,100,303,0,303
Aunika,F,100,303,0,303
Avri,F,95,287,16,303
Barbette,F,100,303,0,303
Brenlee,F,100,303,0,303
Cederick,M,100,0,303,303
Christiann,F,100,303,0,303
Curtisha,F,100,303,0,303
Dajaun,M,100,0,303,303
Dannia,F,100,303,0,303
Davarius,M,100,0,303,303
Elric,M,100,0,303,303
Franceska,F,100,303,0,303
Hilliary,F,100,303,0,303
Jackline,F,100,303,0,303
Jaiyana,F,100,303,0,303
Johnn,M,100,0,303,303
Jojo,M,67,100,203,303
Jomari,M,81,59,244,303
Kameisha,F,100,303,0,303
Kassidie,F,100,303,0,303
Kaylina,F,100,303,0,303
Kiven,M,100,0,303,303
Kristain,F,78,237,66,303
Laketha,F,100,303,0,303
Leonia,F,100,303,0,303
Maeleigh,F,100,303,0,303
Meiling,F,100,303,0,303
Princella,F,100,303,0,303
Shandria,F,100,303,0,303
Shandrika,F,100,303,0,303
Tazia,F,100,303,0,303
Tonimarie,F,100,303,0,303
Toran,M,100,0,303,303
Travian,M,100,0,303,303
Tyliah,F,100,303,0,303
Yang,M,84,47,256,303
Aamiyah,F,100,302,0,302
Alayia,F,100,302,0,302
Alayiah,F,100,302,0,302
Alyss,F,100,302,0,302
Amad,M,100,0,302,302
Carilyn,F,100,302,0,302
Da,M,62,116,186,302
Darrelle,M,79,64,238,302
Dawnetta,F,100,302,0,302
Demondre,M,100,0,302,302
Jayani,F,100,302,0,302
Jerolyn,F,100,302,0,302
Jesalyn,F,100,302,0,302
Josiyah,M,100,0,302,302
Ladale,M,97,10,292,302
Milica,F,100,302,0,302
Nabor,M,100,0,302,302
Niam,M,100,0,302,302
Nolin,M,100,0,302,302
Raley,F,100,302,0,302
Ramonda,F,100,302,0,302
Rashmi,F,100,302,0,302
Rieley,F,63,191,111,302
Tajai,M,51,147,155,302
Tee,M,87,40,262,302
Vraj,M,100,0,302,302
Wenceslao,M,100,0,302,302
Zamiah,F,100,302,0,302
Alanzo,M,100,0,301,301
Aphrodite,F,100,301,0,301
Arieonna,F,100,301,0,301
Avrum,M,100,0,301,301
Carren,F,100,301,0,301
Chantia,F,100,301,0,301
Delanee,F,100,301,0,301
Isidra,F,100,301,0,301
Jermya,F,100,301,0,301
Jessen,M,100,0,301,301
Kaige,M,98,5,296,301
Karmello,M,100,0,301,301
Keonia,F,100,301,0,301
Kharisma,F,100,301,0,301
Levert,M,100,0,301,301
Lilley,F,100,301,0,301
Lynee,F,100,301,0,301
Mahamadou,M,100,0,301,301
Mylon,M,100,0,301,301
Oluwadamilola,F,65,197,104,301
Pao,M,100,0,301,301
Paxtyn,F,56,168,133,301
Pearly,F,90,271,30,301
Richar,M,100,0,301,301
Roanne,F,100,301,0,301
Romain,M,100,0,301,301
Sanyah,F,100,301,0,301
Satori,F,97,291,10,301
Tenecia,F,100,301,0,301
Tenise,F,100,301,0,301
Tunisha,F,100,301,0,301
Tylyn,F,82,246,55,301
Valor,M,92,24,277,301
Voncile,F,100,301,0,301
Adrin,M,96,12,288,300
Aloni,F,100,300,0,300
Annistyn,F,100,300,0,300
Axell,M,100,0,300,300
Benn,M,100,0,300,300
Cheikh,M,100,0,300,300
Easten,M,100,0,300,300
Eliberto,M,100,0,300,300
Encarnacion,M,100,0,300,300
Fong,M,98,5,295,300
Gabriana,F,100,300,0,300
Izael,M,100,0,300,300
Jaevion,M,100,0,300,300
Jarold,M,100,0,300,300
Keynan,M,100,0,300,300
Khyle,M,94,18,282,300
Laini,F,100,300,0,300
Lasaundra,F,100,300,0,300
Magdelena,F,100,300,0,300
Mame,F,100,300,0,300
Marra,F,100,300,0,300
Mikeya,F,100,300,0,300
Milad,M,100,0,300,300
Othello,M,100,0,300,300
Samora,F,98,295,5,300
Shatera,F,100,300,0,300
Shekita,F,100,300,0,300
Tacey,F,100,300,0,300
Takita,F,100,300,0,300
Teyona,F,100,300,0,300
Tonjia,F,100,300,0,300
Tressia,F,100,300,0,300
Winson,M,100,0,300,300
Allyah,F,100,299,0,299
Angelus,M,97,10,289,299
Dailen,M,98,5,294,299
Dang,M,98,6,293,299
Ebonique,F,100,299,0,299
Everley,F,100,299,0,299
Jaelee,F,100,299,0,299
Jassiel,M,98,5,294,299
Jaydenn,M,86,42,257,299
Jennice,F,100,299,0,299
Kenson,M,100,0,299,299
Lliam,M,100,0,299,299
Marimar,F,100,299,0,299
Mert,M,100,0,299,299
Mickala,F,100,299,0,299
Reshonda,F,100,299,0,299
Rhyanna,F,100,299,0,299
Ryatt,M,98,7,292,299
Shamarr,M,98,5,294,299
Sherilynn,F,100,299,0,299
Tejal,F,100,299,0,299
Tong,M,100,0,299,299
Zakkery,M,100,0,299,299
Zymere,M,100,0,299,299
Ameliah,F,100,298,0,298
Angeliki,F,100,298,0,298
Areil,F,100,298,0,298
Aymen,M,94,17,281,298
Calem,M,100,0,298,298
Camran,M,94,18,280,298
Conchetta,F,100,298,0,298
Edlin,F,95,284,14,298
Ellisha,F,100,298,0,298
Emilynn,F,100,298,0,298
Falcon,M,95,16,282,298
Favor,F,81,241,57,298
Isauro,M,100,0,298,298
Jadee,F,100,298,0,298
Jalaysia,F,100,298,0,298
Jerzey,F,97,288,10,298
Johanny,F,86,256,42,298
Jovonte,M,100,0,298,298
Kameshia,F,100,298,0,298
Kelvon,M,100,0,298,298
Kindal,F,100,298,0,298
Lamberto,M,100,0,298,298
Lathen,M,100,0,298,298
Lorain,F,100,298,0,298
Macoy,M,100,0,298,298
Makila,F,100,298,0,298
Makoto,M,100,0,298,298
Maksymilian,M,100,0,298,298
Marium,F,100,298,0,298
Mayan,F,64,192,106,298
Paulett,F,100,298,0,298
Rody,M,100,0,298,298
Saahil,M,100,0,298,298
Takashi,M,100,0,298,298
Tuyet,F,100,298,0,298
Xion,M,91,26,272,298
Yonas,M,100,0,298,298
Zarion,M,100,0,298,298
Aadil,M,100,0,297,297
Adelin,F,100,297,0,297
Ardelia,F,100,297,0,297
Assunta,F,100,297,0,297
Cruzito,M,100,0,297,297
Damonta,M,100,0,297,297
Danner,M,98,5,292,297
Dariyah,F,100,297,0,297
Dawnn,F,100,297,0,297
Emsley,F,100,297,0,297
Gio,M,98,5,292,297
Grasiela,F,100,297,0,297
Jahdiel,M,100,0,297,297
Jondavid,M,100,0,297,297
Kelon,M,100,0,297,297
Kijuan,M,100,0,297,297
Klye,M,100,0,297,297
Krisanne,F,100,297,0,297
Kynley,F,100,297,0,297
Lacole,F,100,297,0,297
Marjie,F,100,297,0,297
Mckade,M,100,0,297,297
Mushka,F,100,297,0,297
Nijel,M,100,0,297,297
Pax,M,98,5,292,297
Sanora,F,100,297,0,297
Shamonica,F,100,297,0,297
Tannis,F,98,292,5,297
Trinda,F,100,297,0,297
Valori,F,100,297,0,297
Vanessia,F,100,297,0,297
Vegas,M,61,115,182,297
Yoan,M,100,0,297,297
Aireanna,F,100,296,0,296
Ariani,F,100,296,0,296
Ashunti,F,100,296,0,296
Aveline,F,100,296,0,296
Carles,M,98,5,291,296
Coralynn,F,100,296,0,296
Corion,M,100,0,296,296
Cyerra,F,100,296,0,296
Delonda,F,100,296,0,296
Donaciano,M,100,0,296,296
Donnella,F,100,296,0,296
Eastin,M,97,10,286,296
Emigdio,M,100,0,296,296
Gunter,M,100,0,296,296
Gwenivere,F,100,296,0,296
Jaaziel,M,98,5,291,296
Kachina,F,100,296,0,296
Keefer,M,100,0,296,296
Luisenrique,M,100,0,296,296
Lynnann,F,100,296,0,296
Montrice,F,70,208,88,296
Onnie,M,52,141,155,296
Rael,M,52,143,153,296
Shameca,F,100,296,0,296
Shayda,F,100,296,0,296
Shefali,F,100,296,0,296
Tareq,M,100,0,296,296
Tauni,F,100,296,0,296
Aishani,F,100,295,0,295
Anajah,F,100,295,0,295
Analysa,F,100,295,0,295
Anora,F,100,295,0,295
Corianna,F,100,295,0,295
Daila,F,100,295,0,295
Davieon,M,100,0,295,295
Daylynn,F,90,266,29,295
Defne,F,100,295,0,295
Denyce,F,100,295,0,295
Desta,F,100,295,0,295
Dorrell,M,100,0,295,295
Fergus,M,100,0,295,295
Finlee,F,93,275,20,295
Gerod,M,100,0,295,295
Janani,F,100,295,0,295
Javontay,M,100,0,295,295
Jeovani,M,100,0,295,295
Jessicah,F,100,295,0,295
Jonee,F,100,295,0,295
Kree,F,76,223,72,295
Larie,F,100,295,0,295
Lenzie,F,61,179,116,295
Lethia,F,100,295,0,295
Maddax,M,97,8,287,295
Maeva,F,100,295,0,295
Mousa,M,100,0,295,295
Nea,F,100,295,0,295
Nechelle,F,100,295,0,295
Raymont,M,100,0,295,295
Roswell,M,100,0,295,295
Shanah,F,100,295,0,295
Shawan,F,80,236,59,295
Skilar,F,83,245,50,295
Sophronia,F,100,295,0,295
Sudie,F,100,295,0,295
Timisha,F,100,295,0,295
Xyla,F,100,295,0,295
Zubin,M,100,0,295,295
Abdon,M,100,0,294,294
Adithi,F,100,294,0,294
Adonay,M,100,0,294,294
Alayja,F,100,294,0,294
Alesandro,M,100,0,294,294
Allianna,F,100,294,0,294
Amarianna,F,100,294,0,294
Arren,M,93,21,273,294
Aslyn,F,100,294,0,294
Ayriana,F,100,294,0,294
Braysen,M,100,0,294,294
Brentt,M,100,0,294,294
Carrianne,F,100,294,0,294
Evetta,F,100,294,0,294
Evonna,F,100,294,0,294
Hashem,M,100,0,294,294
Isys,F,100,294,0,294
Jassmin,F,100,294,0,294
Jayke,M,100,0,294,294
Jhalil,M,100,0,294,294
Joanette,F,100,294,0,294
Kaaliyah,F,100,294,0,294
Kareli,F,100,294,0,294
Kehaulani,F,100,294,0,294
Kyanne,F,100,294,0,294
Lauraine,F,100,294,0,294
Master,M,100,0,294,294
Meganne,F,100,294,0,294
Megin,F,100,294,0,294
Michalle,F,100,294,0,294
Nira,F,100,294,0,294
Palak,F,98,289,5,294
Quante,M,98,6,288,294
Quintan,M,100,0,294,294
Roselie,F,100,294,0,294
Sayda,F,100,294,0,294
Sufyan,M,100,0,294,294
Tehilla,F,100,294,0,294
Amela,F,100,293,0,293
Artin,M,100,0,293,293
Audelia,F,100,293,0,293
Dawid,M,100,0,293,293
Deshauna,F,100,293,0,293
Donaldo,M,100,0,293,293
Elliotte,F,89,260,33,293
Glennie,F,77,226,67,293
Halla,F,100,293,0,293
Ivyanna,F,100,293,0,293
Janah,F,100,293,0,293
Julliana,F,100,293,0,293
Kienan,M,100,0,293,293
Layni,F,100,293,0,293
Lorali,F,100,293,0,293
Maciej,M,100,0,293,293
Madix,M,100,0,293,293
Martiza,F,100,293,0,293
Natika,F,100,293,0,293
Nisreen,F,100,293,0,293
Rohini,F,100,293,0,293
Salvator,M,100,0,293,293
Shardai,F,100,293,0,293
Shyheem,M,100,0,293,293
Vaness,F,100,293,0,293
Zackaria,M,100,0,293,293
Aliciana,F,100,292,0,292
Analie,F,100,292,0,292
Blakley,F,83,243,49,292
Bulmaro,M,100,0,292,292
Cathlyn,F,100,292,0,292
Chandon,M,100,0,292,292
Davyon,M,100,0,292,292
Eliceo,M,100,0,292,292
Genae,F,100,292,0,292
Ignacia,F,100,292,0,292
Jaleigha,F,100,292,0,292
Jasmynn,F,100,292,0,292
Kaheem,M,100,0,292,292
Katonya,F,100,292,0,292
Keyerra,F,100,292,0,292
Kumar,M,100,0,292,292
Lakeita,F,100,292,0,292
Lenetta,F,100,292,0,292
Lorenso,M,100,0,292,292
Maryclare,F,100,292,0,292
Maud,F,100,292,0,292
Maurisa,F,100,292,0,292
Mehul,M,100,0,292,292
Merina,F,100,292,0,292
Michaila,F,100,292,0,292
Nefertari,F,100,292,0,292
Niyana,F,100,292,0,292
Nykolas,M,100,0,292,292
Oronde,M,100,0,292,292
Raman,M,100,0,292,292
Rosaly,F,100,292,0,292
Ruqayyah,F,100,292,0,292
Skai,F,95,276,16,292
Tamea,F,100,292,0,292
Tao,M,97,10,282,292
Teira,F,100,292,0,292
Treg,M,100,0,292,292
Troyce,M,85,43,249,292
Verenise,F,100,292,0,292
Yianni,M,100,0,292,292
Adain,M,100,0,291,291
Adna,F,100,291,0,291
Agastya,M,100,0,291,291
Ahniya,F,100,291,0,291
Anysia,F,100,291,0,291
Artina,F,100,291,0,291
Cagney,F,64,186,105,291
Carle,M,54,134,157,291
Carlea,F,100,291,0,291
Chantee,F,100,291,0,291
Danine,F,100,291,0,291
Danon,M,90,30,261,291
Edyth,F,100,291,0,291
Eulises,M,100,0,291,291
Gavriella,F,100,291,0,291
Gianny,F,51,147,144,291
Gualberto,M,100,0,291,291
Jillyan,F,100,291,0,291
Kellon,M,100,0,291,291
Kiyara,F,100,291,0,291
Laetitia,F,100,291,0,291
Lalena,F,100,291,0,291
Lashannon,F,100,291,0,291
Lorilyn,F,100,291,0,291
Mackenize,F,100,291,0,291
Makye,M,100,0,291,291
Marcedes,F,98,286,5,291
Mayli,F,100,291,0,291
Nicholi,M,100,0,291,291
Quinci,F,87,254,37,291
Shaterra,F,100,291,0,291
Sophee,F,100,291,0,291
Tanyah,F,100,291,0,291
Vonita,F,100,291,0,291
Zaila,F,100,291,0,291
Adriona,F,100,290,0,290
Altha,F,100,290,0,290
Aydyn,M,96,11,279,290
Aylene,F,100,290,0,290
Bashar,M,100,0,290,290
Benetta,F,100,290,0,290
Bethsaida,F,100,290,0,290
Brya,F,98,284,6,290
Carlyon,F,100,290,0,290
Cha,M,87,37,253,290
Daryus,M,100,0,290,290
Davona,F,100,290,0,290
Debria,F,100,290,0,290
Deyanna,F,100,290,0,290
Dreanna,F,100,290,0,290
Eun,F,98,285,5,290
Eytan,M,100,0,290,290
Gleen,M,100,0,290,290
Hyatt,M,90,29,261,290
Jamiracle,F,100,290,0,290
Janvi,F,100,290,0,290
Jezelle,F,100,290,0,290
Jorgia,F,100,290,0,290
Julyan,M,100,0,290,290
Kaveon,M,100,0,290,290
Kayelynn,F,100,290,0,290
Kaylob,M,100,0,290,290
Kazandra,F,100,290,0,290
Kevaughn,M,100,0,290,290
Latressa,F,100,290,0,290
Linzee,F,100,290,0,290
Mandalyn,F,100,290,0,290
Natausha,F,100,290,0,290
Ninel,F,100,290,0,290
Rawley,M,100,0,290,290
Riot,M,89,31,259,290
Saud,M,100,0,290,290
Savian,M,100,0,290,290
Suki,F,100,290,0,290
Talbot,M,96,11,279,290
Tamu,F,98,285,5,290
Taro,M,100,0,290,290
Tatumn,F,98,285,5,290
Traver,M,100,0,290,290
Vinicius,M,100,0,290,290
Wannetta,F,100,290,0,290
Ziana,F,100,290,0,290
Zori,F,100,290,0,290
Alasha,F,100,289,0,289
Andretta,F,100,289,0,289
Arsalan,M,100,0,289,289
Avaree,F,100,289,0,289
Brandom,M,100,0,289,289
Catia,F,100,289,0,289
Chenise,F,100,289,0,289
Demiyah,F,100,289,0,289
Donnald,M,100,0,289,289
Dornell,M,100,0,289,289
Gerron,M,100,0,289,289
Javarus,M,100,0,289,289
Jeyden,M,100,0,289,289
Katreena,F,100,289,0,289
Kevonna,F,100,289,0,289
Larence,M,100,0,289,289
Latrease,F,100,289,0,289
Lindia,F,100,289,0,289
Mareena,F,100,289,0,289
Mileah,F,100,289,0,289
Monea,F,100,289,0,289
Natalina,F,100,289,0,289
Oz,M,100,0,289,289
Sadey,F,100,289,0,289
Shariya,F,100,289,0,289
Sharline,F,100,289,0,289
Tanajah,F,100,289,0,289
Taygen,F,55,160,129,289
Trayson,M,100,0,289,289
Tyeler,M,91,27,262,289
Ula,F,100,289,0,289
Akosua,F,100,288,0,288
Amish,M,100,0,288,288
Arlyne,F,100,288,0,288
Avyn,F,55,157,131,288
Cyndia,F,100,288,0,288
Dajohn,M,100,0,288,288
Deondray,M,100,0,288,288
Dodd,M,100,0,288,288
Dvid,M,100,0,288,288
Gae,F,100,288,0,288
Jamesa,F,100,288,0,288
Kaidynce,F,98,282,6,288
Kameka,F,100,288,0,288
Kamoni,F,62,179,109,288
Kemi,F,100,288,0,288
Kipling,M,100,0,288,288
Lamichael,M,100,0,288,288
Latoia,F,100,288,0,288
Lexani,F,98,283,5,288
Mahamed,M,100,0,288,288
Mao,F,97,278,10,288
Meryem,F,100,288,0,288
Nariya,F,100,288,0,288
Neelam,F,100,288,0,288
Quinisha,F,100,288,0,288
Renan,M,100,0,288,288
Sahid,M,100,0,288,288
Topaz,F,98,282,6,288
Zaven,M,100,0,288,288
Zeyad,M,100,0,288,288
Allyana,F,100,287,0,287
Anique,F,100,287,0,287
Arvis,M,73,77,210,287
Babak,M,100,0,287,287
Braxtin,M,98,5,282,287
Charm,F,100,287,0,287
Detria,F,100,287,0,287
Dyshawn,M,100,0,287,287
Esly,F,98,281,6,287
Grason,M,100,0,287,287
Gurnoor,F,62,178,109,287
Haakon,M,100,0,287,287
Halsey,F,70,202,85,287
Harout,M,100,0,287,287
Hawkins,M,100,0,287,287
Jennetta,F,100,287,0,287
Joeangel,M,100,0,287,287
Jshawn,M,100,0,287,287
Khayden,M,94,18,269,287
Kyliah,F,100,287,0,287
Laretta,F,100,287,0,287
Lexine,F,100,287,0,287
Quintel,M,100,0,287,287
Rielle,F,100,287,0,287
Samanthajo,F,100,287,0,287
Shaelin,F,100,287,0,287
Shakerra,F,100,287,0,287
Sharalyn,F,100,287,0,287
Soni,F,100,287,0,287
Tanecia,F,100,287,0,287
Tansy,F,100,287,0,287
Terrisa,F,100,287,0,287
Tiquan,M,100,0,287,287
Trevonne,M,100,0,287,287
Tyee,M,100,0,287,287
Ab,M,100,0,286,286
Alizee,F,100,286,0,286
Alizon,F,100,286,0,286
Arella,F,100,286,0,286
Atira,F,100,286,0,286
Aubryn,F,100,286,0,286
Aylissa,F,100,286,0,286
Bellah,F,100,286,0,286
Burnette,F,80,230,56,286
Chantalle,F,100,286,0,286
Cherika,F,100,286,0,286
Christepher,M,100,0,286,286
Corian,M,93,21,265,286
Daimen,M,100,0,286,286
Dejuana,F,100,286,0,286
Ezmeralda,F,100,286,0,286
Fredrik,M,100,0,286,286
Gilad,M,100,0,286,286
Jhoan,M,100,0,286,286
Josaiah,M,100,0,286,286
Kadedra,F,100,286,0,286
Kearia,F,100,286,0,286
Leanthony,M,100,0,286,286
Mackynzie,F,100,286,0,286
Makela,F,100,286,0,286
Micaella,F,100,286,0,286
Njeri,F,100,286,0,286
Ramsay,M,88,34,252,286
Raniah,F,100,286,0,286
Rashana,F,100,286,0,286
Sereen,F,100,286,0,286
Sherline,F,100,286,0,286
Suleima,F,100,286,0,286
Takenya,F,100,286,0,286
Talaysia,F,100,286,0,286
Umer,M,100,0,286,286
Yovanna,F,100,286,0,286
Zarian,M,90,28,258,286
Zylah,F,100,286,0,286
Aggie,F,100,285,0,285
Alis,F,98,280,5,285
Aziya,F,100,285,0,285
Braleigh,F,100,285,0,285
Cachet,F,100,285,0,285
Carolene,F,100,285,0,285
Darelle,M,96,11,274,285
Dilara,F,100,285,0,285
Etan,M,100,0,285,285
Faithlynn,F,100,285,0,285
Javaun,M,100,0,285,285
Kennah,F,100,285,0,285
Latausha,F,100,285,0,285
Letasha,F,100,285,0,285
Loukas,M,100,0,285,285
Lynnelle,F,100,285,0,285
Mariangela,F,100,285,0,285
Myonna,F,100,285,0,285
Pria,F,100,285,0,285
Ryle,M,88,35,250,285
Ryler,M,100,0,285,285
Saraann,F,100,285,0,285
Shellene,F,100,285,0,285
Shirah,F,100,285,0,285
Slyvia,F,100,285,0,285
Tanesia,F,100,285,0,285
Tishia,F,100,285,0,285
Tykira,F,100,285,0,285
Yuma,M,81,55,230,285
Zaedyn,M,98,5,280,285
Zair,M,100,0,285,285
Zayah,F,94,269,16,285
Zaydin,M,100,0,285,285
Zenas,M,98,5,280,285
Agata,F,100,284,0,284
Alima,F,100,284,0,284
Arsema,F,100,284,0,284
Arsen,M,100,0,284,284
Cleophas,M,100,0,284,284
Deklyn,M,80,57,227,284
Deneice,F,100,284,0,284
Destynie,F,100,284,0,284
Drayson,M,100,0,284,284
Ellyson,F,100,284,0,284
Giannah,F,100,284,0,284
Gryffin,M,100,0,284,284
Harnoor,F,72,205,79,284
Jalana,F,100,284,0,284
Janitza,F,100,284,0,284
Karmella,F,100,284,0,284
Ladawna,F,100,284,0,284
Laranda,F,100,284,0,284
Lilya,F,100,284,0,284
Madisynn,F,100,284,0,284
Makinlee,F,100,284,0,284
Ozie,M,73,76,208,284
Ramiya,F,100,284,0,284
Sayer,M,98,5,279,284
Slayton,M,100,0,284,284
Takai,M,83,48,236,284
Tangelia,F,100,284,0,284
Tawn,F,89,252,32,284
Thedore,M,100,0,284,284
Trinitie,F,100,284,0,284
Xoe,F,100,284,0,284
Adeel,M,100,0,283,283
Akeria,F,100,283,0,283
Amarian,M,100,0,283,283
Ambyr,F,100,283,0,283
Ange,F,98,278,5,283
Boubacar,M,100,0,283,283
Brewer,M,100,0,283,283
Chia,F,76,214,69,283
Daly,F,88,250,33,283
Dima,F,79,223,60,283
Dyami,M,98,5,278,283
Johnnathan,M,100,0,283,283
Joren,M,100,0,283,283
Khya,F,100,283,0,283
Makalya,F,100,283,0,283
Marleah,F,100,283,0,283
Mikesha,F,100,283,0,283
Mishayla,F,100,283,0,283
Norvin,M,100,0,283,283
Octavis,M,100,0,283,283
Ozella,F,100,283,0,283
Riah,F,100,283,0,283
Rommie,M,100,0,283,283
Salam,F,72,205,78,283
Shadai,F,100,283,0,283
Shanekia,F,100,283,0,283
Shyne,M,77,66,217,283
Talise,F,100,283,0,283
Verner,M,98,5,278,283
Ahkeem,M,100,0,282,282
Annslee,F,100,282,0,282
Ashlinn,F,100,282,0,282
Bayne,M,100,0,282,282
Britne,F,100,282,0,282
Chistina,F,100,282,0,282
Cierrah,F,100,282,0,282
Damarious,M,100,0,282,282
Damiah,F,100,282,0,282
Devera,F,100,282,0,282
Domnick,M,100,0,282,282
Drayke,M,100,0,282,282
Felissa,F,100,282,0,282
Giavana,F,100,282,0,282
Hailei,F,100,282,0,282
Jabrea,F,100,282,0,282
Jammal,M,100,0,282,282
Jaris,M,94,16,266,282
Jhony,M,100,0,282,282
Kanen,M,100,0,282,282
Koni,F,100,282,0,282
Latessa,F,100,282,0,282
Letoya,F,100,282,0,282
Louetta,F,100,282,0,282
Luba,F,100,282,0,282
Margy,F,100,282,0,282
Mckinna,F,100,282,0,282
Moraima,F,100,282,0,282
Nonie,F,100,282,0,282
Oluwatosin,F,53,150,132,282
Omeed,M,100,0,282,282
Patina,F,100,282,0,282
Reilley,F,64,180,102,282
Rickelle,F,100,282,0,282
Riggin,M,100,0,282,282
Riku,M,100,0,282,282
Romen,M,100,0,282,282
Rukiya,F,100,282,0,282
Sitara,F,100,282,0,282
Suhaib,M,100,0,282,282
Sundee,F,100,282,0,282
Tahani,F,100,282,0,282
Tahara,F,100,282,0,282
Timofey,M,100,0,282,282
Wynston,M,100,0,282,282
Xadrian,M,100,0,282,282
Abie,M,80,57,224,281
Angeleena,F,100,281,0,281
Anissia,F,100,281,0,281
Anneli,F,100,281,0,281
Ashon,M,100,0,281,281
Banjamin,M,100,0,281,281
Belem,F,100,281,0,281
Bonney,F,100,281,0,281
Bralen,M,98,5,276,281
Braun,M,100,0,281,281
Brayant,M,100,0,281,281
Cariann,F,100,281,0,281
Caydance,F,100,281,0,281
Caylynn,F,100,281,0,281
Cecille,F,100,281,0,281
Daltyn,M,100,0,281,281
Damesha,F,100,281,0,281
Danely,F,100,281,0,281
Edder,M,100,0,281,281
Elleana,F,100,281,0,281
Ethin,M,100,0,281,281
Favour,F,89,251,30,281
Fontaine,M,58,119,162,281
Jaiana,F,100,281,0,281
Jakera,F,100,281,0,281
Jatin,M,100,0,281,281
Jerime,M,100,0,281,281
Josuha,M,100,0,281,281
Json,M,100,0,281,281
Kayda,F,100,281,0,281
Khala,F,100,281,0,281
Kursten,F,100,281,0,281
Lahna,F,100,281,0,281
Leelan,M,100,0,281,281
Malyk,M,100,0,281,281
Maral,F,100,281,0,281
Markeis,M,100,0,281,281
Martavis,M,100,0,281,281
Nature,F,80,224,57,281
Nickalaus,M,100,0,281,281
Oletha,F,100,281,0,281
Olivya,F,100,281,0,281
Perris,M,62,107,174,281
Phill,M,100,0,281,281
Raeghan,F,100,281,0,281
Reygan,F,100,281,0,281
Ruthanna,F,100,281,0,281
Ryana,F,100,281,0,281
Shavonte,F,83,233,48,281
Stephene,F,100,281,0,281
Taden,M,100,0,281,281
Telina,F,100,281,0,281
Waddell,M,100,0,281,281
Alnisa,F,100,280,0,280
Alvan,M,100,0,280,280
Ashling,F,100,280,0,280
Baudelio,M,100,0,280,280
Baya,F,100,280,0,280
Brylin,M,56,123,157,280
Carmilla,F,100,280,0,280
Chrisanne,F,100,280,0,280
Delorean,M,84,46,234,280
Deundre,M,100,0,280,280
Ebin,M,100,0,280,280
Ellyssa,F,100,280,0,280
Garyn,M,74,73,207,280
Husain,M,100,0,280,280
Itza,F,100,280,0,280
Jahquan,M,100,0,280,280
Jannely,F,100,280,0,280
Keenya,F,100,280,0,280
Ladeana,F,100,280,0,280
Lezley,F,100,280,0,280
Lyndall,M,60,113,167,280
Markelle,M,56,124,156,280
Meesha,F,100,280,0,280
Meliyah,F,100,280,0,280
Moustafa,M,100,0,280,280
Najib,M,100,0,280,280
Neev,M,100,0,280,280
Nekesha,F,100,280,0,280
Nichalas,M,100,0,280,280
Raymie,F,60,168,112,280
Rosland,F,100,280,0,280
Sabree,F,94,262,18,280
Saki,F,96,269,11,280
Scherrie,F,100,280,0,280
Secilia,F,100,280,0,280
Sophea,F,98,275,5,280
Takera,F,100,280,0,280
Tarri,F,100,280,0,280
Turkessa,F,100,280,0,280
Wesam,M,100,0,280,280
Anuhea,F,100,279,0,279
Ashelyn,F,100,279,0,279
Ayari,F,100,279,0,279
Bartlett,M,100,0,279,279
Byanka,F,100,279,0,279
Deashia,F,100,279,0,279
Desirey,F,100,279,0,279
Doren,M,87,36,243,279
Eleno,M,100,0,279,279
Emlyn,F,100,279,0,279
Genesys,F,100,279,0,279
Irineo,M,100,0,279,279
Jaki,M,64,100,179,279
Janmichael,M,100,0,279,279
Jawara,M,98,5,274,279
Johnesha,F,100,279,0,279
Khadejah,F,100,279,0,279
Kinza,F,100,279,0,279
Kiyoshi,M,96,10,269,279
Kyng,M,100,0,279,279
Ladeja,F,100,279,0,279
Lalo,M,100,0,279,279
Landrey,F,90,252,27,279
Maurio,M,100,0,279,279
Meylin,F,100,279,0,279
Nasreen,F,100,279,0,279
Nzinga,F,100,279,0,279
Phuc,M,97,7,272,279
Priest,M,100,0,279,279
Rhetta,F,100,279,0,279
Romney,M,83,48,231,279
Samika,F,100,279,0,279
Shelonda,F,100,279,0,279
Timathy,M,100,0,279,279
Tynasia,F,100,279,0,279
Aldrich,M,100,0,278,278
Allure,F,100,278,0,278
Anival,M,100,0,278,278
Ayona,F,100,278,0,278
Bayden,M,98,6,272,278
Bentzion,M,100,0,278,278
Blakelyn,F,100,278,0,278
Brinson,M,98,6,272,278
Cathryne,F,100,278,0,278
Dalayna,F,100,278,0,278
Deaglan,M,100,0,278,278
Deneise,F,100,278,0,278
Donnia,F,100,278,0,278
Dunya,F,100,278,0,278
Elleigh,F,100,278,0,278
Estill,M,100,0,278,278
Euan,M,100,0,278,278
Gautham,M,100,0,278,278
Italo,M,100,0,278,278
Izetta,F,100,278,0,278
Javonda,F,100,278,0,278
Kayron,M,82,51,227,278
Konstance,F,100,278,0,278
Latroya,F,100,278,0,278
Laurell,F,100,278,0,278
Leilana,F,100,278,0,278
Linnae,F,100,278,0,278
Mahmood,M,100,0,278,278
Merline,F,100,278,0,278
Paighton,F,100,278,0,278
Salbador,M,100,0,278,278
Sanaiya,F,100,278,0,278
Shantasia,F,100,278,0,278
Sheala,F,100,278,0,278
Swara,F,100,278,0,278
Swayze,F,79,221,57,278
Taeshawn,M,100,0,278,278
Tikisha,F,100,278,0,278
Trany,F,100,278,0,278
Vaden,M,100,0,278,278
Varian,M,100,0,278,278
Wacey,M,100,0,278,278
Xitlalic,F,100,278,0,278
Yari,F,91,254,24,278
Adiana,F,100,277,0,277
Ailynn,F,100,277,0,277
Alik,M,98,5,272,277
Anaise,F,100,277,0,277
Anapaula,F,100,277,0,277
Areeba,F,100,277,0,277
Blimie,F,100,277,0,277
Caytlin,F,100,277,0,277
Chrisandra,F,100,277,0,277
Dalylah,F,100,277,0,277
Dao,M,68,88,189,277
Ellasyn,F,100,277,0,277
Eoghan,M,100,0,277,277
Galia,F,100,277,0,277
Giovan,M,100,0,277,277
Graceyn,F,100,277,0,277
Huriel,M,100,0,277,277
Izzabelle,F,100,277,0,277
Jaelan,M,86,39,238,277
Jahziel,M,95,15,262,277
Jamyiah,F,100,277,0,277
Jung,M,54,128,149,277
Kaavya,F,100,277,0,277
Karinne,F,100,277,0,277
Kassim,M,100,0,277,277
Kayona,F,100,277,0,277
Kima,F,100,277,0,277
Kimiya,F,100,277,0,277
Lorrain,F,100,277,0,277
Mahaley,F,100,277,0,277
Matai,M,100,0,277,277
Mattingly,F,81,224,53,277
Orenthal,M,100,0,277,277
Reniya,F,100,277,0,277
Reonna,F,100,277,0,277
Rik,M,100,0,277,277
Rosibel,F,100,277,0,277
Savino,M,100,0,277,277
Silvino,M,100,0,277,277
Takeia,F,100,277,0,277
Takyla,F,100,277,0,277
Trampus,M,100,0,277,277
Treanna,F,100,277,0,277
Yanette,F,100,277,0,277
Aariyah,F,100,276,0,276
Alicja,F,100,276,0,276
Amana,F,100,276,0,276
Antonious,M,100,0,276,276
Arlisha,F,100,276,0,276
Austine,M,55,123,153,276
Ayde,F,100,276,0,276
Bertin,M,100,0,276,276
Breunna,F,100,276,0,276
Britini,F,100,276,0,276
Burgundy,F,100,276,0,276
Chipper,M,100,0,276,276
Christerpher,M,100,0,276,276
Darvell,M,100,0,276,276
Denaya,F,100,276,0,276
Esra,F,100,276,0,276
Genee,F,100,276,0,276
Gust,M,100,0,276,276
Huyen,F,100,276,0,276
Jadine,F,100,276,0,276
Jatavius,M,100,0,276,276
Judyth,F,100,276,0,276
Karlina,F,100,276,0,276
Kayloni,F,100,276,0,276
Keano,M,100,0,276,276
Kiela,F,100,276,0,276
Kirill,M,100,0,276,276
Kishon,M,93,20,256,276
Lehi,M,100,0,276,276
Luisfernando,M,100,0,276,276
Luwana,F,100,276,0,276
Lyliana,F,100,276,0,276
Lynann,F,100,276,0,276
Mandell,M,100,0,276,276
Markey,M,98,5,271,276
Mattia,M,51,136,140,276
Mckaela,F,100,276,0,276
Neesha,F,100,276,0,276
Sanae,F,100,276,0,276
Shamere,F,68,188,88,276
Tanaja,F,100,276,0,276
Toyna,F,100,276,0,276
Wynetta,F,100,276,0,276
Yeimy,F,100,276,0,276
Zalen,M,100,0,276,276
Chevis,M,96,11,264,275
Chyler,F,81,223,52,275
Cristyn,F,100,275,0,275
Deijah,F,100,275,0,275
Demita,F,100,275,0,275
Disa,F,100,275,0,275
Eiden,M,100,0,275,275
Evianna,F,100,275,0,275
Gara,F,100,275,0,275
Gates,M,84,44,231,275
Gricel,F,100,275,0,275
Harald,M,100,0,275,275
Ilhan,F,77,211,64,275
Jahki,M,100,0,275,275
Jalie,F,100,275,0,275
Janeya,F,100,275,0,275
Jeferson,M,100,0,275,275
Jemiah,F,66,181,94,275
Jhane,F,100,275,0,275
Jodelle,F,100,275,0,275
Kazi,M,78,61,214,275
Kenner,M,100,0,275,275
Lauria,F,100,275,0,275
Mattix,M,100,0,275,275
Mykenna,F,100,275,0,275
Netanel,M,100,0,275,275
Sharlette,F,100,275,0,275
Siria,F,100,275,0,275
Tassie,F,100,275,0,275
Teven,M,100,0,275,275
Tilman,M,100,0,275,275
Abdurahman,M,100,0,274,274
Alyxis,F,100,274,0,274
Amulya,F,100,274,0,274
Ason,M,100,0,274,274
Berl,M,100,0,274,274
Chasitie,F,100,274,0,274
Cylis,M,100,0,274,274
Cynthea,F,100,274,0,274
Deakon,M,100,0,274,274
Deionte,M,100,0,274,274
Dmya,F,100,274,0,274
Emin,M,100,0,274,274
Garnell,M,96,11,263,274
Giavanni,F,68,186,88,274
Havannah,F,100,274,0,274
Jakel,M,96,11,263,274
Jamilette,F,100,274,0,274
Jatziry,F,100,274,0,274
Jlyn,F,60,164,110,274
Jordain,F,78,215,59,274
Josecarlos,M,100,0,274,274
Kacia,F,100,274,0,274
Kaemon,M,100,0,274,274
Katelynd,F,100,274,0,274
Keerthana,F,100,274,0,274
Kensleigh,F,100,274,0,274
Koleton,M,100,0,274,274
Loc,M,100,0,274,274
Malini,F,100,274,0,274
Marifer,F,100,274,0,274
Natilie,F,100,274,0,274
Niharika,F,100,274,0,274
Obryan,M,100,0,274,274
Paco,M,100,0,274,274
Rodricus,M,100,0,274,274
Shelden,M,98,5,269,274
Shey,M,51,135,139,274
Tishawn,M,81,52,222,274
Weronika,F,100,274,0,274
Xian,M,70,81,193,274
Xitlalli,F,100,274,0,274
Ylonda,F,100,274,0,274
Ahtziry,F,100,273,0,273
Arrielle,F,100,273,0,273
Claretta,F,100,273,0,273
Cruise,M,100,0,273,273
Danasha,F,100,273,0,273
Deandrew,M,100,0,273,273
Demeka,F,100,273,0,273
Devian,M,92,22,251,273
Dillinger,M,100,0,273,273
Domanik,M,100,0,273,273
Donnesha,F,100,273,0,273
Eleena,F,100,273,0,273
Hadasa,F,100,273,0,273
Haleema,F,100,273,0,273
Harvest,F,67,182,91,273
Iysis,F,100,273,0,273
Jerzi,F,100,273,0,273
Kahmari,M,71,78,195,273
Kelie,F,100,273,0,273
Keni,F,73,200,73,273
Kishia,F,100,273,0,273
Laquanna,F,100,273,0,273
Lataisha,F,100,273,0,273
Loreto,M,96,11,262,273
Nai,F,74,202,71,273
Nashaun,M,100,0,273,273
Nicci,F,100,273,0,273
Nylan,M,82,49,224,273
Orli,F,100,273,0,273
Raef,M,100,0,273,273
Rakel,F,100,273,0,273
Raza,M,100,0,273,273
Shanitra,F,100,273,0,273
Shanyla,F,100,273,0,273
Shatika,F,100,273,0,273
Shauntia,F,100,273,0,273
Sherae,F,100,273,0,273
Tigran,M,100,0,273,273
Travelle,M,100,0,273,273
Yazeed,M,100,0,273,273
Zsazsa,F,100,273,0,273
Airel,F,100,272,0,272
Aiyanah,F,100,272,0,272
Alivea,F,100,272,0,272
Anetta,F,100,272,0,272
Aracelli,F,100,272,0,272
Arek,M,100,0,272,272
Arye,M,100,0,272,272
Breleigh,F,100,272,0,272
Christalyn,F,100,272,0,272
Damarkus,M,100,0,272,272
Delaynie,F,100,272,0,272
Deyana,F,100,272,0,272
Dorean,F,67,182,90,272
Elisandro,M,100,0,272,272
Eshaal,F,100,272,0,272
Fue,M,100,0,272,272
Galina,F,100,272,0,272
Halena,F,100,272,0,272
Haze,M,98,5,267,272
Jaidynn,F,89,242,30,272
Javonni,M,89,31,241,272
Jeffie,M,66,93,179,272
Karigan,F,100,272,0,272
Kitt,F,61,166,106,272
Lakeasha,F,100,272,0,272
Lamorris,M,100,0,272,272
Lashante,F,100,272,0,272
Lene,F,100,272,0,272
Lidya,F,100,272,0,272
Livier,F,100,272,0,272
Makyra,F,100,272,0,272
Malayia,F,100,272,0,272
Manasa,F,100,272,0,272
Marayah,F,100,272,0,272
Markez,M,100,0,272,272
Muskan,F,100,272,0,272
Nasiah,F,63,172,100,272
Navneet,F,90,244,28,272
Rhythm,M,55,123,149,272
Roshawnda,F,100,272,0,272
Song,F,74,201,71,272
Stephens,M,100,0,272,272
Taiylor,F,100,272,0,272
Tamaira,F,100,272,0,272
Tevan,M,100,0,272,272
Thelonious,M,100,0,272,272
Timohty,M,100,0,272,272
Zenda,F,100,272,0,272
Aaminah,F,100,271,0,271
Alvera,F,100,271,0,271
Annelyse,F,100,271,0,271
Bryley,F,79,215,56,271
Clevon,M,100,0,271,271
Daysy,F,100,271,0,271
Jadia,F,100,271,0,271
Jarquez,M,100,0,271,271
Jovian,M,98,5,266,271
Kalesha,F,100,271,0,271
Madiha,F,100,271,0,271
Maksym,M,100,0,271,271
Maloree,F,100,271,0,271
Mansour,M,100,0,271,271
Maranatha,F,100,271,0,271
Mardy,M,78,60,211,271
Mariateresa,F,100,271,0,271
Natassja,F,100,271,0,271
Rajveer,M,100,0,271,271
Shamarion,M,98,5,266,271
Shavona,F,100,271,0,271
Shayanna,F,100,271,0,271
Siedah,F,100,271,0,271
Taylorann,F,100,271,0,271
Thomasa,F,100,271,0,271
Tyan,M,75,68,203,271
Xylia,F,100,271,0,271
Xzavian,M,100,0,271,271
Zacari,M,67,90,181,271
Alvita,F,100,270,0,270
Argentina,F,100,270,0,270
Candiss,F,100,270,0,270
Canisha,F,100,270,0,270
Davell,M,100,0,270,270
Dekayla,F,100,270,0,270
Estefan,M,100,0,270,270
Hero,M,57,115,155,270
Herschell,M,100,0,270,270
Jennel,F,100,270,0,270
Kaleya,F,100,270,0,270
Kayelyn,F,100,270,0,270
Kriti,F,100,270,0,270
Kross,M,100,0,270,270
Larwence,M,100,0,270,270
Lorielle,F,100,270,0,270
Marcellis,M,100,0,270,270
Mc,F,77,209,61,270
Moranda,F,100,270,0,270
Naylah,F,100,270,0,270
Nnenna,F,100,270,0,270
Phu,M,100,0,270,270
Porshe,F,100,270,0,270
Rameen,F,63,170,100,270
Ramonia,F,100,270,0,270
Reine,F,100,270,0,270
Sarayah,F,100,270,0,270
Shalinda,F,100,270,0,270
Sydny,F,100,270,0,270
Tameko,F,100,270,0,270
Tanush,M,100,0,270,270
Taquita,F,100,270,0,270
Aliscia,F,100,269,0,269
Alitza,F,100,269,0,269
Alter,M,100,0,269,269
Amirrah,F,100,269,0,269
Aniceto,M,100,0,269,269
Annais,F,100,269,0,269
Arleta,F,100,269,0,269
Aylssa,F,100,269,0,269
Batoul,F,100,269,0,269
Birgit,F,100,269,0,269
Brekken,M,94,17,252,269
Carmelle,F,100,269,0,269
Christeena,F,100,269,0,269
Curvin,M,100,0,269,269
Damaso,M,100,0,269,269
Dejanique,F,100,269,0,269
Ellisyn,F,100,269,0,269
Fernie,M,100,0,269,269
Fortune,F,69,185,84,269
Gwenette,F,100,269,0,269
Hewitt,M,100,0,269,269
Iyesha,F,100,269,0,269
Katlyne,F,100,269,0,269
Kemiyah,F,100,269,0,269
Khira,F,100,269,0,269
Kwanza,F,84,227,42,269
Kynsley,F,100,269,0,269
Liborio,M,100,0,269,269
Lis,F,100,269,0,269
Markevious,M,100,0,269,269
Marvetta,F,100,269,0,269
Mujahid,M,100,0,269,269
Nekeisha,F,100,269,0,269
Ogechi,F,100,269,0,269
Ojas,M,100,0,269,269
Osmara,F,100,269,0,269
Rissa,F,100,269,0,269
Shawnell,F,92,248,21,269
Shloma,M,100,0,269,269
Suhail,M,91,25,244,269
Sumaiyah,F,100,269,0,269
Takela,F,100,269,0,269
Yolander,F,100,269,0,269
Zamantha,F,100,269,0,269
Zidane,M,100,0,269,269
Abijah,M,84,42,226,268
Abrian,M,98,5,263,268
Advay,M,100,0,268,268
Aiya,F,100,268,0,268
Akin,M,100,0,268,268
Anevay,F,100,268,0,268
Annahi,F,100,268,0,268
Antonisha,F,100,268,0,268
Bayard,M,100,0,268,268
Clete,M,100,0,268,268
Doyal,M,100,0,268,268
Dshaun,M,100,0,268,268
Dublin,M,78,59,209,268
Genetta,F,100,268,0,268
Jachai,M,96,10,258,268
Jaylanie,F,100,268,0,268
Kadeja,F,100,268,0,268
Lakiyah,F,100,268,0,268
Lashaya,F,100,268,0,268
Marven,M,100,0,268,268
Medardo,M,100,0,268,268
Melisse,F,100,268,0,268
Nichlas,M,100,0,268,268
Randen,M,100,0,268,268
Sanaii,F,100,268,0,268
Sheran,F,100,268,0,268
Sheva,F,100,268,0,268
Thaily,F,100,268,0,268
Tyjon,M,100,0,268,268
Tymothy,M,100,0,268,268
Tyresse,M,100,0,268,268
Vanette,F,100,268,0,268
Venezia,F,100,268,0,268
Aadit,M,100,0,267,267
Alexsandro,M,100,0,267,267
Amonie,F,100,267,0,267
Aniket,M,100,0,267,267
Aretta,F,100,267,0,267
Avy,F,94,251,16,267
Belita,F,100,267,0,267
Capricia,F,100,267,0,267
Catharina,F,100,267,0,267
Eon,M,100,0,267,267
Faren,F,100,267,0,267
Gal,M,51,131,136,267
Halona,F,100,267,0,267
Kauan,M,100,0,267,267
Krisandra,F,100,267,0,267
Lylian,F,100,267,0,267
Lyrica,F,100,267,0,267
Maryum,F,100,267,0,267
Miguelina,F,100,267,0,267
Nakyah,F,100,267,0,267
Nalini,F,100,267,0,267
Nikitha,F,100,267,0,267
Rehana,F,100,267,0,267
Rohith,M,100,0,267,267
Romano,M,100,0,267,267
Shanyce,F,100,267,0,267
Shya,F,100,267,0,267
Tamme,F,100,267,0,267
Zahmir,M,100,0,267,267
Aarohi,F,100,266,0,266
Adriannah,F,100,266,0,266
Alayzia,F,100,266,0,266
Aubreyanna,F,100,266,0,266
Baird,M,100,0,266,266
Brenon,M,100,0,266,266
Brilyn,F,85,226,40,266
Calyssa,F,100,266,0,266
Carder,M,100,0,266,266
Caymen,M,93,18,248,266
Chrislynn,F,100,266,0,266
Corinda,F,100,266,0,266
Denetria,F,100,266,0,266
Dewane,M,100,0,266,266
Edda,F,100,266,0,266
Esmee,F,100,266,0,266
Exzavier,M,100,0,266,266
Graylon,M,100,0,266,266
Helayna,F,100,266,0,266
Ifeoluwa,F,69,183,83,266
Ileanna,F,100,266,0,266
Izaiha,M,100,0,266,266
Izeah,M,100,0,266,266
Jak,M,100,0,266,266
Jakarri,M,100,0,266,266
Jamone,M,100,0,266,266
Janeal,F,100,266,0,266
Janifer,F,100,266,0,266
Jarmal,M,100,0,266,266
Jeananne,F,100,266,0,266
Jeidy,F,100,266,0,266
Johsua,M,100,0,266,266
Kalynne,F,100,266,0,266
Kanin,M,100,0,266,266
Keegen,M,100,0,266,266
Khan,M,100,0,266,266
Moneka,F,100,266,0,266
Nami,F,100,266,0,266
Olimpia,F,100,266,0,266
Shakiyah,F,100,266,0,266
Shauntell,F,100,266,0,266
Sheikh,M,96,10,256,266
Shenique,F,100,266,0,266
Tashea,F,100,266,0,266
Tiphani,F,100,266,0,266
Whitaker,M,98,5,261,266
Wylee,M,86,37,229,266
Xanthe,F,100,266,0,266
Yuritza,F,100,266,0,266
Zakyra,F,100,266,0,266
Zyquan,M,100,0,266,266
Adyan,M,100,0,265,265
Alicha,F,100,265,0,265
Alphonza,M,100,0,265,265
Amerika,F,100,265,0,265
Arena,F,100,265,0,265
Ayron,M,98,5,260,265
Bonna,F,100,265,0,265
Burdette,M,90,27,238,265
Cadan,M,100,0,265,265
Ceana,F,100,265,0,265
Charbel,M,100,0,265,265
Ciena,F,100,265,0,265
Court,M,100,0,265,265
Danai,F,98,260,5,265
Dariya,F,100,265,0,265
Dejanee,F,100,265,0,265
Deundra,M,62,102,163,265
Edra,F,100,265,0,265
Emmarae,F,100,265,0,265
Esa,M,83,46,219,265
Frederich,M,100,0,265,265
Ganesh,M,100,0,265,265
Harlene,F,100,265,0,265
Hutson,M,100,0,265,265
Iden,M,100,0,265,265
Jakwon,M,100,0,265,265
Jameika,F,100,265,0,265
Jeannemarie,F,100,265,0,265
Jema,F,100,265,0,265
Jennife,F,100,265,0,265
Kassady,F,100,265,0,265
Kaydi,F,100,265,0,265
Mikaylee,F,100,265,0,265
Naoma,F,100,265,0,265
Navdeep,M,53,125,140,265
Nickalos,M,100,0,265,265
Nihar,M,100,0,265,265
Quantavius,M,100,0,265,265
Shauni,F,100,265,0,265
Shyler,F,62,163,102,265
Souleymane,M,100,0,265,265
Tadhg,M,100,0,265,265
Teandre,M,100,0,265,265
Urian,M,100,0,265,265
Aboubacar,M,100,0,264,264
Aeisha,F,100,264,0,264
Alyjah,M,83,45,219,264
Amra,F,100,264,0,264
Anahit,F,100,264,0,264
Arvella,F,100,264,0,264
Brayam,M,100,0,264,264
Brenetta,F,100,264,0,264
Brodyn,M,100,0,264,264
Channelle,F,100,264,0,264
Erice,M,89,30,234,264
Jasamine,F,100,264,0,264
Jashun,M,100,0,264,264
Jazzman,F,91,240,24,264
Jonquil,F,79,209,55,264
Khaleah,F,100,264,0,264
Kirsta,F,100,264,0,264
Kojo,M,100,0,264,264
Kongmeng,M,100,0,264,264
Korryn,F,100,264,0,264
Lakresha,F,100,264,0,264
Lasalle,M,94,16,248,264
Lindzey,F,100,264,0,264
Lofton,M,100,0,264,264
Marquerite,F,100,264,0,264
Maryella,F,100,264,0,264
Mills,M,96,11,253,264
Milos,M,100,0,264,264
Mouhamadou,M,100,0,264,264
Murat,M,100,0,264,264
Mylea,F,100,264,0,264
Mylia,F,100,264,0,264
Mylinh,F,100,264,0,264
Nakyra,F,100,264,0,264
Prashant,M,100,0,264,264
Rozetta,F,100,264,0,264
Schneur,M,100,0,264,264
Shenee,F,100,264,0,264
Simra,F,100,264,0,264
Suzane,F,100,264,0,264
Tamecia,F,100,264,0,264
Taunia,F,100,264,0,264
Treylon,M,100,0,264,264
Trystyn,M,70,79,185,264
Vani,F,100,264,0,264
Wyeth,M,100,0,264,264
Andrej,M,100,0,263,263
Betheny,F,100,263,0,263
Braya,F,100,263,0,263
Brittne,F,100,263,0,263
Burnis,M,100,0,263,263
Chinita,F,100,263,0,263
Dalonte,M,100,0,263,263
Dennice,F,100,263,0,263
Donyea,M,65,92,171,263
Ezabella,F,100,263,0,263
Finleigh,F,100,263,0,263
Gaylyn,F,100,263,0,263
Hanaa,F,100,263,0,263
Helmut,M,100,0,263,263
Jemimah,F,100,263,0,263
Joeanthony,M,100,0,263,263
Jonathyn,M,100,0,263,263
Kadience,F,100,263,0,263
Kelsei,F,100,263,0,263
Khaliya,F,100,263,0,263
Kieley,F,100,263,0,263
Kippy,M,61,102,161,263
Lakisa,F,100,263,0,263
Lanah,F,100,263,0,263
Loredana,F,100,263,0,263
Meridian,F,100,263,0,263
Naquita,F,100,263,0,263
Nishan,M,100,0,263,263
Nuala,F,100,263,0,263
Raveena,F,100,263,0,263
Rejeana,F,100,263,0,263
Rithik,M,100,0,263,263
Rylinn,F,100,263,0,263
Sadiya,F,100,263,0,263
Sadiyah,F,100,263,0,263
Sakia,F,100,263,0,263
Seidy,F,100,263,0,263
Sharetta,F,100,263,0,263
Shemaiah,F,95,251,12,263
Shyana,F,100,263,0,263
Skie,F,100,263,0,263
Tangy,F,100,263,0,263
Uriyah,M,73,71,192,263
Wandra,F,100,263,0,263
Yulian,M,100,0,263,263
Yunuen,F,100,263,0,263
Zaelyn,M,59,109,154,263
Zeppelin,M,94,16,247,263
Aalijah,M,59,107,155,262
Alitzel,F,100,262,0,262
Almadelia,F,100,262,0,262
Anaka,F,100,262,0,262
Azaleah,F,100,262,0,262
Blessin,F,100,262,0,262
Bradleigh,F,96,251,11,262
Ceili,F,100,262,0,262
Chaeli,F,100,262,0,262
Deklin,M,100,0,262,262
Delsie,F,100,262,0,262
Deone,F,58,152,110,262
Ethon,M,100,0,262,262
Indiya,F,100,262,0,262
Ivyonna,F,100,262,0,262
Jalynne,F,100,262,0,262
Jasdeep,M,81,49,213,262
Johncarlo,M,100,0,262,262
Lateria,F,100,262,0,262
Leeyah,F,100,262,0,262
Lonita,F,100,262,0,262
Lydiann,F,100,262,0,262
Lynnett,F,100,262,0,262
Malee,F,100,262,0,262
Melanye,F,100,262,0,262
Neviah,F,100,262,0,262
Niyati,F,100,262,0,262
Othniel,M,100,0,262,262
Ramar,M,100,0,262,262
Saddie,F,100,262,0,262
Samanth,F,100,262,0,262
Sarahanne,F,100,262,0,262
Scheryl,F,100,262,0,262
Shanyn,F,100,262,0,262
Tyrisha,F,100,262,0,262
Wai,M,66,88,174,262
Yanis,M,65,92,170,262
Yomar,M,100,0,262,262
Anilah,F,100,261,0,261
Antonetta,F,100,261,0,261
Branndon,M,100,0,261,261
Britaney,F,100,261,0,261
Brok,M,100,0,261,261
Carden,M,90,26,235,261
Chandrea,F,100,261,0,261
Christphor,M,100,0,261,261
Dywane,M,100,0,261,261
Emmelia,F,100,261,0,261
Fernand,M,100,0,261,261
Graison,M,86,36,225,261
Hena,F,100,261,0,261
Irby,M,100,0,261,261
Jassen,M,100,0,261,261
Jazmon,F,86,225,36,261
Jourden,M,68,84,177,261
Jw,M,100,0,261,261
Kamon,M,100,0,261,261
Knight,M,100,0,261,261
Latrena,F,100,261,0,261
Maverik,M,100,0,261,261
Merek,M,100,0,261,261
Mitcheal,M,100,0,261,261
Mubarak,M,100,0,261,261
Ronya,F,100,261,0,261
Sallye,F,100,261,0,261
Seline,F,100,261,0,261
Shenice,F,100,261,0,261
Shimeka,F,100,261,0,261
Shontavia,F,100,261,0,261
Soliana,F,100,261,0,261
Stony,M,100,0,261,261
Tydarius,M,100,0,261,261
Tyion,M,100,0,261,261
Venisha,F,100,261,0,261
Yakima,F,100,261,0,261
Zenovia,F,100,261,0,261
Advika,F,100,260,0,260
Allayah,F,100,260,0,260
Amadi,F,57,148,112,260
Anis,M,93,19,241,260
Ardie,M,79,55,205,260
Audreana,F,100,260,0,260
Danajah,F,100,260,0,260
Deantae,M,100,0,260,260
Dvon,M,100,0,260,260
Endya,F,100,260,0,260
Ewa,F,100,260,0,260
Haeden,M,87,34,226,260
Houa,F,70,181,79,260
Jeral,M,98,5,255,260
Josten,M,100,0,260,260
Jushua,M,100,0,260,260
Kamaal,M,100,0,260,260
Kiwana,F,100,260,0,260
Lilit,F,100,260,0,260
Lorey,F,100,260,0,260
Magalie,F,100,260,0,260
Makenah,F,100,260,0,260
Malie,F,100,260,0,260
Martyna,F,100,260,0,260
Muskaan,F,100,260,0,260
Nakiesha,F,100,260,0,260
Niambi,F,100,260,0,260
Nickia,F,100,260,0,260
Nikhita,F,100,260,0,260
Niurka,F,100,260,0,260
Omarian,M,100,0,260,260
Paras,M,100,0,260,260
Poonam,F,100,260,0,260
Quana,F,100,260,0,260
Reannon,F,100,260,0,260
Seanpaul,M,100,0,260,260
Seldon,M,100,0,260,260
Shahin,M,100,0,260,260
Sherece,F,100,260,0,260
Shota,M,100,0,260,260
Starsha,F,100,260,0,260
Tiegan,F,70,183,77,260
Yecheskel,M,100,0,260,260
Yusuke,M,100,0,260,260
Alazae,F,100,259,0,259
Allysson,F,100,259,0,259
Brynli,F,100,259,0,259
Chayne,M,90,25,234,259
Chima,M,100,0,259,259
Colsen,M,100,0,259,259
Cortina,F,100,259,0,259
Cranston,M,100,0,259,259
Darnita,F,100,259,0,259
Domani,M,98,5,254,259
Doreena,F,100,259,0,259
Erique,M,100,0,259,259
Fleming,M,100,0,259,259
Hennessey,F,100,259,0,259
Jamaiya,F,100,259,0,259
Jarae,F,76,197,62,259
Jsean,M,100,0,259,259
Kaniesha,F,100,259,0,259
Kenzleigh,F,100,259,0,259
Kitrina,F,100,259,0,259
Korine,F,100,259,0,259
Lakendria,F,100,259,0,259
Lakeria,F,100,259,0,259
Larri,F,76,197,62,259
Marcina,F,100,259,0,259
Marysue,F,100,259,0,259
Naketa,F,100,259,0,259
Naoki,M,96,10,249,259
Norita,F,100,259,0,259
Oakleigh,F,100,259,0,259
Omkar,M,100,0,259,259
Onica,F,100,259,0,259
Ozias,M,100,0,259,259
Priti,F,100,259,0,259
Rachana,F,100,259,0,259
Rainah,F,100,259,0,259
Rayland,M,100,0,259,259
Riyad,M,100,0,259,259
Roldan,M,100,0,259,259
Ronnesha,F,100,259,0,259
Sereena,F,100,259,0,259
Shabazz,M,100,0,259,259
Sharanya,F,100,259,0,259
Siarah,F,100,259,0,259
Temekia,F,100,259,0,259
Tiwanna,F,100,259,0,259
Vaida,F,100,259,0,259
Xiana,F,100,259,0,259
Zykerria,F,100,259,0,259
Adalena,F,100,258,0,258
Alizea,F,100,258,0,258
Amerah,F,100,258,0,258
Cambell,F,72,185,73,258
Christyan,M,98,5,253,258
Daneshia,F,100,258,0,258
Deby,F,100,258,0,258
Devondre,M,100,0,258,258
Emilyanne,F,100,258,0,258
Enna,F,100,258,0,258
Erandi,F,100,258,0,258
Ericha,F,100,258,0,258
Felisia,F,100,258,0,258
Halyn,F,100,258,0,258
Isatou,F,100,258,0,258
Jakala,F,100,258,0,258
Jamekia,F,100,258,0,258
Janelis,F,100,258,0,258
Jaquelynn,F,100,258,0,258
Jaqwan,M,100,0,258,258
Jerzee,F,100,258,0,258
Kaloni,F,95,246,12,258
Keishia,F,100,258,0,258
Kenzlie,F,100,258,0,258
Kyiah,F,100,258,0,258
Leshaun,M,89,28,230,258
Lyann,F,100,258,0,258
Maeli,F,100,258,0,258
Majed,M,100,0,258,258
Masai,M,100,0,258,258
Maximilien,M,100,0,258,258
Meenakshi,F,100,258,0,258
Naira,F,100,258,0,258
Najia,F,100,258,0,258
Nickolis,M,100,0,258,258
Odaliz,F,100,258,0,258
Romelle,M,50,128,130,258
Sharlie,F,100,258,0,258
Shawnita,F,100,258,0,258
Tunya,F,100,258,0,258
Ulric,M,100,0,258,258
Valdez,M,100,0,258,258
Whyatt,M,100,0,258,258
Wiktoria,F,100,258,0,258
Yuto,M,100,0,258,258
Abdalla,M,100,0,257,257
Akeisha,F,100,257,0,257
Amaziah,M,70,77,180,257
Andreea,F,100,257,0,257
Aza,F,85,218,39,257
Brand,M,93,18,239,257
Cassiopeia,F,100,257,0,257
Chidinma,F,100,257,0,257
Dala,F,100,257,0,257
Denicia,F,100,257,0,257
Dreyton,M,100,0,257,257
Dulcinea,F,100,257,0,257
Dynesha,F,100,257,0,257
Ethelene,F,100,257,0,257
Evalee,F,100,257,0,257
Ferlin,M,100,0,257,257
Gabbriella,F,100,257,0,257
Jatavion,M,100,0,257,257
Jawanda,F,100,257,0,257
Kemal,M,100,0,257,257
Khayree,M,100,0,257,257
Lakevia,F,100,257,0,257
Laressa,F,100,257,0,257
Laterra,F,100,257,0,257
Lindsee,F,100,257,0,257
Lorelie,F,100,257,0,257
Maurico,M,100,0,257,257
Na,F,87,223,34,257
Resha,F,100,257,0,257
Roneshia,F,100,257,0,257
Shakeela,F,100,257,0,257
Shontelle,F,100,257,0,257
Trai,M,100,0,257,257
Ymani,F,100,257,0,257
Yosgart,M,100,0,257,257
Zohra,F,100,257,0,257
Abreanna,F,100,256,0,256
Amika,F,100,256,0,256
Anouk,F,100,256,0,256
Benjamyn,M,100,0,256,256
Chaniyah,F,100,256,0,256
Chapin,M,82,45,211,256
Chaseton,M,100,0,256,256
Chenell,F,100,256,0,256
Davione,M,96,11,245,256
Dhani,M,75,65,191,256
Eagan,M,100,0,256,256
Emmette,M,100,0,256,256
Evone,F,98,251,5,256
Imunique,F,100,256,0,256
Jacolyn,F,100,256,0,256
Janele,F,100,256,0,256
Jden,M,100,0,256,256
Jequan,M,100,0,256,256
Kanan,M,96,11,245,256
Kandise,F,100,256,0,256
Kealan,M,100,0,256,256
Keidy,F,100,256,0,256
Kewanna,F,100,256,0,256
Kianah,F,100,256,0,256
Kyrese,M,100,0,256,256
Lacrystal,F,100,256,0,256
Lashawndra,F,100,256,0,256
Litisha,F,100,256,0,256
Luster,M,100,0,256,256
Madox,M,100,0,256,256
Marcelus,M,100,0,256,256
Marielys,F,100,256,0,256
Masey,F,100,256,0,256
Montay,M,100,0,256,256
Nyeshia,F,100,256,0,256
Reyana,F,100,256,0,256
Soumya,F,100,256,0,256
Taariq,M,100,0,256,256
Trevone,M,100,0,256,256
Undrea,F,73,186,70,256
Ane,F,100,255,0,255
Arilyn,F,100,255,0,255
Aryanah,F,100,255,0,255
Blong,M,100,0,255,255
Burak,M,100,0,255,255
Cena,F,98,249,6,255
Daishaun,M,100,0,255,255
Deshane,M,93,17,238,255
Dolphus,M,100,0,255,255
Dominiq,M,98,5,250,255
Dorotha,F,100,255,0,255
Elizaveta,F,100,255,0,255
Evah,F,100,255,0,255
Evelena,F,100,255,0,255
Ezana,M,100,0,255,255
Faithlyn,F,100,255,0,255
Floy,F,95,242,13,255
Hutton,M,98,6,249,255
Jaaliyah,F,100,255,0,255
Jadis,M,51,126,129,255
Jahayra,F,100,255,0,255
Kaius,M,100,0,255,255
Ketra,F,100,255,0,255
Kimorah,F,100,255,0,255
Kristol,F,100,255,0,255
Lanique,F,100,255,0,255
Makaylie,F,100,255,0,255
Marili,F,100,255,0,255
Marsalis,M,100,0,255,255
Millisa,F,100,255,0,255
Nyeem,M,100,0,255,255
Remmington,M,71,74,181,255
Riyah,F,100,255,0,255
Rue,F,82,208,47,255
Shadoe,M,73,68,187,255
Shakendra,F,100,255,0,255
Shamyah,F,100,255,0,255
Shawnetta,F,100,255,0,255
Syndi,F,100,255,0,255
Tabria,F,100,255,0,255
Tahiry,F,100,255,0,255
Taleigha,F,100,255,0,255
Tashema,F,100,255,0,255
Tineka,F,100,255,0,255
Tomie,F,67,170,85,255
Torres,M,100,0,255,255
Vianne,F,100,255,0,255
Abubakr,M,100,0,254,254
Aidden,M,100,0,254,254
Brae,F,60,153,101,254
Cayne,M,100,0,254,254
Chalice,F,100,254,0,254
Cynde,F,100,254,0,254
Daivion,M,100,0,254,254
Dela,F,98,249,5,254
Demarques,M,100,0,254,254
Hila,F,100,254,0,254
Iisha,F,100,254,0,254
Ileah,F,100,254,0,254
Jahson,M,100,0,254,254
Janki,F,100,254,0,254
Jazlynne,F,100,254,0,254
Jobany,M,100,0,254,254
Jocie,F,100,254,0,254
Justise,F,83,210,44,254
Kenden,M,100,0,254,254
Kynli,F,100,254,0,254
Laritza,F,100,254,0,254
Lenice,F,100,254,0,254
Libni,F,100,254,0,254
Madilyne,F,100,254,0,254
Marcelyn,F,100,254,0,254
Margretta,F,100,254,0,254
Melchizedek,M,100,0,254,254
Melquan,M,100,0,254,254
Ndia,F,100,254,0,254
Oisin,M,100,0,254,254
Raimundo,M,100,0,254,254
Santia,F,100,254,0,254
Sieanna,F,100,254,0,254
Tikia,F,100,254,0,254
Tomorrow,F,100,254,0,254
Tymia,F,100,254,0,254
Aaniya,F,100,253,0,253
Akio,M,100,0,253,253
Ambriel,F,100,253,0,253
Arben,M,100,0,253,253
Braheem,M,100,0,253,253
Cyann,F,100,253,0,253
Delrico,M,100,0,253,253
Derwood,M,100,0,253,253
Dolton,M,100,0,253,253
Dulse,F,100,253,0,253
Duriel,M,100,0,253,253
Ebon,M,100,0,253,253
Eisha,F,100,253,0,253
Eliasar,M,100,0,253,253
Elissia,F,100,253,0,253
Elsi,F,100,253,0,253
Haralambos,M,100,0,253,253
Heena,F,100,253,0,253
Illianna,F,100,253,0,253
Isel,F,100,253,0,253
Jeilyn,F,100,253,0,253
Jenalyn,F,100,253,0,253
Jordis,F,98,247,6,253
Juda,M,85,37,216,253
Kadrian,M,96,11,242,253
Kaelon,M,100,0,253,253
Katurah,F,100,253,0,253
Kearstyn,F,100,253,0,253
Kewon,M,100,0,253,253
Keyshia,F,100,253,0,253
Lehua,F,100,253,0,253
Mariangel,F,100,253,0,253
Mathews,M,100,0,253,253
Mizuki,F,96,242,11,253
Naphtali,M,73,68,185,253
Natalynn,F,100,253,0,253
Olena,F,100,253,0,253
Rashaunda,F,100,253,0,253
Seraiah,F,98,247,6,253
Shaylon,F,66,166,87,253
Sundeep,M,98,5,248,253
Tanica,F,100,253,0,253
Tannah,F,100,253,0,253
Tannya,F,100,253,0,253
Teffany,F,100,253,0,253
Tryone,M,100,0,253,253
Tyquez,M,100,0,253,253
Vicci,F,100,253,0,253
Yafet,M,100,0,253,253
Aasha,F,100,252,0,252
Aireal,F,100,252,0,252
Akera,F,98,247,5,252
Amri,F,100,252,0,252
Annalyssa,F,100,252,0,252
Arah,F,100,252,0,252
Aryiah,F,100,252,0,252
Ashaki,F,100,252,0,252
Ayasha,F,100,252,0,252
Batool,F,100,252,0,252
Cyanne,F,100,252,0,252
Dametria,F,100,252,0,252
Deland,M,100,0,252,252
Dennisha,F,100,252,0,252
Dorathy,F,100,252,0,252
Drayven,M,100,0,252,252
Eddison,M,100,0,252,252
Ikia,F,100,252,0,252
Jailon,M,100,0,252,252
Jalise,F,100,252,0,252
Jamielyn,F,100,252,0,252
Juliah,F,100,252,0,252
Justeen,F,100,252,0,252
Kamuela,M,100,0,252,252
Kathye,F,100,252,0,252
Kilie,F,100,252,0,252
Kleigh,F,100,252,0,252
Lakai,M,88,30,222,252
Latonda,F,100,252,0,252
Leib,M,100,0,252,252
Leonid,M,100,0,252,252
Maxximus,M,100,0,252,252
Meda,F,100,252,0,252
Menashe,M,100,0,252,252
Mikie,M,93,18,234,252
Nalaya,F,100,252,0,252
Nelle,F,100,252,0,252
Othman,M,100,0,252,252
Peytan,F,100,252,0,252
Purvi,F,100,252,0,252
Reniyah,F,100,252,0,252
Rutger,M,100,0,252,252
Shikha,F,100,252,0,252
Sotirios,M,100,0,252,252
Terek,M,100,0,252,252
Tomeika,F,100,252,0,252
Trevia,F,100,252,0,252
Tyriana,F,100,252,0,252
Ancil,M,100,0,251,251
Angelino,M,100,0,251,251
Arti,F,100,251,0,251
Asaf,M,100,0,251,251
Asanti,F,81,203,48,251
Aurelie,F,100,251,0,251
Azlan,M,97,8,243,251
Becket,M,100,0,251,251
Blaike,M,63,93,158,251
Caralynn,F,100,251,0,251
Ciarah,F,100,251,0,251
Clearence,M,100,0,251,251
Danaja,F,100,251,0,251
Dayjah,F,100,251,0,251
Ephram,M,100,0,251,251
Evee,F,100,251,0,251
Geselle,F,100,251,0,251
Ghassan,M,100,0,251,251
Happy,F,67,168,83,251
Idali,F,100,251,0,251
Jerrion,M,100,0,251,251
Jibran,M,100,0,251,251
Jonnae,F,100,251,0,251
Kabria,F,100,251,0,251
Kalya,F,100,251,0,251
Keevon,M,100,0,251,251
Keshauna,F,100,251,0,251
Lajoyce,F,100,251,0,251
Larone,M,100,0,251,251
Lavonya,F,100,251,0,251
Levelle,M,100,0,251,251
Manson,M,100,0,251,251
Manuella,F,100,251,0,251
Maylyn,F,100,251,0,251
Nicklos,M,100,0,251,251
Nyashia,F,100,251,0,251
Oneisha,F,100,251,0,251
Quillan,M,100,0,251,251
Quynh,F,100,251,0,251
Remonia,F,100,251,0,251
Shanterria,F,100,251,0,251
Sheetal,F,100,251,0,251
Siearra,F,100,251,0,251
Sigfredo,M,100,0,251,251
Soniya,F,100,251,0,251
Taiesha,F,100,251,0,251
Taline,F,100,251,0,251
Tayquan,M,100,0,251,251
Tonni,F,100,251,0,251
Valicia,F,100,251,0,251
Alleyah,F,100,250,0,250
Amaar,M,100,0,250,250
Arelly,F,100,250,0,250
Ashden,M,94,16,234,250
Chasten,M,98,5,245,250
Chayden,M,98,6,244,250
Daquarius,M,100,0,250,250
Fielding,M,100,0,250,250
Gizel,F,100,250,0,250
Hillari,F,100,250,0,250
Hudsen,M,98,6,244,250
Izabellah,F,100,250,0,250
Judee,F,100,250,0,250
Kamorah,F,100,250,0,250
Karas,M,100,0,250,250
Karlena,F,100,250,0,250
Keishon,M,100,0,250,250
Khiya,F,100,250,0,250
Kinney,M,100,0,250,250
Kshawn,M,100,0,250,250
Lacosta,F,100,250,0,250
Laresha,F,100,250,0,250
Lorence,M,100,0,250,250
Madysin,F,100,250,0,250
Mandrell,M,100,0,250,250
Marielis,F,100,250,0,250
Mckaylah,F,100,250,0,250
Meriel,F,100,250,0,250
Mistee,F,100,250,0,250
Nayda,F,100,250,0,250
Neyla,F,100,250,0,250
Ondre,M,100,0,250,250
Riannon,F,100,250,0,250
Salimah,F,100,250,0,250
Samaiyah,F,100,250,0,250
Sameeha,F,100,250,0,250
Sumit,M,100,0,250,250
Theran,M,100,0,250,250
Tramayne,M,100,0,250,250
Tymesha,F,100,250,0,250
Tyreon,M,100,0,250,250
Ulrich,M,100,0,250,250
Yeison,M,100,0,250,250
Yi,M,58,104,146,250
Zeferino,M,100,0,250,250
Zeshan,M,100,0,250,250
Alinna,F,100,249,0,249
Bader,M,100,0,249,249
Bayle,F,89,221,28,249
Becker,M,100,0,249,249
Brynden,M,100,0,249,249
Cainen,M,100,0,249,249
Caiya,F,100,249,0,249
Camielle,F,100,249,0,249
Chantilly,F,100,249,0,249
Cheynne,F,100,249,0,249
Chrystle,F,100,249,0,249
Damauri,M,100,0,249,249
Danyla,F,100,249,0,249
Dawanda,F,100,249,0,249
Deshan,M,95,12,237,249
Dhriti,F,100,249,0,249
Donzella,F,100,249,0,249
Elex,M,100,0,249,249
Eleyna,F,100,249,0,249
Hulon,M,100,0,249,249
Hykeem,M,100,0,249,249
Ilissa,F,100,249,0,249
Itzell,F,100,249,0,249
Jamariah,F,100,249,0,249
Janeka,F,100,249,0,249
Janeva,F,100,249,0,249
Jasha,F,100,249,0,249
Javarion,M,100,0,249,249
Jeno,M,100,0,249,249
Josph,M,100,0,249,249
Kjersti,F,100,249,0,249
Maciel,F,80,198,51,249
Manas,M,100,0,249,249
Mannat,F,100,249,0,249
Maryama,F,100,249,0,249
Mont,M,100,0,249,249
Renner,M,100,0,249,249
Rosary,F,100,249,0,249
Samanda,F,100,249,0,249
Sharica,F,100,249,0,249
Tomesha,F,100,249,0,249
Verania,F,100,249,0,249
Verle,M,100,0,249,249
Wagner,M,100,0,249,249
Yoland,F,100,249,0,249
Yonis,M,100,0,249,249
Abdi,M,96,10,238,248
Adylene,F,100,248,0,248
Almir,M,100,0,248,248
Bedford,M,100,0,248,248
Biff,M,100,0,248,248
Bryannah,F,100,248,0,248
Burney,M,100,0,248,248
Charlott,F,100,248,0,248
Chauna,F,100,248,0,248
Coltrane,M,100,0,248,248
Courtlynn,F,100,248,0,248
Daelan,M,100,0,248,248
Dashae,F,98,243,5,248
Dhruva,M,100,0,248,248
Draya,F,100,248,0,248
Ellanor,F,100,248,0,248
Florance,F,100,248,0,248
Fredrika,F,100,248,0,248
Gordy,M,100,0,248,248
Gwenna,F,100,248,0,248
Haliey,F,100,248,0,248
Hussien,M,100,0,248,248
Isabellah,F,100,248,0,248
Ivorie,F,100,248,0,248
Jaray,M,100,0,248,248
Jerrard,M,100,0,248,248
Kamelia,F,100,248,0,248
Keian,M,100,0,248,248
Lamiah,F,100,248,0,248
Lansing,M,100,0,248,248
Larene,F,100,248,0,248
Laycie,F,100,248,0,248
Leor,M,90,24,224,248
Lonzie,M,100,0,248,248
Manahil,F,100,248,0,248
Marqueta,F,100,248,0,248
Marsela,F,100,248,0,248
Menelik,M,100,0,248,248
Mersades,F,100,248,0,248
Muhsin,M,100,0,248,248
Nakaya,F,100,248,0,248
Naraly,F,100,248,0,248
Nilson,M,100,0,248,248
Niylah,F,100,248,0,248
Rheana,F,100,248,0,248
Samariah,F,100,248,0,248
Sanita,F,100,248,0,248
Sevan,M,92,21,227,248
Sirenity,F,100,248,0,248
Sonnet,F,100,248,0,248
Tahja,F,94,233,15,248
Tonica,F,100,248,0,248
Tra,M,97,7,241,248
Valisha,F,100,248,0,248
Yordy,M,100,0,248,248
Zahrah,F,100,248,0,248
Alazay,F,100,247,0,247
Aloma,F,100,247,0,247
Amamda,F,100,247,0,247
Anely,F,100,247,0,247
Ashok,M,100,0,247,247
Cabot,M,100,0,247,247
Ciearra,F,100,247,0,247
Creg,M,100,0,247,247
Daijha,F,100,247,0,247
Darroll,M,100,0,247,247
Dontrel,M,100,0,247,247
Eliabeth,F,100,247,0,247
Glendell,M,84,40,207,247
Husna,F,100,247,0,247
Jabarri,M,100,0,247,247
Jannetta,F,100,247,0,247
Javonn,M,100,0,247,247
Jennier,F,100,247,0,247
Jermone,M,100,0,247,247
Jibri,M,100,0,247,247
Jontavius,M,100,0,247,247
Joshau,M,100,0,247,247
Kaisley,F,100,247,0,247
Kaydn,M,76,59,188,247
Kayti,F,100,247,0,247
Leovardo,M,100,0,247,247
Lief,M,100,0,247,247
Morena,F,100,247,0,247
Naasir,M,100,0,247,247
Prithvi,M,100,0,247,247
Sarahelizabeth,F,100,247,0,247
Semone,F,100,247,0,247
Shonn,M,98,5,242,247
Standley,M,100,0,247,247
Tarissa,F,100,247,0,247
Travone,M,100,0,247,247
Vineet,M,100,0,247,247
Xuan,F,93,230,17,247
Aastha,F,100,246,0,246
Abbegail,F,100,246,0,246
Adit,M,100,0,246,246
Alferd,M,100,0,246,246
Amarius,M,100,0,246,246
Brance,M,100,0,246,246
Brennyn,F,52,128,118,246
Ceceilia,F,100,246,0,246
Cyara,F,100,246,0,246
Daphna,F,100,246,0,246
Dayona,F,100,246,0,246
Dekari,M,100,0,246,246
Elanda,F,100,246,0,246
Emmelyn,F,100,246,0,246
Gabreil,M,91,22,224,246
Harbor,F,60,147,99,246
Ilka,F,100,246,0,246
Jacquese,F,61,149,97,246
Jamonica,F,100,246,0,246
Jonovan,M,100,0,246,246
Kemiya,F,100,246,0,246
Kolbey,M,91,22,224,246
Krishiv,M,100,0,246,246
Kyaire,M,100,0,246,246
Lai,F,90,221,25,246
Laporcha,F,100,246,0,246
Lyndal,M,73,67,179,246
Macgregor,M,100,0,246,246
Manasvi,F,100,246,0,246
Mckensey,F,100,246,0,246
Nakhia,F,100,246,0,246
Nikya,F,100,246,0,246
Oluwaseyi,M,67,80,166,246
Omair,M,100,0,246,246
Quandarius,M,100,0,246,246
Ridhi,F,100,246,0,246
Safaa,F,100,246,0,246
Shallon,F,100,246,0,246
Shaquira,F,100,246,0,246
Sharmayne,F,100,246,0,246
Sharonica,F,100,246,0,246
Siddhi,F,100,246,0,246
Sinthia,F,100,246,0,246
Talik,M,100,0,246,246
Tasean,M,98,5,241,246
Tykeisha,F,100,246,0,246
Valory,F,100,246,0,246
Velton,M,100,0,246,246
Vertis,M,87,31,215,246
Vignesh,M,100,0,246,246
Vinicio,M,100,0,246,246
Zadok,M,100,0,246,246
Zaveon,M,100,0,246,246
Zemirah,F,100,246,0,246
Adalyne,F,100,245,0,245
Ajdin,M,100,0,245,245
Avelardo,M,100,0,245,245
Casee,F,100,245,0,245
Chett,M,100,0,245,245
Dray,M,100,0,245,245
Elleanna,F,100,245,0,245
Graciana,F,100,245,0,245
Griffyn,M,91,22,223,245
Jacobb,M,100,0,245,245
Jatoria,F,100,245,0,245
Jeffre,M,100,0,245,245
Jhovanny,M,100,0,245,245
Johnel,M,98,5,240,245
Kalika,F,100,245,0,245
Karrisa,F,100,245,0,245
Kevis,M,100,0,245,245
Kristelle,F,100,245,0,245
Kurtiss,M,100,0,245,245
Marcelene,F,100,245,0,245
Mirranda,F,100,245,0,245
Nakota,M,60,98,147,245
Nashla,F,100,245,0,245
Nataliah,F,100,245,0,245
Nhia,M,87,32,213,245
Ronalda,F,100,245,0,245
Samaj,M,93,18,227,245
Seanpatrick,M,100,0,245,245
Seeley,M,73,67,178,245
Shamecca,F,100,245,0,245
Shimshon,M,100,0,245,245
Siyona,F,100,245,0,245
Tagen,M,60,99,146,245
Taleyah,F,100,245,0,245
Telma,F,100,245,0,245
Theresea,F,100,245,0,245
Yumna,F,100,245,0,245
Zaylon,M,100,0,245,245
Zuria,F,100,245,0,245
Zykira,F,100,245,0,245
Adelaine,F,100,244,0,244
Aminta,F,100,244,0,244
Arasely,F,100,244,0,244
Auri,F,96,234,10,244
Ayani,F,100,244,0,244
Charo,F,98,238,6,244
Chrishaun,M,98,5,239,244
Cicero,M,100,0,244,244
Hakan,M,100,0,244,244
Hughes,M,100,0,244,244
Imanuel,M,100,0,244,244
Iyanla,F,100,244,0,244
Javed,M,100,0,244,244
Jeison,M,100,0,244,244
Jonta,M,86,33,211,244
Jyllian,F,100,244,0,244
Kendrik,M,100,0,244,244
Kiearra,F,100,244,0,244
Kolette,F,100,244,0,244
Kristinia,F,100,244,0,244
Kristof,M,100,0,244,244
Lalah,F,100,244,0,244
Luetta,F,100,244,0,244
Machi,M,100,0,244,244
Maxwel,M,100,0,244,244
Meili,F,100,244,0,244
Mersadie,F,100,244,0,244
Morey,M,100,0,244,244
Mykiah,F,100,244,0,244
Neli,F,100,244,0,244
Nicklous,M,100,0,244,244
Nizar,M,100,0,244,244
Raigen,F,100,244,0,244
Ryelee,F,77,187,57,244
Sheppard,M,100,0,244,244
Srishti,F,100,244,0,244
Temiloluwa,F,64,156,88,244
Thurmon,M,100,0,244,244
Tzipporah,F,100,244,0,244
Vondell,M,79,51,193,244
Zakry,M,100,0,244,244
Zayleigh,F,100,244,0,244
Alorah,F,100,243,0,243
Anastassia,F,100,243,0,243
Arber,M,100,0,243,243
Aryannah,F,100,243,0,243
Blu,M,68,78,165,243
Brookelynne,F,100,243,0,243
Cadynce,F,100,243,0,243
Christol,F,100,243,0,243
Cotina,F,100,243,0,243
Cyla,F,100,243,0,243
Cyntha,F,100,243,0,243
Deondrae,M,100,0,243,243
Dinesha,F,100,243,0,243
Doyce,M,100,0,243,243
Eilish,F,100,243,0,243
Erinne,F,100,243,0,243
Jadarian,M,100,0,243,243
Jeweliana,F,100,243,0,243
Johnaton,M,100,0,243,243
Jolan,M,74,62,181,243
Katha,F,100,243,0,243
Kaylanie,F,100,243,0,243
Kelii,M,100,0,243,243
Lc,M,100,0,243,243
Macauley,M,88,30,213,243
Manraj,M,100,0,243,243
Margorie,F,100,243,0,243
Mystie,F,100,243,0,243
Novah,F,77,188,55,243
Philander,M,100,0,243,243
Rhyleigh,F,100,243,0,243
Shadd,M,100,0,243,243
Shateria,F,100,243,0,243
Teighlor,F,100,243,0,243
Truc,F,93,226,17,243
Ade,M,98,5,237,242
Adriauna,F,100,242,0,242
Aigner,F,100,242,0,242
Anjelique,F,100,242,0,242
Arnetha,F,100,242,0,242
Avantika,F,100,242,0,242
Azan,M,100,0,242,242
Babara,F,100,242,0,242
Bodi,M,100,0,242,242
Chandelle,F,100,242,0,242
Chandi,F,100,242,0,242
Corderro,M,100,0,242,242
Dustine,F,60,146,96,242
Emrys,M,83,42,200,242
Eraina,F,100,242,0,242
Jahkai,M,100,0,242,242
Janda,F,100,242,0,242
Juluis,M,100,0,242,242
Kanijah,F,100,242,0,242
Kateria,F,100,242,0,242
Kely,F,96,232,10,242
Keyani,F,100,242,0,242
Kolson,M,100,0,242,242
Kosta,M,100,0,242,242
Lavance,M,100,0,242,242
Laymon,M,100,0,242,242
Lendon,M,100,0,242,242
Malikye,M,100,0,242,242
Porschia,F,100,242,0,242
Rosabel,F,100,242,0,242
Shelva,F,100,242,0,242
Shere,F,100,242,0,242
Summit,M,93,16,226,242
Syra,F,100,242,0,242
Taletha,F,100,242,0,242
Taneika,F,100,242,0,242
Tedric,M,100,0,242,242
Treon,M,100,0,242,242
Akane,F,100,241,0,241
Alycea,F,100,241,0,241
Amatullah,F,100,241,0,241
Angeleen,F,100,241,0,241
Audery,F,100,241,0,241
Axcel,M,100,0,241,241
Ballard,M,100,0,241,241
Breelynn,F,100,241,0,241
Chasey,F,100,241,0,241
Coren,M,57,104,137,241
Daelen,M,100,0,241,241
Davonn,M,100,0,241,241
Dayshia,F,100,241,0,241
Devita,F,100,241,0,241
Dragan,M,100,0,241,241
Everson,M,100,0,241,241
Farhad,M,100,0,241,241
Gram,M,100,0,241,241
Heraclio,M,100,0,241,241
Inari,F,100,241,0,241
Jerusalem,F,80,192,49,241
Joscelin,F,100,241,0,241
Kathreen,F,100,241,0,241
Kinzi,F,100,241,0,241
Lamona,F,100,241,0,241
Lanyia,F,100,241,0,241
Levette,F,100,241,0,241
Manette,F,100,241,0,241
Melford,M,100,0,241,241
Merwin,M,100,0,241,241
Naryah,F,100,241,0,241
Pola,F,100,241,0,241
Raffaella,F,100,241,0,241
Shajuana,F,100,241,0,241
Shalandra,F,100,241,0,241
Shanara,F,100,241,0,241
Sher,M,51,119,122,241
Sinan,M,100,0,241,241
Sujay,M,100,0,241,241
Sumeet,M,96,10,231,241
Tobyn,M,94,14,227,241
Wilhelmenia,F,100,241,0,241
Wyett,M,100,0,241,241
Zarius,M,100,0,241,241
Adaliz,F,100,240,0,240
Aubryana,F,100,240,0,240
Bary,M,100,0,240,240
Biviana,F,100,240,0,240
Branon,M,100,0,240,240
Brianni,F,100,240,0,240
Brinleigh,F,100,240,0,240
Caelum,M,100,0,240,240
Calisha,F,100,240,0,240
Calleen,F,100,240,0,240
Caton,M,76,58,182,240
Cevin,M,100,0,240,240
Dameka,F,100,240,0,240
Daviona,F,100,240,0,240
Esvin,M,100,0,240,240
Jasmeet,F,73,176,64,240
Jeris,M,70,72,168,240
Jerrilynn,F,100,240,0,240
Jiles,M,100,0,240,240
Kadir,M,100,0,240,240
Kalla,F,100,240,0,240
Katerra,F,100,240,0,240
Keiton,M,100,0,240,240
Kenidee,F,100,240,0,240
Lakedra,F,100,240,0,240
Meagon,F,100,240,0,240
Minka,F,100,240,0,240
Paxon,M,100,0,240,240
Raider,M,100,0,240,240
Rilie,F,100,240,0,240
Rockne,M,100,0,240,240
Sachiko,F,100,240,0,240
Samarion,M,100,0,240,240
Serenitee,F,100,240,0,240
Shannin,F,100,240,0,240
Shubham,M,100,0,240,240
Soriah,F,100,240,0,240
Tabita,F,100,240,0,240
Tamsin,F,100,240,0,240
Traivon,M,100,0,240,240
Tushar,M,100,0,240,240
Velicia,F,100,240,0,240
Yasha,F,82,198,42,240
Yazlin,F,100,240,0,240
Yolunda,F,100,240,0,240
Zayveon,M,100,0,240,240
Zyaira,F,100,240,0,240
Adren,M,100,0,239,239
Afrika,F,100,239,0,239
Akshita,F,100,239,0,239
Alfreida,F,100,239,0,239
Ashleynicole,F,100,239,0,239
Braley,F,95,228,11,239
Breydan,M,100,0,239,239
Breylon,M,100,0,239,239
Burnie,M,100,0,239,239
Claudina,F,100,239,0,239
Dashiel,M,100,0,239,239
Dejour,M,94,14,225,239
Demika,F,100,239,0,239
Desa,F,100,239,0,239
Dimitria,F,100,239,0,239
Elianny,F,100,239,0,239
Emri,F,92,219,20,239
Esbeidy,F,100,239,0,239
Fadumo,F,100,239,0,239
Govanni,M,100,0,239,239
Haylin,F,100,239,0,239
Iliyah,F,100,239,0,239
Jaquis,M,96,10,229,239
Jatziri,F,100,239,0,239
Johni,F,100,239,0,239
Jonesha,F,100,239,0,239
Joylene,F,100,239,0,239
Kenni,F,96,229,10,239
Kiron,M,100,0,239,239
Kostantinos,M,100,0,239,239
Ladasia,F,100,239,0,239
Levonne,F,89,213,26,239
Luellen,F,100,239,0,239
Maclean,M,100,0,239,239
Maham,F,100,239,0,239
Maigan,F,100,239,0,239
Makeyla,F,100,239,0,239
Mckaila,F,100,239,0,239
Moustapha,M,100,0,239,239
Mujtaba,M,100,0,239,239
Roizy,F,100,239,0,239
Roshad,M,100,0,239,239
Saara,F,100,239,0,239
Sahaj,M,100,0,239,239
Sharel,F,100,239,0,239
Steaven,M,100,0,239,239
Stephenia,F,100,239,0,239
Taite,M,54,110,129,239
Terryon,M,100,0,239,239
Tria,F,100,239,0,239
Trigg,M,100,0,239,239
Vanissa,F,100,239,0,239
Ahniyah,F,100,238,0,238
Airen,F,57,135,103,238
Albertine,F,100,238,0,238
Allex,M,70,71,167,238
Angelgabriel,M,100,0,238,238
Ashani,F,100,238,0,238
Avyanna,F,100,238,0,238
Basma,F,100,238,0,238
Bricia,F,100,238,0,238
Brookie,F,100,238,0,238
Bruchy,F,100,238,0,238
Caniya,F,100,238,0,238
Caylon,M,95,12,226,238
Chelcee,F,100,238,0,238
Demetreus,M,100,0,238,238
Deyton,M,100,0,238,238
Djimon,M,95,11,227,238
Electa,F,100,238,0,238
Emiya,F,100,238,0,238
Forever,F,97,232,6,238
Hanad,M,100,0,238,238
Jeoffrey,M,100,0,238,238
Jorey,M,89,25,213,238
Kamera,F,100,238,0,238
Kathelyn,F,100,238,0,238
Kayon,M,97,6,232,238
Kiyonna,F,100,238,0,238
Lenoard,M,100,0,238,238
Levie,M,100,0,238,238
Lorayne,F,100,238,0,238
Marquee,M,86,34,204,238
Meela,F,100,238,0,238
Mitchael,M,100,0,238,238
Nyanna,F,100,238,0,238
Prairie,F,100,238,0,238
Rmani,F,69,165,73,238
Shantele,F,100,238,0,238
Shaquitta,F,100,238,0,238
Shereese,F,100,238,0,238
Siona,F,100,238,0,238
Syrai,F,100,238,0,238
Taiden,M,100,0,238,238
Thierno,M,100,0,238,238
Twan,M,89,27,211,238
Tyrianna,F,100,238,0,238
Vedika,F,100,238,0,238
Wyndell,M,100,0,238,238
Abbiegail,F,100,237,0,237
Cherlynn,F,100,237,0,237
Crandall,M,100,0,237,237
Davionne,M,71,68,169,237
Demisha,F,100,237,0,237
Elieser,M,100,0,237,237
Erikson,M,100,0,237,237
Iniya,F,100,237,0,237
Ishana,F,100,237,0,237
Jayona,F,100,237,0,237
Jeriann,F,100,237,0,237
Jhordan,M,67,78,159,237
Jinnie,F,100,237,0,237
Kelbi,F,100,237,0,237
Keyly,F,100,237,0,237
Khalila,F,100,237,0,237
Lashonta,F,100,237,0,237
Lenton,M,100,0,237,237
Merik,M,100,0,237,237
Noemie,F,100,237,0,237
Oanh,F,100,237,0,237
Roarke,M,100,0,237,237
Ryla,F,100,237,0,237
Samule,M,100,0,237,237
Sylvanna,F,100,237,0,237
Ta,F,87,207,30,237
Tanvir,M,97,7,230,237
Tarisha,F,100,237,0,237
Tevyn,M,98,5,232,237
Thanya,F,100,237,0,237
Toba,F,100,237,0,237
Truong,M,100,0,237,237
Vernia,F,100,237,0,237
Wessley,M,100,0,237,237
Yailyn,F,100,237,0,237
Aby,F,76,180,56,236
Alasdair,M,100,0,236,236
Anikka,F,100,236,0,236
Ashlynd,F,100,236,0,236
Aubreyana,F,100,236,0,236
Betzabeth,F,100,236,0,236
Chelci,F,100,236,0,236
Cloud,M,100,0,236,236
Cresta,F,100,236,0,236
Daaron,M,100,0,236,236
Dailynn,F,98,231,5,236
Darrold,M,100,0,236,236
Deadrian,M,100,0,236,236
Ediel,M,100,0,236,236
Eirik,M,100,0,236,236
Eliany,F,100,236,0,236
Elis,F,63,148,88,236
Elynn,F,100,236,0,236
Emanuele,M,100,0,236,236
Faithann,F,100,236,0,236
Hays,M,100,0,236,236
Hyla,F,100,236,0,236
Ilah,F,100,236,0,236
Ilyanna,F,100,236,0,236
Jacci,F,100,236,0,236
Jackquelyn,F,100,236,0,236
Jaran,M,100,0,236,236
Jassica,F,100,236,0,236
Jaylean,F,100,236,0,236
Jaziya,F,100,236,0,236
Jennett,F,100,236,0,236
Joaquina,F,100,236,0,236
Laasia,F,100,236,0,236
Lakya,F,100,236,0,236
Leighana,F,100,236,0,236
Lissandra,F,100,236,0,236
Manjot,M,60,95,141,236
Mansoor,M,100,0,236,236
Marlyne,F,100,236,0,236
Mckenley,F,88,207,29,236
Naija,F,100,236,0,236
Naleah,F,100,236,0,236
Nickol,F,100,236,0,236
Nikeisha,F,100,236,0,236
Reneisha,F,100,236,0,236
Rinoa,F,100,236,0,236
Sherlynn,F,100,236,0,236
Sherrelle,F,100,236,0,236
Tambria,F,100,236,0,236
Teka,F,100,236,0,236
Trendon,M,100,0,236,236
Trevaun,M,100,0,236,236
Treyce,M,100,0,236,236
Tyronn,M,100,0,236,236
Xayvion,M,100,0,236,236
Yusif,M,100,0,236,236
Aira,F,100,235,0,235
Alecsander,M,100,0,235,235
Amely,F,100,235,0,235
Amila,F,100,235,0,235
Anant,M,100,0,235,235
Arianni,F,100,235,0,235
Azhar,M,71,68,167,235
Blayton,M,100,0,235,235
Brylynn,F,100,235,0,235
Bryttany,F,100,235,0,235
Chalmers,M,100,0,235,235
Daesean,M,100,0,235,235
Dalanie,F,100,235,0,235
Deshana,F,100,235,0,235
Dhilan,M,100,0,235,235
Dylana,F,100,235,0,235
Eleora,F,100,235,0,235
Emmajean,F,100,235,0,235
Exodus,M,87,31,204,235
Gabrelle,F,100,235,0,235
Halea,F,100,235,0,235
Ikram,F,97,229,6,235
Ingris,F,100,235,0,235
Jaisha,F,100,235,0,235
Jaklyn,F,100,235,0,235
Jakyah,F,100,235,0,235
Jazariah,F,100,235,0,235
Joenathan,M,100,0,235,235
Jolean,F,100,235,0,235
Karlea,F,100,235,0,235
Keysean,M,100,0,235,235
Kiandre,M,100,0,235,235
Kla,F,100,235,0,235
Klarisa,F,100,235,0,235
Laterrica,F,100,235,0,235
Lauraann,F,100,235,0,235
Margi,F,100,235,0,235
Meeghan,F,100,235,0,235
Mekhia,F,100,235,0,235
Michaeljohn,M,100,0,235,235
Mikeyla,F,100,235,0,235
Napolean,M,100,0,235,235
Nicasio,M,100,0,235,235
Nicko,M,97,8,227,235
Phylliss,F,100,235,0,235
Ralpheal,M,100,0,235,235
Raziya,F,100,235,0,235
Shamone,F,91,213,22,235
Shirel,F,100,235,0,235
Shravan,M,100,0,235,235
Taivon,M,100,0,235,235
Tanaisha,F,100,235,0,235
Tiphany,F,100,235,0,235
Tyrez,M,100,0,235,235
Yug,M,100,0,235,235
Aaleah,F,100,234,0,234
Aeson,M,100,0,234,234
Alashia,F,100,234,0,234
Ariany,F,100,234,0,234
Chrystine,F,100,234,0,234
Cordia,F,100,234,0,234
Cully,M,100,0,234,234
Donalyn,F,100,234,0,234
Dwanda,F,100,234,0,234
French,M,100,0,234,234
Gillis,M,100,0,234,234
Hiro,M,100,0,234,234
Isidora,F,100,234,0,234
Itzae,M,82,43,191,234
Jandel,M,98,5,229,234
Jenasis,F,100,234,0,234
Jennfier,F,100,234,0,234
Johnluke,M,100,0,234,234
Loletha,F,100,234,0,234
Magic,M,85,34,200,234
Mat,M,100,0,234,234
Nadra,F,100,234,0,234
Parys,F,98,229,5,234
Quincie,F,98,229,5,234
Reham,F,100,234,0,234
Reyn,M,98,5,229,234
Rhegan,F,100,234,0,234
Sanyia,F,100,234,0,234
Shakisha,F,100,234,0,234
Shameek,M,98,5,229,234
Stiles,M,100,0,234,234
Tanyla,F,100,234,0,234
Terissa,F,100,234,0,234
Therron,M,100,0,234,234
Trip,M,100,0,234,234
Abdur,M,100,0,233,233
Anastasha,F,100,233,0,233
Anayely,F,100,233,0,233
Avagrace,F,100,233,0,233
Ayianna,F,100,233,0,233
Barbar,F,100,233,0,233
Burnetta,F,100,233,0,233
Casyn,M,89,26,207,233
Chanika,F,100,233,0,233
Dayshon,M,100,0,233,233
Deysy,F,100,233,0,233
Elham,F,97,226,7,233
Elinore,F,100,233,0,233
Elishah,M,88,27,206,233
Eufemia,F,100,233,0,233
Evren,M,97,7,226,233
Faizah,F,100,233,0,233
Faizon,M,100,0,233,233
Giavonni,F,61,142,91,233
Ivet,F,100,233,0,233
Jenan,F,100,233,0,233
Josejuan,M,100,0,233,233
Juanda,F,100,233,0,233
Kilynn,F,100,233,0,233
Kinda,F,100,233,0,233
Leandria,F,100,233,0,233
Linsy,F,100,233,0,233
Livan,M,100,0,233,233
Lorean,F,100,233,0,233
Lorian,F,100,233,0,233
Maleeya,F,100,233,0,233
Malloree,F,100,233,0,233
Markeita,F,100,233,0,233
Marlette,F,100,233,0,233
Masson,M,100,0,233,233
Matthan,M,100,0,233,233
Oreoluwa,F,62,144,89,233
Rahkeem,M,100,0,233,233
Rheta,F,100,233,0,233
Rondey,M,100,0,233,233
Sadira,F,100,233,0,233
Serrina,F,100,233,0,233
Shandreka,F,100,233,0,233
Shayley,F,100,233,0,233
Shaynna,F,100,233,0,233
Tishana,F,100,233,0,233
Willliam,M,100,0,233,233
Xane,M,100,0,233,233
Yaneliz,F,100,233,0,233
Aamina,F,100,232,0,232
Alando,M,100,0,232,232
Alixander,M,100,0,232,232
Ariyon,F,72,167,65,232
Asli,F,100,232,0,232
Cadi,F,100,232,0,232
Coriana,F,100,232,0,232
Daniesha,F,100,232,0,232
Davison,M,100,0,232,232
Dorla,F,100,232,0,232
Garnetta,F,100,232,0,232
Hakop,M,100,0,232,232
Harvie,M,100,0,232,232
Hermann,M,100,0,232,232
Ilea,F,100,232,0,232
Jabir,M,100,0,232,232
Jaequan,M,100,0,232,232
Jahmai,M,100,0,232,232
Jahniyah,F,100,232,0,232
Jaion,M,100,0,232,232
Javia,F,100,232,0,232
Kamirah,F,100,232,0,232
Nashira,F,100,232,0,232
Natalea,F,100,232,0,232
Nela,F,100,232,0,232
Quinta,F,82,191,41,232
Renald,M,100,0,232,232
Shubh,M,100,0,232,232
Taleya,F,100,232,0,232
Tessah,F,100,232,0,232
Tiye,F,100,232,0,232
Tyia,F,100,232,0,232
Tyjah,F,75,174,58,232
Xan,F,53,122,110,232
Yashua,M,100,0,232,232
Yunior,M,100,0,232,232
Zyah,F,100,232,0,232
Aliena,F,100,231,0,231
Aliyha,F,100,231,0,231
Anyeli,F,100,231,0,231
Aslynn,F,100,231,0,231
Azelia,F,100,231,0,231
Cadon,M,100,0,231,231
Corah,F,100,231,0,231
Cyris,M,100,0,231,231
Debarah,F,100,231,0,231
Deren,M,100,0,231,231
Devonda,F,100,231,0,231
Emeterio,M,100,0,231,231
Evangelyn,F,100,231,0,231
Farhana,F,100,231,0,231
Fintan,M,100,0,231,231
Garrie,M,87,31,200,231
Giorgia,F,100,231,0,231
Jahnia,F,100,231,0,231
Jaimeson,M,93,16,215,231
Jamareon,M,100,0,231,231
Jamilee,F,100,231,0,231
Jaquell,M,98,5,226,231
Jaquise,M,83,40,191,231
Javona,F,100,231,0,231
Jaylea,F,100,231,0,231
Jaylenn,F,64,148,83,231
Jennavecia,F,100,231,0,231
Kalicia,F,100,231,0,231
Kalum,M,100,0,231,231
Katalyna,F,100,231,0,231
Kaycen,M,92,19,212,231
Kennidi,F,100,231,0,231
Kenslie,F,100,231,0,231
Keyarah,F,100,231,0,231
Kin,M,97,6,225,231
Koraima,F,100,231,0,231
Kyeisha,F,100,231,0,231
Lawyer,M,100,0,231,231
Leonte,M,100,0,231,231
Levonte,M,100,0,231,231
Mahlik,M,100,0,231,231
Marelin,F,100,231,0,231
Marilynne,F,100,231,0,231
Marrianne,F,100,231,0,231
Marybelle,F,100,231,0,231
Neeko,M,100,0,231,231
Oriel,M,55,104,127,231
Orvil,M,100,0,231,231
Rakayla,F,100,231,0,231
Rashae,F,100,231,0,231
Raynetta,F,100,231,0,231
Rishik,M,100,0,231,231
Saiya,F,100,231,0,231
Sharah,F,100,231,0,231
Sherea,F,100,231,0,231
Sidni,F,100,231,0,231
Skyeler,F,50,116,115,231
Treazure,F,100,231,0,231
Varonica,F,100,231,0,231
Ajit,M,100,0,230,230
Allessandra,F,100,230,0,230
Allina,F,100,230,0,230
Allyanna,F,100,230,0,230
Alonah,F,100,230,0,230
Ausha,F,100,230,0,230
Barkley,M,98,5,225,230
Chanz,M,100,0,230,230
Charmian,F,100,230,0,230
Chrisie,F,100,230,0,230
Christabelle,F,100,230,0,230
Crystalynn,F,100,230,0,230
Deborra,F,100,230,0,230
Dimond,F,100,230,0,230
Dorraine,F,100,230,0,230
Kairee,M,54,105,125,230
Kasra,M,100,0,230,230
Keaundra,F,100,230,0,230
Kennethia,F,100,230,0,230
Kiyla,F,100,230,0,230
Lajoy,F,100,230,0,230
Lamyah,F,100,230,0,230
Lasya,F,100,230,0,230
Lejon,M,100,0,230,230
Mairi,F,100,230,0,230
Margeret,F,100,230,0,230
Mckala,F,100,230,0,230
Md,M,100,0,230,230
Mieke,F,100,230,0,230
Orien,M,100,0,230,230
Ousman,M,100,0,230,230
Panayiotis,M,100,0,230,230
Parley,M,100,0,230,230
Ravan,F,100,230,0,230
Rishard,M,100,0,230,230
Ronnel,M,100,0,230,230
Rosmery,F,100,230,0,230
Shaunak,M,100,0,230,230
Shenetta,F,100,230,0,230
Sohaib,M,100,0,230,230
Tamberly,F,100,230,0,230
Treavon,M,100,0,230,230
Tyeesha,F,100,230,0,230
Valkyrie,F,100,230,0,230
Adasia,F,100,229,0,229
Adolf,M,100,0,229,229
Aimar,M,50,114,115,229
Aimy,F,100,229,0,229
Alanys,F,100,229,0,229
Anice,F,100,229,0,229
Anshika,F,100,229,0,229
Auguste,M,94,13,216,229
Basim,M,100,0,229,229
Beauty,F,100,229,0,229
Chakira,F,100,229,0,229
Chariti,F,100,229,0,229
Cherity,F,100,229,0,229
Courtnei,F,100,229,0,229
Decorian,M,100,0,229,229
Ekam,M,59,93,136,229
Erle,M,100,0,229,229
Evi,F,100,229,0,229
Gaius,M,100,0,229,229
Hannelore,F,100,229,0,229
Hatcher,M,100,0,229,229
Jerimie,M,100,0,229,229
Jniya,F,100,229,0,229
Johnta,M,98,5,224,229
Josiel,M,100,0,229,229
Kasara,F,100,229,0,229
Kiannah,F,100,229,0,229
Kjerstin,F,100,229,0,229
Leiann,F,100,229,0,229
Loic,M,100,0,229,229
Maciah,F,56,129,100,229
Makeisha,F,100,229,0,229
Matasha,F,100,229,0,229
Murtaza,M,100,0,229,229
Niva,F,100,229,0,229
Patrecia,F,100,229,0,229
Perseus,M,91,20,209,229
Rushi,M,100,0,229,229
Sakeenah,F,100,229,0,229
Schneider,M,100,0,229,229
Sirius,M,100,0,229,229
Sonna,F,100,229,0,229
Tessica,F,100,229,0,229
Thorn,M,100,0,229,229
Tieara,F,100,229,0,229
Tyshae,F,100,229,0,229
Yann,M,100,0,229,229
Acen,M,100,0,228,228
Annaya,F,100,228,0,228
Anthonette,F,100,228,0,228
Anurag,M,100,0,228,228
Arna,F,100,228,0,228
Corazon,F,100,228,0,228
Corrinna,F,100,228,0,228
Daveyon,M,100,0,228,228
Dejia,F,100,228,0,228
Delania,F,100,228,0,228
Eyvette,F,100,228,0,228
Holiday,F,100,228,0,228
Jaxston,M,100,0,228,228
Jefry,M,100,0,228,228
Jonavan,M,100,0,228,228
Jyoti,F,100,228,0,228
Kamalani,F,97,222,6,228
Kanai,M,70,68,160,228
Kehinde,M,64,81,147,228
Khrista,F,100,228,0,228
Kirston,F,100,228,0,228
Kmari,M,52,109,119,228
Koleen,F,100,228,0,228
Lamontae,M,100,0,228,228
Lexton,M,100,0,228,228
Lexxus,F,100,228,0,228
Makaia,F,100,228,0,228
Marca,F,100,228,0,228
Marcellina,F,100,228,0,228
Marlaine,F,100,228,0,228
Mars,M,100,0,228,228
Masin,M,100,0,228,228
Mishel,F,100,228,0,228
Murrell,M,100,0,228,228
Nakea,F,100,228,0,228
Nykole,F,100,228,0,228
Rockelle,F,100,228,0,228
Sabastion,M,100,0,228,228
Soriya,F,98,223,5,228
Storie,F,100,228,0,228
Taila,F,100,228,0,228
Tanysha,F,100,228,0,228
Terrionna,F,100,228,0,228
Tieler,M,85,35,193,228
Tonatiuh,M,100,0,228,228
Traylon,M,100,0,228,228
Trayshawn,M,100,0,228,228
Trenae,F,100,228,0,228
Vesna,F,100,228,0,228
Victormanuel,M,100,0,228,228
Xiara,F,100,228,0,228
Adraine,F,98,222,5,227
Airelle,F,100,227,0,227
Alwyn,M,100,0,227,227
Alyzza,F,100,227,0,227
Amol,M,100,0,227,227
Avid,M,100,0,227,227
Ayson,M,100,0,227,227
Bambie,F,100,227,0,227
Benjimin,M,100,0,227,227
Bolivar,M,100,0,227,227
Brayon,M,100,0,227,227
Camdin,M,100,0,227,227
Chawn,M,82,40,187,227
Cornisha,F,100,227,0,227
Cozetta,F,100,227,0,227
Damarrion,M,100,0,227,227
Daqwan,M,100,0,227,227
Deepika,F,100,227,0,227
Demetrica,F,100,227,0,227
Demiya,F,100,227,0,227
Derral,M,100,0,227,227
Deshayla,F,100,227,0,227
Efe,M,100,0,227,227
Equilla,F,100,227,0,227
Gayatri,F,100,227,0,227
Geneen,F,100,227,0,227
Giordano,M,100,0,227,227
Jaine,F,100,227,0,227
Kadisha,F,100,227,0,227
Kamarri,M,68,73,154,227
Khamya,F,100,227,0,227
Layana,F,100,227,0,227
Magnum,M,100,0,227,227
Martese,M,100,0,227,227
Maurisha,F,100,227,0,227
Mikalyn,F,100,227,0,227
Naria,F,100,227,0,227
Nashae,F,100,227,0,227
Odetta,F,100,227,0,227
Olvin,M,100,0,227,227
Patrycja,F,100,227,0,227
Peng,M,100,0,227,227
Renn,M,87,29,198,227
Roemello,M,100,0,227,227
Ruchel,F,100,227,0,227
Rune,M,93,15,212,227
Sajan,M,100,0,227,227
Samella,F,100,227,0,227
Shahidah,F,100,227,0,227
Shamieka,F,100,227,0,227
Shayana,F,100,227,0,227
Swathi,F,100,227,0,227
Teriana,F,100,227,0,227
Trella,F,100,227,0,227
Yaron,M,100,0,227,227
Zaccary,M,100,0,227,227
Zaylan,M,100,0,227,227
Zekiel,M,100,0,227,227
Agnieszka,F,100,226,0,226
Akeen,M,100,0,226,226
Alanni,F,100,226,0,226
Alexcis,F,95,215,11,226
Alivya,F,100,226,0,226
Amorie,F,82,185,41,226
Ariston,M,100,0,226,226
Artesia,F,100,226,0,226
Aviona,F,100,226,0,226
Bairon,M,100,0,226,226
Bartosz,M,100,0,226,226
Brittane,F,100,226,0,226
Chaela,F,100,226,0,226
Christell,F,100,226,0,226
Daelon,M,100,0,226,226
Deshae,F,82,185,41,226
Elenore,F,100,226,0,226
Felicha,F,100,226,0,226
Haeli,F,100,226,0,226
Hilari,F,100,226,0,226
Jaionna,F,100,226,0,226
Jamarco,M,100,0,226,226
Jenipher,F,100,226,0,226
Jeziel,M,100,0,226,226
Joncarlo,M,100,0,226,226
Julyana,F,100,226,0,226
Kayvion,M,100,0,226,226
Kobee,M,90,22,204,226
Lamonta,M,100,0,226,226
Lovey,F,100,226,0,226
Madelina,F,100,226,0,226
Maresha,F,100,226,0,226
Margert,F,100,226,0,226
Paislie,F,100,226,0,226
Quanah,M,82,40,186,226
Rodriques,M,100,0,226,226
Roshon,M,73,60,166,226
Saidee,F,100,226,0,226
Syann,F,100,226,0,226
Tahjae,F,54,122,104,226
Tarius,M,100,0,226,226
Taylie,F,100,226,0,226
Tocarra,F,100,226,0,226
Tyleek,M,100,0,226,226
Yaritzi,F,100,226,0,226
Yishai,M,100,0,226,226
Yuli,F,100,226,0,226
Adrianah,F,100,225,0,225
Annet,F,100,225,0,225
Arjuna,M,100,0,225,225
Arran,M,100,0,225,225
Aubery,M,72,63,162,225
Aysa,F,98,220,5,225
Bessy,F,100,225,0,225
Brendalyn,F,100,225,0,225
Caillou,M,100,0,225,225
Chealsea,F,100,225,0,225
Cloee,F,100,225,0,225
Coleby,M,100,0,225,225
Cyndal,F,100,225,0,225
Dalaina,F,100,225,0,225
Darryel,M,100,0,225,225
Deldrick,M,100,0,225,225
Edwar,M,100,0,225,225
Eilleen,F,100,225,0,225
Elley,F,100,225,0,225
Gelsey,F,100,225,0,225
Glorie,F,100,225,0,225
Grissel,F,100,225,0,225
Halleigh,F,100,225,0,225
Jaydence,F,58,131,94,225
Jazzelle,F,100,225,0,225
Kaio,M,100,0,225,225
Khalea,F,100,225,0,225
Kimmarie,F,100,225,0,225
Kinte,M,95,12,213,225
Laneshia,F,100,225,0,225
Laurey,F,100,225,0,225
Maelle,F,100,225,0,225
Manoj,M,100,0,225,225
Meko,M,57,97,128,225
Nathanyel,M,100,0,225,225
Nyiesha,F,100,225,0,225
Quantina,F,100,225,0,225
Rai,M,68,72,153,225
Raidyn,M,88,27,198,225
Reganne,F,100,225,0,225
Rodnesha,F,100,225,0,225
Sandon,M,100,0,225,225
Savior,M,100,0,225,225
Shawni,F,100,225,0,225
Shyasia,F,100,225,0,225
Sierria,F,100,225,0,225
Tonianne,F,100,225,0,225
Valaree,F,100,225,0,225
Viaan,M,100,0,225,225
Yaileen,F,100,225,0,225
Yaqub,M,100,0,225,225
Aaralynn,F,100,224,0,224
Afiya,F,100,224,0,224
Aleiya,F,100,224,0,224
Ameris,F,100,224,0,224
Avonna,F,100,224,0,224
Branch,M,100,0,224,224
Cherylene,F,100,224,0,224
Dawnya,F,100,224,0,224
Devanta,M,100,0,224,224
Elisabetta,F,100,224,0,224
Franci,F,100,224,0,224
Fuquan,M,100,0,224,224
Gregrey,M,100,0,224,224
Jabarie,M,100,0,224,224
Jadien,M,86,31,193,224
Jalexis,F,100,224,0,224
Jasn,M,100,0,224,224
Kashvi,F,100,224,0,224
Kaushik,M,100,0,224,224
Kayton,F,63,142,82,224
Keiosha,F,100,224,0,224
Kerron,M,100,0,224,224
Krystalynn,F,100,224,0,224
Laurianne,F,100,224,0,224
Lenisha,F,100,224,0,224
Lerin,F,87,195,29,224
Manan,M,100,0,224,224
Markella,F,100,224,0,224
Melis,F,100,224,0,224
Mikea,F,100,224,0,224
Patriciaann,F,100,224,0,224
Reyne,F,100,224,0,224
Shaakira,F,100,224,0,224
Syanne,F,100,224,0,224
Taje,M,56,99,125,224
Ugochukwu,M,100,0,224,224
Yasmen,F,100,224,0,224
Yeira,F,100,224,0,224
Airyanna,F,100,223,0,223
Akeira,F,100,223,0,223
Amylynn,F,100,223,0,223
Anacristina,F,100,223,0,223
Analisse,F,100,223,0,223
Anik,M,92,17,206,223
Anquan,M,100,0,223,223
Aymar,F,100,223,0,223
Braeleigh,F,100,223,0,223
Braxston,M,100,0,223,223
Candus,F,100,223,0,223
Celsey,F,100,223,0,223
Chanze,M,100,0,223,223
Chimene,F,100,223,0,223
Creola,F,100,223,0,223
Daisa,F,100,223,0,223
Denishia,F,100,223,0,223
Deztiny,F,100,223,0,223
Django,M,100,0,223,223
Edelyn,F,100,223,0,223
Elaysia,F,100,223,0,223
Erendida,F,100,223,0,223
Gwenetta,F,100,223,0,223
Inda,F,100,223,0,223
Itamar,M,93,16,207,223
Ivar,M,100,0,223,223
Jearld,M,100,0,223,223
Jeret,M,100,0,223,223
Jerline,F,100,223,0,223
Keath,M,100,0,223,223
Kelsay,F,100,223,0,223
Latiffany,F,100,223,0,223
Layten,M,92,17,206,223
Lenaya,F,100,223,0,223
Lynnmarie,F,100,223,0,223
Mickle,M,100,0,223,223
Nandita,F,100,223,0,223
Nathin,M,100,0,223,223
Nethaniel,M,100,0,223,223
Piers,M,100,0,223,223
Raeana,F,100,223,0,223
Shonnie,F,100,223,0,223
Tirso,M,100,0,223,223
Trilby,F,100,223,0,223
Xzayvier,M,100,0,223,223
Zahirah,F,100,223,0,223
Zekiah,M,63,82,141,223
Aaradhya,F,100,222,0,222
Alam,M,100,0,222,222
Alazia,F,100,222,0,222
Aleese,F,100,222,0,222
Amillion,F,67,149,73,222
Andray,M,100,0,222,222
Antavius,M,100,0,222,222
Antionne,M,100,0,222,222
Anu,F,95,212,10,222
Ascher,M,100,0,222,222
Aydrian,M,82,40,182,222
Azalee,F,100,222,0,222
Beauregard,M,100,0,222,222
Brandonlee,M,100,0,222,222
Carrin,F,100,222,0,222
Caydan,M,98,5,217,222
Chalise,F,100,222,0,222
Cleatus,M,100,0,222,222
Cleavon,M,100,0,222,222
Danelly,F,100,222,0,222
Ellagrace,F,100,222,0,222
Emelio,M,100,0,222,222
Gared,M,100,0,222,222
Jaisa,F,100,222,0,222
Jakyia,F,100,222,0,222
Jalik,M,100,0,222,222
Jamoni,M,57,95,127,222
Janeil,F,90,199,23,222
Jannessa,F,100,222,0,222
Jaymen,M,100,0,222,222
Joash,M,100,0,222,222
Jourdin,F,66,146,76,222
Julion,M,100,0,222,222
Kenechukwu,M,100,0,222,222
Kenyanna,F,100,222,0,222
Kevia,F,100,222,0,222
Korea,F,100,222,0,222
Leitha,F,100,222,0,222
Mackay,M,91,21,201,222
Madisun,F,100,222,0,222
Mearl,M,98,5,217,222
Merrilyn,F,100,222,0,222
Mirissa,F,100,222,0,222
Missi,F,100,222,0,222
Nalayah,F,100,222,0,222
Nashley,F,100,222,0,222
Nixie,F,100,222,0,222
Nohelia,F,100,222,0,222
Raif,M,100,0,222,222
Ranveer,M,100,0,222,222
Raynisha,F,100,222,0,222
Saharsh,M,100,0,222,222
Seairra,F,100,222,0,222
Shealee,F,100,222,0,222
Stormey,F,97,215,7,222
Tekesha,F,100,222,0,222
Tersa,F,100,222,0,222
Thinh,M,100,0,222,222
Tiannah,F,100,222,0,222
Usiel,M,100,0,222,222
Yazen,M,100,0,222,222
Yenny,F,100,222,0,222
Yuvan,M,100,0,222,222
Aariona,F,100,221,0,221
Abryanna,F,100,221,0,221
Alanmichael,M,100,0,221,221
Allanna,F,100,221,0,221
Alvester,M,100,0,221,221
Anishka,F,100,221,0,221
Apostolos,M,100,0,221,221
Carlean,F,100,221,0,221
Chantil,F,100,221,0,221
Debbora,F,100,221,0,221
Deeksha,F,100,221,0,221
Delfin,M,100,0,221,221
Desira,F,100,221,0,221
Eliaz,M,100,0,221,221
Flecia,F,100,221,0,221
Gerritt,M,100,0,221,221
Greydon,M,100,0,221,221
Haskel,M,100,0,221,221
Ivis,F,70,155,66,221
Jannis,F,100,221,0,221
Kalijah,M,70,67,154,221
Katelen,F,100,221,0,221
Keante,M,94,13,208,221
Kesi,F,100,221,0,221
Kiowa,M,75,55,166,221
Lizzett,F,100,221,0,221
Lylia,F,100,221,0,221
Marieli,F,100,221,0,221
Marletta,F,100,221,0,221
Miette,F,100,221,0,221
Montrail,M,100,0,221,221
Muneeb,M,100,0,221,221
Naidelin,F,100,221,0,221
Neenah,F,100,221,0,221
Nickoli,M,100,0,221,221
Quetzali,F,100,221,0,221
Ranson,M,100,0,221,221
Raylie,F,100,221,0,221
Shirlean,F,100,221,0,221
Sreya,F,100,221,0,221
Sura,F,100,221,0,221
Tahmid,M,100,0,221,221
Theordore,M,100,0,221,221
Tsion,F,83,184,37,221
Tung,M,100,0,221,221
Yaphet,M,98,5,216,221
Adenike,F,100,220,0,220
Albion,M,100,0,220,220
Anaja,F,100,220,0,220
Aubryanna,F,100,220,0,220
Bon,M,100,0,220,220
Cathaleen,F,100,220,0,220
Charrise,F,100,220,0,220
Cortavious,M,100,0,220,220
Cynithia,F,100,220,0,220
Dacian,M,100,0,220,220
Daekwon,M,100,0,220,220
Dail,M,61,86,134,220
Dalis,F,98,215,5,220
Egbert,M,100,0,220,220
Fatmata,F,100,220,0,220
Fidelia,F,100,220,0,220
Glover,M,100,0,220,220
Harshini,F,100,220,0,220
Hutch,M,100,0,220,220
Jakye,M,100,0,220,220
Janaia,F,100,220,0,220
Jarrick,M,100,0,220,220
Jerzy,F,52,115,105,220
Kimmi,F,100,220,0,220
Kimra,F,100,220,0,220
Kindell,F,76,168,52,220
Leita,F,100,220,0,220
Lexxi,F,100,220,0,220
Liel,F,89,196,24,220
Makani,M,87,29,191,220
Malkia,F,100,220,0,220
Meilin,F,100,220,0,220
Montrey,M,100,0,220,220
Nakyia,F,100,220,0,220
Nishi,F,100,220,0,220
Paraskevi,F,100,220,0,220
Reeva,F,100,220,0,220
Reise,M,55,98,122,220
Rodderick,M,100,0,220,220
Roth,M,100,0,220,220
Rourke,M,100,0,220,220
Sakai,M,72,61,159,220
Sameria,F,100,220,0,220
Saumya,F,98,215,5,220
Shamona,F,100,220,0,220
Shanavia,F,100,220,0,220
Shanieka,F,100,220,0,220
Shatonya,F,100,220,0,220
Stanislav,M,100,0,220,220
Teniya,F,100,220,0,220
Zaylah,F,100,220,0,220
Akiera,F,100,219,0,219
Alexianna,F,100,219,0,219
Anaria,F,100,219,0,219
Anoop,M,91,19,200,219
Atavia,F,100,219,0,219
Brown,M,98,5,214,219
Camaya,F,100,219,0,219
Chamar,M,100,0,219,219
Chistian,M,100,0,219,219
Chondra,F,100,219,0,219
Chyrl,F,100,219,0,219
Conlin,M,100,0,219,219
Corra,F,100,219,0,219
Crystin,F,100,219,0,219
Danuel,M,98,5,214,219
Darolyn,F,100,219,0,219
Dawaun,M,100,0,219,219
Dorthey,F,100,219,0,219
Dquan,M,100,0,219,219
Eban,M,100,0,219,219
Edana,F,100,219,0,219
Elese,F,100,219,0,219
Goddess,F,100,219,0,219
Jakie,M,95,11,208,219
Javares,M,100,0,219,219
Jerimyah,M,100,0,219,219
Jerlene,F,100,219,0,219
Jiraiya,M,100,0,219,219
Kalianna,F,100,219,0,219
Kamdin,M,98,5,214,219
Kelvyn,M,100,0,219,219
Kert,M,100,0,219,219
Khaden,M,100,0,219,219
Kourtlyn,F,100,219,0,219
Kyarra,F,100,219,0,219
Laisa,F,100,219,0,219
Laportia,F,100,219,0,219
Latunya,F,100,219,0,219
Leira,F,100,219,0,219
Lorilei,F,100,219,0,219
Maelie,F,100,219,0,219
Malon,M,74,58,161,219
Molley,F,100,219,0,219
Naeema,F,100,219,0,219
Nautika,F,100,219,0,219
Roch,M,100,0,219,219
Saber,M,83,37,182,219
Taffany,F,100,219,0,219
Taquilla,F,100,219,0,219
Tellis,M,100,0,219,219
Tenita,F,100,219,0,219
Vontrell,M,100,0,219,219
Zachrey,M,100,0,219,219
Zed,M,100,0,219,219
Adalene,F,100,218,0,218
Alexandrina,F,100,218,0,218
Belladonna,F,100,218,0,218
Calle,F,100,218,0,218
Carlas,M,73,59,159,218
Deloria,F,100,218,0,218
Deng,M,100,0,218,218
Falecia,F,100,218,0,218
Fransisca,F,100,218,0,218
Helio,M,100,0,218,218
Ivee,F,100,218,0,218
Jahmil,M,100,0,218,218
Jalesia,F,100,218,0,218
Jaquelyne,F,100,218,0,218
Jaquisha,F,100,218,0,218
Jasa,F,100,218,0,218
Jemari,M,100,0,218,218
Josyah,M,100,0,218,218
Kaitland,F,100,218,0,218
Khayri,M,100,0,218,218
Laiya,F,100,218,0,218
Libra,F,100,218,0,218
Lilyrose,F,100,218,0,218
Macaria,F,100,218,0,218
Malaak,F,100,218,0,218
Maxi,F,57,125,93,218
Mirra,F,100,218,0,218
Pinchos,M,100,0,218,218
Raiya,F,100,218,0,218
Rolfe,M,100,0,218,218
Shakelia,F,100,218,0,218
Shanesha,F,100,218,0,218
Sravya,F,100,218,0,218
Stormee,F,100,218,0,218
Tacoma,M,81,42,176,218
Teddrick,M,100,0,218,218
Timaya,F,100,218,0,218
Veola,F,100,218,0,218
Verdie,F,89,194,24,218
Verline,F,100,218,0,218
Vernelle,F,100,218,0,218
Yaa,F,100,218,0,218
Yazid,M,100,0,218,218
Ziyan,M,56,95,123,218
Aldahir,M,100,0,217,217
Analynn,F,100,217,0,217
Angelmarie,F,100,217,0,217
Armanii,F,70,151,66,217
Aryaman,M,100,0,217,217
Ashtynn,F,100,217,0,217
Blayde,M,100,0,217,217
Braniya,F,100,217,0,217
Cacey,F,92,200,17,217
Caoimhe,F,100,217,0,217
Chryl,F,100,217,0,217
Ciel,F,74,161,56,217
Clenton,M,100,0,217,217
Concha,F,100,217,0,217
Delanna,F,100,217,0,217
Desree,F,100,217,0,217
Evens,M,100,0,217,217
Jahnya,F,100,217,0,217
Jakhai,M,98,5,212,217
Jejuan,M,100,0,217,217
Jerricka,F,100,217,0,217
Jeylin,F,100,217,0,217
Jowanna,F,100,217,0,217
Karrina,F,100,217,0,217
Katrenia,F,100,217,0,217
Kayl,M,89,24,193,217
Kenshin,M,100,0,217,217
Laelah,F,100,217,0,217
Lorel,F,100,217,0,217
Margareta,F,100,217,0,217
Marka,F,98,212,5,217
Marlisha,F,100,217,0,217
Micholas,M,100,0,217,217
Moxie,F,100,217,0,217
Nelsy,F,100,217,0,217
Nikolos,M,100,0,217,217
Paxson,M,100,0,217,217
Praveen,M,100,0,217,217
Raenell,F,100,217,0,217
Rosselyn,F,100,217,0,217
Shaleena,F,100,217,0,217
Shanicka,F,100,217,0,217
Sharece,F,100,217,0,217
Stace,M,85,33,184,217
Sweta,F,100,217,0,217
Valetta,F,100,217,0,217
Vennessa,F,100,217,0,217
Zackarie,M,100,0,217,217
Ailed,F,100,216,0,216
Annakate,F,100,216,0,216
Ashar,M,100,0,216,216
Avangeline,F,100,216,0,216
Baraka,M,92,18,198,216
Breanah,F,100,216,0,216
Brooklen,F,100,216,0,216
Camree,F,100,216,0,216
Chrisy,F,100,216,0,216
Danh,M,100,0,216,216
Dayten,M,100,0,216,216
Deserea,F,100,216,0,216
Eily,F,100,216,0,216
Evanie,F,100,216,0,216
Geffrey,M,100,0,216,216
Henok,M,100,0,216,216
Huma,F,100,216,0,216
Illa,F,100,216,0,216
Jerene,F,100,216,0,216
Jericha,F,100,216,0,216
Jniyah,F,100,216,0,216
Jobani,M,100,0,216,216
Jony,M,100,0,216,216
Juanetta,F,100,216,0,216
Kaeo,M,100,0,216,216
Keiden,M,100,0,216,216
Kenyen,M,100,0,216,216
Keyauna,F,100,216,0,216
Kionte,M,93,16,200,216
Kyisha,F,100,216,0,216
Lavan,M,100,0,216,216
Leviathan,M,100,0,216,216
Linder,F,100,216,0,216
Makaylia,F,100,216,0,216
Meshia,F,100,216,0,216
Mystery,F,100,216,0,216
Nadalie,F,100,216,0,216
Natnael,M,100,0,216,216
Nghia,M,98,5,211,216
Nike,M,51,106,110,216
Niveah,F,100,216,0,216
Oluwakemi,F,100,216,0,216
Patrici,F,100,216,0,216
Raynesha,F,100,216,0,216
Rhianne,F,100,216,0,216
Shanina,F,100,216,0,216
Shayonna,F,100,216,0,216
Siaosi,M,100,0,216,216
Trino,M,100,0,216,216
Tyden,M,100,0,216,216
Vahe,M,100,0,216,216
Yani,F,77,166,50,216
Yarelly,F,100,216,0,216
Yavonne,F,100,216,0,216
Yitta,F,100,216,0,216
Zaeden,M,100,0,216,216
Zenna,F,100,216,0,216
Zosia,F,100,216,0,216
Abayomi,M,100,0,215,215
Abrie,F,100,215,0,215
Alois,M,100,0,215,215
Amour,F,89,192,23,215
Angelos,M,100,0,215,215
Aryia,F,100,215,0,215
Ashtan,F,55,119,96,215
Atasha,F,100,215,0,215
Bailea,F,100,215,0,215
Bethanny,F,100,215,0,215
Buddie,M,100,0,215,215
Caria,F,100,215,0,215
Charday,F,100,215,0,215
Charnise,F,100,215,0,215
Chiana,F,100,215,0,215
Clell,M,100,0,215,215
Dalary,F,100,215,0,215
Damonique,F,100,215,0,215
Dashan,M,95,10,205,215
Daviyon,M,100,0,215,215
Debbe,F,100,215,0,215
Earla,F,100,215,0,215
Elivia,F,100,215,0,215
Jahmya,F,100,215,0,215
Jakaylah,F,100,215,0,215
Jameil,M,100,0,215,215
Jaston,M,100,0,215,215
Jessamy,F,100,215,0,215
Juleah,F,100,215,0,215
Kalliopi,F,100,215,0,215
Keatyn,F,66,142,73,215
Khadeeja,F,100,215,0,215
Kyona,F,100,215,0,215
Ladonya,F,100,215,0,215
Laia,F,100,215,0,215
Laretha,F,100,215,0,215
Larra,F,100,215,0,215
Latyra,F,100,215,0,215
Leanda,F,100,215,0,215
Luisantonio,M,100,0,215,215
Mithcell,M,100,0,215,215
Nhung,F,100,215,0,215
Rehanna,F,100,215,0,215
Rivaldo,M,100,0,215,215
Samay,M,98,5,210,215
Shantea,F,100,215,0,215
Tamber,F,100,215,0,215
Tamma,F,100,215,0,215
Teralyn,F,100,215,0,215
Tynisa,F,100,215,0,215
Yaniv,M,100,0,215,215
Aanika,F,100,214,0,214
Amalya,F,100,214,0,214
Amberlie,F,100,214,0,214
Amma,F,100,214,0,214
Ashana,F,100,214,0,214
Ashika,F,100,214,0,214
Broadus,M,100,0,214,214
Caniyah,F,100,214,0,214
Charmel,F,100,214,0,214
Chidubem,M,100,0,214,214
Colonel,M,100,0,214,214
Contrell,M,100,0,214,214
Delmi,F,100,214,0,214
Demarea,M,100,0,214,214
Derryck,M,100,0,214,214
Doreene,F,100,214,0,214
Doy,M,98,5,209,214
Elizandro,M,100,0,214,214
Esmae,F,100,214,0,214
Gustaf,M,100,0,214,214
Helder,M,100,0,214,214
Hydeia,F,100,214,0,214
Idrees,M,100,0,214,214
Ilani,F,100,214,0,214
Ismerai,F,100,214,0,214
Iya,F,100,214,0,214
Izick,M,100,0,214,214
Jastin,M,93,14,200,214
Javeion,M,100,0,214,214
Johnice,F,100,214,0,214
Jorene,F,100,214,0,214
Kerina,F,100,214,0,214
Machai,M,100,0,214,214
Maisen,M,75,54,160,214
Manford,M,100,0,214,214
Marcas,M,100,0,214,214
Maylani,F,100,214,0,214
Mcdonald,M,100,0,214,214
Montina,F,100,214,0,214
Myrl,M,83,37,177,214
Nasira,F,100,214,0,214
Nasiyah,F,100,214,0,214
Ngan,F,100,214,0,214
Niaya,F,100,214,0,214
Niyanna,F,100,214,0,214
Pascha,F,100,214,0,214
Raheel,M,100,0,214,214
Rella,F,100,214,0,214
Roc,M,100,0,214,214
Sabrinna,F,100,214,0,214
Sanad,M,100,0,214,214
Shelsey,F,100,214,0,214
Tabbetha,F,100,214,0,214
Tameem,M,100,0,214,214
Tanara,F,100,214,0,214
Taquila,F,100,214,0,214
Tarance,M,100,0,214,214
Teyla,F,100,214,0,214
Thia,F,100,214,0,214
Tiyon,M,100,0,214,214
Tykesha,F,100,214,0,214
Valissa,F,100,214,0,214
Yaqueline,F,100,214,0,214
Yeriel,M,100,0,214,214
Agustus,M,100,0,213,213
Alexea,F,100,213,0,213
Aliceson,F,100,213,0,213
Analysia,F,100,213,0,213
Angala,F,100,213,0,213
Betania,F,100,213,0,213
Billee,F,100,213,0,213
Bowden,M,100,0,213,213
Breigh,F,100,213,0,213
Brittony,F,100,213,0,213
Dayanira,F,100,213,0,213
Delmus,M,100,0,213,213
Dougles,M,100,0,213,213
Elleanor,F,100,213,0,213
Emaya,F,100,213,0,213
Emberlee,F,100,213,0,213
Ervey,M,100,0,213,213
Fady,M,100,0,213,213
Hiliana,F,100,213,0,213
Hiromi,F,100,213,0,213
Irvine,M,100,0,213,213
Jaeleigh,F,100,213,0,213
Jahmeir,M,100,0,213,213
Jakin,M,100,0,213,213
Jaleya,F,100,213,0,213
Jameal,M,100,0,213,213
Jamiere,M,100,0,213,213
Janelys,F,100,213,0,213
Katlynne,F,100,213,0,213
Keilen,M,85,31,182,213
Kelbie,F,100,213,0,213
Kendarious,M,100,0,213,213
Kristjan,M,100,0,213,213
Kurk,M,100,0,213,213
Ladean,F,98,208,5,213
Lekia,F,100,213,0,213
Leontyne,F,100,213,0,213
Lyrick,F,51,108,105,213
Mahkai,M,100,0,213,213
Markiesha,F,100,213,0,213
Meliton,M,100,0,213,213
Myrick,M,100,0,213,213
Naiyah,F,100,213,0,213
Nevayah,F,100,213,0,213
Rachna,F,100,213,0,213
Rasaan,M,100,0,213,213
Rebecah,F,100,213,0,213
Shamirah,F,100,213,0,213
Shaquil,M,97,7,206,213
Tayshon,M,100,0,213,213
Trissa,F,100,213,0,213
Vesper,F,100,213,0,213
Yuji,M,100,0,213,213
Zalika,F,100,213,0,213
Aamira,F,100,212,0,212
Aireona,F,100,212,0,212
Akeya,F,100,212,0,212
Aliyyah,F,100,212,0,212
Allexus,F,100,212,0,212
Ayven,M,90,22,190,212
Benjimen,M,100,0,212,212
Claryssa,F,100,212,0,212
Coye,M,100,0,212,212
Daion,M,100,0,212,212
Decklan,M,100,0,212,212
Demoni,M,76,51,161,212
Dexton,M,100,0,212,212
Elim,M,57,92,120,212
Fredrich,M,100,0,212,212
Geovana,F,100,212,0,212
Gilmer,M,100,0,212,212
Gwynneth,F,100,212,0,212
Haely,F,100,212,0,212
Hason,M,100,0,212,212
Ishmeal,M,100,0,212,212
Jenisha,F,100,212,0,212
Josilynn,F,100,212,0,212
Kennen,M,100,0,212,212
Kyrra,F,100,212,0,212
Leelah,F,100,212,0,212
Leodis,M,100,0,212,212
Lonney,M,100,0,212,212
Loralai,F,100,212,0,212
Maurene,F,100,212,0,212
Melessia,F,100,212,0,212
Mio,F,89,189,23,212
Nelvin,M,100,0,212,212
Nilay,M,98,5,207,212
Oluwanifemi,F,56,118,94,212
Paije,F,100,212,0,212
Radiance,F,100,212,0,212
Rekha,F,100,212,0,212
Roselind,F,100,212,0,212
Seraphine,F,100,212,0,212
Shahara,F,100,212,0,212
Shakeel,M,100,0,212,212
Shakeitha,F,100,212,0,212
Shar,F,100,212,0,212
Taegen,F,68,144,68,212
Thamara,F,100,212,0,212
Thuan,M,98,5,207,212
Torina,F,100,212,0,212
Urvi,F,100,212,0,212
Vincient,M,100,0,212,212
Yumiko,F,100,212,0,212
Ahliyah,F,100,211,0,211
Aleka,F,100,211,0,211
Alireza,M,100,0,211,211
Areonna,F,100,211,0,211
Aundray,M,100,0,211,211
Azariya,F,100,211,0,211
Bena,F,100,211,0,211
Berk,M,100,0,211,211
Brietta,F,100,211,0,211
Carinne,F,100,211,0,211
Casia,F,100,211,0,211
Cornesha,F,100,211,0,211
Dema,F,100,211,0,211
Deziyah,F,100,211,0,211
Domenik,M,98,5,206,211
Dominigue,F,78,165,46,211
Drina,F,100,211,0,211
Elizabella,F,100,211,0,211
Francena,F,100,211,0,211
Jailey,F,100,211,0,211
Jamai,M,90,22,189,211
Jarome,M,100,0,211,211
Jeanita,F,100,211,0,211
Juandedios,M,100,0,211,211
Kadince,F,100,211,0,211
Kahleel,M,100,0,211,211
Kiala,F,100,211,0,211
Kierrah,F,100,211,0,211
Kristyl,F,100,211,0,211
Kwane,M,100,0,211,211
Labrandon,M,100,0,211,211
Liara,F,100,211,0,211
Maleeha,F,100,211,0,211
Maleeka,F,100,211,0,211
Michai,M,100,0,211,211
Mieka,F,100,211,0,211
Myson,M,100,0,211,211
Norvel,M,100,0,211,211
Orelia,F,100,211,0,211
Ostin,M,100,0,211,211
Peytin,F,91,193,18,211
Quandra,F,100,211,0,211
Rylann,F,88,186,25,211
Shawntelle,F,100,211,0,211
Soo,F,91,193,18,211
Timera,F,100,211,0,211
Tolbert,M,100,0,211,211
Tosca,F,100,211,0,211
Trayden,M,100,0,211,211
Tywaun,M,100,0,211,211
Victoriana,F,100,211,0,211
Xaden,M,100,0,211,211
Yohannes,M,100,0,211,211
Zaineb,F,100,211,0,211
Abagael,F,100,210,0,210
Aizik,M,100,0,210,210
Alera,F,100,210,0,210
Andris,M,100,0,210,210
Annalissa,F,100,210,0,210
Annaliza,F,100,210,0,210
Ayane,F,100,210,0,210
Baylon,M,100,0,210,210
Benett,M,100,0,210,210
Biana,F,100,210,0,210
Candia,F,100,210,0,210
Cherina,F,100,210,0,210
Christyne,F,100,210,0,210
Clarine,F,100,210,0,210
Cyniah,F,100,210,0,210
Deigo,M,100,0,210,210
Demarlo,M,100,0,210,210
Dionicia,F,100,210,0,210
Dreshaun,M,100,0,210,210
Florita,F,100,210,0,210
Franko,M,100,0,210,210
Frenchie,F,83,175,35,210
Fritzi,F,100,210,0,210
Ivyana,F,100,210,0,210
Jaiveon,M,100,0,210,210
Jameia,F,100,210,0,210
Januel,M,100,0,210,210
Jenie,F,100,210,0,210
Lashai,F,100,210,0,210
Lucciano,M,100,0,210,210
Malvina,F,100,210,0,210
Marcellino,M,100,0,210,210
Marny,F,100,210,0,210
Melane,F,100,210,0,210
Melicia,F,100,210,0,210
Mera,F,100,210,0,210
Mikyle,M,100,0,210,210
Naama,F,100,210,0,210
Nabeeha,F,100,210,0,210
Najeeb,M,100,0,210,210
Navaya,F,100,210,0,210
Pleshette,F,100,210,0,210
Prateek,M,100,0,210,210
Quay,M,95,10,200,210
Reality,F,100,210,0,210
Saniyyah,F,100,210,0,210
Sherrilynn,F,100,210,0,210
Shoshannah,F,100,210,0,210
Shreyan,M,100,0,210,210
Suad,F,98,205,5,210
Tarrin,M,54,97,113,210
Tatayana,F,100,210,0,210
Tayleigh,F,100,210,0,210
Teigen,M,79,44,166,210
Terricka,F,100,210,0,210
Texas,M,90,21,189,210
Tibor,M,100,0,210,210
Trevonn,M,100,0,210,210
Tylesha,F,100,210,0,210
Valeta,F,100,210,0,210
Vashaun,M,97,6,204,210
Yarelli,F,100,210,0,210
Yazmyn,F,100,210,0,210
Adalin,F,100,209,0,209
Adya,F,100,209,0,209
Anallely,F,100,209,0,209
Antonya,F,100,209,0,209
Arjay,M,100,0,209,209
Aryam,F,95,199,10,209
Brandey,F,100,209,0,209
Caress,F,100,209,0,209
Carrieanne,F,100,209,0,209
Corrigan,M,82,38,171,209
Davisha,F,100,209,0,209
Dennette,F,100,209,0,209
Devansh,M,100,0,209,209
Domnique,F,66,138,71,209
Ellarose,F,100,209,0,209
Emerick,M,100,0,209,209
Emmalyne,F,100,209,0,209
Esma,F,100,209,0,209
Estaban,M,100,0,209,209
Fawaz,M,100,0,209,209
Flo,F,100,209,0,209
Jahmier,M,100,0,209,209
Jakayden,M,100,0,209,209
Jamontae,M,100,0,209,209
Janiyla,F,100,209,0,209
Jasai,M,98,5,204,209
Jermale,M,100,0,209,209
Jrue,M,88,25,184,209
Jyaire,M,100,0,209,209
Kailana,F,100,209,0,209
Kelda,F,100,209,0,209
Keoshia,F,100,209,0,209
Ketsia,F,100,209,0,209
Kingsten,M,100,0,209,209
Konor,M,100,0,209,209
Latice,F,100,209,0,209
Lillien,F,100,209,0,209
Lindey,F,100,209,0,209
Loann,F,100,209,0,209
Lusia,F,100,209,0,209
Makailyn,F,100,209,0,209
Makeila,F,100,209,0,209
Marcea,F,100,209,0,209
Miqueas,M,100,0,209,209
Param,M,100,0,209,209
Riordan,M,100,0,209,209
Seleena,F,100,209,0,209
Shaheim,M,100,0,209,209
Shalese,F,100,209,0,209
Shasha,F,100,209,0,209
Taheem,M,100,0,209,209
Talasia,F,100,209,0,209
Tashanda,F,100,209,0,209
Yarielis,F,100,209,0,209
Yobany,M,100,0,209,209
Yvon,M,78,47,162,209
Zadrian,M,100,0,209,209
Zailyn,F,67,141,68,209
Zerek,M,100,0,209,209
Affan,M,100,0,208,208
Ahnika,F,100,208,0,208
Ailen,F,100,208,0,208
Aliayah,F,100,208,0,208
Alisen,F,100,208,0,208
Aneth,F,100,208,0,208
Antar,M,100,0,208,208
Aodhan,M,100,0,208,208
Casy,M,59,86,122,208
Colie,M,59,85,123,208
Crystol,F,100,208,0,208
Daeton,M,100,0,208,208
Darionna,F,100,208,0,208
Demaya,F,100,208,0,208
Deniro,M,100,0,208,208
Dontel,M,100,0,208,208
Dore,F,90,188,20,208
Ellwood,M,100,0,208,208
Ennifer,F,100,208,0,208
Erline,F,100,208,0,208
Fahd,M,100,0,208,208
Gertha,F,100,208,0,208
Gissela,F,100,208,0,208
Greyden,M,100,0,208,208
Haniyah,F,100,208,0,208
Hayde,F,100,208,0,208
Honorio,M,100,0,208,208
Imane,F,100,208,0,208
Irania,F,100,208,0,208
Ishmail,M,100,0,208,208
Jamaury,M,100,0,208,208
Jarion,M,100,0,208,208
Jayley,F,100,208,0,208
Jmya,F,100,208,0,208
Jolaine,F,100,208,0,208
Jordynne,F,100,208,0,208
Joshaua,M,100,0,208,208
Josian,M,100,0,208,208
Kathleene,F,100,208,0,208
Kaybree,F,100,208,0,208
Kendalynn,F,100,208,0,208
Keny,M,98,5,203,208
Khyri,M,97,7,201,208
Kinsler,M,88,25,183,208
Laprecious,F,100,208,0,208
Linken,M,100,0,208,208
Lonetta,F,100,208,0,208
Mahogani,F,100,208,0,208
Marwah,F,100,208,0,208
Matheu,M,100,0,208,208
Merica,F,100,208,0,208
Miklo,M,100,0,208,208
Monice,F,100,208,0,208
Mykela,F,100,208,0,208
Narada,M,97,7,201,208
Nattalie,F,100,208,0,208
Nica,F,100,208,0,208
Onalee,F,100,208,0,208
Partick,M,100,0,208,208
Prudencio,M,100,0,208,208
Rexanne,F,100,208,0,208
Shameria,F,100,208,0,208
Shaquasia,F,100,208,0,208
Talula,F,100,208,0,208
Taysean,M,100,0,208,208
Tekoa,F,72,150,58,208
Tovia,M,80,41,167,208
Travia,F,100,208,0,208
Turhan,M,100,0,208,208
Tyeasha,F,100,208,0,208
Zakeria,F,98,203,5,208
Alysandra,F,100,207,0,207
Anthonee,M,100,0,207,207
Anysa,F,100,207,0,207
Aquanetta,F,100,207,0,207
Ariam,F,95,196,11,207
Atul,M,100,0,207,207
Balian,M,100,0,207,207
Barack,M,100,0,207,207
Brendt,M,100,0,207,207
Cecilee,F,100,207,0,207
Celita,F,100,207,0,207
Chenille,F,100,207,0,207
Chivon,F,100,207,0,207
Clayten,M,100,0,207,207
Deondria,F,100,207,0,207
Dereke,M,100,0,207,207
Destenie,F,100,207,0,207
Deward,M,100,0,207,207
Dezmin,M,100,0,207,207
Domique,F,67,139,68,207
Eleny,F,100,207,0,207
Elinda,F,100,207,0,207
Ermalinda,F,100,207,0,207
Gabbrielle,F,100,207,0,207
Gonsalo,M,100,0,207,207
Haaris,M,100,0,207,207
Jabri,M,92,16,191,207
Jeree,F,98,202,5,207
Jeremaine,M,100,0,207,207
Johnda,F,100,207,0,207
Jullien,M,100,0,207,207
Kayna,F,100,207,0,207
Kell,M,100,0,207,207
Kirbie,F,100,207,0,207
Konni,F,100,207,0,207
Larua,F,100,207,0,207
Lenzy,M,74,54,153,207
Lua,F,100,207,0,207
Maaliyah,F,100,207,0,207
Mahagony,F,100,207,0,207
Malissia,F,100,207,0,207
Mariona,F,100,207,0,207
Maylea,F,100,207,0,207
Mohan,M,100,0,207,207
Morrisa,F,100,207,0,207
Nyelle,F,100,207,0,207
Nykira,F,100,207,0,207
Promyse,F,100,207,0,207
Read,M,100,0,207,207
Ricahrd,M,100,0,207,207
Robbye,F,100,207,0,207
Rudell,M,81,39,168,207
Samuele,M,100,0,207,207
Sanayah,F,100,207,0,207
Saryn,F,100,207,0,207
Savier,M,100,0,207,207
Shakala,F,100,207,0,207
Shawntee,F,100,207,0,207
Sherrin,F,100,207,0,207
Shooter,M,100,0,207,207
Sianni,F,100,207,0,207
Snigdha,F,100,207,0,207
Stehanie,F,100,207,0,207
Talar,F,100,207,0,207
Taleisha,F,100,207,0,207
Terion,M,100,0,207,207
Tonique,F,100,207,0,207
Tyffany,F,100,207,0,207
Tyrease,M,100,0,207,207
Tyshay,F,100,207,0,207
Xylina,F,100,207,0,207
Yury,F,92,190,17,207
Zaidan,M,100,0,207,207
Zaide,M,57,90,117,207
Aiyonna,F,100,206,0,206
Alliya,F,100,206,0,206
Amberrose,F,100,206,0,206
Aniyha,F,100,206,0,206
Anniya,F,100,206,0,206
Arlys,F,100,206,0,206
Banyan,M,100,0,206,206
Chesky,M,100,0,206,206
Chyrel,F,100,206,0,206
Cougar,M,100,0,206,206
Cyrah,F,100,206,0,206
Donalee,F,100,206,0,206
Durinda,F,100,206,0,206
Dyke,M,100,0,206,206
Eiley,F,100,206,0,206
Evalena,F,100,206,0,206
Everet,M,100,0,206,206
Geriann,F,100,206,0,206
Hava,F,100,206,0,206
Jaggar,M,100,0,206,206
Jaianna,F,100,206,0,206
Jarita,F,100,206,0,206
Jawanza,M,98,5,201,206
Jazmarie,F,100,206,0,206
Jonalyn,F,100,206,0,206
Jonika,F,100,206,0,206
Kasidee,F,100,206,0,206
Kaytlen,F,100,206,0,206
Kristiann,F,100,206,0,206
Letrell,M,100,0,206,206
Lucette,F,100,206,0,206
Lucianne,F,100,206,0,206
Maizey,F,100,206,0,206
Metzli,F,100,206,0,206
Mirielle,F,100,206,0,206
Myer,M,98,5,201,206
Navjot,F,52,108,98,206
Nelva,F,100,206,0,206
Quetzaly,F,100,206,0,206
Quintasia,F,100,206,0,206
Rhyse,M,69,64,142,206
Rockell,F,100,206,0,206
Rosaleigh,F,100,206,0,206
Ryenne,F,100,206,0,206
Ryliegh,F,100,206,0,206
Sakiya,F,100,206,0,206
Sayaka,F,100,206,0,206
Shanik,F,100,206,0,206
Simya,F,100,206,0,206
Staphanie,F,100,206,0,206
Takari,M,71,59,147,206
Vencent,M,100,0,206,206
Witten,M,100,0,206,206
Zanae,F,100,206,0,206
Abhi,M,100,0,205,205
Alabama,F,100,205,0,205
Altariq,M,100,0,205,205
Arlicia,F,100,205,0,205
Arrick,M,100,0,205,205
Arshad,M,100,0,205,205
Bassel,M,100,0,205,205
Bryttani,F,100,205,0,205
Cheril,F,100,205,0,205
Chrys,F,90,184,21,205
Cyprian,M,100,0,205,205
Dairon,M,100,0,205,205
Darinda,F,100,205,0,205
Dorette,F,100,205,0,205
Dorise,F,100,205,0,205
Duwan,M,100,0,205,205
Elad,M,100,0,205,205
Fina,F,100,205,0,205
Jaeleen,F,100,205,0,205
Jajaira,F,100,205,0,205
Javius,M,100,0,205,205
Jermarion,M,100,0,205,205
Joletta,F,100,205,0,205
Jourdain,M,82,36,169,205
Jovonne,F,86,177,28,205
Kavonte,M,100,0,205,205
Kedarius,M,100,0,205,205
Keyandra,F,100,205,0,205
Korene,F,100,205,0,205
Krisa,F,100,205,0,205
Kyoko,F,100,205,0,205
Lakelynn,F,100,205,0,205
Larkyn,F,100,205,0,205
Leyana,F,100,205,0,205
Libbi,F,100,205,0,205
Luismiguel,M,100,0,205,205
Malajah,F,100,205,0,205
Margrett,F,100,205,0,205
Marlei,F,100,205,0,205
Mckinleigh,F,100,205,0,205
Meleana,F,100,205,0,205
Michaelah,F,100,205,0,205
Naiara,F,100,205,0,205
Namya,F,100,205,0,205
Natsumi,F,100,205,0,205
Naysha,F,100,205,0,205
Oseas,M,100,0,205,205
Peytyn,F,100,205,0,205
Raynelle,F,100,205,0,205
Rondarius,M,100,0,205,205
Sady,F,100,205,0,205
Seon,M,100,0,205,205
Shawon,M,80,40,165,205
Sheritta,F,100,205,0,205
Shiri,F,100,205,0,205
Skarlet,F,100,205,0,205
Taeshaun,M,100,0,205,205
Taiga,M,100,0,205,205
Tascha,F,100,205,0,205
Tianah,F,100,205,0,205
Trinita,F,100,205,0,205
Trishelle,F,100,205,0,205
Trygve,M,100,0,205,205
Zaul,M,100,0,205,205
Amrom,M,100,0,204,204
Ante,M,100,0,204,204
Ashonti,F,100,204,0,204
Atarah,F,100,204,0,204
Brylea,F,100,204,0,204
Buzz,M,100,0,204,204
Catrell,M,100,0,204,204
Chung,M,95,11,193,204
Dajanique,F,100,204,0,204
Dallyn,M,91,18,186,204
Deano,M,100,0,204,204
Dierdra,F,100,204,0,204
Diezel,M,100,0,204,204
Doloris,F,100,204,0,204
Emran,M,100,0,204,204
Frady,F,100,204,0,204
Harsha,M,91,19,185,204
Jaima,F,100,204,0,204
Jamion,M,100,0,204,204
Janicia,F,100,204,0,204
Josean,M,100,0,204,204
Kaina,F,100,204,0,204
Kanita,F,100,204,0,204
Kashayla,F,100,204,0,204
Kasin,M,100,0,204,204
Kaula,F,100,204,0,204
Klein,M,100,0,204,204
Laiyah,F,100,204,0,204
Laterria,F,100,204,0,204
Lindzy,F,100,204,0,204
Loucinda,F,100,204,0,204
Mallarie,F,100,204,0,204
Miklos,M,100,0,204,204
Neosha,F,100,204,0,204
Nyala,F,100,204,0,204
Oliwia,F,100,204,0,204
Quantae,M,100,0,204,204
Raiyan,M,100,0,204,204
Ralene,F,100,204,0,204
Ramanda,F,100,204,0,204
Rupal,F,100,204,0,204
Sarahbeth,F,100,204,0,204
Shatyra,F,100,204,0,204
Stefanny,F,100,204,0,204
Stuti,F,100,204,0,204
Tajia,F,100,204,0,204
Tamirah,F,100,204,0,204
Tyberius,M,100,0,204,204
Tynlee,F,100,204,0,204
Willson,M,100,0,204,204
Zea,F,100,204,0,204
Zeniah,F,100,204,0,204
Aasia,F,100,203,0,203
Acquanetta,F,100,203,0,203
Addeline,F,100,203,0,203
Adeeb,M,100,0,203,203
Ahman,M,100,0,203,203
Allannah,F,100,203,0,203
Anyae,F,100,203,0,203
Aylee,F,100,203,0,203
Caven,M,100,0,203,203
Ceejay,M,100,0,203,203
Crystale,F,100,203,0,203
Darol,M,100,0,203,203
Daviel,M,100,0,203,203
Donalda,F,100,203,0,203
Donovyn,M,100,0,203,203
Dyna,F,100,203,0,203
Ebrima,M,100,0,203,203
Elesa,F,100,203,0,203
Ereka,F,100,203,0,203
Jonerik,M,100,0,203,203
Kaede,F,85,173,30,203
Kassius,M,100,0,203,203
Katriana,F,100,203,0,203
Keerthi,F,100,203,0,203
Keslie,F,100,203,0,203
Kwadwo,M,100,0,203,203
Kyshaun,M,100,0,203,203
Lexey,F,100,203,0,203
Livi,F,100,203,0,203
Mahesh,M,100,0,203,203
Maleni,F,100,203,0,203
Marvyn,M,100,0,203,203
Masaki,M,100,0,203,203
Meila,F,100,203,0,203
Nadezhda,F,100,203,0,203
Natonya,F,100,203,0,203
Nethra,F,100,203,0,203
Orest,M,100,0,203,203
Paulla,F,100,203,0,203
Phelicia,F,100,203,0,203
Ringo,M,100,0,203,203
Ruchy,F,100,203,0,203
Rylon,M,100,0,203,203
Sharea,F,100,203,0,203
Shivali,F,100,203,0,203
Sierah,F,100,203,0,203
Stefanee,F,100,203,0,203
Tailer,F,95,193,10,203
Takila,F,100,203,0,203
Talita,F,100,203,0,203
Tanairi,F,100,203,0,203
Tatym,F,98,198,5,203
Tearsa,F,100,203,0,203
Wilkins,M,100,0,203,203
Yaritzel,F,100,203,0,203
Yashvi,F,100,203,0,203
Zadyn,M,100,0,203,203
Zuhair,M,100,0,203,203
Amily,F,100,202,0,202
Analea,F,100,202,0,202
Analiza,F,100,202,0,202
Andry,M,98,5,197,202
Annelisa,F,100,202,0,202
Bijou,F,100,202,0,202
Bobie,F,93,187,15,202
Breanda,F,100,202,0,202
Brennin,M,100,0,202,202
Chauntelle,F,100,202,0,202
Cherylynn,F,100,202,0,202
Cordney,M,94,12,190,202
Coretha,F,100,202,0,202
Daffney,F,100,202,0,202
Danaisha,F,100,202,0,202
Danyka,F,100,202,0,202
Dashayla,F,100,202,0,202
Deaaron,M,100,0,202,202
Deantre,M,100,0,202,202
Demontay,M,100,0,202,202
Denecia,F,100,202,0,202
Dreyson,M,100,0,202,202
Eldana,F,100,202,0,202
Eleftheria,F,100,202,0,202
Ellias,M,100,0,202,202
Ferne,F,100,202,0,202
Glenice,F,100,202,0,202
Guyla,F,100,202,0,202
Hannahmarie,F,100,202,0,202
Iyan,M,100,0,202,202
Iza,F,100,202,0,202
Jalayna,F,100,202,0,202
Jameca,F,100,202,0,202
Jasmon,F,63,128,74,202
Jillaine,F,100,202,0,202
Kailene,F,100,202,0,202
Kassem,M,100,0,202,202
Keahi,M,90,20,182,202
Kearah,F,100,202,0,202
Kennetta,F,100,202,0,202
Keymani,F,61,124,78,202
Koltan,M,100,0,202,202
Laterica,F,100,202,0,202
Llesenia,F,100,202,0,202
Maniah,F,100,202,0,202
Marae,F,100,202,0,202
Marialena,F,100,202,0,202
Marquavis,M,100,0,202,202
Marzell,M,98,5,197,202
Medea,F,100,202,0,202
Mikyah,F,100,202,0,202
Misaki,F,100,202,0,202
Nayra,F,100,202,0,202
Neco,M,81,38,164,202
Niani,F,100,202,0,202
Omni,F,95,192,10,202
Preet,M,62,77,125,202
Purcell,M,100,0,202,202
Rayshad,M,100,0,202,202
Roann,F,100,202,0,202
Saidy,F,100,202,0,202
Sammye,F,100,202,0,202
Shamaine,F,98,197,5,202
Shamra,F,100,202,0,202
Sidrah,F,100,202,0,202
Supreme,M,100,0,202,202
Taralee,F,100,202,0,202
Teshaun,M,100,0,202,202
Veronia,F,100,202,0,202
Yevonne,F,100,202,0,202
Zandrea,F,100,202,0,202
Zealand,M,93,15,187,202
Ziomara,F,100,202,0,202
Zyier,M,100,0,202,202
Zyir,M,100,0,202,202
Adamarys,F,100,201,0,201
Adhya,F,100,201,0,201
Ahnaf,M,100,0,201,201
Alic,M,100,0,201,201
Anaalicia,F,100,201,0,201
Astoria,F,100,201,0,201
Atina,F,100,201,0,201
Chisa,F,100,201,0,201
Daneka,F,100,201,0,201
Dejanay,F,100,201,0,201
Deke,M,100,0,201,201
Denorris,M,100,0,201,201
Doneshia,F,100,201,0,201
Dvante,M,100,0,201,201
Elen,F,100,201,0,201
Emiline,F,100,201,0,201
Erubiel,M,100,0,201,201
Holten,M,100,0,201,201
Jaisen,M,100,0,201,201
Jamis,M,100,0,201,201
Janelli,F,100,201,0,201
Jareli,F,100,201,0,201
Javyn,M,100,0,201,201
Jazline,F,100,201,0,201
Kalandra,F,100,201,0,201
Kalis,F,98,196,5,201
Karolynn,F,100,201,0,201
Labrea,F,100,201,0,201
Marshia,F,100,201,0,201
Michaelann,F,100,201,0,201
Mkenzie,F,100,201,0,201
Nafeesah,F,100,201,0,201
Naylani,F,100,201,0,201
Nehal,F,67,135,66,201
Nycholas,M,100,0,201,201
Quincee,F,98,196,5,201
Quintana,F,100,201,0,201
Shareena,F,100,201,0,201
Shemica,F,100,201,0,201
Taiki,M,100,0,201,201
Tanashia,F,100,201,0,201
Terrianne,F,100,201,0,201
Timothee,M,100,0,201,201
Tomia,F,100,201,0,201
Vihan,M,100,0,201,201
Williard,M,100,0,201,201
Yandiel,M,100,0,201,201
Adaiah,F,84,167,33,200
Addis,M,73,54,146,200
Afua,F,100,200,0,200
Aidel,F,100,200,0,200
Ajayla,F,100,200,0,200
Akhila,F,100,200,0,200
Alaija,F,100,200,0,200
Alok,M,100,0,200,200
Alonnah,F,100,200,0,200
Annora,F,100,200,0,200
Asjah,F,100,200,0,200
Audel,M,100,0,200,200
Bisma,F,100,200,0,200
Blinda,F,100,200,0,200
Briya,F,100,200,0,200
Caileb,M,100,0,200,200
Caliah,F,100,200,0,200
Camarie,F,90,179,21,200
Cay,F,100,200,0,200
Chrishon,M,100,0,200,200
Cohl,M,100,0,200,200
Cristabel,F,100,200,0,200
Daleen,F,100,200,0,200
Esmond,M,100,0,200,200
Garritt,M,100,0,200,200
Gavynn,M,100,0,200,200
Gessica,F,100,200,0,200
Jamason,M,100,0,200,200
Janeece,F,100,200,0,200
Jaquala,F,100,200,0,200
Jaquavis,M,100,0,200,200
Jaremy,M,100,0,200,200
Jewelz,F,76,153,47,200
Jianni,M,51,98,102,200
Kaizen,M,100,0,200,200
Kashawna,F,100,200,0,200
Kathline,F,100,200,0,200
Lamount,M,100,0,200,200
Latravia,F,100,200,0,200
Lavel,M,100,0,200,200
Leetta,F,100,200,0,200
Leonette,F,100,200,0,200
Lydon,M,100,0,200,200
Machael,M,98,5,195,200
Markiya,F,100,200,0,200
Nathanuel,M,100,0,200,200
Noach,M,100,0,200,200
Pachia,F,100,200,0,200
Rochella,F,100,200,0,200
Roza,F,100,200,0,200
Sahithi,F,100,200,0,200
Samie,F,60,120,80,200
Sequita,F,100,200,0,200
Takya,F,100,200,0,200
Telecia,F,100,200,0,200
Thoms,M,100,0,200,200
Tiffane,F,100,200,0,200
Trica,F,100,200,0,200
Wynell,F,97,194,6,200
Younes,M,100,0,200,200
Zamirah,F,100,200,0,200
Allye,F,100,199,0,199
Anslie,F,100,199,0,199
Arias,M,82,36,163,199
Arma,F,100,199,0,199
Arpan,M,97,5,194,199
Artasia,F,100,199,0,199
Ashkan,M,100,0,199,199
Aviya,F,100,199,0,199
Ayodeji,M,100,0,199,199
Betzalel,M,100,0,199,199
Brevan,M,100,0,199,199
British,F,89,178,21,199
Cailie,F,100,199,0,199
Champion,M,100,0,199,199
Cheria,F,100,199,0,199
Cing,F,100,199,0,199
Cydne,F,100,199,0,199
Danzell,M,100,0,199,199
Darlinda,F,100,199,0,199
Darragh,M,82,35,164,199
Draden,M,100,0,199,199
Eliyana,F,100,199,0,199
Eyana,F,100,199,0,199
Finesse,F,95,189,10,199
Gevork,M,100,0,199,199
Ionna,F,100,199,0,199
Jawaan,M,100,0,199,199
Kaivon,M,100,0,199,199
Kalieb,M,100,0,199,199
Kayann,F,100,199,0,199
Kayler,F,56,112,87,199
Kelen,M,87,25,174,199
Kweli,M,94,11,188,199
Kyel,M,97,5,194,199
Lorrene,F,100,199,0,199
Marshun,M,100,0,199,199
Mishka,F,100,199,0,199
Montray,M,100,0,199,199
Nassim,M,89,21,178,199
Neeka,F,100,199,0,199
Nehemie,F,100,199,0,199
Nieko,M,100,0,199,199
Nimra,F,100,199,0,199
Oaklie,F,100,199,0,199
Parag,M,100,0,199,199
Phinehas,M,100,0,199,199
Ralf,M,100,0,199,199
Ranier,M,100,0,199,199
Rogena,F,100,199,0,199
Serenidy,F,100,199,0,199
Shterna,F,100,199,0,199
Travas,M,100,0,199,199
Violett,F,100,199,0,199
Yahayra,F,100,199,0,199
Zamia,F,100,199,0,199
Alaena,F,100,198,0,198
Amberle,F,100,198,0,198
Anisia,F,100,198,0,198
Antawan,M,100,0,198,198
Asharia,F,100,198,0,198
Breawna,F,100,198,0,198
Byrant,M,100,0,198,198
Cailan,M,64,71,127,198
Caryssa,F,100,198,0,198
Cathe,F,100,198,0,198
Christana,F,100,198,0,198
Chrles,M,100,0,198,198
Cindel,F,100,198,0,198
Daoud,M,100,0,198,198
Dashana,F,100,198,0,198
Daune,F,75,148,50,198
Debralee,F,100,198,0,198
Devean,M,100,0,198,198
Donae,F,97,192,6,198
Edwards,M,100,0,198,198
Farzana,F,100,198,0,198
Genesee,F,100,198,0,198
Glenford,M,100,0,198,198
Haisley,F,100,198,0,198
Harshil,M,100,0,198,198
Herald,M,100,0,198,198
Idy,F,100,198,0,198
Izayiah,M,100,0,198,198
Jaree,F,54,106,92,198
Jaxten,M,100,0,198,198
Jeanenne,F,100,198,0,198
Jentri,F,100,198,0,198
Johntavious,M,100,0,198,198
Kaevon,M,100,0,198,198
Katherene,F,100,198,0,198
Kealii,M,100,0,198,198
Keileigh,F,100,198,0,198
Kinnley,F,100,198,0,198
Kynadee,F,100,198,0,198
Leonda,F,100,198,0,198
Letta,F,100,198,0,198
Leylanie,F,100,198,0,198
Lonette,F,100,198,0,198
Maecy,F,100,198,0,198
Marquon,M,100,0,198,198
Maxmillian,M,100,0,198,198
Melrose,F,100,198,0,198
Milliana,F,100,198,0,198
Owens,M,100,0,198,198
Reynalda,F,100,198,0,198
Sande,F,92,182,16,198
Shajuan,F,72,142,56,198
Sheanna,F,100,198,0,198
Sorcha,F,100,198,0,198
Taesha,F,100,198,0,198
Yariana,F,100,198,0,198
Adana,F,100,197,0,197
Aijalon,M,52,95,102,197
Aldrick,M,100,0,197,197
Amarra,F,100,197,0,197
Anuar,M,100,0,197,197
Arielis,F,100,197,0,197
Arkeem,M,100,0,197,197
Autymn,F,100,197,0,197
Beauford,M,100,0,197,197
Bryndon,M,100,0,197,197
Caeleigh,F,100,197,0,197
Celenia,F,100,197,0,197
Chaniqua,F,100,197,0,197
Charae,F,100,197,0,197
Corrado,M,100,0,197,197
Cortny,F,100,197,0,197
Cyana,F,100,197,0,197
Deanndra,F,100,197,0,197
Devarius,M,100,0,197,197
Ekaterini,F,100,197,0,197
Elizibeth,F,100,197,0,197
Eward,M,100,0,197,197
Filbert,M,100,0,197,197
Harlowe,F,100,197,0,197
Imer,M,100,0,197,197
Itsel,F,100,197,0,197
Jahkeem,M,100,0,197,197
Jaloni,M,70,60,137,197
Jasie,F,100,197,0,197
Javoni,M,95,10,187,197
Jazzalyn,F,100,197,0,197
Jervis,M,100,0,197,197
Karita,F,100,197,0,197
Krist,M,81,37,160,197
Lejuan,M,100,0,197,197
Letesha,F,100,197,0,197
Melissaann,F,100,197,0,197
Najai,F,80,157,40,197
Nyja,F,100,197,0,197
Osei,M,100,0,197,197
Raedyn,F,66,130,67,197
Raphaella,F,100,197,0,197
Saarah,F,100,197,0,197
Sabrinia,F,100,197,0,197
Shakeisha,F,100,197,0,197
Shakura,F,100,197,0,197
Shantella,F,100,197,0,197
Shaqueena,F,100,197,0,197
Shifa,F,100,197,0,197
Shweta,F,100,197,0,197
Stanislaw,M,100,0,197,197
Syanna,F,100,197,0,197
Tamina,F,100,197,0,197
Tay,M,75,50,147,197
Tayvian,M,100,0,197,197
Tomislav,M,100,0,197,197
Treysen,M,100,0,197,197
Zarin,M,53,92,105,197
Zaydan,M,100,0,197,197
Zemira,F,100,197,0,197
Aadam,M,100,0,196,196
Acxel,M,100,0,196,196
Adamariz,F,100,196,0,196
Aleenah,F,100,196,0,196
Ameila,F,100,196,0,196
Antoria,F,100,196,0,196
Bain,M,100,0,196,196
Bayler,M,78,43,153,196
Burgandy,F,100,196,0,196
Camala,F,100,196,0,196
Chancie,F,97,191,5,196
Christyana,F,100,196,0,196
Cimone,F,100,196,0,196
Comfort,F,100,196,0,196
Conroy,M,100,0,196,196
Debraann,F,100,196,0,196
Delos,M,100,0,196,196
Dishawn,M,100,0,196,196
Elchonon,M,100,0,196,196
Emilyrose,F,100,196,0,196
Fairy,F,100,196,0,196
Gwendalynn,F,100,196,0,196
Hayato,M,100,0,196,196
Ismaeel,M,100,0,196,196
Jaiceon,M,100,0,196,196
Jakaila,F,100,196,0,196
Jnae,F,100,196,0,196
Joeli,F,100,196,0,196
Joelynn,F,100,196,0,196
Jusiah,M,100,0,196,196
Kellyjo,F,100,196,0,196
Kempton,M,100,0,196,196
Kharon,M,100,0,196,196
Lahela,F,100,196,0,196
Lanitra,F,100,196,0,196
Laterrance,M,100,0,196,196
Macallister,M,100,0,196,196
Markcus,M,100,0,196,196
Meklit,F,100,196,0,196
Merrik,M,97,5,191,196
Miyonna,F,100,196,0,196
Moreen,F,100,196,0,196
Morissa,F,100,196,0,196
Natoria,F,100,196,0,196
Noma,F,100,196,0,196
Nyiah,F,100,196,0,196
Phillippe,M,100,0,196,196
Remie,F,100,196,0,196
Roddie,M,100,0,196,196
Roe,M,73,53,143,196
Roschelle,F,100,196,0,196
Sharonne,F,100,196,0,196
Sheyna,F,100,196,0,196
Simar,F,77,150,46,196
Takeshi,M,97,5,191,196
Tamula,F,100,196,0,196
Tigerlily,F,100,196,0,196
Tyheim,M,100,0,196,196
Tyleigh,F,100,196,0,196
Xin,F,84,165,31,196
Yatzil,F,100,196,0,196
Yossi,M,100,0,196,196
Aasim,M,100,0,195,195
Aayushi,F,100,195,0,195
Aiken,M,100,0,195,195
Ailie,F,100,195,0,195
Alexza,F,100,195,0,195
Amariona,F,100,195,0,195
Ande,F,82,159,36,195
Aniello,M,100,0,195,195
Annell,F,100,195,0,195
Areatha,F,100,195,0,195
Arieona,F,100,195,0,195
Armanie,F,69,134,61,195
Audley,M,100,0,195,195
Carnisha,F,100,195,0,195
Celie,F,100,195,0,195
Charnele,F,100,195,0,195
Chassie,F,100,195,0,195
Chen,M,73,52,143,195
Cherilynn,F,100,195,0,195
Daichi,M,100,0,195,195
Damonie,M,68,62,133,195
Denetta,F,100,195,0,195
Erskin,M,100,0,195,195
Fanchon,F,100,195,0,195
Fransheska,F,100,195,0,195
Gerasimos,M,100,0,195,195
Glee,F,100,195,0,195
Grayland,M,100,0,195,195
Green,M,100,0,195,195
Haelee,F,100,195,0,195
Haitham,M,100,0,195,195
Ion,M,100,0,195,195
Jazon,M,100,0,195,195
Johnni,F,94,184,11,195
Kailynne,F,100,195,0,195
Kendan,M,100,0,195,195
Keundra,F,100,195,0,195
Keyron,M,100,0,195,195
Lalia,F,100,195,0,195
Ling,F,91,177,18,195
Mahathi,F,100,195,0,195
Makale,M,100,0,195,195
Malaiya,F,100,195,0,195
Maleke,M,100,0,195,195
Manika,F,100,195,0,195
Marce,F,87,169,26,195
Mariaha,F,100,195,0,195
Marlita,F,100,195,0,195
Marquay,M,100,0,195,195
Marquisa,F,100,195,0,195
Mesiah,M,97,5,190,195
Montague,M,100,0,195,195
Morgane,F,100,195,0,195
Nazeer,M,100,0,195,195
Raquell,F,100,195,0,195
Rozalynn,F,100,195,0,195
Salinda,F,100,195,0,195
Shataya,F,100,195,0,195
Shauntelle,F,100,195,0,195
Sherronda,F,100,195,0,195
Sibel,F,100,195,0,195
Simrah,F,100,195,0,195
Sofija,F,100,195,0,195
Takeo,M,100,0,195,195
Terea,F,100,195,0,195
Travius,M,100,0,195,195
Yanuel,M,100,0,195,195
Aireana,F,100,194,0,194
Altonio,M,100,0,194,194
Atthew,M,100,0,194,194
Ayham,M,100,0,194,194
Blessed,F,71,138,56,194
Buffi,F,100,194,0,194
Cammeron,M,100,0,194,194
Cato,M,100,0,194,194
Chadric,M,100,0,194,194
Charlsey,F,100,194,0,194
Charnice,F,100,194,0,194
Costas,M,100,0,194,194
Damieon,M,100,0,194,194
Denica,F,100,194,0,194
Devesh,M,100,0,194,194
Eesa,M,100,0,194,194
Ein,M,100,0,194,194
Emogene,F,100,194,0,194
Eniola,F,87,169,25,194
Hristopher,M,100,0,194,194
Janellie,F,100,194,0,194
Jaysin,M,100,0,194,194
Jennamarie,F,100,194,0,194
Jerelle,M,94,12,182,194
Joncarlos,M,100,0,194,194
Joram,M,100,0,194,194
Kaileah,F,100,194,0,194
Katura,F,100,194,0,194
Kayleeann,F,100,194,0,194
Khalik,M,100,0,194,194
Kiarrah,F,100,194,0,194
Kreed,M,100,0,194,194
Lando,M,100,0,194,194
Lydiah,F,100,194,0,194
Maly,F,100,194,0,194
Mariame,F,100,194,0,194
Marquet,M,100,0,194,194
Maxxwell,M,100,0,194,194
Mckenize,F,100,194,0,194
Mehar,F,95,184,10,194
Nathanal,M,100,0,194,194
Neilson,M,100,0,194,194
Nelli,F,100,194,0,194
Nickoles,M,100,0,194,194
Pantelis,M,100,0,194,194
Pearlean,F,100,194,0,194
Pegeen,F,100,194,0,194
Quinlin,M,97,5,189,194
Rafal,M,100,0,194,194
Ramadan,M,100,0,194,194
Reiss,M,78,42,152,194
Renessa,F,100,194,0,194
Ronrico,M,100,0,194,194
Rook,M,100,0,194,194
Royer,M,100,0,194,194
Saveon,M,100,0,194,194
Slayde,M,100,0,194,194
Sonyia,F,100,194,0,194
Stephanny,F,100,194,0,194
Suhey,F,100,194,0,194
Syon,M,100,0,194,194
Taneeka,F,100,194,0,194
Tessy,F,100,194,0,194
Trevante,M,100,0,194,194
Tristine,F,97,189,5,194
Tyshawna,F,100,194,0,194
Vaishali,F,100,194,0,194
Varick,M,100,0,194,194
Verlie,F,94,183,11,194
Yasamin,F,100,194,0,194
Yasiel,M,100,0,194,194
Yeilin,F,100,194,0,194
Zackari,M,100,0,194,194
Aaryanna,F,100,193,0,193
Abdou,M,100,0,193,193
Adianna,F,100,193,0,193
Adib,M,100,0,193,193
Ahaan,M,100,0,193,193
Airyana,F,100,193,0,193
Annalena,F,100,193,0,193
Ayame,F,100,193,0,193
Bluma,F,100,193,0,193
Brayn,M,100,0,193,193
Chameka,F,100,193,0,193
Daltin,M,100,0,193,193
Dartanian,M,100,0,193,193
Demiah,F,100,193,0,193
Desere,F,100,193,0,193
Duayne,M,100,0,193,193
Elize,F,97,188,5,193
Essynce,F,100,193,0,193
Evonda,F,100,193,0,193
Ewing,M,100,0,193,193
Febe,F,100,193,0,193
Galileo,M,100,0,193,193
Jady,F,97,188,5,193
Jasalyn,F,100,193,0,193
Jasan,M,100,0,193,193
Kalyani,F,100,193,0,193
Kamaile,F,100,193,0,193
Keagon,M,100,0,193,193
Keilon,M,100,0,193,193
Keshana,F,100,193,0,193
Keylie,F,100,193,0,193
Kyrstyn,F,100,193,0,193
Lakeithia,F,100,193,0,193
Lekendrick,M,100,0,193,193
Letica,F,100,193,0,193
Loriel,F,100,193,0,193
Madisan,F,100,193,0,193
Marshayla,F,100,193,0,193
Meghin,F,100,193,0,193
Meztli,F,100,193,0,193
Mitsy,F,100,193,0,193
Muhamad,M,100,0,193,193
Nakeesha,F,100,193,0,193
Narayan,M,100,0,193,193
Navon,M,100,0,193,193
North,M,100,0,193,193
Paticia,F,100,193,0,193
Payam,M,100,0,193,193
Savannha,F,100,193,0,193
Shamell,M,66,65,128,193
Sherah,F,100,193,0,193
Sherisse,F,100,193,0,193
Tamura,F,100,193,0,193
Tulio,M,100,0,193,193
Tvisha,F,100,193,0,193
Yahye,M,100,0,193,193
Ytzel,F,100,193,0,193
Adis,M,100,0,192,192
Amberlin,F,100,192,0,192
Amiaya,F,100,192,0,192
Aneliz,F,100,192,0,192
Anguel,M,100,0,192,192
Attilio,M,100,0,192,192
Avalina,F,100,192,0,192
Aveah,F,100,192,0,192
Bailyn,F,92,177,15,192
Bernardette,F,100,192,0,192
Braelee,F,100,192,0,192
Brigido,M,100,0,192,192
Bryony,F,100,192,0,192
Carmesha,F,100,192,0,192
Chandria,F,100,192,0,192
Charnette,F,100,192,0,192
Chayna,F,100,192,0,192
Chelise,F,100,192,0,192
Cinde,F,100,192,0,192
Dejean,M,100,0,192,192
Desteni,F,100,192,0,192
Haiven,F,85,164,28,192
Haruki,M,100,0,192,192
Ifrah,F,100,192,0,192
Ilean,F,100,192,0,192
Island,F,97,186,6,192
Jahni,F,56,107,85,192
Jenissa,F,100,192,0,192
Jjesus,M,100,0,192,192
Johnjoseph,M,100,0,192,192
Jonasia,F,100,192,0,192
Joran,M,100,0,192,192
Kaled,M,100,0,192,192
Kyllie,F,100,192,0,192
Lemon,M,95,10,182,192
Lenea,F,100,192,0,192
Lowen,M,100,0,192,192
Marx,M,100,0,192,192
Mckale,M,97,6,186,192
Mckinzee,F,100,192,0,192
Nafeesa,F,100,192,0,192
Nayleen,F,100,192,0,192
Nevaya,F,100,192,0,192
Nimrod,M,100,0,192,192
Rishon,M,100,0,192,192
Rosely,F,100,192,0,192
Sala,F,100,192,0,192
Sayvon,M,100,0,192,192
Sharnette,F,100,192,0,192
Shervin,M,100,0,192,192
Shirlie,F,100,192,0,192
Shravya,F,100,192,0,192
Sinda,F,100,192,0,192
Sindia,F,100,192,0,192
Soyla,F,100,192,0,192
Sultana,F,100,192,0,192
Sway,F,82,158,34,192
Taaliyah,F,100,192,0,192
Tieshia,F,100,192,0,192
Tyshia,F,100,192,0,192
Yetunde,F,100,192,0,192
Zanyia,F,100,192,0,192
Aiven,M,100,0,191,191
Austan,M,100,0,191,191
Billiejean,F,100,191,0,191
Briyonna,F,100,191,0,191
Caliph,M,100,0,191,191
Carmichael,M,100,0,191,191
Ceil,F,100,191,0,191
Dabria,F,100,191,0,191
Damyah,F,100,191,0,191
Deah,F,100,191,0,191
Delaila,F,100,191,0,191
Enes,M,100,0,191,191
Fredrico,M,100,0,191,191
Gilles,M,100,0,191,191
Henson,M,100,0,191,191
Hoover,M,100,0,191,191
Jaceyon,M,100,0,191,191
Jamyria,F,100,191,0,191
Jaquin,M,97,5,186,191
Jaslyne,F,100,191,0,191
Jerran,M,100,0,191,191
Jocee,F,100,191,0,191
Kalik,M,100,0,191,191
Katrisha,F,100,191,0,191
Katti,F,100,191,0,191
Kaylla,F,100,191,0,191
Keveon,M,100,0,191,191
Kirbi,F,100,191,0,191
Lisia,F,100,191,0,191
Magenta,F,100,191,0,191
Marga,F,100,191,0,191
Markise,M,100,0,191,191
Mayur,M,100,0,191,191
Mikya,F,100,191,0,191
Mileigh,F,100,191,0,191
Nancyann,F,100,191,0,191
Nidal,M,100,0,191,191
Nikie,F,100,191,0,191
Olanda,M,58,80,111,191
Perrie,F,85,163,28,191
Quenisha,F,100,191,0,191
Rachyl,F,100,191,0,191
Raegyn,F,100,191,0,191
Raeya,F,100,191,0,191
Raiford,M,100,0,191,191
Redonna,F,100,191,0,191
Safari,F,97,186,5,191
Saleema,F,100,191,0,191
Samyiah,F,100,191,0,191
Sharis,F,100,191,0,191
Subrena,F,100,191,0,191
Tannon,M,100,0,191,191
Trenisha,F,100,191,0,191
Tymeka,F,100,191,0,191
Ulani,F,100,191,0,191
Vanshika,F,100,191,0,191
Vasti,F,100,191,0,191
Yuuki,M,92,16,175,191
Zakhia,F,100,191,0,191
Aamna,F,100,190,0,190
Aerielle,F,100,190,0,190
Alyric,F,96,183,7,190
Amylia,F,100,190,0,190
Andras,M,100,0,190,190
Antion,M,100,0,190,190
Anup,M,100,0,190,190
Ardyn,F,100,190,0,190
Armonte,M,100,0,190,190
Aurthur,M,100,0,190,190
Aysiah,F,100,190,0,190
Brack,M,100,0,190,190
Carlesha,F,100,190,0,190
Charma,F,100,190,0,190
Cline,M,100,0,190,190
Craven,M,100,0,190,190
Cynethia,F,100,190,0,190
Danile,M,97,5,185,190
Der,F,100,190,0,190
Deray,M,100,0,190,190
Djibril,M,100,0,190,190
Dynasia,F,100,190,0,190
Eleah,F,100,190,0,190
Eleonor,F,100,190,0,190
Evynn,F,97,185,5,190
Hermela,F,100,190,0,190
Izreal,M,100,0,190,190
Jakeira,F,100,190,0,190
Jamayah,F,100,190,0,190
Jauan,M,100,0,190,190
Jermond,M,100,0,190,190
Jla,F,100,190,0,190
Joice,F,100,190,0,190
Lebaron,M,100,0,190,190
Mahum,F,100,190,0,190
Maisyn,F,89,170,20,190
Medora,F,100,190,0,190
Miyuki,F,100,190,0,190
Naithan,M,100,0,190,190
Ndea,F,100,190,0,190
Omarie,M,94,12,178,190
Oriah,F,97,185,5,190
Rainna,F,100,190,0,190
Rashauna,F,100,190,0,190
Raynah,F,100,190,0,190
Rogene,F,100,190,0,190
Saket,M,100,0,190,190
Shannelle,F,100,190,0,190
Shawntavia,F,100,190,0,190
Sonita,F,100,190,0,190
Tamon,M,100,0,190,190
Tayron,M,100,0,190,190
Tianne,F,100,190,0,190
Yajahira,F,100,190,0,190
Zamariah,F,100,190,0,190
Andreu,M,100,0,189,189
Annmargaret,F,100,189,0,189
Ashe,M,72,52,137,189
Atianna,F,100,189,0,189
Aubriel,F,100,189,0,189
Benancio,M,100,0,189,189
Brandii,F,100,189,0,189
Cashius,M,100,0,189,189
Chonda,F,100,189,0,189
Christophere,M,100,0,189,189
Coady,M,100,0,189,189
Daeveon,M,100,0,189,189
Dalphine,F,100,189,0,189
Deryn,F,87,164,25,189
Dhalia,F,100,189,0,189
Dietrick,M,100,0,189,189
Donasia,F,100,189,0,189
Dravyn,M,100,0,189,189
Elbony,F,100,189,0,189
Ellamarie,F,100,189,0,189
Ellinor,F,100,189,0,189
Essica,F,100,189,0,189
Ginni,F,100,189,0,189
Hardin,M,100,0,189,189
Hodan,F,100,189,0,189
Ishmel,M,100,0,189,189
Izeyah,M,100,0,189,189
Jahaad,M,100,0,189,189
Jakaya,F,100,189,0,189
Jermia,F,100,189,0,189
Jilberto,M,100,0,189,189
Jurni,F,100,189,0,189
Kamaron,M,95,10,179,189
Kameko,F,97,184,5,189
Katoya,F,100,189,0,189
Kerith,F,100,189,0,189
Kieanna,F,100,189,0,189
Klaryssa,F,100,189,0,189
Lachell,F,100,189,0,189
Lacreshia,F,100,189,0,189
Lajune,F,100,189,0,189
Laraya,F,100,189,0,189
Layce,F,100,189,0,189
Maille,F,100,189,0,189
Maleak,M,100,0,189,189
Maleki,M,100,0,189,189
Marcelline,F,100,189,0,189
Miachel,M,100,0,189,189
Miami,F,100,189,0,189
Nalin,M,89,21,168,189
Noal,M,100,0,189,189
Nylia,F,100,189,0,189
Quinette,F,100,189,0,189
Refugia,F,100,189,0,189
Seraphim,F,77,146,43,189
Shakeyla,F,100,189,0,189
Shaletha,F,100,189,0,189
Shanikqua,F,100,189,0,189
Sindhu,F,100,189,0,189
Strider,M,100,0,189,189
Takeyah,F,100,189,0,189
Tolulope,F,80,151,38,189
Tranisha,F,100,189,0,189
Venicia,F,100,189,0,189
Adarian,M,100,0,188,188
Akul,M,100,0,188,188
Alakai,M,100,0,188,188
Aleksia,F,100,188,0,188
Alexxander,M,100,0,188,188
Allaina,F,100,188,0,188
Arria,F,100,188,0,188
Aujanae,F,100,188,0,188
Bethanee,F,100,188,0,188
Brahm,M,100,0,188,188
Bruin,M,100,0,188,188
Clif,M,100,0,188,188
Corday,M,100,0,188,188
Danaysha,F,100,188,0,188
Deara,F,100,188,0,188
Dontell,M,100,0,188,188
Edrian,M,100,0,188,188
Elwanda,F,100,188,0,188
Erian,F,56,106,82,188
Hasina,F,100,188,0,188
Hatim,M,100,0,188,188
Hesston,M,100,0,188,188
Jariya,F,100,188,0,188
Jirah,F,88,166,22,188
Jonahtan,M,100,0,188,188
Kaitlinn,F,100,188,0,188
Kamillah,F,100,188,0,188
Kasiah,F,100,188,0,188
Kieryn,F,94,177,11,188
Lajean,F,100,188,0,188
Laketta,F,100,188,0,188
Matin,M,100,0,188,188
Maurion,M,100,0,188,188
Moriyah,F,100,188,0,188
Moss,M,100,0,188,188
Myrta,F,100,188,0,188
Naren,M,100,0,188,188
Nichlos,M,100,0,188,188
Oakland,M,93,14,174,188
Pahola,F,100,188,0,188
Preethi,F,100,188,0,188
Rayshell,F,100,188,0,188
Sabrin,F,100,188,0,188
Sayvion,M,100,0,188,188
Serenna,F,100,188,0,188
Sevon,M,97,6,182,188
Shoshanah,F,100,188,0,188
Talulah,F,100,188,0,188
Tashona,F,100,188,0,188
Trude,F,100,188,0,188
Tyeson,M,100,0,188,188
Tyller,M,76,46,142,188
Yassir,M,100,0,188,188
Zakhi,M,100,0,188,188
Abed,M,100,0,187,187
Adeana,F,100,187,0,187
Anahis,F,100,187,0,187
Avner,M,100,0,187,187
Bexley,F,86,161,26,187
Bhargav,M,100,0,187,187
Bri,F,100,187,0,187
Briceyda,F,100,187,0,187
Catalino,M,100,0,187,187
Cauy,M,100,0,187,187
Cayde,M,100,0,187,187
Chanya,F,100,187,0,187
Charonda,F,100,187,0,187
Clemens,M,100,0,187,187
Cleven,M,100,0,187,187
Daleah,F,100,187,0,187
Davier,M,100,0,187,187
Daymion,M,100,0,187,187
Demarian,M,100,0,187,187
Doralee,F,100,187,0,187
Hazem,M,100,0,187,187
Indi,F,97,181,6,187
Isiaih,M,100,0,187,187
Jency,F,95,177,10,187
Johnwilliam,M,100,0,187,187
Kamare,M,97,5,182,187
Keeshawn,M,100,0,187,187
Keniah,F,100,187,0,187
Kerah,F,100,187,0,187
Kerryn,F,100,187,0,187
Kinzee,F,100,187,0,187
Kyrian,M,97,5,182,187
Lariza,F,100,187,0,187
Lugenia,F,100,187,0,187
Macaulay,M,92,15,172,187
Makenze,F,100,187,0,187
Makira,F,100,187,0,187
Manasi,F,100,187,0,187
Manvir,M,88,23,164,187
Merly,F,100,187,0,187
Michaeleen,F,100,187,0,187
Mickell,M,73,51,136,187
Nesreen,F,100,187,0,187
Nikiyah,F,100,187,0,187
Papa,M,100,0,187,187
Quadre,M,100,0,187,187
Railee,F,100,187,0,187
Rayelle,F,100,187,0,187
Raynold,M,100,0,187,187
Rogina,F,100,187,0,187
Romone,M,100,0,187,187
Sanii,F,100,187,0,187
Shacoya,F,100,187,0,187
Sharief,M,100,0,187,187
Shiya,F,86,160,27,187
Shuaib,M,100,0,187,187
Sophina,F,100,187,0,187
Stephenson,M,100,0,187,187
Synai,F,100,187,0,187
Tanishka,F,100,187,0,187
Vona,F,100,187,0,187
Acey,M,95,10,176,186
Agueda,F,100,186,0,186
Amias,M,100,0,186,186
Aneya,F,100,186,0,186
Angelyne,F,100,186,0,186
Arhaan,M,100,0,186,186
Atiyah,F,100,186,0,186
Briell,F,100,186,0,186
Broxton,M,100,0,186,186
Caitriona,F,100,186,0,186
Canden,M,100,0,186,186
Carlise,F,100,186,0,186
Conswella,F,100,186,0,186
Crisanto,M,100,0,186,186
Dailey,F,88,163,23,186
Daimian,M,100,0,186,186
Daleysa,F,100,186,0,186
Daniqua,F,100,186,0,186
Danyela,F,100,186,0,186
Dariyon,M,95,10,176,186
Deamber,F,100,186,0,186
Demarrio,M,100,0,186,186
Demauri,M,100,0,186,186
Dera,F,100,186,0,186
Donatella,F,100,186,0,186
Dyquan,M,100,0,186,186
Ej,M,100,0,186,186
Elice,F,100,186,0,186
Esthefany,F,100,186,0,186
Gaetana,F,100,186,0,186
Himani,F,100,186,0,186
Jaleena,F,100,186,0,186
Jashan,M,97,5,181,186
Jaymison,M,100,0,186,186
Joeleen,F,100,186,0,186
Jontrell,M,100,0,186,186
Jonus,M,100,0,186,186
Juquan,M,100,0,186,186
Kairon,M,100,0,186,186
Kamyiah,F,100,186,0,186
Kashon,M,100,0,186,186
Keiasia,F,100,186,0,186
Khylan,M,97,5,181,186
Lancer,M,100,0,186,186
Lavanya,F,100,186,0,186
Malikhi,M,100,0,186,186
Mikeisha,F,100,186,0,186
Mirakle,F,100,186,0,186
Quashaun,M,100,0,186,186
Ryheem,M,100,0,186,186
Sharnita,F,100,186,0,186
Shawndale,M,85,28,158,186
Shemeika,F,100,186,0,186
Sirr,M,100,0,186,186
Skylen,F,59,110,76,186
Tranae,F,100,186,0,186
Tuyen,F,86,160,26,186
Yanci,F,100,186,0,186
Zakirah,F,100,186,0,186
Agam,M,59,76,109,185
Allizon,F,100,185,0,185
Amylee,F,100,185,0,185
Angelik,F,100,185,0,185
Arhianna,F,100,185,0,185
Audreyana,F,100,185,0,185
Avontae,M,100,0,185,185
Braelen,M,100,0,185,185
Braison,M,100,0,185,185
Careen,F,100,185,0,185
Clary,F,64,119,66,185
Damilola,F,77,142,43,185
Dayden,M,100,0,185,185
Declyn,M,64,66,119,185
Dilcia,F,100,185,0,185
Donni,F,97,179,6,185
Ehan,M,100,0,185,185
Fabion,M,100,0,185,185
Faige,F,100,185,0,185
Falen,F,100,185,0,185
Geeta,F,100,185,0,185
Genifer,F,100,185,0,185
Gradyn,M,100,0,185,185
Jacksyn,M,82,33,152,185
Jaquanna,F,100,185,0,185
Jashayla,F,100,185,0,185
Jatara,F,100,185,0,185
Jayni,F,84,155,30,185
Jeramyah,M,100,0,185,185
Karmon,F,100,185,0,185
Karolyne,F,100,185,0,185
Kema,F,100,185,0,185
Kenneith,M,100,0,185,185
Kentavius,M,100,0,185,185
Kino,M,100,0,185,185
Kymberlie,F,100,185,0,185
Lalani,F,100,185,0,185
Lavaris,M,100,0,185,185
Leman,M,100,0,185,185
Lonnette,F,100,185,0,185
Maleea,F,100,185,0,185
Marciana,F,100,185,0,185
Massimiliano,M,100,0,185,185
Maysie,F,100,185,0,185
Minami,F,100,185,0,185
Monda,F,100,185,0,185
Nathalya,F,100,185,0,185
Onix,M,100,0,185,185
Pennye,F,100,185,0,185
Quaneshia,F,100,185,0,185
Quavion,M,100,0,185,185
Rakeisha,F,100,185,0,185
Sakshi,F,100,185,0,185
Seve,M,100,0,185,185
Shavaughn,F,94,174,11,185
Sumayya,F,100,185,0,185
Symir,M,100,0,185,185
Taiwo,M,69,57,128,185
Taiyo,M,100,0,185,185
Tameya,F,100,185,0,185
Treniece,F,100,185,0,185
Virgel,M,100,0,185,185
Zarai,F,100,185,0,185
Abbye,F,100,184,0,184
Abiola,F,76,140,44,184
Admir,M,100,0,184,184
Aloha,F,100,184,0,184
Anaisha,F,100,184,0,184
Areona,F,100,184,0,184
Basheer,M,100,0,184,184
Briggette,F,100,184,0,184
Charnetta,F,100,184,0,184
Dahlila,F,100,184,0,184
Darneisha,F,100,184,0,184
Daved,M,100,0,184,184
Day,F,69,127,57,184
Demontez,M,100,0,184,184
Duyen,F,100,184,0,184
Emmalene,F,100,184,0,184
Estiven,M,100,0,184,184
Fatimata,F,100,184,0,184
Gabreal,M,78,41,143,184
Gaspare,M,100,0,184,184
Hildy,F,100,184,0,184
Inetta,F,100,184,0,184
Jakaria,F,100,184,0,184
Jerlyn,F,100,184,0,184
Joniyah,F,100,184,0,184
Joshalyn,F,100,184,0,184
Kailon,M,96,7,177,184
Katleen,F,100,184,0,184
Kaylianna,F,100,184,0,184
Kel,M,100,0,184,184
Kelden,M,100,0,184,184
Kendelle,F,97,179,5,184
Kenyatte,M,67,61,123,184
Kiaan,M,100,0,184,184
Kimberlly,F,100,184,0,184
Kmya,F,100,184,0,184
Kolden,M,100,0,184,184
Kynadi,F,100,184,0,184
Kynedi,F,100,184,0,184
Lameisha,F,100,184,0,184
Leniyah,F,100,184,0,184
Maahi,F,100,184,0,184
Mackinsey,F,100,184,0,184
Marilla,F,100,184,0,184
Mariposa,F,100,184,0,184
Maron,M,82,33,151,184
Nanami,F,100,184,0,184
Niccolas,M,100,0,184,184
Nijae,F,92,169,15,184
Nyela,F,100,184,0,184
Nyima,F,100,184,0,184
Nysa,F,100,184,0,184
Quanasia,F,100,184,0,184
Quentavious,M,100,0,184,184
Raeford,M,100,0,184,184
Roniyah,F,100,184,0,184
Ruchama,F,100,184,0,184
Seryna,F,100,184,0,184
Shiori,F,100,184,0,184
Tasheba,F,100,184,0,184
Tondalaya,F,100,184,0,184
Toshua,F,70,129,55,184
Tylea,F,100,184,0,184
Zafir,M,100,0,184,184
Zoelle,F,100,184,0,184
Ahnna,F,100,183,0,183
Airabella,F,100,183,0,183
Akeia,F,100,183,0,183
Alishea,F,100,183,0,183
Allyssia,F,100,183,0,183
Alvena,F,100,183,0,183
Anaysia,F,100,183,0,183
Ata,M,100,0,183,183
Bharat,M,100,0,183,183
Billijo,F,100,183,0,183
Bonne,F,100,183,0,183
Caidon,M,100,0,183,183
Carrera,F,100,183,0,183
Cavon,M,100,0,183,183
Celica,F,100,183,0,183
Chelcy,F,100,183,0,183
Cherae,F,100,183,0,183
Chidi,M,100,0,183,183
Damier,M,100,0,183,183
Damonica,F,100,183,0,183
Danijah,F,100,183,0,183
Deneka,F,100,183,0,183
Denisia,F,100,183,0,183
Dom,M,100,0,183,183
Elgie,M,100,0,183,183
Gracelin,F,100,183,0,183
Gracelynne,F,100,183,0,183
Hansika,F,100,183,0,183
Icis,F,100,183,0,183
Jamol,M,100,0,183,183
Jaquil,M,100,0,183,183
Jasemine,F,100,183,0,183
Jeaninne,F,100,183,0,183
Jhoselyn,F,100,183,0,183
Karver,M,100,0,183,183
Kashay,F,100,183,0,183
Kasheena,F,100,183,0,183
Keilin,F,72,132,51,183
Lailoni,F,100,183,0,183
Lakeeta,F,100,183,0,183
Latayna,F,100,183,0,183
Latriece,F,100,183,0,183
Levita,F,100,183,0,183
Madason,F,100,183,0,183
Maddyx,M,51,90,93,183
Makaylyn,F,100,183,0,183
Manaal,F,100,183,0,183
Mariyam,F,100,183,0,183
Masiyah,F,75,137,46,183
Merril,M,70,55,128,183
Molina,F,100,183,0,183
Montasia,F,100,183,0,183
Nari,F,100,183,0,183
Nashia,F,100,183,0,183
Nevah,F,100,183,0,183
Neya,F,100,183,0,183
Niaja,F,100,183,0,183
Nneoma,F,100,183,0,183
Nyzir,M,100,0,183,183
Orlan,M,100,0,183,183
Raeley,F,100,183,0,183
Rashanna,F,100,183,0,183
Rumi,M,53,86,97,183
Sabeen,F,100,183,0,183
Sarthak,M,100,0,183,183
Tabathia,F,100,183,0,183
Tiras,M,100,0,183,183
Ulyssa,F,100,183,0,183
Valora,F,100,183,0,183
Virna,F,100,183,0,183
Wisam,M,100,0,183,183
Yarissa,F,100,183,0,183
Ahava,F,100,182,0,182
Ahmod,M,100,0,182,182
Akyla,F,100,182,0,182
Antavia,F,100,182,0,182
Arleny,F,100,182,0,182
Avett,M,96,7,175,182
Aylani,F,100,182,0,182
Beecher,M,100,0,182,182
Breion,M,75,45,137,182
Brentton,M,100,0,182,182
Bridney,F,100,182,0,182
Camy,F,100,182,0,182
Carloyn,F,100,182,0,182
Caty,F,100,182,0,182
Colan,M,100,0,182,182
Dacari,M,100,0,182,182
Dekendrick,M,100,0,182,182
Elkin,M,100,0,182,182
Gelila,F,100,182,0,182
Gyselle,F,100,182,0,182
Hamp,M,100,0,182,182
Jaeli,F,100,182,0,182
Jakeob,M,100,0,182,182
Jasiya,F,96,174,8,182
Jazara,F,100,182,0,182
Jeryn,M,66,61,121,182
Johnnae,F,100,182,0,182
Judyann,F,100,182,0,182
Juliya,F,100,182,0,182
Kahlea,F,100,182,0,182
Kalief,M,100,0,182,182
Kashara,F,100,182,0,182
Khaya,F,100,182,0,182
Kyarah,F,100,182,0,182
Lakea,F,100,182,0,182
Lamarius,M,100,0,182,182
Larah,F,100,182,0,182
Laveah,F,100,182,0,182
Leiya,F,100,182,0,182
Leodan,M,100,0,182,182
Lesle,F,100,182,0,182
Letonya,F,100,182,0,182
Liviana,F,100,182,0,182
Lyniah,F,100,182,0,182
Madaleine,F,100,182,0,182
Martavion,M,100,0,182,182
Mavrik,M,100,0,182,182
Merryl,F,100,182,0,182
Mishawn,F,64,117,65,182
Nain,M,100,0,182,182
Nashly,F,100,182,0,182
Nishanth,M,100,0,182,182
Nyaira,F,100,182,0,182
Nysir,M,100,0,182,182
Obrien,M,100,0,182,182
Oliverio,M,100,0,182,182
Paitynn,F,100,182,0,182
Paulmichael,M,100,0,182,182
Ramia,F,100,182,0,182
Reigan,F,100,182,0,182
Rodgers,M,100,0,182,182
Stepfanie,F,100,182,0,182
Sundi,F,100,182,0,182
Takiesha,F,100,182,0,182
Tamaka,F,100,182,0,182
Tamarius,M,100,0,182,182
Taytem,F,94,171,11,182
Tiffannie,F,100,182,0,182
Tonantzin,F,100,182,0,182
Tyquon,M,100,0,182,182
Zavon,M,100,0,182,182
Zein,M,100,0,182,182
Zeriah,F,97,177,5,182
Adriyanna,F,100,181,0,181
Ahmaud,M,100,0,181,181
Alaycia,F,100,181,0,181
Amand,F,100,181,0,181
Anju,F,100,181,0,181
Aviah,F,100,181,0,181
Banner,M,93,12,169,181
Beyonca,F,100,181,0,181
Bryona,F,100,181,0,181
Camaria,F,100,181,0,181
Caramia,F,100,181,0,181
Caspar,M,100,0,181,181
Chalmer,M,100,0,181,181
Charlye,F,100,181,0,181
Chessie,F,100,181,0,181
Clarabelle,F,100,181,0,181
Dashanti,F,100,181,0,181
Dashauna,F,100,181,0,181
Davied,M,100,0,181,181
Devell,M,100,0,181,181
Didi,F,100,181,0,181
Fathima,F,100,181,0,181
Gerilynn,F,100,181,0,181
Greydis,F,100,181,0,181
Heiress,F,100,181,0,181
Ife,F,100,181,0,181
Jabe,M,100,0,181,181
Japhet,M,100,0,181,181
Jermany,M,53,85,96,181
Jerrico,M,100,0,181,181
Jessicaann,F,100,181,0,181
Jilliana,F,100,181,0,181
Juanmiguel,M,100,0,181,181
Keanthony,M,100,0,181,181
Kesler,M,100,0,181,181
Khadeja,F,100,181,0,181
Kimisha,F,100,181,0,181
Latesa,F,100,181,0,181
Latiana,F,100,181,0,181
Latoyna,F,100,181,0,181
Laurina,F,100,181,0,181
Lenay,F,100,181,0,181
Marda,F,100,181,0,181
Margaretann,F,100,181,0,181
Marjan,F,100,181,0,181
Masie,F,100,181,0,181
Mayank,M,100,0,181,181
Mclain,M,92,14,167,181
Mekala,F,100,181,0,181
Mekia,F,100,181,0,181
Mulan,F,97,176,5,181
Nasiya,F,100,181,0,181
Nickayla,F,100,181,0,181
Noriah,F,100,181,0,181
Ogden,M,100,0,181,181
Osie,M,77,42,139,181
Raelle,F,100,181,0,181
Ramesh,M,100,0,181,181
Redell,M,84,29,152,181
Rheya,F,100,181,0,181
Rontrell,M,100,0,181,181
Ryun,M,100,0,181,181
Sanaia,F,100,181,0,181
Shadeed,M,100,0,181,181
Shakeila,F,100,181,0,181
Sirron,M,100,0,181,181
Staley,M,59,74,107,181
Symphany,F,100,181,0,181
Tamim,M,100,0,181,181
Tasnia,F,100,181,0,181
Torria,F,100,181,0,181
Tracyann,F,100,181,0,181
Tykisha,F,100,181,0,181
Valon,M,97,5,176,181
Yazlyn,F,100,181,0,181
Yomara,F,100,181,0,181
Yostin,M,100,0,181,181
Allon,M,100,0,180,180
Amro,M,100,0,180,180
Angalina,F,100,180,0,180
Angelice,F,100,180,0,180
Anothy,M,100,0,180,180
Arionne,F,100,180,0,180
Aster,F,91,163,17,180
Atanacio,M,100,0,180,180
Brentyn,M,100,0,180,180
Breyton,M,100,0,180,180
Britiany,F,100,180,0,180
Broderic,M,100,0,180,180
Chelesa,F,100,180,0,180
Christee,F,100,180,0,180
Correne,F,100,180,0,180
Dae,M,65,63,117,180
Dalicia,F,100,180,0,180
Damere,M,100,0,180,180
Daruis,M,100,0,180,180
Deloras,F,100,180,0,180
Diavian,F,97,175,5,180
Dynisha,F,100,180,0,180
Elysabeth,F,100,180,0,180
Estreya,F,100,180,0,180
Giabella,F,100,180,0,180
Grantham,M,100,0,180,180
Jahlia,F,100,180,0,180
Jakeya,F,100,180,0,180
Janeene,F,100,180,0,180
Janith,F,100,180,0,180
Jasim,M,100,0,180,180
Jayzon,M,100,0,180,180
Jesselle,F,100,180,0,180
Juvencio,M,100,0,180,180
Jvion,M,100,0,180,180
Kailash,M,100,0,180,180
Keeana,F,100,180,0,180
Kerria,F,100,180,0,180
Kortlyn,F,100,180,0,180
Kreig,M,100,0,180,180
Lanayah,F,100,180,0,180
Laneka,F,100,180,0,180
Laylanie,F,100,180,0,180
Lige,M,100,0,180,180
Linkoln,M,100,0,180,180
Maks,M,100,0,180,180
Maryl,F,100,180,0,180
Melat,F,100,180,0,180
Niasha,F,100,180,0,180
Osmond,M,100,0,180,180
Qamar,M,66,62,118,180
Quintell,M,97,5,175,180
Remmy,M,58,75,105,180
Shannette,F,100,180,0,180
Sharmila,F,100,180,0,180
Shevy,F,94,170,10,180
Sirus,M,100,0,180,180
Sutter,M,97,6,174,180
Thoams,M,100,0,180,180
Tyreka,F,100,180,0,180
Yardley,M,55,81,99,180
Yochanan,M,100,0,180,180
Zaiya,F,100,180,0,180
Zynia,F,100,180,0,180
Abrea,F,100,179,0,179
Adisen,F,100,179,0,179
Amayia,F,100,179,0,179
Anani,F,100,179,0,179
Aniketh,M,100,0,179,179
Antia,F,100,179,0,179
Ashawn,M,100,0,179,179
Aubreana,F,100,179,0,179
Avika,F,100,179,0,179
Braian,M,100,0,179,179
Brevyn,M,94,11,168,179
Bristal,F,100,179,0,179
Carollynn,F,100,179,0,179
Chanah,F,100,179,0,179
Charvis,M,100,0,179,179
Chaze,M,100,0,179,179
Cherene,F,100,179,0,179
Christifer,M,100,0,179,179
Cregg,M,100,0,179,179
Dai,M,64,64,115,179
Daiveon,M,100,0,179,179
Darrall,M,100,0,179,179
Deadrick,M,100,0,179,179
Devonia,F,100,179,0,179
Donzel,M,100,0,179,179
Dyon,M,97,5,174,179
Ellary,F,100,179,0,179
Erynne,F,100,179,0,179
Evely,F,100,179,0,179
Faduma,F,100,179,0,179
Gagandeep,M,72,50,129,179
Garrit,M,100,0,179,179
Harlynn,F,100,179,0,179
Jahnay,F,100,179,0,179
Jailan,M,82,32,147,179
Jamilynn,F,100,179,0,179
Jarissa,F,100,179,0,179
Jarmel,M,100,0,179,179
Jaylia,F,100,179,0,179
Jayvier,M,100,0,179,179
Jazmaine,F,100,179,0,179
Jeet,M,100,0,179,179
Jenafer,F,100,179,0,179
Jeronica,F,100,179,0,179
Jesly,F,100,179,0,179
Jessaca,F,100,179,0,179
Jhase,M,100,0,179,179
Joelie,F,100,179,0,179
Johanan,M,100,0,179,179
Joselle,F,100,179,0,179
Kasean,M,100,0,179,179
Keiera,F,100,179,0,179
Ketura,F,100,179,0,179
Labarron,M,100,0,179,179
Ladina,F,100,179,0,179
Lamine,M,100,0,179,179
Lamir,M,100,0,179,179
Lannah,F,100,179,0,179
Leannah,F,100,179,0,179
Lolly,F,100,179,0,179
Magon,F,100,179,0,179
Makara,F,100,179,0,179
Malynn,F,100,179,0,179
Mareo,M,100,0,179,179
Mariaeduarda,F,100,179,0,179
Marsh,M,94,11,168,179
Meckenzie,F,100,179,0,179
Naijah,F,100,179,0,179
Nasra,F,100,179,0,179
Natina,F,100,179,0,179
Naviah,F,100,179,0,179
Ninah,F,100,179,0,179
Omara,F,100,179,0,179
Orlinda,F,100,179,0,179
Petula,F,100,179,0,179
Phung,F,91,163,16,179
Pinky,F,100,179,0,179
Pj,M,100,0,179,179
Rip,M,100,0,179,179
Roylene,F,100,179,0,179
Saher,F,97,174,5,179
Shahan,M,100,0,179,179
Shanasia,F,100,179,0,179
Shanen,F,73,131,48,179
Sofya,F,100,179,0,179
Syris,M,100,0,179,179
Teren,M,68,57,122,179
Toneka,F,100,179,0,179
Witney,F,100,179,0,179
Yamel,F,85,153,26,179
Zarianna,F,100,179,0,179
Aerith,F,100,178,0,178
Afreen,F,100,178,0,178
Alyona,F,100,178,0,178
Argie,F,91,162,16,178
Ashleah,F,100,178,0,178
Briahnna,F,100,178,0,178
Charolett,F,100,178,0,178
Cherisa,F,100,178,0,178
Chermaine,F,100,178,0,178
Connelly,F,54,96,82,178
Daeshon,M,100,0,178,178
Damacio,M,100,0,178,178
Damyon,M,100,0,178,178
Deetra,F,100,178,0,178
Delona,F,100,178,0,178
Deziah,F,97,173,5,178
Diasia,F,100,178,0,178
Diesha,F,100,178,0,178
Dilia,F,100,178,0,178
Edit,F,100,178,0,178
Ellysa,F,100,178,0,178
Erlin,M,94,11,167,178
Florina,F,100,178,0,178
Haniel,M,97,5,173,178
Jacub,M,100,0,178,178
Jamilya,F,100,178,0,178
Janiaya,F,100,178,0,178
Jmari,M,100,0,178,178
Joedy,M,92,15,163,178
Joven,M,100,0,178,178
Juliauna,F,100,178,0,178
Kamali,M,56,79,99,178
Katoria,F,100,178,0,178
Keithon,M,100,0,178,178
Khriz,M,100,0,178,178
Kinga,F,100,178,0,178
Koal,M,100,0,178,178
Krystelle,F,100,178,0,178
Ladiamond,F,100,178,0,178
Lakeyia,F,100,178,0,178
Lakina,F,100,178,0,178
Latavious,M,100,0,178,178
Lenor,F,100,178,0,178
Lynanne,F,100,178,0,178
Makenlee,F,100,178,0,178
Maxen,M,100,0,178,178
Meleena,F,100,178,0,178
Montia,F,100,178,0,178
Nalanie,F,100,178,0,178
Raghad,F,100,178,0,178
Roniesha,F,100,178,0,178
Sarvesh,M,100,0,178,178
Shakya,F,100,178,0,178
Shloimy,M,100,0,178,178
Staphany,F,100,178,0,178
Stepan,M,100,0,178,178
Suzetta,F,100,178,0,178
Taejon,M,100,0,178,178
Teyon,M,100,0,178,178
Theon,M,95,9,169,178
Torion,M,100,0,178,178
Trestin,M,100,0,178,178
Tydus,M,100,0,178,178
Vedanth,M,100,0,178,178
Vendetta,F,100,178,0,178
Zakeya,F,100,178,0,178
Zollie,M,94,11,167,178
Adeleine,F,100,177,0,177
Airon,M,97,5,172,177
Alverta,F,100,177,0,177
Aolanis,F,100,177,0,177
Ashara,F,100,177,0,177
Augustino,M,100,0,177,177
Austynn,F,100,177,0,177
Azaliah,F,100,177,0,177
Brandelyn,F,100,177,0,177
Bridie,F,100,177,0,177
Bryssa,F,100,177,0,177
Caidance,F,100,177,0,177
Castor,M,100,0,177,177
Dayleen,F,100,177,0,177
Deeric,M,100,0,177,177
Derrien,M,100,0,177,177
Devere,M,100,0,177,177
Dianey,F,100,177,0,177
Emeric,M,100,0,177,177
Enaya,F,100,177,0,177
Faysal,M,100,0,177,177
Feige,F,100,177,0,177
Felesha,F,100,177,0,177
Hady,M,78,39,138,177
Harshita,F,100,177,0,177
Hussam,M,100,0,177,177
Izaiyah,M,100,0,177,177
Jadi,F,100,177,0,177
Jaimen,M,100,0,177,177
Jonan,M,100,0,177,177
Juline,F,100,177,0,177
Kaedynce,F,100,177,0,177
Katesha,F,100,177,0,177
Keaston,M,100,0,177,177
Kennet,M,100,0,177,177
Ladan,F,100,177,0,177
Lamyia,F,100,177,0,177
Lennin,M,100,0,177,177
Levina,F,100,177,0,177
Lewie,M,100,0,177,177
Livie,F,100,177,0,177
Marcheta,F,100,177,0,177
Marquail,M,100,0,177,177
Mckinzey,F,100,177,0,177
Melondy,F,100,177,0,177
Merit,F,71,125,52,177
Merrissa,F,100,177,0,177
Nachum,M,100,0,177,177
Naureen,F,100,177,0,177
Nealy,F,97,172,5,177
Nilesh,M,100,0,177,177
Quayshawn,M,97,5,172,177
Ravenna,F,100,177,0,177
Sandford,M,100,0,177,177
Shanetra,F,100,177,0,177
Shraddha,F,100,177,0,177
Siah,F,55,97,80,177
Skyelynn,F,100,177,0,177
Smriti,F,100,177,0,177
Sylvania,F,97,172,5,177
Tambi,F,100,177,0,177
Thresea,F,100,177,0,177
Timotheus,M,100,0,177,177
Tiwanda,F,100,177,0,177
Vir,M,100,0,177,177
Wilmar,M,100,0,177,177
Wylan,M,100,0,177,177
Zarinah,F,100,177,0,177
Zedric,M,100,0,177,177
Adreonna,F,100,176,0,176
Akeila,F,100,176,0,176
Alyzah,F,100,176,0,176
Amaira,F,100,176,0,176
Amran,F,80,140,36,176
Anniah,F,100,176,0,176
Anwita,F,100,176,0,176
Asahel,M,100,0,176,176
Bradrick,M,100,0,176,176
Brehanna,F,100,176,0,176
Brooklinn,F,100,176,0,176
Celines,F,100,176,0,176
Chanee,F,100,176,0,176
Christorpher,M,100,0,176,176
Chrsitopher,M,100,0,176,176
Cordaryl,M,100,0,176,176
Cove,M,97,6,170,176
Demetrias,M,72,49,127,176
Denym,M,52,85,91,176
Eleanna,F,100,176,0,176
Erial,F,100,176,0,176
Eriona,F,100,176,0,176
Farouk,M,100,0,176,176
Galilee,F,100,176,0,176
Hamish,M,100,0,176,176
Jahlani,M,94,11,165,176
Jaquarious,M,100,0,176,176
Jeanean,F,100,176,0,176
Jemia,F,100,176,0,176
Jenavie,F,100,176,0,176
Jerimah,M,100,0,176,176
Joesphine,F,100,176,0,176
Julitza,F,100,176,0,176
Keiri,F,100,176,0,176
Krisalyn,F,100,176,0,176
Lakaya,F,100,176,0,176
Lujain,F,100,176,0,176
Luretha,F,100,176,0,176
Maanya,F,100,176,0,176
Madyn,F,100,176,0,176
Mayco,M,100,0,176,176
Mekiah,F,62,110,66,176
Nanetta,F,100,176,0,176
Nocole,F,100,176,0,176
Nyshawn,M,100,0,176,176
Obert,M,100,0,176,176
Orvin,M,100,0,176,176
Owais,M,100,0,176,176
Paquita,F,100,176,0,176
Rafay,M,100,0,176,176
Raia,F,100,176,0,176
Ramiz,M,100,0,176,176
Romey,M,52,84,92,176
Salley,F,100,176,0,176
Sarahmarie,F,100,176,0,176
Sharmain,F,100,176,0,176
Sheddrick,M,100,0,176,176
Shekina,F,100,176,0,176
Sherrica,F,100,176,0,176
Sherrika,F,100,176,0,176
Shiraz,M,68,57,119,176
Shuan,M,100,0,176,176
Sugar,F,74,130,46,176
Summerlyn,F,100,176,0,176
Susa,F,100,176,0,176
Tane,F,90,159,17,176
Tanny,F,97,171,5,176
Tattiana,F,100,176,0,176
Tevion,M,100,0,176,176
Thomson,M,100,0,176,176
Timiya,F,100,176,0,176
Tishara,F,100,176,0,176
Toneisha,F,100,176,0,176
Tuwana,F,100,176,0,176
Tyerra,F,100,176,0,176
Tykerria,F,100,176,0,176
Ulonda,F,100,176,0,176
Vonn,M,97,5,171,176
Xiong,M,100,0,176,176
Yolinda,F,100,176,0,176
Zavior,M,100,0,176,176
Aaran,M,100,0,175,175
Aleister,M,100,0,175,175
Alexzia,F,100,175,0,175
Allecia,F,100,175,0,175
Amany,F,100,175,0,175
Arhan,M,100,0,175,175
Ariyanah,F,100,175,0,175
Arvell,M,100,0,175,175
Asyah,F,100,175,0,175
Aunesty,F,100,175,0,175
Avila,F,100,175,0,175
Bernestine,F,100,175,0,175
Cane,M,100,0,175,175
Channah,F,100,175,0,175
Cheryln,F,100,175,0,175
Cobin,M,100,0,175,175
Daenerys,F,100,175,0,175
Darianne,F,100,175,0,175
Dastan,M,100,0,175,175
Deontrae,M,100,0,175,175
Donyel,F,55,96,79,175
Dorismar,F,100,175,0,175
Eisa,M,74,45,130,175
Enis,M,100,0,175,175
Eyanna,F,100,175,0,175
Freja,F,100,175,0,175
Geddy,M,100,0,175,175
Ghislaine,F,100,175,0,175
Haidy,F,100,175,0,175
Huber,M,100,0,175,175
Ilisa,F,100,175,0,175
Isobella,F,100,175,0,175
Jasira,F,100,175,0,175
Jebadiah,M,100,0,175,175
Jennalynn,F,100,175,0,175
Kahne,M,97,5,170,175
Keisean,M,100,0,175,175
Keyonda,F,100,175,0,175
Kiasha,F,100,175,0,175
Kiosha,F,100,175,0,175
Latreece,F,100,175,0,175
Lauryl,F,100,175,0,175
Maesyn,F,89,156,19,175
Malania,F,100,175,0,175
Markeda,F,100,175,0,175
Marleena,F,100,175,0,175
Maxamus,M,100,0,175,175
Meade,M,97,6,169,175
Melek,F,77,135,40,175
Miata,F,100,175,0,175
Morgaine,F,100,175,0,175
Naziya,F,100,175,0,175
Ohm,M,100,0,175,175
Pina,F,100,175,0,175
Sabien,M,100,0,175,175
Shaneil,F,100,175,0,175
Shawniece,F,100,175,0,175
Stephanye,F,100,175,0,175
Storey,F,100,175,0,175
Syrina,F,100,175,0,175
Taher,M,100,0,175,175
Taronda,F,100,175,0,175
Tavarious,M,100,0,175,175
Temima,F,100,175,0,175
Tiron,M,100,0,175,175
Tonee,F,97,170,5,175
Vasilis,M,100,0,175,175
Yahia,M,100,0,175,175
Yanett,F,100,175,0,175
Youa,F,100,175,0,175
Aireonna,F,100,174,0,174
Alegria,F,100,174,0,174
Alger,M,100,0,174,174
Alric,M,100,0,174,174
Ameriah,F,100,174,0,174
Amrutha,F,100,174,0,174
Anias,M,89,19,155,174
Ardena,F,100,174,0,174
Bernadett,F,100,174,0,174
Brinly,F,100,174,0,174
Celes,F,100,174,0,174
Clariza,F,100,174,0,174
Copper,M,75,43,131,174
Cynthya,F,100,174,0,174
Danyah,F,100,174,0,174
Darenda,F,100,174,0,174
Deeya,F,100,174,0,174
Desman,M,100,0,174,174
Devinne,F,100,174,0,174
Diron,M,100,0,174,174
Dyllen,M,100,0,174,174
Edoardo,M,100,0,174,174
Eliodoro,M,100,0,174,174
Estephani,F,100,174,0,174
Estil,M,100,0,174,174
Folashade,F,100,174,0,174
Franziska,F,100,174,0,174
Frisco,M,100,0,174,174
Gaelen,M,90,18,156,174
Gar,M,100,0,174,174
Garald,M,100,0,174,174
Glorimar,F,100,174,0,174
Harly,F,87,152,22,174
Huntington,M,100,0,174,174
Huzaifa,M,100,0,174,174
Ieesha,F,100,174,0,174
Jahzeel,M,73,47,127,174
Janssen,M,100,0,174,174
Jaquari,M,100,0,174,174
Jehad,M,100,0,174,174
Jessel,F,97,169,5,174
Juanice,F,100,174,0,174
Juanisha,F,100,174,0,174
Kaylub,M,100,0,174,174
Keyunna,F,100,174,0,174
Lanaiya,F,100,174,0,174
Latoiya,F,100,174,0,174
Latondra,F,100,174,0,174
Lilyanah,F,100,174,0,174
Maddalynn,F,100,174,0,174
Madissen,F,100,174,0,174
Majesta,F,100,174,0,174
Malya,F,100,174,0,174
Marvens,M,100,0,174,174
Mattilynn,F,100,174,0,174
Megean,F,100,174,0,174
Morna,F,100,174,0,174
Muneer,M,100,0,174,174
Myan,F,54,94,80,174
Natanel,M,100,0,174,174
Nazyia,F,100,174,0,174
Orrie,M,97,6,168,174
Oswin,M,83,29,145,174
Pariss,F,97,169,5,174
Quentyn,M,100,0,174,174
Rigby,M,83,30,144,174
Rodneisha,F,100,174,0,174
Sabiha,F,100,174,0,174
Semir,M,100,0,174,174
Shatasha,F,100,174,0,174
Shaterica,F,100,174,0,174
Shavonn,F,100,174,0,174
Shellye,F,100,174,0,174
Shimika,F,100,174,0,174
Suhayb,M,100,0,174,174
Sylina,F,100,174,0,174
Trixy,F,100,174,0,174
Tykera,F,100,174,0,174
Wylder,M,100,0,174,174
Xavius,M,100,0,174,174
Yeray,M,97,5,169,174
Zevin,M,100,0,174,174
Zorian,M,100,0,174,174
Zurie,F,100,174,0,174
Airika,F,100,173,0,173
Amyla,F,100,173,0,173
Anasophia,F,100,173,0,173
Anayla,F,100,173,0,173
Antoinett,F,100,173,0,173
Areya,F,100,173,0,173
Avielle,F,97,167,6,173
Avrianna,F,100,173,0,173
Camauri,M,62,66,107,173
Caulin,M,100,0,173,173
Ceairra,F,100,173,0,173
Chesnee,F,100,173,0,173
Cheyane,F,100,173,0,173
Chukwuma,M,100,0,173,173
Cleotis,M,100,0,173,173
Dajana,F,100,173,0,173
Denni,F,91,158,15,173
Deshea,F,91,157,16,173
Edye,F,100,173,0,173
Eira,F,100,173,0,173
Elisea,F,100,173,0,173
Elnathan,M,100,0,173,173
Federica,F,100,173,0,173
Haygen,M,93,12,161,173
Irven,M,100,0,173,173
Jacyln,F,100,173,0,173
Jaid,F,97,168,5,173
Jassiah,M,90,17,156,173
Jerie,F,100,173,0,173
Jeyla,F,100,173,0,173
Jkwon,M,100,0,173,173
Jnya,F,100,173,0,173
Jocsan,M,100,0,173,173
Kalai,M,83,29,144,173
Kamariah,F,100,173,0,173
Karder,M,96,7,166,173
Kassadi,F,100,173,0,173
Kaston,M,100,0,173,173
Kaylaann,F,100,173,0,173
Liandra,F,100,173,0,173
Lyah,F,100,173,0,173
Mailani,F,100,173,0,173
Nakima,F,100,173,0,173
Nayara,F,100,173,0,173
Nikolus,M,100,0,173,173
Novia,F,100,173,0,173
Oni,F,100,173,0,173
Orel,M,97,6,167,173
Petrice,F,100,173,0,173
Rakisha,F,100,173,0,173
Romulus,M,100,0,173,173
Ruffin,M,100,0,173,173
Sagal,F,100,173,0,173
Sevanna,F,100,173,0,173
Shawnese,F,100,173,0,173
Sila,F,100,173,0,173
Simmone,F,100,173,0,173
Tacora,F,100,173,0,173
Tanayah,F,100,173,0,173
Teniyah,F,100,173,0,173
Tlaloc,M,100,0,173,173
Valaria,F,100,173,0,173
Wyndi,F,100,173,0,173
Yiannis,M,100,0,173,173
Zeniyah,F,100,173,0,173
Zohar,F,62,107,66,173
Zula,F,100,173,0,173
Aailyah,F,100,172,0,172
Adonte,M,100,0,172,172
Adrie,F,100,172,0,172
Alaiah,F,100,172,0,172
Alexsandria,F,100,172,0,172
Amedeo,M,100,0,172,172
Analese,F,100,172,0,172
Brizeyda,F,100,172,0,172
Camey,F,100,172,0,172
Capria,F,100,172,0,172
Catalaya,F,100,172,0,172
Caydee,F,100,172,0,172
Chaylee,F,100,172,0,172
Cipriana,F,100,172,0,172
Cynia,F,100,172,0,172
Daisi,F,100,172,0,172
Davene,F,97,167,5,172
Dejana,F,100,172,0,172
Delpha,F,100,172,0,172
Dequon,M,100,0,172,172
Dhruvi,F,100,172,0,172
Draiden,M,100,0,172,172
Drevion,M,100,0,172,172
Dyasia,F,100,172,0,172
Emylie,F,100,172,0,172
Gitel,F,100,172,0,172
Halim,M,100,0,172,172
Jadence,F,83,142,30,172
Jakaden,M,100,0,172,172
Jammi,F,100,172,0,172
Jayan,M,100,0,172,172
Jaycelyn,F,100,172,0,172
Johnte,M,100,0,172,172
Joquan,M,100,0,172,172
Kariyah,F,100,172,0,172
Kashana,F,100,172,0,172
Kuuipo,F,100,172,0,172
Latesia,F,100,172,0,172
Leshay,F,100,172,0,172
Lileigh,F,100,172,0,172
Maelin,F,100,172,0,172
Maleiah,F,100,172,0,172
Mandolin,F,100,172,0,172
Marijean,F,100,172,0,172
Meaghen,F,100,172,0,172
Melyna,F,100,172,0,172
Monai,F,100,172,0,172
Morningstar,F,100,172,0,172
Nazim,M,100,0,172,172
Nickalous,M,100,0,172,172
Rashada,F,100,172,0,172
Raydon,M,100,0,172,172
Reka,F,100,172,0,172
Rexton,M,100,0,172,172
Richetta,F,100,172,0,172
Riyanna,F,100,172,0,172
Romar,M,100,0,172,172
Roniya,F,100,172,0,172
Sangeeta,F,100,172,0,172
Sem,M,100,0,172,172
Shakil,M,97,5,167,172
Shamal,M,100,0,172,172
Shamicka,F,100,172,0,172
Shamond,M,100,0,172,172
Shaquill,M,90,17,155,172
Shatima,F,100,172,0,172
Sinclaire,F,100,172,0,172
Stayce,F,100,172,0,172
Tahmir,M,100,0,172,172
Twylla,F,100,172,0,172
Yanel,F,100,172,0,172
Zasha,F,100,172,0,172
Aftyn,F,100,171,0,171
Alannis,F,100,171,0,171
Alyne,F,100,171,0,171
Anupama,F,100,171,0,171
Arslan,M,100,0,171,171
Asheton,M,54,78,93,171
Audi,F,59,101,70,171
Blakeleigh,F,100,171,0,171
Blondie,F,100,171,0,171
Caterin,F,100,171,0,171
Cerra,F,100,171,0,171
Ciaira,F,100,171,0,171
Clelia,F,100,171,0,171
Dajae,F,100,171,0,171
Damisha,F,100,171,0,171
Darly,M,61,67,104,171
Darneshia,F,100,171,0,171
Devyne,F,68,116,55,171
Dyrell,M,100,0,171,171
Elainna,F,100,171,0,171
Fredis,M,100,0,171,171
Harrel,M,100,0,171,171
Jacson,M,100,0,171,171
Jaretzi,F,100,171,0,171
Jazalynn,F,100,171,0,171
Jillyn,F,100,171,0,171
Jode,F,85,146,25,171
Joshus,M,100,0,171,171
Kathyann,F,100,171,0,171
Katianna,F,100,171,0,171
Kestrel,F,97,166,5,171
Kewana,F,100,171,0,171
Keyandre,M,100,0,171,171
Keyden,M,100,0,171,171
Keyleigh,F,100,171,0,171
Kianni,F,100,171,0,171
Larz,M,100,0,171,171
Lateka,F,100,171,0,171
Latrise,F,100,171,0,171
Leilanni,F,100,171,0,171
Lyne,F,97,166,5,171
Mariaclara,F,100,171,0,171
Maveric,M,100,0,171,171
Merin,F,100,171,0,171
Metta,F,100,171,0,171
Mikhi,M,100,0,171,171
Mylin,F,78,134,37,171
Nicholl,F,100,171,0,171
Norina,F,100,171,0,171
Nygeria,F,100,171,0,171
Oluwademilade,M,64,61,110,171
Oluwafemi,M,100,0,171,171
Pierrette,F,100,171,0,171
Revan,M,100,0,171,171
Rhiannan,F,100,171,0,171
Sarim,M,100,0,171,171
Savoy,M,93,12,159,171
Senai,F,57,97,74,171
Sherrick,M,97,5,166,171
Shukri,F,91,156,15,171
Tabia,F,100,171,0,171
Tanequa,F,100,171,0,171
Tashianna,F,100,171,0,171
Tressy,F,100,171,0,171
Tymel,M,100,0,171,171
Whitten,M,97,5,166,171
Zissel,F,100,171,0,171
Zylan,M,100,0,171,171
Aerabella,F,100,170,0,170
Alhaji,M,100,0,170,170
Alisah,F,100,170,0,170
Allean,F,100,170,0,170
Anala,F,100,170,0,170
Arielys,F,100,170,0,170
Asaph,M,100,0,170,170
Ashdon,M,100,0,170,170
Asmar,M,100,0,170,170
Benedicto,M,100,0,170,170
Brenya,F,100,170,0,170
Brycin,M,100,0,170,170
Carvell,M,100,0,170,170
Chukwudi,M,100,0,170,170
Cid,M,100,0,170,170
Daizha,F,100,170,0,170
Deaisha,F,100,170,0,170
Desmin,M,97,5,165,170
Dinna,F,100,170,0,170
Eleina,F,100,170,0,170
Eyleen,F,100,170,0,170
Ferdinando,M,100,0,170,170
Gustin,M,100,0,170,170
Hanne,F,100,170,0,170
Haytham,M,100,0,170,170
Hazelle,F,100,170,0,170
Helaman,M,100,0,170,170
Ingram,M,92,13,157,170
Isam,M,100,0,170,170
Issabelle,F,100,170,0,170
Izic,M,100,0,170,170
Janasha,F,100,170,0,170
Jasmarie,F,100,170,0,170
Jaylenne,F,100,170,0,170
Jeffifer,F,100,170,0,170
Jesseka,F,100,170,0,170
Jewelle,F,100,170,0,170
Junell,F,100,170,0,170
Kaelob,M,100,0,170,170
Kanaya,F,100,170,0,170
Keilany,F,100,170,0,170
Kendry,M,87,22,148,170
Kevonta,M,100,0,170,170
Krystale,F,100,170,0,170
Krystall,F,100,170,0,170
Labaron,M,100,0,170,170
Ladonte,M,100,0,170,170
Leiyah,F,100,170,0,170
Madelein,F,100,170,0,170
Makenley,F,100,170,0,170
Makinzee,F,100,170,0,170
Marlies,F,100,170,0,170
Maxamillian,M,100,0,170,170
Mikaelah,F,100,170,0,170
Milia,F,100,170,0,170
Mylasia,F,100,170,0,170
Nairi,F,100,170,0,170
Nakul,M,100,0,170,170
Nickson,M,100,0,170,170
Normajean,F,100,170,0,170
Onya,F,100,170,0,170
Raeden,M,63,63,107,170
Refujio,M,100,0,170,170
Ryota,M,100,0,170,170
Ryson,M,100,0,170,170
Satina,F,100,170,0,170
Secundino,M,100,0,170,170
Shacoria,F,100,170,0,170
Shaneequa,F,100,170,0,170
Shrihan,M,100,0,170,170
Syrenity,F,100,170,0,170
Tameron,M,69,53,117,170
Tayia,F,100,170,0,170
Toua,M,100,0,170,170
Wava,F,100,170,0,170
Yamaris,F,100,170,0,170
Yatzari,F,100,170,0,170
Yoltzin,M,51,83,87,170
Zackrey,M,100,0,170,170
Zorah,F,100,170,0,170
Aizah,F,100,169,0,169
Anberlin,F,100,169,0,169
Anjani,F,100,169,0,169
Annisha,F,100,169,0,169
Audy,M,100,0,169,169
Avaneesh,M,100,0,169,169
Aynslee,F,100,169,0,169
Brylei,F,100,169,0,169
Conda,F,97,164,5,169
Dailon,M,100,0,169,169
Dehlia,F,100,169,0,169
Dionisia,F,100,169,0,169
Donevan,M,100,0,169,169
Dustina,F,100,169,0,169
Essance,F,100,169,0,169
Faydra,F,100,169,0,169
Gabi,F,100,169,0,169
Gerado,M,100,0,169,169
Griffon,M,100,0,169,169
Grisell,F,100,169,0,169
Hall,M,100,0,169,169
Jah,M,100,0,169,169
Jalayla,F,100,169,0,169
Jarvin,M,100,0,169,169
Jearl,M,97,5,164,169
Jemaine,M,100,0,169,169
Jilda,F,100,169,0,169
Kaisyn,M,62,64,105,169
Kelina,F,100,169,0,169
Kemba,F,100,169,0,169
Kenedee,F,100,169,0,169
Kismet,F,100,169,0,169
Kolyn,M,100,0,169,169
Krue,M,100,0,169,169
Lewanda,F,100,169,0,169
Lizmary,F,100,169,0,169
Madi,F,100,169,0,169
Maely,F,100,169,0,169
Mahkayla,F,100,169,0,169
Makenzye,F,100,169,0,169
Mechel,M,59,70,99,169
Melinna,F,100,169,0,169
Minah,F,100,169,0,169
Nelissa,F,100,169,0,169
Nik,M,100,0,169,169
Nikiah,F,100,169,0,169
Pattiann,F,100,169,0,169
Pharell,M,100,0,169,169
Saleemah,F,100,169,0,169
Saliha,F,100,169,0,169
Shaquandra,F,100,169,0,169
Shir,F,100,169,0,169
Sicilia,F,100,169,0,169
Tenesia,F,100,169,0,169
Tison,M,100,0,169,169
Toriann,F,100,169,0,169
Tyjai,M,54,77,92,169
Tyquavious,M,100,0,169,169
Vuong,M,100,0,169,169
Aaisha,F,100,168,0,168
Abdifatah,M,100,0,168,168
Adwoa,F,100,168,0,168
Alean,F,100,168,0,168
Annick,F,100,168,0,168
Brihana,F,100,168,0,168
Candas,F,100,168,0,168
Carinna,F,100,168,0,168
Chiquitta,F,100,168,0,168
Claudene,F,100,168,0,168
Colinda,F,100,168,0,168
Contrina,F,100,168,0,168
Deanglo,M,100,0,168,168
Dedee,F,100,168,0,168
Delvonte,M,100,0,168,168
Derrika,F,100,168,0,168
Dontai,M,100,0,168,168
Elain,F,100,168,0,168
Elizeth,F,100,168,0,168
Emitt,M,100,0,168,168
Fawna,F,100,168,0,168
Galadriel,F,100,168,0,168
Geo,M,100,0,168,168
Harrold,M,100,0,168,168
Imanie,F,100,168,0,168
Indiah,F,100,168,0,168
Ivelis,F,100,168,0,168
Jazira,F,100,168,0,168
Jenyfer,F,100,168,0,168
Jhamari,M,100,0,168,168
Kemisha,F,100,168,0,168
Keyuna,F,100,168,0,168
Kimarie,F,100,168,0,168
Kindred,M,57,73,95,168
Kristion,M,97,5,163,168
Lamin,M,100,0,168,168
Latacha,F,100,168,0,168
Leaira,F,100,168,0,168
Lillyonna,F,100,168,0,168
Loa,F,100,168,0,168
Lucrezia,F,100,168,0,168
Mackenzey,F,100,168,0,168
Maddon,M,100,0,168,168
Makhiya,F,100,168,0,168
Makinzi,F,100,168,0,168
Makinzy,F,100,168,0,168
Makyiah,F,100,168,0,168
Maruice,M,100,0,168,168
Momin,M,100,0,168,168
Myrical,F,100,168,0,168
Netra,F,100,168,0,168
Nyjae,F,100,168,0,168
Petrona,F,100,168,0,168
Quierra,F,100,168,0,168
Quinley,F,100,168,0,168
Riyana,F,100,168,0,168
Ronav,M,100,0,168,168
Saivon,M,100,0,168,168
Sederick,M,100,0,168,168
Shaima,F,100,168,0,168
Shawnia,F,100,168,0,168
Sheryn,F,100,168,0,168
Simpson,M,100,0,168,168
Sophiya,F,100,168,0,168
Suriya,F,94,158,10,168
Tanza,F,100,168,0,168
Tenea,F,100,168,0,168
Tenlee,F,100,168,0,168
Tenoch,M,100,0,168,168
Tessla,F,100,168,0,168
Trevelle,M,100,0,168,168
Vennie,F,70,117,51,168
Vielka,F,100,168,0,168
Wyland,M,100,0,168,168
Zakya,F,100,168,0,168
Zaniel,M,100,0,168,168
Zunairah,F,100,168,0,168
Aarianna,F,100,167,0,167
Alyscia,F,100,167,0,167
Bard,M,100,0,167,167
Bhavin,M,100,0,167,167
Bright,M,97,5,162,167
Calub,M,100,0,167,167
Calypso,F,100,167,0,167
Carvel,M,100,0,167,167
Chanele,F,100,167,0,167
Colletta,F,100,167,0,167
Dagon,M,100,0,167,167
Danil,M,100,0,167,167
Deetya,F,100,167,0,167
Denece,F,100,167,0,167
Dinesh,M,100,0,167,167
Durant,M,100,0,167,167
Earon,M,97,5,162,167
Eashan,M,100,0,167,167
Emanie,F,100,167,0,167
Faten,F,100,167,0,167
Garnette,F,100,167,0,167
Geonna,F,100,167,0,167
Jadae,F,100,167,0,167
Jahrell,M,100,0,167,167
Jaishawn,M,100,0,167,167
Janari,M,69,52,115,167
Jawann,M,100,0,167,167
Johnsie,F,100,167,0,167
Jolea,F,100,167,0,167
Keo,M,100,0,167,167
Kysa,F,100,167,0,167
Lavante,M,100,0,167,167
Lynnie,F,90,151,16,167
Matisha,F,100,167,0,167
Meha,F,100,167,0,167
Moua,M,100,0,167,167
Myers,M,93,11,156,167
Naliah,F,100,167,0,167
Nkechi,F,100,167,0,167
Nysha,F,100,167,0,167
Octavion,M,100,0,167,167
Pennelope,F,100,167,0,167
Perrion,M,100,0,167,167
Porcia,F,100,167,0,167
Princessa,F,100,167,0,167
Reneta,F,100,167,0,167
Ronia,F,100,167,0,167
Roshanna,F,100,167,0,167
Ryenn,F,100,167,0,167
Samnang,M,83,28,139,167
Shalice,F,100,167,0,167
Shinika,F,100,167,0,167
Sisto,M,100,0,167,167
Sulamita,F,100,167,0,167
Tabby,F,97,162,5,167
Tejon,M,100,0,167,167
Trystian,M,100,0,167,167
Valera,F,100,167,0,167
Vonzell,M,100,0,167,167
Vrinda,F,100,167,0,167
Xoey,F,100,167,0,167
Zamyah,F,100,167,0,167
Aedin,M,100,0,166,166
Ahmon,M,100,0,166,166
Allyna,F,100,166,0,166
Alontae,M,100,0,166,166
Alyzabeth,F,100,166,0,166
Anara,F,100,166,0,166
Aneli,F,100,166,0,166
Annai,F,100,166,0,166
Annalysa,F,100,166,0,166
Aryka,F,100,166,0,166
Aydee,F,100,166,0,166
Brenson,M,100,0,166,166
Carmeron,M,100,0,166,166
Clora,F,100,166,0,166
Cordie,F,82,136,30,166
Cruzita,F,100,166,0,166
Daryon,M,100,0,166,166
Deliyah,F,100,166,0,166
Devontre,M,100,0,166,166
Dezaree,F,100,166,0,166
Donis,F,67,112,54,166
Elfreda,F,100,166,0,166
Genecis,F,100,166,0,166
Grizelda,F,100,166,0,166
Haja,F,100,166,0,166
Jameeka,F,100,166,0,166
Jarmarcus,M,100,0,166,166
Jocabed,F,100,166,0,166
Jordane,F,96,159,7,166
Kalyb,M,100,0,166,166
Kanda,F,100,166,0,166
Kapono,M,100,0,166,166
Kaysia,F,100,166,0,166
Kieffer,M,100,0,166,166
Kincade,M,100,0,166,166
Kito,M,93,11,155,166
Laval,M,100,0,166,166
Lechelle,F,100,166,0,166
Liev,M,100,0,166,166
Linc,M,100,0,166,166
Lyfe,M,73,45,121,166
Lyncoln,M,69,51,115,166
Madinah,F,100,166,0,166
Mahlet,F,100,166,0,166
Malike,M,100,0,166,166
Marquarius,M,100,0,166,166
Mckenzey,F,100,166,0,166
Michaeljames,M,100,0,166,166
Natalija,F,100,166,0,166
Natalyah,F,100,166,0,166
Nesanel,M,100,0,166,166
Purity,F,100,166,0,166
Rehaan,M,100,0,166,166
Richell,F,100,166,0,166
Rionna,F,100,166,0,166
Rishan,M,100,0,166,166
Rosabelle,F,100,166,0,166
Roshaunda,F,100,166,0,166
Savhanna,F,100,166,0,166
Savonna,F,100,166,0,166
Senita,F,100,166,0,166
Solymar,F,100,166,0,166
Tanaiya,F,100,166,0,166
Tarl,M,100,0,166,166
Teancum,M,100,0,166,166
Vadhir,M,100,0,166,166
Vash,M,100,0,166,166
Wyat,M,100,0,166,166
Yareliz,F,100,166,0,166
Yaritzy,F,100,166,0,166
Aahan,M,100,0,165,165
Adalis,F,100,165,0,165
Adante,M,100,0,165,165
Akeela,F,100,165,0,165
Alaja,F,100,165,0,165
Amanie,F,97,160,5,165
Amyria,F,100,165,0,165
Annalisse,F,100,165,0,165
Anquinette,F,100,165,0,165
Antrone,M,100,0,165,165
Arcenio,M,100,0,165,165
Ariyona,F,100,165,0,165
Avana,F,100,165,0,165
Bentlie,F,65,108,57,165
Bing,M,100,0,165,165
Canda,F,100,165,0,165
Conception,F,100,165,0,165
Correen,F,100,165,0,165
Danaysia,F,100,165,0,165
Dorlene,F,100,165,0,165
Ellerie,F,100,165,0,165
Falesha,F,100,165,0,165
Genora,F,100,165,0,165
Gianpaolo,M,100,0,165,165
Hayk,M,100,0,165,165
Isais,M,100,0,165,165
Jabori,M,100,0,165,165
Jahara,F,97,160,5,165
Jameya,F,100,165,0,165
Jarrius,M,100,0,165,165
Jasyn,M,100,0,165,165
Jaylun,M,100,0,165,165
Jaysun,M,100,0,165,165
Jazion,M,100,0,165,165
Jeremiyah,M,100,0,165,165
Jerris,M,72,47,118,165
Jerrol,M,100,0,165,165
Jiyah,F,100,165,0,165
Josselyne,F,100,165,0,165
Kaiyla,F,100,165,0,165
Kenise,F,100,165,0,165
Khi,M,96,7,158,165
Kyandra,F,100,165,0,165
Latiya,F,100,165,0,165
Latravious,M,100,0,165,165
Madia,F,100,165,0,165
Magdelyn,F,100,165,0,165
Malley,F,100,165,0,165
Marigold,F,100,165,0,165
Marshea,F,100,165,0,165
Naveyah,F,100,165,0,165
Nikaya,F,100,165,0,165
Onofre,M,100,0,165,165
Paytan,F,96,158,7,165
Ponciano,M,100,0,165,165
Ronalee,F,100,165,0,165
Roselinda,F,100,165,0,165
Samhitha,F,100,165,0,165
Saurav,M,100,0,165,165
Serria,F,100,165,0,165
Sevag,M,100,0,165,165
Shambria,F,100,165,0,165
Shandee,F,100,165,0,165
Shaquia,F,100,165,0,165
Tabithia,F,100,165,0,165
Tahesha,F,100,165,0,165
Tamelia,F,100,165,0,165
Tery,M,79,34,131,165
Thelbert,M,100,0,165,165
Trichelle,F,100,165,0,165
Trinnity,F,100,165,0,165
Tyke,M,100,0,165,165
Yidel,M,100,0,165,165
Zanyiah,F,100,165,0,165
Zanyla,F,100,165,0,165
Ziyonna,F,100,165,0,165
Aalliyah,F,100,164,0,164
Adri,F,88,144,20,164
Anavictoria,F,100,164,0,164
Anthonia,F,100,164,0,164
Anyelin,F,100,164,0,164
Archit,M,100,0,164,164
Atheena,F,100,164,0,164
Avenir,M,100,0,164,164
Bekki,F,100,164,0,164
Biran,M,100,0,164,164
Carmita,F,100,164,0,164
Cassadee,F,100,164,0,164
Cassadie,F,100,164,0,164
Charnay,F,100,164,0,164
Cheronda,F,100,164,0,164
Daisean,M,100,0,164,164
Danicka,F,100,164,0,164
Dantonio,M,100,0,164,164
Darlen,F,100,164,0,164
Duong,M,100,0,164,164
Eleonore,F,100,164,0,164
Emmalia,F,100,164,0,164
Emonee,F,100,164,0,164
Equan,M,100,0,164,164
Evia,F,100,164,0,164
Haneefah,F,100,164,0,164
Harlei,F,100,164,0,164
Ihor,M,100,0,164,164
Irianna,F,100,164,0,164
Jaise,M,93,11,153,164
Jessye,F,100,164,0,164
Joevon,M,100,0,164,164
Johneisha,F,100,164,0,164
Joneisha,F,100,164,0,164
Junelle,F,100,164,0,164
Kalimah,F,100,164,0,164
Kaymen,M,92,13,151,164
Keiffer,M,100,0,164,164
Kele,M,54,75,89,164
Kenasia,F,100,164,0,164
Kenniya,F,100,164,0,164
Kita,F,100,164,0,164
Lajada,F,100,164,0,164
Lyonel,M,100,0,164,164
Marchella,F,91,150,14,164
Marke,M,97,5,159,164
Miamor,F,100,164,0,164
Mingo,M,100,0,164,164
Miron,M,100,0,164,164
Miyu,F,100,164,0,164
Namrata,F,100,164,0,164
Nello,M,100,0,164,164
Neyland,M,100,0,164,164
Ramaya,F,100,164,0,164
Raushanah,F,100,164,0,164
Reiner,M,100,0,164,164
Ricke,M,100,0,164,164
Sabryn,F,100,164,0,164
Saladin,M,100,0,164,164
Semaja,F,90,147,17,164
Shadee,F,55,91,73,164
Sumeya,F,100,164,0,164
Temia,F,100,164,0,164
Ugonna,M,71,47,117,164
Vanecia,F,100,164,0,164
Vickye,F,100,164,0,164
Winn,M,100,0,164,164
Aariah,F,100,163,0,163
Aela,F,100,163,0,163
Ahriana,F,100,163,0,163
Aika,F,100,163,0,163
Alfrieda,F,100,163,0,163
Alp,M,100,0,163,163
Alysah,F,100,163,0,163
Analisia,F,100,163,0,163
Aoi,F,92,150,13,163
Arrin,M,58,68,95,163
Artrell,M,100,0,163,163
Aurie,F,100,163,0,163
Azya,F,100,163,0,163
Berkleigh,F,100,163,0,163
Birch,M,100,0,163,163
Bransyn,M,100,0,163,163
Charizma,F,100,163,0,163
Charlaine,F,100,163,0,163
Charlett,F,100,163,0,163
Chon,M,100,0,163,163
Christinamarie,F,100,163,0,163
Cote,M,100,0,163,163
Dameian,M,100,0,163,163
Danamarie,F,100,163,0,163
Davidlee,M,100,0,163,163
Delmon,M,100,0,163,163
Demarrion,M,100,0,163,163
Elver,M,97,5,158,163
Emilija,F,100,163,0,163
Fitzroy,M,100,0,163,163
Gloriann,F,100,163,0,163
Hashir,M,100,0,163,163
Isaic,M,100,0,163,163
Issaac,M,100,0,163,163
Jakerria,F,100,163,0,163
Janaisha,F,100,163,0,163
Janard,M,100,0,163,163
Jeanee,F,100,163,0,163
Jeda,F,100,163,0,163
Jeslynn,F,100,163,0,163
Jinna,F,100,163,0,163
Kadden,M,100,0,163,163
Kadeidra,F,100,163,0,163
Kaliq,M,100,0,163,163
Karn,F,97,158,5,163
Katelinn,F,100,163,0,163
Kennette,F,100,163,0,163
Kerim,M,100,0,163,163
Krystofer,M,100,0,163,163
Kyrillos,M,100,0,163,163
Laiden,M,100,0,163,163
Lakoda,M,60,65,98,163
Lashaye,F,100,163,0,163
Maisa,F,100,163,0,163
Makenzey,F,100,163,0,163
Malaia,F,100,163,0,163
Maleigh,F,100,163,0,163
Marte,M,79,35,128,163
Miara,F,100,163,0,163
Paiden,F,56,91,72,163
Praneel,M,100,0,163,163
Quanta,F,57,93,70,163
Raychell,F,100,163,0,163
Raynie,F,100,163,0,163
Robecca,F,100,163,0,163
Rollins,M,97,5,158,163
Rontavious,M,100,0,163,163
Rozina,F,100,163,0,163
Sadonna,F,100,163,0,163
Samuell,M,100,0,163,163
Samyrah,F,100,163,0,163
Saraiah,F,100,163,0,163
Shatisha,F,100,163,0,163
Tadeusz,M,100,0,163,163
Takelia,F,100,163,0,163
Tamikka,F,100,163,0,163
Taris,M,75,41,122,163
Tayja,F,100,163,0,163
Tyjanae,F,100,163,0,163
Velta,F,100,163,0,163
Vici,F,100,163,0,163
Yoshio,M,100,0,163,163
Yosselyn,F,100,163,0,163
Zamzam,F,100,163,0,163
Zanayah,F,100,163,0,163
Zariel,F,90,147,16,163
Zelina,F,100,163,0,163
Abbigael,F,100,162,0,162
Alicya,F,100,162,0,162
Alisse,F,100,162,0,162
Anayiah,F,100,162,0,162
Arel,M,96,6,156,162
Avarose,F,100,162,0,162
Avik,M,100,0,162,162
Betsie,F,100,162,0,162
Charvi,F,100,162,0,162
Chinenye,F,100,162,0,162
Cyleigh,F,100,162,0,162
Dael,M,100,0,162,162
Diago,M,100,0,162,162
Druscilla,F,100,162,0,162
Eleisha,F,100,162,0,162
Everitt,M,100,0,162,162
Gohan,M,100,0,162,162
Graceson,M,86,23,139,162
Grethel,F,100,162,0,162
Griff,M,100,0,162,162
Guenevere,F,100,162,0,162
Helayne,F,100,162,0,162
Heydy,F,100,162,0,162
Jaishon,M,100,0,162,162
Jamorris,M,100,0,162,162
Janeshia,F,100,162,0,162
Jaylei,F,100,162,0,162
Jazzlin,F,100,162,0,162
Jeanmarc,M,100,0,162,162
Julane,F,100,162,0,162
Jurney,F,97,157,5,162
Jyron,M,100,0,162,162
Kathan,M,100,0,162,162
Keelia,F,100,162,0,162
Keliyah,F,100,162,0,162
Kellis,F,57,93,69,162
Kentrail,M,100,0,162,162
Khalfani,M,100,0,162,162
Kiaria,F,100,162,0,162
Krishana,F,100,162,0,162
Lacresia,F,100,162,0,162
Lakysha,F,100,162,0,162
Laquasia,F,100,162,0,162
Lasasha,F,100,162,0,162
Lukis,M,100,0,162,162
Mahira,F,100,162,0,162
Malyah,F,100,162,0,162
Mansur,M,100,0,162,162
Margart,F,100,162,0,162
Marikay,F,100,162,0,162
Marshella,F,100,162,0,162
Mauriana,F,100,162,0,162
Mischell,F,100,162,0,162
Nasean,M,100,0,162,162
Ninamarie,F,100,162,0,162
Nole,M,97,5,157,162
Oniel,M,100,0,162,162
Ritesh,M,100,0,162,162
Roi,M,88,19,143,162
Rosene,F,100,162,0,162
Salmaan,M,100,0,162,162
Sandar,F,100,162,0,162
Shahzaib,M,100,0,162,162
Shanequia,F,100,162,0,162
Shenay,F,100,162,0,162
Sokhna,F,100,162,0,162
Surabhi,F,100,162,0,162
Susen,F,100,162,0,162
Tashyra,F,100,162,0,162
Tel,M,100,0,162,162
Terrius,M,100,0,162,162
Vikash,M,100,0,162,162
Yaiza,F,100,162,0,162
Yena,F,100,162,0,162
Abryana,F,100,161,0,161
Ahrianna,F,100,161,0,161
Alexio,M,100,0,161,161
Allesandra,F,100,161,0,161
Allyiah,F,100,161,0,161
Antario,M,100,0,161,161
Ayssa,F,100,161,0,161
Berenis,F,100,161,0,161
Canesha,F,100,161,0,161
Chandrika,F,100,161,0,161
Chelsei,F,100,161,0,161
Cherissa,F,100,161,0,161
Daishon,M,100,0,161,161
Danyle,F,100,161,0,161
Daquane,M,100,0,161,161
Dejane,F,100,161,0,161
Denson,M,100,0,161,161
Ellin,F,100,161,0,161
Eryca,F,100,161,0,161
Fredick,M,100,0,161,161
Isolde,F,100,161,0,161
Jacion,M,100,0,161,161
Jamarien,M,100,0,161,161
Javel,M,100,0,161,161
Jontay,M,91,15,146,161
Kadeshia,F,100,161,0,161
Kahlyn,F,100,161,0,161
Kinzy,F,100,161,0,161
Kruze,M,100,0,161,161
Ladaysha,F,100,161,0,161
Lameshia,F,100,161,0,161
Leeba,F,100,161,0,161
Letroy,M,100,0,161,161
Lurene,F,100,161,0,161
Makayah,F,100,161,0,161
Marqual,M,100,0,161,161
Mayu,F,100,161,0,161
Megon,F,100,161,0,161
Mikailah,F,100,161,0,161
Mikenzi,F,100,161,0,161
Myrian,F,100,161,0,161
Neidy,F,100,161,0,161
Nieshia,F,100,161,0,161
Oluchi,F,100,161,0,161
Quaron,M,100,0,161,161
Ravneet,F,96,154,7,161
Reeda,F,100,161,0,161
Remon,M,100,0,161,161
Sabri,M,80,33,128,161
Sarahgrace,F,100,161,0,161
Seda,F,100,161,0,161
Shaeleigh,F,100,161,0,161
Soua,F,65,105,56,161
Sukhmani,F,100,161,0,161
Teriann,F,100,161,0,161
Thomes,M,100,0,161,161
Tuwanda,F,100,161,0,161
Usama,M,100,0,161,161
Wilian,M,100,0,161,161
Yeslin,F,100,161,0,161
Zyron,M,100,0,161,161
Adriyana,F,100,160,0,160
Afrah,F,100,160,0,160
Aldan,M,100,0,160,160
Alegandra,F,100,160,0,160
Aleria,F,100,160,0,160
Alexsys,F,100,160,0,160
Alynah,F,100,160,0,160
Ameilia,F,100,160,0,160
Ananth,M,100,0,160,160
Benjermin,M,100,0,160,160
Bobbyjo,F,100,160,0,160
Brandace,F,100,160,0,160
Cabe,M,100,0,160,160
Caylor,M,52,77,83,160
Dantavious,M,100,0,160,160
Darcus,F,93,149,11,160
Dashanae,F,100,160,0,160
Delayla,F,100,160,0,160
Devantae,M,100,0,160,160
Doniesha,F,100,160,0,160
Dwon,M,100,0,160,160
Eleshia,F,100,160,0,160
Frankee,F,100,160,0,160
Frannie,F,100,160,0,160
Gabrille,F,100,160,0,160
Gesenia,F,100,160,0,160
Gurshan,M,100,0,160,160
Hebah,F,100,160,0,160
Icela,F,100,160,0,160
Jevante,M,100,0,160,160
Joaopedro,M,100,0,160,160
Joplin,F,97,155,5,160
Jourdon,M,90,16,144,160
Jovahn,M,100,0,160,160
Juanangel,M,100,0,160,160
Kimothy,M,78,35,125,160
Kresta,F,100,160,0,160
Ladarren,M,100,0,160,160
Lathaniel,M,100,0,160,160
Leshonda,F,100,160,0,160
Letetia,F,100,160,0,160
Lorely,F,100,160,0,160
Luwanna,F,100,160,0,160
Maimuna,F,100,160,0,160
Nation,M,97,5,155,160
Nishat,F,100,160,0,160
Otelia,F,100,160,0,160
Otisha,F,100,160,0,160
Paysen,F,74,119,41,160
Providence,F,100,160,0,160
Qianna,F,100,160,0,160
Ralynn,F,100,160,0,160
Reeya,F,100,160,0,160
Reshad,M,100,0,160,160
Rheba,F,100,160,0,160
Samanvi,F,100,160,0,160
Shailah,F,100,160,0,160
Shantai,F,100,160,0,160
Shemiah,F,100,160,0,160
Shinita,F,100,160,0,160
Shonette,F,100,160,0,160
Si,M,88,19,141,160
Sorah,F,100,160,0,160
Tamanna,F,100,160,0,160
Tauheedah,F,100,160,0,160
Tekla,F,100,160,0,160
Trinady,F,100,160,0,160
Trivia,F,100,160,0,160
Valjean,F,100,160,0,160
Varshini,F,100,160,0,160
Veva,F,100,160,0,160
Vishwa,M,93,11,149,160
Zanaria,F,100,160,0,160
Zayaan,M,100,0,160,160
Aariel,F,100,159,0,159
Abishai,M,87,20,139,159
Amanpreet,F,79,125,34,159
Amelio,M,100,0,159,159
Amontae,M,100,0,159,159
Ancel,M,100,0,159,159
Anella,F,100,159,0,159
Ashvin,M,100,0,159,159
Averill,M,85,24,135,159
Birtha,F,100,159,0,159
Bresha,F,100,159,0,159
Chakia,F,100,159,0,159
Chike,M,100,0,159,159
Cowen,M,100,0,159,159
Damarea,M,94,10,149,159
Daziyah,F,100,159,0,159
Deakin,M,100,0,159,159
Deshonna,F,100,159,0,159
Devanee,F,100,159,0,159
Dhanya,F,100,159,0,159
Divante,M,100,0,159,159
Eliska,F,100,159,0,159
Emmalynne,F,100,159,0,159
Eryck,M,100,0,159,159
Estefanny,F,100,159,0,159
Etai,M,100,0,159,159
Eziah,M,97,5,154,159
Foxx,M,100,0,159,159
Francelia,F,100,159,0,159
Gadge,M,100,0,159,159
Gershom,M,100,0,159,159
Gurjot,M,96,6,153,159
Hema,F,100,159,0,159
Isack,M,100,0,159,159
Issis,F,100,159,0,159
Jaidy,F,100,159,0,159
Jamori,M,100,0,159,159
Janeliz,F,100,159,0,159
Jaquawn,M,100,0,159,159
Jaquelinne,F,100,159,0,159
Jerik,M,100,0,159,159
Jeselle,F,100,159,0,159
Jhan,M,97,5,154,159
Jinelle,F,100,159,0,159
Johnathin,M,100,0,159,159
Kalyna,F,100,159,0,159
Kamilia,F,100,159,0,159
Keevan,M,100,0,159,159
Khadeejah,F,100,159,0,159
Koleman,M,100,0,159,159
Kynslie,F,100,159,0,159
Lafaye,F,100,159,0,159
Laiyla,F,100,159,0,159
Lauriann,F,100,159,0,159
Lucine,F,100,159,0,159
Lurline,F,100,159,0,159
Maryfer,F,100,159,0,159
Mayola,F,100,159,0,159
Mikolaj,M,100,0,159,159
Niajah,F,100,159,0,159
Nyasiah,F,100,159,0,159
Oasis,F,97,154,5,159
Ranny,M,97,5,154,159
Raynor,M,100,0,159,159
Rickell,F,100,159,0,159
Rielyn,F,97,154,5,159
Rolly,M,100,0,159,159
Sahvanna,F,100,159,0,159
Sarit,F,100,159,0,159
Shabana,F,100,159,0,159
Sharicka,F,100,159,0,159
Shayle,F,100,159,0,159
Shekira,F,100,159,0,159
Sonoma,F,100,159,0,159
Taeveon,M,100,0,159,159
Tameaka,F,100,159,0,159
Tariana,F,100,159,0,159
Tomeca,F,100,159,0,159
Tonga,F,100,159,0,159
Uday,M,100,0,159,159
Vela,F,100,159,0,159
Wonder,F,100,159,0,159
Yarixa,F,100,159,0,159
Yasenia,F,100,159,0,159
Zakyah,F,100,159,0,159
Aadarsh,M,100,0,158,158
Abbee,F,100,158,0,158
Adaora,F,100,158,0,158
Ahmaya,F,100,158,0,158
Airi,F,100,158,0,158
Amante,M,100,0,158,158
Amantha,F,100,158,0,158
Asenath,F,100,158,0,158
Athea,F,100,158,0,158
Bekah,F,100,158,0,158
Betzabe,F,100,158,0,158
Bhavik,M,100,0,158,158
Brenee,F,100,158,0,158
Brigetta,F,100,158,0,158
Chadwin,M,100,0,158,158
Chastelyn,F,100,158,0,158
Danashia,F,100,158,0,158
Daquawn,M,100,0,158,158
Destina,F,100,158,0,158
Deveron,M,100,0,158,158
Donique,F,77,122,36,158
Edon,M,100,0,158,158
Enijah,F,100,158,0,158
Etha,F,100,158,0,158
Eustace,M,100,0,158,158
Fatumata,F,100,158,0,158
Gilman,M,100,0,158,158
Herberth,M,100,0,158,158
Hilde,F,100,158,0,158
Idalys,F,100,158,0,158
Jacquette,F,100,158,0,158
Jahanna,F,100,158,0,158
Jahmeer,M,100,0,158,158
Jaisean,M,100,0,158,158
Jaleal,M,100,0,158,158
Jancie,F,100,158,0,158
Jaque,M,85,23,135,158
Jelina,F,100,158,0,158
Jennise,F,100,158,0,158
Joanmarie,F,100,158,0,158
Jolyne,F,100,158,0,158
Kaelynne,F,100,158,0,158
Kamile,F,100,158,0,158
Kayo,M,97,5,153,158
Kowen,M,100,0,158,158
Kymoni,M,68,50,108,158
Madesyn,F,100,158,0,158
Mardee,F,100,158,0,158
Marquavion,M,100,0,158,158
Mileidy,F,100,158,0,158
Mohsen,M,100,0,158,158
Muad,M,100,0,158,158
Nero,M,100,0,158,158
Niobe,F,100,158,0,158
Novaleigh,F,100,158,0,158
Paxten,M,84,26,132,158
Rashay,F,100,158,0,158
Reannah,F,100,158,0,158
Retina,F,100,158,0,158
Riad,M,100,0,158,158
Ronae,F,100,158,0,158
Serenitie,F,100,158,0,158
Shawnika,F,100,158,0,158
Shyhiem,M,100,0,158,158
Silviano,M,100,0,158,158
Sten,M,100,0,158,158
Stepfon,M,100,0,158,158
Talonda,F,100,158,0,158
Tayelor,F,100,158,0,158
Taygan,F,87,138,20,158
Tell,M,100,0,158,158
Traniya,F,100,158,0,158
Travaughn,M,100,0,158,158
Tywone,M,100,0,158,158
Urias,M,100,0,158,158
Xzayvion,M,100,0,158,158
Yarden,F,58,92,66,158
Yizel,F,100,158,0,158
Youssouf,M,100,0,158,158
Zalia,F,100,158,0,158
Zayquan,M,100,0,158,158
Zettie,F,97,153,5,158
Ziyana,F,100,158,0,158
Aaria,F,100,157,0,157
Alvia,F,68,106,51,157
Amanee,F,100,157,0,157
Anda,F,100,157,0,157
Ansen,M,100,0,157,157
Antara,F,100,157,0,157
Ashad,M,100,0,157,157
Berneice,F,100,157,0,157
Brendaliz,F,100,157,0,157
Briony,F,100,157,0,157
Carrina,F,100,157,0,157
Caytlyn,F,100,157,0,157
Chaley,F,100,157,0,157
Charlayne,F,100,157,0,157
Cordarryl,M,100,0,157,157
Darnice,F,100,157,0,157
Dary,M,85,24,133,157
Deontaye,M,100,0,157,157
Dolph,M,100,0,157,157
Domini,F,100,157,0,157
Draylon,M,100,0,157,157
Edwing,M,100,0,157,157
Erez,M,100,0,157,157
Gabrella,F,100,157,0,157
Garo,M,100,0,157,157
Graclyn,F,100,157,0,157
Idolina,F,100,157,0,157
Illana,F,100,157,0,157
Jacqueli,F,100,157,0,157
Jaishaun,M,100,0,157,157
Jakiera,F,100,157,0,157
Jalila,F,100,157,0,157
Javae,F,74,116,41,157
Jayleene,F,100,157,0,157
Jazelyn,F,100,157,0,157
Jeily,F,100,157,0,157
Jenese,F,100,157,0,157
Jenicka,F,100,157,0,157
Jodiann,F,100,157,0,157
Julya,F,100,157,0,157
Kateleen,F,100,157,0,157
Kember,F,100,157,0,157
Kennita,F,100,157,0,157
Keshonda,F,100,157,0,157
Khale,M,100,0,157,157
Khalib,M,100,0,157,157
Kimblery,F,100,157,0,157
Kwana,F,100,157,0,157
Lasharon,F,100,157,0,157
Latori,F,100,157,0,157
Lielle,F,100,157,0,157
Marcha,F,100,157,0,157
Miakoda,F,100,157,0,157
Morning,F,100,157,0,157
Mylei,F,100,157,0,157
Nazaret,F,78,123,34,157
Nemiah,M,54,72,85,157
Nini,F,100,157,0,157
Nychelle,F,100,157,0,157
Pasqual,M,100,0,157,157
Saed,M,100,0,157,157
Selam,F,100,157,0,157
Shakiah,F,100,157,0,157
Shantana,F,100,157,0,157
Sharetha,F,100,157,0,157
Shaterrica,F,100,157,0,157
Shavanna,F,100,157,0,157
Sheronica,F,100,157,0,157
Symeon,M,100,0,157,157
Taheerah,F,100,157,0,157
Taleshia,F,100,157,0,157
Tationa,F,100,157,0,157
Trevino,M,100,0,157,157
Ulysess,M,100,0,157,157
Vartan,M,100,0,157,157
Vyctoria,F,100,157,0,157
Wadell,M,100,0,157,157
Wassim,M,100,0,157,157
Wilver,M,100,0,157,157
Wrangler,M,100,0,157,157
Yaremi,F,100,157,0,157
Yazmyne,F,100,157,0,157
Yeraldi,F,100,157,0,157
Yoshiko,F,100,157,0,157
Zabian,M,100,0,157,157
Zenab,F,100,157,0,157
Zuleica,F,100,157,0,157
Zyann,F,100,157,0,157
Adelena,F,100,156,0,156
Akaylah,F,100,156,0,156
Allah,M,100,0,156,156
Alyviah,F,100,156,0,156
Ammaar,M,100,0,156,156
Anjolina,F,100,156,0,156
Annelies,F,100,156,0,156
Annise,F,100,156,0,156
Antonieta,F,100,156,0,156
Avanna,F,100,156,0,156
Bailei,F,100,156,0,156
Basha,F,100,156,0,156
Bevelyn,F,100,156,0,156
Braxon,M,100,0,156,156
Breuna,F,100,156,0,156
Brysin,M,100,0,156,156
Camiah,F,100,156,0,156
Capone,M,100,0,156,156
Charlina,F,100,156,0,156
Delontae,M,100,0,156,156
Demarie,F,67,104,52,156
Deondrea,F,56,88,68,156
Devann,F,95,148,8,156
Dimetrius,M,100,0,156,156
Eleftherios,M,100,0,156,156
Eriyana,F,100,156,0,156
Hadar,F,100,156,0,156
Hamlet,M,100,0,156,156
Jalyne,F,94,146,10,156
Jamina,F,100,156,0,156
Jasun,M,100,0,156,156
Jayzen,M,100,0,156,156
Jermiyah,F,89,139,17,156
Jessicamarie,F,100,156,0,156
Jinan,F,97,151,5,156
Joanny,F,97,151,5,156
Jwan,M,87,20,136,156
Karlisha,F,100,156,0,156
Keirston,F,100,156,0,156
Kelaiah,F,100,156,0,156
Lacheryl,F,100,156,0,156
Lamiracle,F,100,156,0,156
Laruen,F,100,156,0,156
Lashika,F,100,156,0,156
Laythan,M,100,0,156,156
Leahna,F,100,156,0,156
Leno,M,100,0,156,156
Loralye,F,100,156,0,156
Luane,F,100,156,0,156
Lynleigh,F,100,156,0,156
Mailen,F,100,156,0,156
Marvelous,M,75,39,117,156
Mija,F,100,156,0,156
Monserrate,F,78,122,34,156
Nansi,F,100,156,0,156
Navarro,M,100,0,156,156
Nikeria,F,100,156,0,156
Ohn,M,100,0,156,156
Ortencia,F,100,156,0,156
Ozan,M,100,0,156,156
Quindell,M,100,0,156,156
Quinnlyn,F,100,156,0,156
Raziyah,F,100,156,0,156
Reinhard,M,100,0,156,156
Rosalea,F,100,156,0,156
Seara,F,100,156,0,156
Sehar,F,100,156,0,156
Shawnmichael,M,100,0,156,156
Sherlonda,F,100,156,0,156
Shine,F,67,104,52,156
Simuel,M,100,0,156,156
Sofiah,F,100,156,0,156
Somya,F,100,156,0,156
Teliyah,F,100,156,0,156
Tierany,F,100,156,0,156
Tiffine,F,100,156,0,156
Tomeko,F,100,156,0,156
Trust,M,71,45,111,156
Tyechia,F,100,156,0,156
Yomayra,F,100,156,0,156
Yony,M,100,0,156,156
Yulitza,F,100,156,0,156
Zaryiah,F,100,156,0,156
Zelie,F,100,156,0,156
Aamari,M,57,67,88,155
Abdulkareem,M,100,0,155,155
Abri,F,100,155,0,155
Ahlana,F,100,155,0,155
Altair,F,55,86,69,155
Anastyn,F,100,155,0,155
Areyana,F,100,155,0,155
Aryona,F,100,155,0,155
Azhane,F,100,155,0,155
Bengie,M,100,0,155,155
Bosco,M,100,0,155,155
Brenin,M,97,5,150,155
Briany,F,100,155,0,155
Catori,F,100,155,0,155
Caysie,F,100,155,0,155
Chade,F,88,137,18,155
Chalon,F,86,133,22,155
Chesnie,F,100,155,0,155
Conard,M,100,0,155,155
Coulson,M,100,0,155,155
Cyndel,F,100,155,0,155
Cystal,F,100,155,0,155
Danialle,F,100,155,0,155
Darshawn,M,100,0,155,155
Deforest,M,100,0,155,155
Dennisse,F,100,155,0,155
Devaney,F,100,155,0,155
Dorri,F,100,155,0,155
Eidan,M,100,0,155,155
Evanne,F,100,155,0,155
Harlo,F,77,120,35,155
Hassen,M,100,0,155,155
Jaleia,F,100,155,0,155
Janaysia,F,100,155,0,155
Jandi,F,100,155,0,155
Javious,M,100,0,155,155
Jermari,M,100,0,155,155
Jonh,M,100,0,155,155
Joyanne,F,100,155,0,155
Julionna,F,100,155,0,155
Kadarrius,M,100,0,155,155
Karlei,F,100,155,0,155
Katilin,F,100,155,0,155
Kenyona,F,100,155,0,155
Khalel,M,100,0,155,155
Koston,M,100,0,155,155
Lachele,F,100,155,0,155
Lacoya,F,100,155,0,155
Larysa,F,100,155,0,155
Laurana,F,100,155,0,155
Layanna,F,100,155,0,155
Macala,F,100,155,0,155
Madailein,F,100,155,0,155
Mael,M,100,0,155,155
Mattalyn,F,100,155,0,155
Moiz,M,100,0,155,155
Neka,F,100,155,0,155
Pal,M,94,10,145,155
Pepe,M,100,0,155,155
Raihan,M,100,0,155,155
Rashee,M,100,0,155,155
Reubin,M,100,0,155,155
Sadhana,F,100,155,0,155
Semisi,M,100,0,155,155
Skyllar,F,100,155,0,155
Slayden,M,100,0,155,155
Stephonie,F,100,155,0,155
Suhayla,F,100,155,0,155
Suhaylah,F,100,155,0,155
Tavi,F,68,105,50,155
Terisha,F,100,155,0,155
Tilford,M,100,0,155,155
Timo,M,100,0,155,155
Tita,F,100,155,0,155
Tujuana,F,100,155,0,155
Vasco,M,100,0,155,155
Yamira,F,100,155,0,155
Abigial,F,100,154,0,154
Adael,M,100,0,154,154
Akanksha,F,100,154,0,154
Alexias,F,100,154,0,154
Alianah,F,100,154,0,154
Analeise,F,100,154,0,154
Armany,M,100,0,154,154
Arora,F,100,154,0,154
Arshdeep,M,86,21,133,154
Aryiana,F,100,154,0,154
Aryianna,F,100,154,0,154
Ashiyah,F,100,154,0,154
Ayo,M,56,68,86,154
Azad,M,100,0,154,154
Azara,F,100,154,0,154
Azuri,F,100,154,0,154
Braniyah,F,100,154,0,154
Brean,F,94,144,10,154
Breandan,M,100,0,154,154
Brieonna,F,100,154,0,154
Carmell,F,92,142,12,154
Charls,M,100,0,154,154
Charman,F,100,154,0,154
Crysten,F,100,154,0,154
Dazhane,F,100,154,0,154
Deamonte,M,100,0,154,154
Delaynee,F,100,154,0,154
Dezman,M,100,0,154,154
Donley,M,100,0,154,154
Edwinna,F,100,154,0,154
Elenna,F,100,154,0,154
Elisandra,F,100,154,0,154
Embree,F,100,154,0,154
Erricka,F,100,154,0,154
Findley,M,69,47,107,154
Glenis,F,97,149,5,154
Glenys,F,100,154,0,154
Gracemarie,F,100,154,0,154
Hydia,F,100,154,0,154
Iridiana,F,100,154,0,154
Izaih,M,100,0,154,154
Jaekwon,M,100,0,154,154
Jevaughn,M,100,0,154,154
Jonanthony,M,100,0,154,154
Josealberto,M,100,0,154,154
Jozalyn,F,100,154,0,154
Justiss,F,88,136,18,154
Kalid,M,100,0,154,154
Kamarii,F,54,83,71,154
Karnell,M,100,0,154,154
Kawon,M,100,0,154,154
Kechia,F,100,154,0,154
Keighley,F,100,154,0,154
Kentravious,M,100,0,154,154
Khalon,M,100,0,154,154
Kimie,F,100,154,0,154
Kimla,F,100,154,0,154
Krithik,M,100,0,154,154
Ladarrion,M,100,0,154,154
Laurann,F,100,154,0,154
Makayle,F,100,154,0,154
Manveer,M,94,10,144,154
Marnae,F,100,154,0,154
Matson,M,100,0,154,154
Nakeem,M,100,0,154,154
Nanea,F,100,154,0,154
Natara,F,100,154,0,154
Oluwadarasimi,F,64,98,56,154
Ornella,F,100,154,0,154
Ranjit,M,100,0,154,154
Remedy,F,97,149,5,154
Rhya,F,100,154,0,154
Roberts,M,100,0,154,154
Rochester,M,100,0,154,154
Sandrine,F,100,154,0,154
Shakeera,F,100,154,0,154
Sharonna,F,100,154,0,154
Shaunette,F,100,154,0,154
Shequila,F,100,154,0,154
Shilynn,F,100,154,0,154
Stelios,M,100,0,154,154
Taleia,F,100,154,0,154
Travontae,M,100,0,154,154
Trezure,F,100,154,0,154
Tryton,M,100,0,154,154
Tycho,M,100,0,154,154
Tyiana,F,100,154,0,154
Tylasia,F,100,154,0,154
Tysheem,M,100,0,154,154
Tyteanna,F,100,154,0,154
Vikrant,M,100,0,154,154
Vinod,M,100,0,154,154
Yuriy,M,100,0,154,154
Zarahi,F,100,154,0,154
Zhana,F,100,154,0,154
Zhi,M,89,17,137,154
Adisa,F,58,89,64,153
Alem,M,100,0,153,153
Alyra,F,100,153,0,153
Amaurie,M,56,68,85,153
Amoreena,F,100,153,0,153
Anaijah,F,100,153,0,153
Angee,F,100,153,0,153
Angelisse,F,100,153,0,153
Aravind,M,100,0,153,153
Arieon,M,57,66,87,153
Arryanna,F,100,153,0,153
Artesha,F,100,153,0,153
Atoya,F,100,153,0,153
Azayla,F,100,153,0,153
Blanton,M,100,0,153,153
Braycen,M,100,0,153,153
Bronda,F,100,153,0,153
Calahan,M,100,0,153,153
Calton,M,100,0,153,153
Clotilde,F,100,153,0,153
Danford,M,100,0,153,153
Danilynn,F,100,153,0,153
Deairra,F,100,153,0,153
Deontra,M,88,18,135,153
Diogenes,M,100,0,153,153
Doak,M,100,0,153,153
Doriana,F,100,153,0,153
Eavan,F,96,147,6,153
Emmary,F,100,153,0,153
Francella,F,100,153,0,153
Gaylin,F,52,80,73,153
Graciano,M,100,0,153,153
Haleem,M,100,0,153,153
Inaki,M,100,0,153,153
Isiac,M,100,0,153,153
Jaclin,F,100,153,0,153
Jafari,M,100,0,153,153
Jakell,M,96,6,147,153
Jashanti,F,100,153,0,153
Jerral,M,100,0,153,153
Joscelynn,F,100,153,0,153
Juandavid,M,100,0,153,153
Justene,F,100,153,0,153
Juwuan,M,100,0,153,153
Kaiana,F,100,153,0,153
Kalyse,F,100,153,0,153
Karington,F,100,153,0,153
Kasai,M,100,0,153,153
Kden,M,100,0,153,153
Khalani,F,90,138,15,153
Khristen,F,100,153,0,153
Kimyata,F,100,153,0,153
Lamarkus,M,100,0,153,153
Lashia,F,100,153,0,153
Liany,F,100,153,0,153
Maitland,F,70,107,46,153
Marbin,M,100,0,153,153
Marguis,M,100,0,153,153
Merelyn,F,100,153,0,153
Milli,F,100,153,0,153
Monserratt,F,100,153,0,153
Myrle,F,54,83,70,153
Naasia,F,100,153,0,153
Navayah,F,100,153,0,153
Qais,M,100,0,153,153
Rajanae,F,100,153,0,153
Raneen,F,100,153,0,153
Rendy,F,89,136,17,153
Rennee,F,100,153,0,153
Rhonna,F,100,153,0,153
Riaan,M,100,0,153,153
Rilan,M,90,15,138,153
Rupa,F,100,153,0,153
Santi,M,86,22,131,153
Surie,F,100,153,0,153
Tameia,F,100,153,0,153
Tammatha,F,100,153,0,153
Tarena,F,100,153,0,153
Tashonna,F,100,153,0,153
Timiyah,F,100,153,0,153
Tris,F,61,94,59,153
Velisa,F,100,153,0,153
Viktoriya,F,100,153,0,153
Yitzhak,M,100,0,153,153
Yukari,F,100,153,0,153
Yukiko,F,100,153,0,153
Zyniah,F,100,153,0,153
Ainara,F,100,152,0,152
Akita,F,100,152,0,152
Alaiza,F,100,152,0,152
Aleja,F,100,152,0,152
Audrinna,F,100,152,0,152
Beautifull,F,100,152,0,152
Breslin,M,62,57,95,152
Briceson,M,100,0,152,152
Briyah,F,100,152,0,152
Cassandr,F,100,152,0,152
Chelcey,F,100,152,0,152
Chelly,F,100,152,0,152
Dahiana,F,100,152,0,152
Damira,F,100,152,0,152
Darria,F,100,152,0,152
Dasiah,F,100,152,0,152
Delsin,M,100,0,152,152
Deran,M,100,0,152,152
Derriona,F,100,152,0,152
Dervin,M,100,0,152,152
Diontay,M,100,0,152,152
Diontre,M,100,0,152,152
Donda,F,100,152,0,152
Dotti,F,100,152,0,152
Drelyn,M,100,0,152,152
Ellieana,F,100,152,0,152
Eluterio,M,100,0,152,152
Garvey,M,100,0,152,152
Gavrielle,F,100,152,0,152
Haide,F,100,152,0,152
Isaul,M,100,0,152,152
Izzac,M,100,0,152,152
Jakorey,M,100,0,152,152
Jarreau,M,100,0,152,152
Jazmeen,F,100,152,0,152
Jezel,F,100,152,0,152
Johnay,F,100,152,0,152
Jonai,F,97,147,5,152
Jorryn,M,51,75,77,152
Josealfredo,M,100,0,152,152
Juandaniel,M,100,0,152,152
Kang,F,71,108,44,152
Keldric,M,100,0,152,152
Kenlyn,F,93,142,10,152
Keyante,M,96,6,146,152
Krishawn,M,92,12,140,152
Kuulei,F,100,152,0,152
Lakeidra,F,100,152,0,152
Latanga,F,100,152,0,152
Leyland,M,100,0,152,152
Loletta,F,100,152,0,152
Makynli,F,100,152,0,152
Makynzi,F,100,152,0,152
Mercadez,F,100,152,0,152
Nardos,F,100,152,0,152
Nathalee,F,100,152,0,152
Nowell,M,100,0,152,152
Nyzaiah,M,100,0,152,152
Omaria,F,100,152,0,152
Oyuki,F,100,152,0,152
Roena,F,100,152,0,152
Shauntee,F,100,152,0,152
Shayann,F,100,152,0,152
Sophiamarie,F,100,152,0,152
Srihan,M,100,0,152,152
Sumedha,F,100,152,0,152
Timothea,F,100,152,0,152
Tuwanna,F,100,152,0,152
Tyera,F,100,152,0,152
Wen,M,57,65,87,152
Wilfrid,M,100,0,152,152
Winda,F,100,152,0,152
Yarnell,F,58,88,64,152
Zaydon,M,100,0,152,152
Adrick,M,100,0,151,151
Alichia,F,100,151,0,151
Ankush,M,100,0,151,151
Annya,F,100,151,0,151
Apoorva,F,100,151,0,151
Barbarann,F,100,151,0,151
Beonca,F,100,151,0,151
Brentin,M,100,0,151,151
Bryse,M,96,6,145,151
Burk,M,100,0,151,151
Carnel,M,100,0,151,151
Ceclia,F,100,151,0,151
Chekesha,F,100,151,0,151
Dawood,M,100,0,151,151
Deerica,F,100,151,0,151
Delcie,F,100,151,0,151
Denessa,F,100,151,0,151
Desmen,M,100,0,151,151
Elaysha,F,100,151,0,151
Elienai,F,100,151,0,151
Eluzer,M,100,0,151,151
Emiah,F,100,151,0,151
Emilo,M,100,0,151,151
Esiah,M,100,0,151,151
Eustacia,F,100,151,0,151
Faria,F,100,151,0,151
Fatemah,F,100,151,0,151
Guiselle,F,100,151,0,151
Heavan,F,100,151,0,151
Hershal,M,100,0,151,151
Irelynd,F,100,151,0,151
Jaclyne,F,100,151,0,151
Jacobey,M,100,0,151,151
Jahron,M,100,0,151,151
Jamise,F,100,151,0,151
Janaria,F,100,151,0,151
Jaxtyn,M,100,0,151,151
Jerlean,F,100,151,0,151
Jersi,F,100,151,0,151
Jessice,F,100,151,0,151
Jonay,F,100,151,0,151
Karsin,M,83,26,125,151
Keelen,M,100,0,151,151
Khady,F,100,151,0,151
Kiren,M,78,33,118,151
Latavius,M,100,0,151,151
Latorria,F,100,151,0,151
Leilene,F,100,151,0,151
Leslyn,F,100,151,0,151
Lorenia,F,100,151,0,151
Macaila,F,100,151,0,151
Magaret,F,100,151,0,151
Maleeah,F,100,151,0,151
Marigrace,F,100,151,0,151
Mercie,F,100,151,0,151
Mishal,F,97,146,5,151
Muaz,M,100,0,151,151
Nohealani,F,100,151,0,151
Nusrat,F,100,151,0,151
Orlena,F,100,151,0,151
Pama,F,100,151,0,151
Patches,F,100,151,0,151
Quashon,M,100,0,151,151
Saranya,F,100,151,0,151
Shakenya,F,100,151,0,151
Shaquel,F,52,78,73,151
Shavonta,F,93,141,10,151
Shawnn,M,71,44,107,151
Sheray,F,100,151,0,151
Shermika,F,100,151,0,151
Shuree,F,100,151,0,151
Steen,M,100,0,151,151
Stepheni,F,100,151,0,151
Symia,F,100,151,0,151
Tannar,M,93,10,141,151
Tanveer,M,81,29,122,151
Tanyon,M,100,0,151,151
Tasheika,F,100,151,0,151
Tationna,F,100,151,0,151
Tericka,F,100,151,0,151
Topacio,F,100,151,0,151
Vermell,F,100,151,0,151
Vienne,F,100,151,0,151
Yates,M,100,0,151,151
Yitzel,F,100,151,0,151
Yuko,F,100,151,0,151
Yuriel,M,100,0,151,151
Zayde,M,83,25,126,151
Alquan,M,100,0,150,150
Ameshia,F,100,150,0,150
Angelys,F,100,150,0,150
Arshan,M,100,0,150,150
Assad,M,100,0,150,150
Bridgitt,F,100,150,0,150
Brittanni,F,100,150,0,150
Chena,F,100,150,0,150
Chezney,F,100,150,0,150
Courage,M,87,19,131,150
Creedence,M,75,37,113,150
Crescencio,M,100,0,150,150
Crystalann,F,100,150,0,150
Daliana,F,100,150,0,150
Davarion,M,100,0,150,150
Dorin,M,86,21,129,150
Eilis,F,100,150,0,150
Elea,F,100,150,0,150
Falicity,F,100,150,0,150
Guilianna,F,100,150,0,150
Harmonii,F,100,150,0,150
Hikaru,M,88,18,132,150
Hoy,M,100,0,150,150
Isabele,F,100,150,0,150
Ithzel,F,100,150,0,150
Izan,M,100,0,150,150
Jacqulyne,F,100,150,0,150
Jairen,M,100,0,150,150
Jakim,M,100,0,150,150
Jalonda,F,100,150,0,150
Janayla,F,100,150,0,150
Jathen,M,100,0,150,150
Jaydeen,F,51,77,73,150
Jaydien,M,100,0,150,150
Jeffey,M,100,0,150,150
Jerrit,M,100,0,150,150
Jiovany,M,100,0,150,150
Jnai,F,100,150,0,150
Jull,F,100,150,0,150
Kanyla,F,100,150,0,150
Kazuma,M,100,0,150,150
Kedron,M,97,5,145,150
Kenyotta,F,87,130,20,150
Kenzey,F,100,150,0,150
Kharis,F,97,145,5,150
Kielee,F,100,150,0,150
Kristell,F,100,150,0,150
Krystl,F,100,150,0,150
Kynzee,F,100,150,0,150
Lainy,F,100,150,0,150
Lavert,M,100,0,150,150
Lawan,F,64,96,54,150
Lem,M,100,0,150,150
Librada,F,100,150,0,150
Mariadel,F,100,150,0,150
Maytal,F,100,150,0,150
Miniya,F,100,150,0,150
Mohamud,M,100,0,150,150
Moksh,M,100,0,150,150
Moorea,F,100,150,0,150
Odysseus,M,100,0,150,150
Preciosa,F,100,150,0,150
Quayshaun,M,100,0,150,150
Ramla,F,100,150,0,150
Rashea,F,97,145,5,150
Rayner,M,100,0,150,150
Rhenda,F,100,150,0,150
Rickayla,F,100,150,0,150
Rosangelica,F,100,150,0,150
Roslin,F,100,150,0,150
Sareen,F,100,150,0,150
Sausha,F,100,150,0,150
Shineka,F,100,150,0,150
Tamey,F,100,150,0,150
Tavita,M,77,34,116,150
Tejay,M,100,0,150,150
Temica,F,100,150,0,150
Tequita,F,100,150,0,150
Teresha,F,100,150,0,150
Terrez,M,100,0,150,150
Tiearra,F,100,150,0,150
Tomoki,M,100,0,150,150
Uzma,F,100,150,0,150
Voncille,F,100,150,0,150
Yesli,F,100,150,0,150
Yesmin,F,100,150,0,150
Yousra,F,100,150,0,150
Zanai,F,100,150,0,150
Zariana,F,100,150,0,150
Zayed,M,100,0,150,150
Zyere,M,100,0,150,150
Abrina,F,100,149,0,149
Adja,F,100,149,0,149
Adore,F,91,136,13,149
Alayza,F,100,149,0,149
Allona,F,100,149,0,149
Andranik,M,100,0,149,149
Anessia,F,100,149,0,149
Annalis,F,100,149,0,149
Anneth,F,100,149,0,149
Aqeel,M,100,0,149,149
Arjen,M,100,0,149,149
Ayyub,M,100,0,149,149
Breylin,M,78,33,116,149
Burr,M,100,0,149,149
Calea,F,100,149,0,149
Carolyna,F,100,149,0,149
Cashel,M,100,0,149,149
Chandlar,F,62,93,56,149
Cheris,F,100,149,0,149
Cilicia,F,100,149,0,149
Daemian,M,100,0,149,149
Daiton,M,100,0,149,149
Dajha,F,100,149,0,149
Dama,F,100,149,0,149
Elasia,F,100,149,0,149
Eleri,F,100,149,0,149
Escher,M,100,0,149,149
Evlyn,F,100,149,0,149
Glendia,F,100,149,0,149
Grazia,F,100,149,0,149
Gurney,M,100,0,149,149
Hailynn,F,100,149,0,149
Hasna,F,100,149,0,149
Henessy,F,100,149,0,149
Herve,M,100,0,149,149
Jaclynne,F,100,149,0,149
Jacynda,F,100,149,0,149
Jeanae,F,100,149,0,149
Jemell,M,100,0,149,149
Jenisa,F,100,149,0,149
Jilliane,F,100,149,0,149
Jorrell,M,100,0,149,149
Kalana,F,100,149,0,149
Kaleisha,F,100,149,0,149
Kanna,F,100,149,0,149
Kariem,M,100,0,149,149
Keiyana,F,100,149,0,149
Kimberla,F,100,149,0,149
Laqueena,F,100,149,0,149
Lazarius,M,100,0,149,149
Leonila,F,100,149,0,149
Lorell,F,93,139,10,149
Mahin,M,89,16,133,149
Manaia,F,93,138,11,149
Markale,M,100,0,149,149
Marquize,M,100,0,149,149
Michiah,F,59,88,61,149
Mieshia,F,100,149,0,149
Mylena,F,100,149,0,149
Nefi,M,100,0,149,149
Nissim,M,100,0,149,149
Nochum,M,100,0,149,149
Nyliah,F,100,149,0,149
Pau,M,100,0,149,149
Posey,F,81,120,29,149
Shaquinta,F,100,149,0,149
Shivangi,F,100,149,0,149
Sophiah,F,100,149,0,149
Sosha,F,100,149,0,149
Taijon,M,100,0,149,149
Tamlyn,F,100,149,0,149
Taylormarie,F,100,149,0,149
Tekeisha,F,100,149,0,149
Tifanny,F,100,149,0,149
Traeton,M,100,0,149,149
Trei,M,100,0,149,149
Trevontae,M,100,0,149,149
Tyauna,F,100,149,0,149
Veneta,F,100,149,0,149
Ygnacio,M,100,0,149,149
Zaevion,M,100,0,149,149
Zamyra,F,100,149,0,149
Zerick,M,100,0,149,149
Abbigal,F,100,148,0,148
Aiysha,F,100,148,0,148
Ajene,M,60,59,89,148
Amreen,F,100,148,0,148
Anamika,F,100,148,0,148
Angelamarie,F,100,148,0,148
Annalina,F,100,148,0,148
Annjanette,F,100,148,0,148
Arnelle,F,100,148,0,148
Aum,M,100,0,148,148
Bond,M,96,6,142,148
Bran,M,100,0,148,148
California,F,100,148,0,148
Cambelle,F,100,148,0,148
Cambrea,F,100,148,0,148
Candence,F,100,148,0,148
Chey,M,51,72,76,148
Chinwe,F,100,148,0,148
Christmas,F,100,148,0,148
Cohan,M,100,0,148,148
Cybele,F,100,148,0,148
Cyera,F,100,148,0,148
Damontre,M,100,0,148,148
Dannetta,F,100,148,0,148
Daud,M,100,0,148,148
Davidmichael,M,100,0,148,148
Deepti,F,100,148,0,148
Delan,M,100,0,148,148
Dennard,M,100,0,148,148
Donne,F,61,90,58,148
El,M,100,0,148,148
Elberta,F,100,148,0,148
Elye,M,100,0,148,148
Erling,M,100,0,148,148
Eymi,F,100,148,0,148
Eyob,M,100,0,148,148
Grigor,M,100,0,148,148
Gustavus,M,100,0,148,148
Hareem,F,100,148,0,148
Harshitha,F,100,148,0,148
Hermila,F,100,148,0,148
Ilir,M,100,0,148,148
Iseah,M,100,0,148,148
Ivann,M,100,0,148,148
Jaeliana,F,100,148,0,148
Jaimes,M,100,0,148,148
Jaiyah,F,100,148,0,148
Janoah,M,100,0,148,148
Jarica,F,100,148,0,148
Jerritt,M,100,0,148,148
Jhayden,M,96,6,142,148
Jheri,F,100,148,0,148
Jinnifer,F,100,148,0,148
Josearmando,M,100,0,148,148
Kameela,F,100,148,0,148
Kashonda,F,100,148,0,148
Keisuke,M,100,0,148,148
Kynsleigh,F,100,148,0,148
Lessa,F,100,148,0,148
Ludwin,M,100,0,148,148
Luwanda,F,100,148,0,148
Lynze,F,100,148,0,148
Mariadelosang,F,100,148,0,148
Markes,M,100,0,148,148
Matilynn,F,100,148,0,148
Mellie,F,100,148,0,148
Mercadies,F,100,148,0,148
Minnette,F,100,148,0,148
Nary,F,100,148,0,148
Nickolaos,M,100,0,148,148
Niguel,M,100,0,148,148
Pahoua,F,100,148,0,148
Pakou,F,100,148,0,148
Ramello,M,100,0,148,148
Rozann,F,100,148,0,148
Rozena,F,100,148,0,148
Sairah,F,100,148,0,148
Sakiyah,F,100,148,0,148
Saleah,F,100,148,0,148
Samiyyah,F,100,148,0,148
Samyuktha,F,100,148,0,148
Seif,M,100,0,148,148
Shalie,F,100,148,0,148
Sharronda,F,100,148,0,148
Shauntavia,F,100,148,0,148
Sheriann,F,100,148,0,148
Sherryann,F,100,148,0,148
Suellyn,F,100,148,0,148
Tanaysia,F,100,148,0,148
Tandrea,F,100,148,0,148
Vivia,F,100,148,0,148
Waynetta,F,100,148,0,148
Wenonah,F,100,148,0,148
Yahshua,M,100,0,148,148
Yesly,F,100,148,0,148
Zaheer,M,100,0,148,148
Zaiah,F,56,83,65,148
Adasyn,F,100,147,0,147
Alantis,F,100,147,0,147
Alphonsa,M,100,0,147,147
Amala,F,100,147,0,147
Amilyah,F,100,147,0,147
Anabeth,F,100,147,0,147
Annelie,F,100,147,0,147
Calbert,M,100,0,147,147
Carnetta,F,100,147,0,147
Cerys,F,100,147,0,147
Cloyce,M,100,0,147,147
Dalessandro,M,100,0,147,147
Danity,F,100,147,0,147
Danniella,F,100,147,0,147
Deicy,F,100,147,0,147
Delando,M,100,0,147,147
Delford,M,100,0,147,147
Denaja,F,100,147,0,147
Donnavan,M,100,0,147,147
Estefano,M,100,0,147,147
Exie,F,100,147,0,147
Fia,F,100,147,0,147
Goerge,M,100,0,147,147
Hanako,F,100,147,0,147
Heliodoro,M,100,0,147,147
Henriette,F,100,147,0,147
Hibba,F,100,147,0,147
Ishia,F,100,147,0,147
Iszabella,F,100,147,0,147
Iveliz,F,100,147,0,147
Jaedynn,F,89,131,16,147
Jalasia,F,100,147,0,147
Jameah,F,100,147,0,147
Jedrek,M,100,0,147,147
Jigar,M,100,0,147,147
Joseguadalupe,M,100,0,147,147
Kahron,M,100,0,147,147
Kalaysia,F,100,147,0,147
Kaleab,M,100,0,147,147
Keandria,F,100,147,0,147
Kelsa,F,100,147,0,147
Kollyn,M,96,6,141,147
Laiah,F,100,147,0,147
Lawrencia,F,100,147,0,147
Lennix,M,64,53,94,147
Markees,M,100,0,147,147
Markeise,M,100,0,147,147
Mattisyn,F,100,147,0,147
Mckenzye,F,100,147,0,147
Meigan,F,100,147,0,147
Miarose,F,100,147,0,147
Mitesh,M,100,0,147,147
Moris,M,100,0,147,147
Mykale,M,84,23,124,147
Nahuel,M,100,0,147,147
Nyquan,M,100,0,147,147
Osher,M,100,0,147,147
Pearse,M,100,0,147,147
Philipe,M,100,0,147,147
Reagyn,F,100,147,0,147
Riggins,M,100,0,147,147
Rogerick,M,100,0,147,147
Shaily,F,100,147,0,147
Shakeeta,F,100,147,0,147
Shakinah,F,100,147,0,147
Shenea,F,100,147,0,147
Shondrea,F,100,147,0,147
Simaya,F,100,147,0,147
Stevey,F,84,124,23,147
Tahra,F,100,147,0,147
Tanji,F,100,147,0,147
Tarick,M,100,0,147,147
Tenleigh,F,100,147,0,147
Thara,F,100,147,0,147
Toniesha,F,100,147,0,147
Tryniti,F,100,147,0,147
Usha,F,100,147,0,147
Zohair,M,100,0,147,147
Aidian,M,100,0,146,146
Anaira,F,100,146,0,146
Anjalee,F,100,146,0,146
Arrionna,F,100,146,0,146
Azion,M,86,21,125,146
Blanchie,F,100,146,0,146
Brinnley,F,100,146,0,146
Caid,M,100,0,146,146
Calisa,F,100,146,0,146
Caprisha,F,100,146,0,146
Caya,F,100,146,0,146
Chrisean,M,100,0,146,146
Cuahutemoc,M,100,0,146,146
Dahmir,M,100,0,146,146
Damontay,M,100,0,146,146
Dayrin,F,100,146,0,146
Daziah,F,100,146,0,146
Detron,M,100,0,146,146
Dorlisa,F,100,146,0,146
Dorn,M,92,12,134,146
Dyllin,M,100,0,146,146
Emmilee,F,100,146,0,146
Emrey,F,77,112,34,146
Geanine,F,100,146,0,146
Geneve,F,100,146,0,146
Haeleigh,F,100,146,0,146
Hawken,M,100,0,146,146
Hildegard,F,100,146,0,146
Imaad,M,100,0,146,146
Isella,F,100,146,0,146
Iyahna,F,100,146,0,146
Jachob,M,100,0,146,146
Janila,F,100,146,0,146
Jasaun,M,100,0,146,146
Jimy,M,100,0,146,146
Joas,M,100,0,146,146
Joshual,M,100,0,146,146
Julita,F,100,146,0,146
Juwaun,M,100,0,146,146
Kanyia,F,100,146,0,146
Kayman,M,86,21,125,146
Keanon,M,100,0,146,146
Kerisha,F,100,146,0,146
Keymon,M,100,0,146,146
Khaleed,M,100,0,146,146
Khristi,F,100,146,0,146
Kitara,F,100,146,0,146
Kourosh,M,100,0,146,146
Krisi,F,100,146,0,146
Kyani,F,100,146,0,146
Kyiesha,F,100,146,0,146
Laketra,F,100,146,0,146
Lanorris,M,100,0,146,146
Lasheika,F,100,146,0,146
Laticha,F,100,146,0,146
Lindalee,F,100,146,0,146
Madelena,F,100,146,0,146
Melquiades,M,100,0,146,146
Mikylah,F,100,146,0,146
Mindel,F,100,146,0,146
Moosa,M,100,0,146,146
Natacia,F,100,146,0,146
Nayshawn,M,100,0,146,146
Niana,F,100,146,0,146
Nicloe,F,100,146,0,146
Oshae,M,100,0,146,146
Rachelann,F,100,146,0,146
Raeshaun,M,100,0,146,146
Raziah,F,100,146,0,146
Reah,F,100,146,0,146
Renarda,F,97,141,5,146
Rhanda,F,100,146,0,146
Sadarius,M,100,0,146,146
Santosh,M,100,0,146,146
Shadman,M,100,0,146,146
Shanikka,F,100,146,0,146
Shantara,F,100,146,0,146
Shevelle,F,100,146,0,146
Starlena,F,100,146,0,146
Taci,F,100,146,0,146
Taisa,F,100,146,0,146
Tanieka,F,100,146,0,146
Theopolis,M,100,0,146,146
Thermon,M,100,0,146,146
Torben,M,100,0,146,146
Trason,M,100,0,146,146
Tyress,M,100,0,146,146
Vaidehi,F,100,146,0,146
Veasna,M,100,0,146,146
Veleka,F,100,146,0,146
Vin,M,100,0,146,146
Vivika,F,100,146,0,146
Yarah,F,100,146,0,146
Yaret,F,67,98,48,146
Yohann,M,100,0,146,146
Yoshi,M,75,36,110,146
Zyshawn,M,100,0,146,146
Aerilyn,F,100,145,0,145
Ahmar,M,100,0,145,145
Airiel,F,100,145,0,145
Alle,F,100,145,0,145
Ambert,F,100,145,0,145
Arlind,M,100,0,145,145
Avriana,F,100,145,0,145
Bekim,M,100,0,145,145
Beverely,F,100,145,0,145
Brandolyn,F,100,145,0,145
Breeona,F,100,145,0,145
Breindel,F,100,145,0,145
Brenleigh,F,100,145,0,145
Brenyn,M,74,37,108,145
Briani,F,100,145,0,145
Chalee,F,100,145,0,145
Cheyeanne,F,100,145,0,145
Chrishelle,F,100,145,0,145
Connery,M,100,0,145,145
Coreyon,M,100,0,145,145
Danira,F,100,145,0,145
Fernado,M,100,0,145,145
Haidar,M,100,0,145,145
Hunt,M,100,0,145,145
Jahkari,M,100,0,145,145
Jaimey,F,83,120,25,145
Jalisia,F,100,145,0,145
Jams,M,100,0,145,145
Jamyrah,F,100,145,0,145
Jayliah,F,100,145,0,145
Jazilyn,F,100,145,0,145
Jazper,M,100,0,145,145
Jencarlo,M,100,0,145,145
Jshaun,M,100,0,145,145
Kaizer,M,100,0,145,145
Kalonji,M,100,0,145,145
Kendallyn,F,100,145,0,145
Kepler,M,100,0,145,145
Keshara,F,100,145,0,145
Kieana,F,100,145,0,145
Kieu,F,100,145,0,145
Kiyona,F,100,145,0,145
Kymir,M,100,0,145,145
Laquinda,F,100,145,0,145
Legrand,M,100,0,145,145
Locklyn,F,93,135,10,145
Lundy,M,93,10,135,145
Makaiyah,F,100,145,0,145
Maleaha,F,100,145,0,145
Maley,F,100,145,0,145
Marlyce,F,100,145,0,145
Maryiah,F,100,145,0,145
Meaghann,F,100,145,0,145
Montavis,M,100,0,145,145
Mykalah,F,100,145,0,145
Mykenzi,F,100,145,0,145
Naarah,F,100,145,0,145
Naquisha,F,100,145,0,145
Nezar,M,100,0,145,145
Nili,F,100,145,0,145
Nomi,F,100,145,0,145
Noya,F,100,145,0,145
Nyaire,M,63,54,91,145
Pollie,F,100,145,0,145
Ralonda,F,100,145,0,145
Raydell,M,100,0,145,145
Ressie,F,100,145,0,145
Rodarius,M,100,0,145,145
Rorey,M,63,53,92,145
Saina,F,100,145,0,145
Sallee,F,100,145,0,145
Setareh,F,100,145,0,145
Shaqueta,F,100,145,0,145
Sharifah,F,100,145,0,145
Shaterria,F,100,145,0,145
Shaundrea,F,100,145,0,145
Shearon,F,100,145,0,145
Sherhonda,F,100,145,0,145
Silena,F,100,145,0,145
Sorin,M,97,5,140,145
Srinika,F,100,145,0,145
Stanely,M,100,0,145,145
Suella,F,100,145,0,145
Takuya,M,100,0,145,145
Taliana,F,100,145,0,145
Tallia,F,100,145,0,145
Tamrah,F,100,145,0,145
Terel,M,100,0,145,145
Thadd,M,100,0,145,145
Trease,F,100,145,0,145
Tyronica,F,100,145,0,145
Vaeda,F,100,145,0,145
Vernica,F,100,145,0,145
Viren,M,100,0,145,145
Vyom,M,100,0,145,145
Xzavien,M,100,0,145,145
Zabdi,F,81,117,28,145
Zaidee,F,100,145,0,145
Aidenn,M,100,0,144,144
Almarosa,F,100,144,0,144
Altovise,F,100,144,0,144
Andreka,F,100,144,0,144
Anett,F,100,144,0,144
Aqib,M,100,0,144,144
Australia,F,100,144,0,144
Ayriel,F,100,144,0,144
Berish,M,100,0,144,144
Breslyn,F,100,144,0,144
Briea,F,100,144,0,144
Brynnan,F,100,144,0,144
Caedence,F,100,144,0,144
Carmie,F,100,144,0,144
Catheryne,F,100,144,0,144
Celise,F,100,144,0,144
Chailyn,F,100,144,0,144
Chaitanya,M,100,0,144,144
Chaslyn,F,100,144,0,144
Cornellius,M,100,0,144,144
Damyen,M,100,0,144,144
Datron,M,100,0,144,144
Dierre,M,100,0,144,144
Donie,F,54,78,66,144
Ernesta,F,100,144,0,144
Euna,F,100,144,0,144
Eustacio,M,100,0,144,144
Eyden,M,97,5,139,144
Fianna,F,100,144,0,144
Genesi,F,100,144,0,144
Gwenith,F,100,144,0,144
Hameed,M,100,0,144,144
Hamsa,M,100,0,144,144
Hollyanne,F,100,144,0,144
Ia,F,100,144,0,144
Jakirah,F,100,144,0,144
Janes,M,100,0,144,144
Jasenia,F,100,144,0,144
Jowan,M,100,0,144,144
Julann,F,100,144,0,144
Keymari,M,77,33,111,144
Khristie,F,100,144,0,144
Laakea,M,93,10,134,144
Lamone,M,100,0,144,144
Larico,M,100,0,144,144
Latrisa,F,100,144,0,144
Layloni,F,100,144,0,144
Legion,M,100,0,144,144
Lenon,M,100,0,144,144
Liese,F,100,144,0,144
Lindzie,F,100,144,0,144
Makail,M,100,0,144,144
Mariadelaluz,F,100,144,0,144
Markeia,F,100,144,0,144
Merrisa,F,100,144,0,144
Micaila,F,100,144,0,144
Mickelle,F,100,144,0,144
Nitika,F,100,144,0,144
Osten,M,100,0,144,144
Patsey,F,100,144,0,144
Princeston,M,100,0,144,144
Rechel,F,100,144,0,144
Reida,F,100,144,0,144
Ryhanna,F,100,144,0,144
Sakara,F,100,144,0,144
Seniyah,F,100,144,0,144
Shaili,F,100,144,0,144
Shareece,F,100,144,0,144
Sharniece,F,100,144,0,144
Shonia,F,100,144,0,144
Shuntae,F,100,144,0,144
Shyquan,M,100,0,144,144
Sigurd,M,100,0,144,144
Skyann,F,100,144,0,144
Tamalyn,F,100,144,0,144
Tanicia,F,100,144,0,144
Tayona,F,100,144,0,144
Tkai,F,50,72,72,144
Travoris,M,100,0,144,144
Tyaire,M,97,5,139,144
Vicke,F,100,144,0,144
Xue,M,76,34,110,144
Yaroslav,M,100,0,144,144
Zeniya,F,100,144,0,144
Zuhayr,M,100,0,144,144
Zuriah,F,96,138,6,144
Adalaide,F,100,143,0,143
Adilee,F,100,143,0,143
Ahan,M,100,0,143,143
Ahnya,F,100,143,0,143
Alicianna,F,100,143,0,143
Ashwini,F,100,143,0,143
Averiana,F,100,143,0,143
Baran,M,83,25,118,143
Bell,F,90,128,15,143
Benoit,M,100,0,143,143
Betsi,F,100,143,0,143
Braedin,M,100,0,143,143
Brasen,M,100,0,143,143
Breonia,F,100,143,0,143
Bryler,M,100,0,143,143
Captain,M,100,0,143,143
Carnesha,F,100,143,0,143
Catcher,M,100,0,143,143
Catlynn,F,100,143,0,143
Caylea,F,100,143,0,143
Chandel,F,100,143,0,143
Clemencia,F,100,143,0,143
Daissy,F,100,143,0,143
Danett,F,100,143,0,143
Daquann,M,100,0,143,143
Darcella,F,100,143,0,143
Davanee,F,100,143,0,143
Deborh,F,100,143,0,143
Dominie,M,96,6,137,143
Elah,F,100,143,0,143
Eveny,F,100,143,0,143
Ezinne,F,100,143,0,143
Fabianna,F,100,143,0,143
Florrie,F,100,143,0,143
Harrietta,F,100,143,0,143
Jahziah,M,92,11,132,143
Jakwan,M,100,0,143,143
Jalexia,F,100,143,0,143
Janeah,F,100,143,0,143
Jenaye,F,100,143,0,143
Joahan,M,100,0,143,143
Joangel,M,100,0,143,143
Jodey,M,65,50,93,143
Joniya,F,100,143,0,143
Jonnette,F,100,143,0,143
Joseh,M,100,0,143,143
Juliannah,F,100,143,0,143
Jullianna,F,100,143,0,143
Jusitn,M,100,0,143,143
Kaysey,F,100,143,0,143
Khadim,M,100,0,143,143
Lachrisha,F,100,143,0,143
Lanecia,F,100,143,0,143
Lariya,F,100,143,0,143
Latangela,F,100,143,0,143
Lj,M,100,0,143,143
Lucita,F,100,143,0,143
Mailin,F,100,143,0,143
Mazzie,F,100,143,0,143
Morgon,M,71,42,101,143
Myley,F,100,143,0,143
Naje,F,78,111,32,143
Netasha,F,100,143,0,143
Nilo,M,100,0,143,143
Noriko,F,100,143,0,143
Ranika,F,100,143,0,143
Rosemaria,F,100,143,0,143
Sayre,M,57,62,81,143
Semya,F,100,143,0,143
Shandiin,F,100,143,0,143
Sharlena,F,100,143,0,143
Shikira,F,100,143,0,143
Sira,F,100,143,0,143
Stephanine,F,100,143,0,143
Suliman,M,100,0,143,143
Tallan,M,100,0,143,143
Tamantha,F,100,143,0,143
Tavious,M,100,0,143,143
Tianni,F,100,143,0,143
Tinya,F,100,143,0,143
Tyaira,F,100,143,0,143
Veera,F,100,143,0,143
Verlean,F,100,143,0,143
Wesleigh,F,97,138,5,143
Yandell,M,100,0,143,143
Zaahir,M,100,0,143,143
Zaelynn,F,100,143,0,143
Zidan,M,100,0,143,143
Zyrah,F,100,143,0,143
Abhimanyu,M,100,0,142,142
Absalom,M,100,0,142,142
Ameliya,F,100,142,0,142
Aranda,F,100,142,0,142
Aspasia,F,100,142,0,142
Atalaya,F,100,142,0,142
Badr,M,100,0,142,142
Baine,M,100,0,142,142
Bich,F,100,142,0,142
Bindi,F,100,142,0,142
Brayten,M,100,0,142,142
Bryli,F,100,142,0,142
Burma,F,100,142,0,142
Cashus,M,100,0,142,142
Chanson,M,100,0,142,142
Christyl,F,100,142,0,142
Couper,M,100,0,142,142
Daniil,M,100,0,142,142
Danuta,F,100,142,0,142
Daritza,F,100,142,0,142
Demitris,M,100,0,142,142
Dorreen,F,100,142,0,142
Dracen,M,100,0,142,142
Drakkar,M,100,0,142,142
Ehtan,M,100,0,142,142
Eliyas,M,100,0,142,142
Else,F,100,142,0,142
Emanuella,F,100,142,0,142
Fiorela,F,100,142,0,142
Gabryela,F,100,142,0,142
Geovannie,M,100,0,142,142
Halana,F,100,142,0,142
Haniyyah,F,100,142,0,142
Haynes,M,100,0,142,142
Ilham,F,96,137,5,142
Inita,F,100,142,0,142
Jadian,M,89,16,126,142
Jaelyne,F,100,142,0,142
Jamisyn,F,96,137,5,142
Janaki,F,100,142,0,142
Jarrette,M,100,0,142,142
Jayston,M,100,0,142,142
Jetaun,F,100,142,0,142
Karagan,F,100,142,0,142
Karista,F,100,142,0,142
Keniel,M,100,0,142,142
Kenyonna,F,100,142,0,142
Kiylee,F,100,142,0,142
Kordae,M,100,0,142,142
Kristalynn,F,100,142,0,142
Laytoya,F,100,142,0,142
Lilyonna,F,100,142,0,142
Livvy,F,100,142,0,142
Malaka,F,100,142,0,142
Mariem,F,100,142,0,142
Meeya,F,100,142,0,142
Michole,F,100,142,0,142
Milayna,F,100,142,0,142
Monik,F,100,142,0,142
Nadyne,F,100,142,0,142
Nyemah,F,100,142,0,142
Ory,M,100,0,142,142
Peyson,F,58,83,59,142
Pieper,F,100,142,0,142
Quenna,F,100,142,0,142
Rafferty,M,100,0,142,142
Raisha,F,100,142,0,142
Rameses,M,100,0,142,142
Reneka,F,100,142,0,142
Ruari,F,61,87,55,142
Sabrea,F,100,142,0,142
Saheed,M,100,0,142,142
Scotlynn,F,100,142,0,142
Segundo,M,100,0,142,142
Seriyah,F,100,142,0,142
Shaddai,F,82,116,26,142
Shemia,F,100,142,0,142
Shunte,F,100,142,0,142
Silvina,F,100,142,0,142
Takuma,M,100,0,142,142
Tanaysha,F,100,142,0,142
Tavyn,M,92,12,130,142
Tuvia,M,100,0,142,142
Tyreak,M,100,0,142,142
Urania,F,100,142,0,142
Zakarie,M,100,0,142,142
Zeva,F,100,142,0,142
Zniyah,F,100,142,0,142
Zoua,F,100,142,0,142
Abdimalik,M,100,0,141,141
Adelisa,F,100,141,0,141
Ahmiya,F,100,141,0,141
Airica,F,100,141,0,141
Alverto,M,100,0,141,141
Aneri,F,100,141,0,141
Anjolaoluwa,F,96,136,5,141
Anjoli,F,100,141,0,141
Arvilla,F,100,141,0,141
Audryna,F,100,141,0,141
Bettylou,F,100,141,0,141
Brunetta,F,100,141,0,141
Brytni,F,100,141,0,141
Camaryn,F,100,141,0,141
Carney,M,96,6,135,141
Cartrell,M,100,0,141,141
Cashay,F,100,141,0,141
Chellsea,F,100,141,0,141
Cintya,F,100,141,0,141
Cotey,M,100,0,141,141
Creek,M,100,0,141,141
Dariona,F,100,141,0,141
Darlisa,F,100,141,0,141
Daundre,M,100,0,141,141
Demontray,M,100,0,141,141
Devanny,F,100,141,0,141
Diani,F,100,141,0,141
Dinari,M,100,0,141,141
Edmar,M,100,0,141,141
Eduin,M,100,0,141,141
Ellieanna,F,100,141,0,141
Francy,F,100,141,0,141
Geofrey,M,100,0,141,141
Georgana,F,100,141,0,141
Gyanna,F,100,141,0,141
Hiliary,F,100,141,0,141
Hoyle,M,100,0,141,141
Iyani,F,100,141,0,141
Jacorie,M,100,0,141,141
Jalaine,F,100,141,0,141
Jaleeyah,F,100,141,0,141
Jatniel,M,100,0,141,141
Jatoya,F,100,141,0,141
Jenya,F,100,141,0,141
Jhamir,M,100,0,141,141
Josedaniel,M,100,0,141,141
Joshia,M,100,0,141,141
Jurnie,F,100,141,0,141
Juvon,M,100,0,141,141
Jyair,M,100,0,141,141
Karlen,F,89,125,16,141
Karmel,F,86,121,20,141
Keriana,F,100,141,0,141
Key,M,93,10,131,141
Keysi,F,100,141,0,141
Kritika,F,100,141,0,141
Laketia,F,100,141,0,141
Laqueshia,F,100,141,0,141
Lequisha,F,100,141,0,141
Lowry,M,93,10,131,141
Loyda,F,100,141,0,141
Lukah,M,100,0,141,141
Luken,M,100,0,141,141
Makinze,F,100,141,0,141
Man,M,65,49,92,141
Markeem,M,100,0,141,141
Matei,M,100,0,141,141
Mathea,F,100,141,0,141
Matteus,M,100,0,141,141
Mellony,F,100,141,0,141
Michaelia,F,100,141,0,141
Minahil,F,100,141,0,141
Minha,F,100,141,0,141
Mycal,M,100,0,141,141
Nareg,M,100,0,141,141
Nemesis,F,100,141,0,141
Nicolis,M,100,0,141,141
Nyeema,F,100,141,0,141
Orman,M,100,0,141,141
Raymar,M,100,0,141,141
Rheanne,F,100,141,0,141
Richerd,M,100,0,141,141
Scottlyn,F,100,141,0,141
Sema,F,100,141,0,141
Shawnya,F,100,141,0,141
Sherleen,F,100,141,0,141
Stephana,F,100,141,0,141
Symiah,F,100,141,0,141
Tahji,M,100,0,141,141
Taison,M,100,0,141,141
Tanmay,M,100,0,141,141
Timoty,M,100,0,141,141
Tramain,M,100,0,141,141
Traniyah,F,100,141,0,141
Verita,F,100,141,0,141
Weyman,M,100,0,141,141
Wynonna,F,100,141,0,141
Zacaria,F,81,114,27,141
Zairah,F,100,141,0,141
Adom,M,100,0,140,140
Ahmiyah,F,100,140,0,140
Ailis,F,100,140,0,140
Alaylah,F,100,140,0,140
Alissah,F,100,140,0,140
Amauria,F,100,140,0,140
Ariely,F,100,140,0,140
Arleene,F,100,140,0,140
Arryana,F,100,140,0,140
Aveion,M,100,0,140,140
Ayzia,F,100,140,0,140
Brogen,M,100,0,140,140
Chantry,M,100,0,140,140
Chellie,F,100,140,0,140
Cowan,M,100,0,140,140
Davit,M,100,0,140,140
Dawnna,F,100,140,0,140
Dayanne,F,100,140,0,140
Deny,M,100,0,140,140
Dresean,M,100,0,140,140
Elek,M,100,0,140,140
Ellenor,F,100,140,0,140
Erasto,M,100,0,140,140
Fartun,F,100,140,0,140
Hannahgrace,F,100,140,0,140
Hendy,F,100,140,0,140
Herny,M,100,0,140,140
Heyden,M,100,0,140,140
Iantha,F,100,140,0,140
Iviana,F,100,140,0,140
Jabron,M,100,0,140,140
Jacoria,F,100,140,0,140
Jakki,F,100,140,0,140
Jannae,F,100,140,0,140
Jessenya,F,100,140,0,140
Juniel,M,100,0,140,140
Karynn,F,100,140,0,140
Kasmira,F,100,140,0,140
Kassity,F,100,140,0,140
Keland,M,100,0,140,140
Kenetra,F,100,140,0,140
Keyshun,M,100,0,140,140
Kinslie,F,100,140,0,140
Kohei,M,100,0,140,140
Kotaro,M,100,0,140,140
Kyair,M,100,0,140,140
Lauriel,F,100,140,0,140
Lavra,F,100,140,0,140
Lazara,F,100,140,0,140
Leyanna,F,100,140,0,140
Macio,M,100,0,140,140
Macsen,M,100,0,140,140
Makaylynn,F,100,140,0,140
Meryn,F,100,140,0,140
Miriya,F,100,140,0,140
Mohini,F,100,140,0,140
Moneisha,F,100,140,0,140
Nakaiya,F,100,140,0,140
Nataki,F,100,140,0,140
Olina,F,100,140,0,140
Oluwatomisin,F,65,91,49,140
Payslee,F,100,140,0,140
Quentina,F,100,140,0,140
Raima,F,100,140,0,140
Raphel,M,100,0,140,140
Reet,F,100,140,0,140
Rewa,F,100,140,0,140
Rhet,M,100,0,140,140
Samaad,M,100,0,140,140
Sanjna,F,100,140,0,140
Shaely,F,100,140,0,140
Shanira,F,100,140,0,140
Shantaya,F,100,140,0,140
Shourya,M,100,0,140,140
Shuntel,F,100,140,0,140
Sieara,F,100,140,0,140
Suresh,M,100,0,140,140
Tearia,F,100,140,0,140
Tiaja,F,100,140,0,140
Tiziana,F,100,140,0,140
Toniya,F,100,140,0,140
Torah,F,100,140,0,140
Vanellope,F,100,140,0,140
Zlata,F,100,140,0,140
Zyire,M,100,0,140,140
Aaleigha,F,100,139,0,139
Aamirah,F,100,139,0,139
Akacia,F,100,139,0,139
Alekhya,F,100,139,0,139
Aleric,M,100,0,139,139
Alf,M,100,0,139,139
Aliha,F,100,139,0,139
Amarionna,F,100,139,0,139
Arta,F,95,132,7,139
Aubriee,F,100,139,0,139
Azadeh,F,100,139,0,139
Batina,F,100,139,0,139
Belvin,M,95,7,132,139
Bernedette,F,100,139,0,139
Brazos,M,100,0,139,139
Breyah,F,100,139,0,139
Caileen,F,100,139,0,139
Callaghan,M,86,19,120,139
Chala,F,100,139,0,139
Cherysh,F,100,139,0,139
Corisa,F,100,139,0,139
Coulton,M,100,0,139,139
Dajanay,F,100,139,0,139
Dally,F,100,139,0,139
Damyia,F,100,139,0,139
Dauna,F,100,139,0,139
Dominyk,M,100,0,139,139
Dorothey,F,100,139,0,139
Ellayna,F,100,139,0,139
Emillia,F,100,139,0,139
Eshawn,M,100,0,139,139
Eveleen,F,100,139,0,139
Franchot,M,100,0,139,139
Gaddiel,M,100,0,139,139
Haroun,M,100,0,139,139
Ilario,M,100,0,139,139
Ileene,F,100,139,0,139
Janos,M,100,0,139,139
Jenin,F,100,139,0,139
Jesaiah,M,100,0,139,139
Jessic,F,100,139,0,139
Jurell,M,100,0,139,139
Kallin,M,83,24,115,139
Kamarah,F,100,139,0,139
Kayliah,F,100,139,0,139
Kelsha,F,100,139,0,139
Kemaya,F,100,139,0,139
Kenedie,F,100,139,0,139
Kerrion,M,87,18,121,139
Khalen,M,96,5,134,139
Klaira,F,100,139,0,139
Lacora,F,100,139,0,139
Lashuna,F,100,139,0,139
Lazette,F,100,139,0,139
Liahna,F,100,139,0,139
Lynia,F,100,139,0,139
Marializ,F,100,139,0,139
Masiel,F,100,139,0,139
Mattheus,M,100,0,139,139
Mckensi,F,100,139,0,139
Mekel,M,88,16,123,139
Naba,F,100,139,0,139
Nikyla,F,100,139,0,139
Porschea,F,100,139,0,139
Ranyah,F,100,139,0,139
Rayneisha,F,100,139,0,139
Renad,F,100,139,0,139
Salene,F,100,139,0,139
Shamarie,F,92,128,11,139
Shamina,F,100,139,0,139
Shaniquia,F,100,139,0,139
Shanty,F,100,139,0,139
Sharlynn,F,100,139,0,139
Shermeka,F,100,139,0,139
Sherral,F,100,139,0,139
Shynia,F,100,139,0,139
Sitlali,F,100,139,0,139
Talli,F,100,139,0,139
Tanaka,F,93,129,10,139
Tenicia,F,100,139,0,139
Terrilee,F,100,139,0,139
Tiffay,F,100,139,0,139
Tima,F,100,139,0,139
Titianna,F,100,139,0,139
Trinaty,F,100,139,0,139
Vira,F,100,139,0,139
Waylin,M,100,0,139,139
Windie,F,100,139,0,139
Yvone,F,100,139,0,139
Zakariyya,M,100,0,139,139
Zayon,M,100,0,139,139
Aashvi,F,100,138,0,138
Abdalrahman,M,100,0,138,138
Aniayah,F,100,138,0,138
Annalysia,F,100,138,0,138
Azaryah,F,75,103,35,138
Benay,F,100,138,0,138
Beren,M,87,18,120,138
Bethannie,F,100,138,0,138
Bhumi,F,100,138,0,138
Bianna,F,100,138,0,138
Bryten,M,95,7,131,138
Cayton,M,80,27,111,138
Daily,F,93,128,10,138
Demarquez,M,100,0,138,138
Desarie,F,100,138,0,138
Dorrine,F,100,138,0,138
Durham,M,100,0,138,138
Eliani,F,100,138,0,138
Eriyanna,F,100,138,0,138
Esaul,M,100,0,138,138
Fayez,M,100,0,138,138
Francetta,F,100,138,0,138
Geniya,F,100,138,0,138
Geraline,F,100,138,0,138
Gerda,F,100,138,0,138
Glady,F,100,138,0,138
Hajra,F,100,138,0,138
Humzah,M,100,0,138,138
Irisa,F,100,138,0,138
Jaeshawn,M,100,0,138,138
Jaliel,M,100,0,138,138
Jayen,M,100,0,138,138
Jordie,M,84,22,116,138
Josalin,F,100,138,0,138
Joseth,M,100,0,138,138
Juddson,M,100,0,138,138
Jumar,M,100,0,138,138
Kashlyn,F,100,138,0,138
Kaulana,M,96,6,132,138
Keah,F,100,138,0,138
Keyairra,F,100,138,0,138
Kiegan,M,96,5,133,138
Kynzi,F,100,138,0,138
Leeam,M,100,0,138,138
Liela,F,100,138,0,138
Lutisha,F,100,138,0,138
Lyndzie,F,100,138,0,138
Madelline,F,100,138,0,138
Makilah,F,100,138,0,138
Matvey,M,100,0,138,138
Meiko,F,64,89,49,138
Merrin,F,100,138,0,138
Mikeria,F,100,138,0,138
Muntaha,F,100,138,0,138
Myliah,F,100,138,0,138
Natelie,F,100,138,0,138
Neaveh,F,100,138,0,138
Nikholas,M,100,0,138,138
Noga,F,100,138,0,138
Paolina,F,100,138,0,138
Ree,F,96,133,5,138
Rolin,M,100,0,138,138
Satoshi,M,100,0,138,138
Seerat,F,100,138,0,138
Seniya,F,100,138,0,138
Shakea,F,100,138,0,138
Shakesha,F,100,138,0,138
Shakirra,F,100,138,0,138
Shalah,F,100,138,0,138
Skeeter,M,91,13,125,138
Tamerra,F,100,138,0,138
Tannen,M,100,0,138,138
Tashiba,F,100,138,0,138
Tata,F,100,138,0,138
Tranell,M,71,40,98,138
Tyrail,M,100,0,138,138
Vallarie,F,100,138,0,138
Zacchary,M,100,0,138,138
Abygayle,F,100,137,0,137
Adewale,M,100,0,137,137
Adir,M,100,0,137,137
Analleli,F,100,137,0,137
Anthonyjames,M,100,0,137,137
Aquan,M,100,0,137,137
Avien,M,100,0,137,137
Ayeisha,F,100,137,0,137
Azarias,M,100,0,137,137
Billal,M,100,0,137,137
Caedan,M,100,0,137,137
Carrah,F,100,137,0,137
Cattaleya,F,100,137,0,137
Charmion,F,100,137,0,137
Chynah,F,100,137,0,137
Davaun,M,100,0,137,137
Deliliah,F,100,137,0,137
Deniqua,F,100,137,0,137
Dessiree,F,100,137,0,137
Draken,M,100,0,137,137
Eithen,M,100,0,137,137
Elajah,F,100,137,0,137
Elara,F,100,137,0,137
Elisheba,F,100,137,0,137
Emidio,M,100,0,137,137
Emmakate,F,100,137,0,137
Espn,M,100,0,137,137
Estanislao,M,100,0,137,137
Falan,F,100,137,0,137
Gaje,M,100,0,137,137
Godric,M,100,0,137,137
Gorman,M,100,0,137,137
Guliana,F,100,137,0,137
Hanifah,F,100,137,0,137
Hasnain,M,100,0,137,137
Ikran,F,100,137,0,137
Ishanvi,F,100,137,0,137
Izaan,M,100,0,137,137
Jalesha,F,100,137,0,137
Jamariya,F,100,137,0,137
Janaiyah,F,100,137,0,137
Janayia,F,100,137,0,137
Jeury,M,100,0,137,137
Jillayne,F,100,137,0,137
Jivan,M,100,0,137,137
Jolleen,F,100,137,0,137
Josejulian,M,100,0,137,137
Jullisa,F,100,137,0,137
Juwana,F,100,137,0,137
Kadar,M,100,0,137,137
Kamylah,F,100,137,0,137
Karelly,F,100,137,0,137
Khalifa,M,100,0,137,137
Khianna,F,100,137,0,137
Kourtnei,F,100,137,0,137
Kuron,M,100,0,137,137
Laparis,F,96,132,5,137
Latravis,M,100,0,137,137
Leeasia,F,100,137,0,137
Lianny,F,100,137,0,137
Lilyth,F,100,137,0,137
Login,M,92,11,126,137
Makyle,M,100,0,137,137
Malayla,F,100,137,0,137
Malyn,F,100,137,0,137
Mandela,M,100,0,137,137
Mazal,F,100,137,0,137
Mehran,M,100,0,137,137
Mekaila,F,100,137,0,137
Michall,M,100,0,137,137
Milta,F,100,137,0,137
Momoko,F,100,137,0,137
Monasia,F,100,137,0,137
Myli,F,100,137,0,137
Natallia,F,100,137,0,137
Naythen,M,100,0,137,137
Nayzeth,F,100,137,0,137
Nelwyn,F,100,137,0,137
Neziah,F,54,74,63,137
Nyna,F,100,137,0,137
Oluwatimilehin,M,100,0,137,137
Ramil,M,100,0,137,137
Ranvir,M,100,0,137,137
Ras,M,100,0,137,137
Rayjon,M,100,0,137,137
Renaye,F,100,137,0,137
Rhondalyn,F,100,137,0,137
Rishawn,M,100,0,137,137
Rocket,M,95,7,130,137
Sagrario,F,100,137,0,137
Saraih,F,100,137,0,137
Savaughn,M,96,5,132,137
Shahad,F,96,132,5,137
Shainna,F,100,137,0,137
Shaquon,M,91,13,124,137
Shayma,F,100,137,0,137
Suleika,F,100,137,0,137
Takeesha,F,100,137,0,137
Tawania,F,100,137,0,137
Tenishia,F,100,137,0,137
Tiffony,F,100,137,0,137
Trinty,F,100,137,0,137
Tyrika,F,100,137,0,137
Venna,F,100,137,0,137
Willim,M,100,0,137,137
Xeng,M,100,0,137,137
Yarelin,F,100,137,0,137
Ysela,F,100,137,0,137
Zainah,F,100,137,0,137
Zaron,M,100,0,137,137
Zuzu,F,100,137,0,137
Adelai,F,100,136,0,136
Adilenne,F,100,136,0,136
Ahjanae,F,100,136,0,136
Ajanay,F,100,136,0,136
Alanya,F,100,136,0,136
Alesana,F,100,136,0,136
Alieu,M,100,0,136,136
Allix,F,100,136,0,136
Ameka,F,100,136,0,136
Aritza,F,100,136,0,136
Aubria,F,100,136,0,136
Aydn,M,100,0,136,136
Azana,F,100,136,0,136
Azel,M,84,22,114,136
Bennetta,F,100,136,0,136
Blessyn,F,100,136,0,136
Britley,F,100,136,0,136
Burhan,M,100,0,136,136
Caily,F,100,136,0,136
Caldwell,M,100,0,136,136
Chais,M,96,5,131,136
Chayson,M,100,0,136,136
Chinmay,M,100,0,136,136
Christasia,F,100,136,0,136
Corydon,M,100,0,136,136
Cybill,F,100,136,0,136
Dalani,F,100,136,0,136
Dariann,F,100,136,0,136
Deunta,M,100,0,136,136
Dez,M,100,0,136,136
Dmonte,M,100,0,136,136
Dontrail,M,100,0,136,136
Dorell,M,100,0,136,136
Dot,F,100,136,0,136
Ellene,F,100,136,0,136
Emalia,F,100,136,0,136
Gera,F,100,136,0,136
Gerell,M,100,0,136,136
Greenley,F,100,136,0,136
Haifa,F,100,136,0,136
Hanzel,M,100,0,136,136
Henretta,F,100,136,0,136
Jabre,M,93,10,126,136
Jadarious,M,100,0,136,136
Jahquez,M,100,0,136,136
Jakaiya,F,100,136,0,136
Jamas,M,100,0,136,136
Jarris,M,100,0,136,136
Javanna,F,100,136,0,136
Jazzy,F,100,136,0,136
Jenilyn,F,100,136,0,136
Jolayne,F,100,136,0,136
Karris,F,100,136,0,136
Keijuan,M,100,0,136,136
Keinan,M,100,0,136,136
Kery,F,56,76,60,136
Kiondra,F,100,136,0,136
Kishaun,M,100,0,136,136
Kissy,F,100,136,0,136
Larron,M,100,0,136,136
Latanja,F,100,136,0,136
Latoy,F,100,136,0,136
Leeta,F,100,136,0,136
Leidi,F,100,136,0,136
Mackinze,F,100,136,0,136
Makynzee,F,100,136,0,136
Manuelito,M,100,0,136,136
Marcayla,F,100,136,0,136
Markela,F,100,136,0,136
Marnell,F,76,104,32,136
Martasia,F,100,136,0,136
Meilyn,F,100,136,0,136
Michalla,F,100,136,0,136
Nastacia,F,100,136,0,136
Natiya,F,100,136,0,136
Paulanthony,M,100,0,136,136
Pio,M,100,0,136,136
Reinhold,M,100,0,136,136
Reyan,M,93,10,126,136
Rhyen,F,73,99,37,136
Rondalyn,F,100,136,0,136
Rowynn,F,100,136,0,136
Rubyann,F,100,136,0,136
Ruthe,F,100,136,0,136
Sehaj,M,54,62,74,136
Shernita,F,100,136,0,136
Sorina,F,100,136,0,136
Stephaie,F,100,136,0,136
Stiven,M,100,0,136,136
Tamyka,F,100,136,0,136
Tenae,F,100,136,0,136
Theia,F,100,136,0,136
Therasa,F,100,136,0,136
Tinlee,F,100,136,0,136
Tollie,M,96,5,131,136
Tyshea,F,100,136,0,136
Vibhav,M,100,0,136,136
Xerxes,M,100,0,136,136
Xitlally,F,100,136,0,136
Yamin,M,100,0,136,136
Yida,M,100,0,136,136
Yoskar,M,100,0,136,136
Zareen,F,100,136,0,136
Abdinasir,M,100,0,135,135
Adanya,F,100,135,0,135
Adriena,F,100,135,0,135
Aivy,F,100,135,0,135
Ajax,M,100,0,135,135
Ajaya,F,100,135,0,135
Akeylah,F,100,135,0,135
Alline,F,100,135,0,135
Alpheus,M,100,0,135,135
Alyas,M,100,0,135,135
Anayia,F,100,135,0,135
Anhthu,F,100,135,0,135
Aras,M,100,0,135,135
Armel,M,100,0,135,135
Askari,M,100,0,135,135
Aslin,F,100,135,0,135
Atzel,M,100,0,135,135
Avishai,M,100,0,135,135
Babacar,M,100,0,135,135
Belvia,F,100,135,0,135
Bobbe,F,100,135,0,135
Brealyn,F,100,135,0,135
Breane,F,100,135,0,135
Breelle,F,100,135,0,135
Brydan,M,100,0,135,135
Cassian,M,100,0,135,135
Charell,F,100,135,0,135
Charidy,F,100,135,0,135
Chasady,F,100,135,0,135
Chez,M,80,27,108,135
Chrishonda,F,100,135,0,135
Cosandra,F,100,135,0,135
Cynara,F,100,135,0,135
Danniela,F,100,135,0,135
Deborahann,F,100,135,0,135
Dewaun,M,100,0,135,135
Dezyre,F,100,135,0,135
Duante,M,100,0,135,135
Edeline,F,100,135,0,135
Emrick,M,100,0,135,135
Emylia,F,100,135,0,135
Faizaan,M,100,0,135,135
Gabbie,F,100,135,0,135
Gorgeous,F,100,135,0,135
Gulianna,F,100,135,0,135
Gurshaan,M,100,0,135,135
Haruto,M,100,0,135,135
Henchy,F,100,135,0,135
Isatu,F,100,135,0,135
Ivelise,F,100,135,0,135
Ivonna,F,100,135,0,135
Iyari,F,96,129,6,135
Jahid,M,100,0,135,135
Javeah,F,100,135,0,135
Jerilee,F,100,135,0,135
Jerryl,M,96,6,129,135
Jetaime,F,100,135,0,135
Jeymi,F,100,135,0,135
Jmarion,M,100,0,135,135
Jveon,M,100,0,135,135
Kadia,F,100,135,0,135
Kamaiya,F,100,135,0,135
Kamariya,F,100,135,0,135
Karne,F,100,135,0,135
Kathee,F,100,135,0,135
Katherinne,F,100,135,0,135
Keari,F,100,135,0,135
Kennede,F,100,135,0,135
Kesa,F,100,135,0,135
Kimbly,F,100,135,0,135
Korynne,F,100,135,0,135
Kwamaine,M,100,0,135,135
Kylieann,F,100,135,0,135
Loise,F,100,135,0,135
Maddelynn,F,100,135,0,135
Mahmud,M,100,0,135,135
March,F,61,82,53,135
Markas,M,100,0,135,135
Marquie,M,80,27,108,135
Mathan,M,100,0,135,135
Maurya,F,93,125,10,135
Meghen,F,100,135,0,135
Micalah,F,100,135,0,135
Michaeal,M,100,0,135,135
Minnah,F,100,135,0,135
Moet,F,100,135,0,135
Monifah,F,100,135,0,135
Myelle,F,100,135,0,135
Namita,F,100,135,0,135
Neesa,F,100,135,0,135
Noele,F,100,135,0,135
Nonnie,F,100,135,0,135
Oluwatobiloba,M,83,23,112,135
Pate,M,100,0,135,135
Phuoc,M,100,0,135,135
Phylisha,F,100,135,0,135
Phyllicia,F,100,135,0,135
Random,M,100,0,135,135
Rashia,F,100,135,0,135
Rayya,F,100,135,0,135
Rehman,M,100,0,135,135
Reisha,F,100,135,0,135
Rendi,F,100,135,0,135
Renelda,F,100,135,0,135
Rhandi,F,100,135,0,135
Roderica,F,100,135,0,135
Ronnika,F,100,135,0,135
Sanaz,F,100,135,0,135
Saree,F,100,135,0,135
Saysha,F,100,135,0,135
Serenah,F,100,135,0,135
Shahab,M,100,0,135,135
Shaquanta,F,100,135,0,135
Shaunita,F,100,135,0,135
Shital,F,100,135,0,135
Sidonie,F,100,135,0,135
Taequan,M,100,0,135,135
Telitha,F,100,135,0,135
Tephanie,F,100,135,0,135
Thayden,M,100,0,135,135
Tiawana,F,100,135,0,135
Velencia,F,100,135,0,135
Verneda,F,100,135,0,135
Xianna,F,100,135,0,135
Yasmyn,F,100,135,0,135
Abbagale,F,100,134,0,134
Adhrit,M,100,0,134,134
Adolpho,M,100,0,134,134
Aivah,F,100,134,0,134
Aizlynn,F,100,134,0,134
Alizia,F,100,134,0,134
Almee,F,100,134,0,134
Amyri,F,100,134,0,134
Anaeli,F,100,134,0,134
Areyanna,F,100,134,0,134
Arlina,F,100,134,0,134
Aruna,F,100,134,0,134
Ashyia,F,100,134,0,134
Aubrii,F,100,134,0,134
Bravlio,M,100,0,134,134
Breven,M,100,0,134,134
Briselda,F,100,134,0,134
Calais,F,100,134,0,134
Camil,F,64,86,48,134
Caree,F,100,134,0,134
Carrson,M,100,0,134,134
Chakita,F,100,134,0,134
Chivas,M,100,0,134,134
Constantin,M,100,0,134,134
Cordera,M,100,0,134,134
Crislyn,F,100,134,0,134
Damareon,M,100,0,134,134
Danaka,F,100,134,0,134
Dannel,M,85,20,114,134
Demetress,F,91,122,12,134
Demitrus,M,100,0,134,134
Deyna,F,100,134,0,134
Dyonna,F,100,134,0,134
Elaijah,F,96,129,5,134
Emira,F,100,134,0,134
Emonnie,F,100,134,0,134
England,F,91,122,12,134
Finola,F,100,134,0,134
Francies,F,100,134,0,134
Frankey,M,96,5,129,134
Icesis,F,100,134,0,134
Isahi,M,100,0,134,134
Jakeisha,F,100,134,0,134
Jaquille,M,100,0,134,134
Jeanni,F,100,134,0,134
Jeramia,M,100,0,134,134
Josaphine,F,100,134,0,134
Joshuan,M,100,0,134,134
Jumaane,M,100,0,134,134
Kanden,M,100,0,134,134
Kapil,M,100,0,134,134
Kaysea,F,100,134,0,134
Khylen,M,100,0,134,134
Kumari,F,77,103,31,134
Lagena,F,100,134,0,134
Laquincy,M,100,0,134,134
Lekita,F,100,134,0,134
Lilja,F,100,134,0,134
Linea,F,100,134,0,134
Lopaka,M,100,0,134,134
Marcquis,M,100,0,134,134
Marenda,F,100,134,0,134
Marri,F,100,134,0,134
Martrice,F,92,123,11,134
Mcguire,M,100,0,134,134
Moe,M,58,56,78,134
Monie,F,100,134,0,134
Nathanyal,M,100,0,134,134
Nazirah,F,100,134,0,134
Omunique,F,100,134,0,134
Orchid,F,100,134,0,134
Pastor,M,100,0,134,134
Prabhjot,M,87,17,117,134
Quynn,F,100,134,0,134
Reade,M,100,0,134,134
Ricquel,F,100,134,0,134
Roneka,F,100,134,0,134
Ronnica,F,100,134,0,134
Rosalita,F,100,134,0,134
Roslind,F,100,134,0,134
Ruairi,M,100,0,134,134
Ruhan,M,100,0,134,134
Sabriyah,F,100,134,0,134
Sanjuan,M,100,0,134,134
Sarin,F,92,123,11,134
Satoria,F,100,134,0,134
Sencere,M,100,0,134,134
Seri,F,100,134,0,134
Sevana,F,100,134,0,134
Shalondra,F,100,134,0,134
Shelbylynn,F,100,134,0,134
Sherel,F,100,134,0,134
Shivansh,M,100,0,134,134
Smita,F,100,134,0,134
Stanislaus,M,100,0,134,134
Starsky,M,100,0,134,134
Tanai,F,100,134,0,134
Tanielle,F,100,134,0,134
Tiamarie,F,100,134,0,134
Timea,F,100,134,0,134
Torsha,F,100,134,0,134
Tredarius,M,100,0,134,134
Trentan,M,100,0,134,134
Tresten,M,100,0,134,134
Treydon,M,100,0,134,134
Trinna,F,100,134,0,134
Uchechukwu,M,82,24,110,134
Valiant,M,100,0,134,134
Verma,F,100,134,0,134
Younis,M,100,0,134,134
Zalaya,F,100,134,0,134
Zaleah,F,100,134,0,134
Aarionna,F,100,133,0,133
Adonys,M,100,0,133,133
Agron,M,100,0,133,133
Aiana,F,100,133,0,133
Aizlyn,F,100,133,0,133
Akesha,F,100,133,0,133
Akylah,F,100,133,0,133
Alhassan,M,100,0,133,133
Alyze,F,100,133,0,133
Ameira,F,100,133,0,133
Ariatna,F,100,133,0,133
Averianna,F,100,133,0,133
Avina,F,100,133,0,133
Brayley,F,100,133,0,133
Brettany,F,100,133,0,133
Britanee,F,100,133,0,133
Caitlinn,F,100,133,0,133
Cardarius,M,100,0,133,133
Cebastian,M,100,0,133,133
Cheick,M,100,0,133,133
Con,M,100,0,133,133
Desirie,F,100,133,0,133
Donatello,M,100,0,133,133
Erienne,F,100,133,0,133
Evangelene,F,100,133,0,133
Evani,F,100,133,0,133
Facundo,M,100,0,133,133
Harding,M,100,0,133,133
Hollace,F,96,128,5,133
Jaiyden,M,96,5,128,133
Jalaina,F,100,133,0,133
Jhanae,F,100,133,0,133
Jilleen,F,100,133,0,133
Jozi,F,100,133,0,133
Juanna,F,100,133,0,133
Kamayah,F,100,133,0,133
Kearney,M,61,52,81,133
Kemontae,M,100,0,133,133
Khushbu,F,100,133,0,133
Klea,F,100,133,0,133
Krithika,F,100,133,0,133
Laporche,F,100,133,0,133
Linday,F,100,133,0,133
Linnaea,F,100,133,0,133
Loraina,F,100,133,0,133
Lorea,F,100,133,0,133
Macrina,F,100,133,0,133
Makaelyn,F,100,133,0,133
Mal,M,100,0,133,133
Malakhai,M,100,0,133,133
Maleeyah,F,100,133,0,133
Maquita,F,100,133,0,133
Mariavictoria,F,100,133,0,133
Mathhew,M,100,0,133,133
Mauriah,F,100,133,0,133
Mayana,F,100,133,0,133
Mckinzy,F,100,133,0,133
Meggen,F,100,133,0,133
Mehek,F,100,133,0,133
Melisssa,F,100,133,0,133
Milaya,F,100,133,0,133
Nirvan,M,100,0,133,133
Niza,F,100,133,0,133
Owin,M,100,0,133,133
Palin,F,100,133,0,133
Raela,F,100,133,0,133
Ramzey,M,100,0,133,133
Rayen,F,53,71,62,133
Rhesa,F,100,133,0,133
Rhilynn,F,100,133,0,133
Robertha,F,100,133,0,133
Rockland,M,100,0,133,133
Savien,M,100,0,133,133
Semaje,M,80,26,107,133
Serigne,M,100,0,133,133
Shanard,M,100,0,133,133
Shawndrea,F,100,133,0,133
Shayra,F,100,133,0,133
Sheera,F,100,133,0,133
Shloka,F,100,133,0,133
Shwanda,F,100,133,0,133
Sireen,F,100,133,0,133
Skarlette,F,100,133,0,133
Skippy,M,100,0,133,133
Sojourner,F,100,133,0,133
Solace,F,68,90,43,133
Sophonie,F,100,133,0,133
Suzzane,F,100,133,0,133
Syrah,F,100,133,0,133
Taggert,M,100,0,133,133
Taneil,F,100,133,0,133
Taryne,F,100,133,0,133
Tashan,M,92,10,123,133
Thalya,F,100,133,0,133
Tilton,M,100,0,133,133
Tiwan,M,92,10,123,133
Trevyon,M,100,0,133,133
Veyda,F,100,133,0,133
Wilhemenia,F,100,133,0,133
Woodley,M,100,0,133,133
Xaivier,M,100,0,133,133
Yachet,F,100,133,0,133
Zayvian,M,100,0,133,133
Zierra,F,100,133,0,133
Aashish,M,100,0,132,132
Afra,F,100,132,0,132
Ahlia,F,100,132,0,132
Akhilesh,M,100,0,132,132
Ambrie,F,100,132,0,132
Anjelo,M,100,0,132,132
Antavion,M,100,0,132,132
Artelia,F,100,132,0,132
Aryon,M,76,32,100,132
Aubrianne,F,100,132,0,132
Avantae,M,100,0,132,132
Brealynn,F,100,132,0,132
Briena,F,100,132,0,132
Camar,M,100,0,132,132
Cariana,F,100,132,0,132
Carime,F,100,132,0,132
Carling,F,100,132,0,132
Chalene,F,100,132,0,132
Chaniece,F,100,132,0,132
Cherica,F,100,132,0,132
Cheyan,F,100,132,0,132
Dajuana,F,100,132,0,132
Darely,F,100,132,0,132
Deavin,M,96,5,127,132
Dreya,F,100,132,0,132
Elisah,M,72,37,95,132
Fishel,M,100,0,132,132
Gerica,F,100,132,0,132
Haasini,F,100,132,0,132
Iara,F,100,132,0,132
Jacole,F,96,127,5,132
Jacoya,F,100,132,0,132
Jafeth,M,100,0,132,132
Jailyne,F,100,132,0,132
Jaxtin,M,100,0,132,132
Jaydrian,M,100,0,132,132
Jaydy,F,100,132,0,132
Jodette,F,100,132,0,132
Kathlean,F,100,132,0,132
Kaydie,F,100,132,0,132
Kaydra,F,100,132,0,132
Kaysan,M,100,0,132,132
Keiyon,M,100,0,132,132
Kyser,M,100,0,132,132
Magaby,F,100,132,0,132
Mailynn,F,100,132,0,132
Margaretmary,F,100,132,0,132
Merranda,F,100,132,0,132
Michille,F,100,132,0,132
Minal,F,100,132,0,132
Mirage,F,96,127,5,132
Nashali,F,100,132,0,132
Naszir,M,100,0,132,132
Nikkol,F,100,132,0,132
Noralee,F,100,132,0,132
Peniel,M,59,54,78,132
Prophet,M,100,0,132,132
Ranferi,M,100,0,132,132
Rayshard,M,100,0,132,132
Renise,F,100,132,0,132
Rolla,M,96,5,127,132
Santasia,F,100,132,0,132
Savahna,F,100,132,0,132
Seher,F,100,132,0,132
Shelise,F,100,132,0,132
Shenica,F,100,132,0,132
Sherolyn,F,100,132,0,132
Sheza,F,100,132,0,132
Shoni,F,100,132,0,132
Stephaun,M,100,0,132,132
Stesha,F,100,132,0,132
Syre,M,100,0,132,132
Tavaras,M,100,0,132,132
Tennile,F,100,132,0,132
Trig,M,100,0,132,132
Tyffani,F,100,132,0,132
Tylisa,F,100,132,0,132
Tyrina,F,100,132,0,132
Valyn,F,100,132,0,132
Veverly,F,100,132,0,132
Victora,F,100,132,0,132
Waco,M,100,0,132,132
Yadriel,M,100,0,132,132
Yussef,M,100,0,132,132
Addisynn,F,100,131,0,131
Ahmere,M,100,0,131,131
Aideen,F,74,97,34,131
Akaysha,F,100,131,0,131
Amalio,M,100,0,131,131
Angeligue,F,100,131,0,131
Antuane,M,100,0,131,131
Apryle,F,100,131,0,131
Arlenne,F,100,131,0,131
Arlethia,F,100,131,0,131
Artyom,M,100,0,131,131
Bensen,M,100,0,131,131
Betzayda,F,100,131,0,131
Braidan,M,100,0,131,131
Breniya,F,100,131,0,131
Breylan,M,100,0,131,131
Brighten,M,57,56,75,131
Britlyn,F,100,131,0,131
Brynnleigh,F,100,131,0,131
Butler,M,100,0,131,131
Cassara,F,100,131,0,131
Ceciley,F,100,131,0,131
Cejay,M,100,0,131,131
Child,M,60,53,78,131
Christianjames,M,100,0,131,131
Collyns,F,100,131,0,131
Corgan,M,100,0,131,131
Daisuke,M,100,0,131,131
Darlina,F,100,131,0,131
Desia,F,100,131,0,131
Dorcus,F,96,126,5,131
Ekin,M,95,6,125,131
Elhadj,M,100,0,131,131
Ellyce,F,100,131,0,131
Eulanda,F,100,131,0,131
Evania,F,100,131,0,131
Evertt,M,100,0,131,131
Franck,M,100,0,131,131
Ganon,M,100,0,131,131
Haadi,M,100,0,131,131
Jaaziah,M,95,6,125,131
Jahred,M,100,0,131,131
Jaivyn,M,100,0,131,131
Jazir,M,100,0,131,131
Jelicia,F,100,131,0,131
Jozee,F,100,131,0,131
Kasten,M,100,0,131,131
Kavish,M,100,0,131,131
Keimani,F,78,102,29,131
Kelita,F,100,131,0,131
Kendarrius,M,100,0,131,131
Khadir,M,100,0,131,131
Khameron,M,100,0,131,131
Khani,M,87,17,114,131
Kinsie,F,100,131,0,131
Konnar,M,96,5,126,131
Korvin,M,100,0,131,131
Krithi,F,100,131,0,131
Lawrie,F,100,131,0,131
Laylee,F,100,131,0,131
Lorcan,M,100,0,131,131
Lusero,F,100,131,0,131
Lynsee,F,100,131,0,131
Macallan,M,100,0,131,131
Malaiyah,F,100,131,0,131
Malayiah,F,100,131,0,131
Marijose,F,100,131,0,131
Markevius,M,100,0,131,131
Maziah,F,64,84,47,131
Meiah,F,100,131,0,131
Mirelle,F,100,131,0,131
Morrie,M,100,0,131,131
Mykeal,M,90,13,118,131
Nephtali,M,95,6,125,131
Nichoel,F,100,131,0,131
Pavielle,F,100,131,0,131
Pecola,F,100,131,0,131
Peni,F,96,126,5,131
Rease,M,53,62,69,131
Reona,F,100,131,0,131
Rhen,M,83,22,109,131
Rhiann,F,100,131,0,131
Rohaan,M,100,0,131,131
Samael,M,100,0,131,131
Severino,M,100,0,131,131
Shanessa,F,100,131,0,131
Shayde,M,58,55,76,131
Shivon,F,100,131,0,131
Tavonte,M,100,0,131,131
Tayllor,F,100,131,0,131
Temesha,F,100,131,0,131
Trameka,F,100,131,0,131
Tyneka,F,100,131,0,131
Yarelie,F,100,131,0,131
Yunis,M,100,0,131,131
Zalayah,F,100,131,0,131
Zeenat,F,100,131,0,131
Alessandria,F,100,130,0,130
Alvenia,F,100,130,0,130
Ameyah,F,100,130,0,130
Anthone,M,100,0,130,130
Antwion,M,100,0,130,130
Ashan,M,100,0,130,130
Asra,F,100,130,0,130
Avyan,M,100,0,130,130
Avyana,F,100,130,0,130
Beya,F,100,130,0,130
Bhakti,F,100,130,0,130
Briannon,F,100,130,0,130
Camira,F,100,130,0,130
Cheralyn,F,100,130,0,130
Cheryn,F,100,130,0,130
Chimamanda,F,100,130,0,130
Chinelo,F,96,125,5,130
Chivonne,F,100,130,0,130
Cionna,F,100,130,0,130
Colburn,M,100,0,130,130
Dacie,F,100,130,0,130
Dariusz,M,100,0,130,130
Darrie,M,84,21,109,130
Davaris,M,100,0,130,130
Daxx,M,100,0,130,130
Daymeon,M,100,0,130,130
Debar,F,100,130,0,130
Delainy,F,100,130,0,130
Delawrence,M,100,0,130,130
Dequavion,M,100,0,130,130
Derya,F,100,130,0,130
Dreon,M,100,0,130,130
Ebbie,M,63,48,82,130
Eero,M,100,0,130,130
Farrin,F,88,115,15,130
Felcia,F,100,130,0,130
Fleur,F,100,130,0,130
Genieve,F,100,130,0,130
Halayna,F,100,130,0,130
Halden,M,100,0,130,130
Hill,M,100,0,130,130
Hydee,F,100,130,0,130
Illyanna,F,100,130,0,130
Indiyah,F,100,130,0,130
Jacoba,F,100,130,0,130
Jaimin,M,100,0,130,130
Jamelah,F,100,130,0,130
Jaquesha,F,100,130,0,130
Jaymere,M,100,0,130,130
Jermiya,F,100,130,0,130
Jing,F,92,120,10,130
Jizel,F,100,130,0,130
Joycelin,F,100,130,0,130
Joyel,F,100,130,0,130
Kadey,F,100,130,0,130
Kahliyah,F,100,130,0,130
Karsynn,F,100,130,0,130
Karysa,F,100,130,0,130
Kashae,F,100,130,0,130
Kashish,F,100,130,0,130
Kathalene,F,100,130,0,130
Keamber,F,100,130,0,130
Kees,M,100,0,130,130
Kendyn,M,100,0,130,130
Khalin,M,95,6,124,130
Kimyetta,F,100,130,0,130
Kitti,F,100,130,0,130
Koron,M,100,0,130,130
Kwamane,M,100,0,130,130
Lanett,F,100,130,0,130
Laquentin,M,100,0,130,130
Laquida,F,100,130,0,130
Layonna,F,100,130,0,130
Leanette,F,100,130,0,130
Lelaina,F,100,130,0,130
Lendy,F,100,130,0,130
Leontine,F,100,130,0,130
Lollie,F,100,130,0,130
Loribeth,F,100,130,0,130
Lorilynn,F,100,130,0,130
Lucindy,F,100,130,0,130
Lunna,F,100,130,0,130
Lyan,M,62,50,80,130
Lynora,F,100,130,0,130
Malaisha,F,100,130,0,130
Marquist,M,100,0,130,130
Marzella,F,100,130,0,130
Mckenlee,F,100,130,0,130
Meilech,M,100,0,130,130
Melesa,F,100,130,0,130
Merick,M,100,0,130,130
Mollye,F,100,130,0,130
Monserath,F,100,130,0,130
Newt,M,100,0,130,130
Nimsi,F,100,130,0,130
Nishika,F,100,130,0,130
Piercen,M,100,0,130,130
Rashika,F,100,130,0,130
Rayette,F,100,130,0,130
Refael,M,100,0,130,130
Regginald,M,100,0,130,130
Reshaun,M,100,0,130,130
Rosalena,F,100,130,0,130
Ruhaan,M,100,0,130,130
Rumaysa,F,100,130,0,130
Rutherford,M,100,0,130,130
Sanyiah,F,100,130,0,130
Saqib,M,100,0,130,130
Shion,M,71,38,92,130
Tamkia,F,100,130,0,130
Tandre,M,100,0,130,130
Tanina,F,100,130,0,130
Terrall,M,100,0,130,130
Terrisha,F,100,130,0,130
Twain,M,100,0,130,130
Uthman,M,100,0,130,130
Alnita,F,100,129,0,129
Andrewjames,M,100,0,129,129
Apurva,F,78,101,28,129
Arihana,F,100,129,0,129
Ayn,F,100,129,0,129
Barbarajean,F,100,129,0,129
Bronsen,M,100,0,129,129
Brynda,F,100,129,0,129
Cambryn,F,87,112,17,129
Carols,M,100,0,129,129
Casimer,M,100,0,129,129
Chamika,F,100,129,0,129
Chapel,F,67,87,42,129
Damarie,M,66,44,85,129
Dannae,F,100,129,0,129
Danyl,M,54,59,70,129
Darriana,F,100,129,0,129
Fajr,F,100,129,0,129
Gelisa,F,100,129,0,129
Heavin,F,100,129,0,129
Hiroto,M,100,0,129,129
Ho,M,100,0,129,129
Honour,F,84,109,20,129
Jamarl,M,100,0,129,129
Javi,M,100,0,129,129
Jayel,F,50,65,64,129
Jef,M,100,0,129,129
Joelly,F,100,129,0,129
Justun,M,100,0,129,129
Kathyjo,F,100,129,0,129
Katrese,F,100,129,0,129
Kayode,M,100,0,129,129
Ketty,F,100,129,0,129
Keyasha,F,100,129,0,129
Khaniya,F,100,129,0,129
Kharter,M,81,24,105,129
Kirtan,M,100,0,129,129
Kyeshia,F,100,129,0,129
Lealand,M,100,0,129,129
Leoni,F,100,129,0,129
Lexandra,F,100,129,0,129
Lorella,F,100,129,0,129
Mairyn,F,100,129,0,129
Malijah,F,68,88,41,129
Manases,M,100,0,129,129
Matalie,F,100,129,0,129
Mathius,M,100,0,129,129
Maybell,F,100,129,0,129
Mehr,F,100,129,0,129
Melah,F,100,129,0,129
Miquan,M,100,0,129,129
Murielle,F,100,129,0,129
Nashayla,F,100,129,0,129
Nawaf,M,100,0,129,129
Nicandro,M,100,0,129,129
Nicholous,M,100,0,129,129
Nishita,F,100,129,0,129
Nyaja,F,100,129,0,129
Oviya,F,100,129,0,129
Raun,M,100,0,129,129
Real,M,80,26,103,129
Rishav,M,100,0,129,129
Saharra,F,100,129,0,129
Samanyu,M,100,0,129,129
Savannaha,F,100,129,0,129
Sayid,M,100,0,129,129
Shadasia,F,100,129,0,129
Sharnay,F,100,129,0,129
Shermon,M,100,0,129,129
Srija,F,100,129,0,129
Taccara,F,100,129,0,129
Taysen,M,100,0,129,129
Teva,F,88,113,16,129
Tobenna,M,100,0,129,129
Torrion,M,100,0,129,129
Valeen,F,100,129,0,129
Valoree,F,100,129,0,129
Vidalia,F,100,129,0,129
Vonte,M,100,0,129,129
Waldon,M,100,0,129,129
Whittany,F,100,129,0,129
Willi,M,100,0,129,129
Wynema,F,100,129,0,129
Xai,M,84,20,109,129
Yago,M,100,0,129,129
Yanin,F,100,129,0,129
Yaretsi,F,100,129,0,129
Zaccai,M,100,0,129,129
Zameer,M,100,0,129,129
Ziair,M,100,0,129,129
Zunaira,F,100,129,0,129
Aasiya,F,100,128,0,128
Abrey,F,100,128,0,128
Adaira,F,100,128,0,128
Amilee,F,100,128,0,128
Amiria,F,100,128,0,128
Andriy,M,100,0,128,128
Aniza,F,100,128,0,128
Antwione,M,100,0,128,128
Ardyth,F,100,128,0,128
Ashantee,F,100,128,0,128
Aswad,M,100,0,128,128
Aylana,F,100,128,0,128
Bijal,F,100,128,0,128
Brittnei,F,100,128,0,128
Brookes,M,66,44,84,128
Cathyann,F,100,128,0,128
Cayci,F,100,128,0,128
Chalonda,F,100,128,0,128
Chanceler,M,100,0,128,128
Chealsey,F,100,128,0,128
Cheray,F,100,128,0,128
Chyan,F,100,128,0,128
Cierria,F,100,128,0,128
Corneisha,F,100,128,0,128
Covey,M,96,5,123,128
Dali,F,73,94,34,128
Danila,F,80,103,25,128
Danylle,F,100,128,0,128
Demara,F,100,128,0,128
Demerius,M,100,0,128,128
Denai,F,100,128,0,128
Donelda,F,100,128,0,128
Dredyn,M,100,0,128,128
Eleen,F,100,128,0,128
Ellan,F,100,128,0,128
Emmamarie,F,100,128,0,128
Emonte,M,100,0,128,128
Evelyna,F,100,128,0,128
Fallan,F,100,128,0,128
Feleshia,F,100,128,0,128
Feven,F,100,128,0,128
Fruma,F,100,128,0,128
Gayathri,F,100,128,0,128
Haelyn,F,100,128,0,128
Imraan,M,100,0,128,128
Ingri,F,100,128,0,128
Jaedah,F,100,128,0,128
Jakolby,M,100,0,128,128
Jakylah,F,100,128,0,128
Jayelle,F,100,128,0,128
Jennfer,F,100,128,0,128
Jessina,F,100,128,0,128
Joclynn,F,100,128,0,128
Karle,F,73,94,34,128
Kathleena,F,100,128,0,128
Kayia,F,100,128,0,128
Kaynen,M,100,0,128,128
Keiondra,F,100,128,0,128
Kervens,M,100,0,128,128
Keta,F,100,128,0,128
Khaiden,M,100,0,128,128
Khiley,F,100,128,0,128
Khloi,F,100,128,0,128
Khyren,M,100,0,128,128
Kyriakos,M,100,0,128,128
Kyrstal,F,100,128,0,128
Laqueisha,F,100,128,0,128
Laria,F,100,128,0,128
Latonga,F,100,128,0,128
Leanndra,F,100,128,0,128
Levander,M,100,0,128,128
Machel,F,92,118,10,128
Maclane,M,100,0,128,128
Mariesha,F,100,128,0,128
Marnisha,F,100,128,0,128
Marqueze,M,100,0,128,128
Maryna,F,100,128,0,128
Mohanad,M,100,0,128,128
Monzerrath,F,100,128,0,128
Nialah,F,100,128,0,128
Novalie,F,100,128,0,128
Nyara,F,100,128,0,128
Obdulia,F,100,128,0,128
Raevin,F,100,128,0,128
Rahcel,F,100,128,0,128
Raileigh,F,100,128,0,128
Rebakah,F,100,128,0,128
Romayne,F,100,128,0,128
Safira,F,100,128,0,128
Sameka,F,100,128,0,128
Samreen,F,100,128,0,128
Saren,F,100,128,0,128
Savio,M,100,0,128,128
Sekai,M,51,63,65,128
Seville,F,61,78,50,128
Shamila,F,100,128,0,128
Shaunee,F,100,128,0,128
Sheletha,F,100,128,0,128
Shevawn,F,100,128,0,128
Stefhanie,F,100,128,0,128
Teauna,F,100,128,0,128
Thaddeaus,M,100,0,128,128
Vitaly,M,100,0,128,128
Wissam,M,100,0,128,128
Xela,F,100,128,0,128
Yamari,F,96,123,5,128
Yolandra,F,100,128,0,128
Zailee,F,100,128,0,128
Zaraya,F,100,128,0,128
Zaydee,F,100,128,0,128
Zerina,F,100,128,0,128
Zorion,M,100,0,128,128
Zylen,M,100,0,128,128
Aamani,F,100,127,0,127
Aedon,M,100,0,127,127
Aladdin,M,100,0,127,127
Amberlea,F,100,127,0,127
Amenah,F,100,127,0,127
Andelyn,F,100,127,0,127
Anuradha,F,100,127,0,127
Anwen,F,100,127,0,127
Areon,M,65,45,82,127
Ashawnti,F,100,127,0,127
Avelynn,F,100,127,0,127
Basir,M,100,0,127,127
Blen,F,100,127,0,127
Brandalynn,F,100,127,0,127
Breeonna,F,100,127,0,127
Brenn,F,50,64,63,127
Cable,M,100,0,127,127
Cait,F,100,127,0,127
Chantrell,F,100,127,0,127
Chardai,F,100,127,0,127
Cherine,F,100,127,0,127
Citlalic,F,100,127,0,127
Clarnce,M,100,0,127,127
Coalton,M,100,0,127,127
Daiden,M,100,0,127,127
Danean,F,100,127,0,127
Denney,M,100,0,127,127
Devaris,M,100,0,127,127
Deyonte,M,100,0,127,127
Dhyan,M,100,0,127,127
Dniyah,F,100,127,0,127
Dontasia,F,100,127,0,127
Dreana,F,100,127,0,127
Dreden,M,100,0,127,127
Eliz,F,100,127,0,127
Emie,F,100,127,0,127
Gabrian,M,100,0,127,127
Gaither,M,100,0,127,127
Glorianne,F,100,127,0,127
Hae,F,100,127,0,127
Iliya,M,91,12,115,127
Inioluwa,F,64,81,46,127
Iyad,M,100,0,127,127
Jahliyah,F,100,127,0,127
Jaicob,M,100,0,127,127
Jaria,F,100,127,0,127
Jefte,M,100,0,127,127
Jeriyah,F,100,127,0,127
Jhoselin,F,100,127,0,127
Jhovani,M,100,0,127,127
Jovonni,M,100,0,127,127
Kaesen,M,100,0,127,127
Kaityln,F,100,127,0,127
Kannan,M,100,0,127,127
Kannen,M,100,0,127,127
Karolee,F,100,127,0,127
Kerianna,F,100,127,0,127
Kinesha,F,100,127,0,127
Kirubel,M,100,0,127,127
Klair,F,100,127,0,127
Lakeem,M,100,0,127,127
Lemmie,M,96,5,122,127
Leroi,M,100,0,127,127
Lorrayne,F,100,127,0,127
Makalynn,F,100,127,0,127
Makelle,F,100,127,0,127
Mally,F,100,127,0,127
Masato,M,100,0,127,127
Maui,M,61,50,77,127
Mayrani,F,100,127,0,127
Meelah,F,100,127,0,127
Mikeila,F,100,127,0,127
Mikhala,F,100,127,0,127
Mohid,M,100,0,127,127
Morad,M,100,0,127,127
Morgin,F,100,127,0,127
Neysha,F,100,127,0,127
Nickcole,F,100,127,0,127
Nikyah,F,100,127,0,127
Nyomie,F,100,127,0,127
Presly,F,100,127,0,127
Quanetta,F,100,127,0,127
Quency,M,100,0,127,127
Querida,F,100,127,0,127
Quinnlan,M,79,27,100,127
Quorra,F,100,127,0,127
Roshard,M,100,0,127,127
Saim,M,100,0,127,127
Sanjit,M,100,0,127,127
Saraiya,F,100,127,0,127
Sarya,F,100,127,0,127
Sefora,F,100,127,0,127
Shaquile,M,94,7,120,127
Shaydon,M,100,0,127,127
Shellsea,F,100,127,0,127
Shley,F,100,127,0,127
Spero,M,100,0,127,127
Stachia,F,100,127,0,127
Starlin,M,68,41,86,127
Syenna,F,100,127,0,127
Taeja,F,100,127,0,127
Tamecka,F,100,127,0,127
Tamee,F,100,127,0,127
Taneal,F,100,127,0,127
Tjuana,F,100,127,0,127
Tracer,M,100,0,127,127
Venissa,F,100,127,0,127
Wasim,M,100,0,127,127
Zakyla,F,100,127,0,127
Abrham,M,100,0,126,126
Akiah,F,100,126,0,126
Alayha,F,100,126,0,126
Alecxander,M,100,0,126,126
Alezander,M,100,0,126,126
Almendra,F,100,126,0,126
Amea,F,100,126,0,126
Amisadai,F,96,121,5,126
Anacaren,F,100,126,0,126
Angeliah,F,100,126,0,126
Anikah,F,100,126,0,126
Antino,M,100,0,126,126
Averil,F,73,92,34,126
Azam,M,100,0,126,126
Bentli,F,73,92,34,126
Bethania,F,100,126,0,126
Biannca,F,100,126,0,126
Calena,F,100,126,0,126
Cameshia,F,100,126,0,126
Celester,M,62,48,78,126
Chablis,F,100,126,0,126
Chauntae,F,100,126,0,126
Cheryal,F,100,126,0,126
Dakhari,M,100,0,126,126
Darriona,F,100,126,0,126
Dashonda,F,100,126,0,126
Deidrea,F,100,126,0,126
Dequante,M,100,0,126,126
Deshara,F,100,126,0,126
Duvid,M,100,0,126,126
Eliannah,F,100,126,0,126
Essex,M,100,0,126,126
Eutimio,M,100,0,126,126
Excell,M,100,0,126,126
Filimon,M,100,0,126,126
Ginevra,F,100,126,0,126
Hadas,F,100,126,0,126
Harsimran,F,75,94,32,126
Ilian,M,72,35,91,126
Issam,M,100,0,126,126
Jayant,M,100,0,126,126
Jaydis,M,90,13,113,126
Jeany,F,100,126,0,126
Jes,M,100,0,126,126
Jessicalynn,F,100,126,0,126
Jillann,F,100,126,0,126
Jobina,F,100,126,0,126
Jonavon,M,100,0,126,126
Josepha,F,100,126,0,126
Joslynne,F,100,126,0,126
Justa,F,100,126,0,126
Kadian,F,65,82,44,126
Kahley,F,100,126,0,126
Keanen,M,100,0,126,126
Keidrick,M,100,0,126,126
Keimon,M,100,0,126,126
Kenzli,F,100,126,0,126
Kirstina,F,100,126,0,126
Kirstine,F,100,126,0,126
Ladaja,F,100,126,0,126
Lakethia,F,100,126,0,126
Larin,F,54,68,58,126
Leahmarie,F,100,126,0,126
Lujean,F,100,126,0,126
Mackenzye,F,100,126,0,126
Makensey,F,100,126,0,126
Maykayla,F,100,126,0,126
Merrit,F,51,64,62,126
Nadalee,F,100,126,0,126
Neira,F,100,126,0,126
Paullette,F,100,126,0,126
Quanika,F,100,126,0,126
Saharah,F,100,126,0,126
Selyna,F,100,126,0,126
Shalae,F,100,126,0,126
Sopheap,F,63,80,46,126
Stran,M,100,0,126,126
Taneia,F,100,126,0,126
Tasheema,F,100,126,0,126
Teodor,M,100,0,126,126
Tesean,M,100,0,126,126
Treshun,M,100,0,126,126
Trinetta,F,100,126,0,126
Victorhugo,M,100,0,126,126
Zaeem,M,100,0,126,126
Zafirah,F,100,126,0,126
Zorina,F,100,126,0,126
Abiageal,F,100,125,0,125
Aidynn,F,51,64,61,125
Alson,M,100,0,125,125
Anjanae,F,100,125,0,125
Arend,M,100,0,125,125
Arty,M,100,0,125,125
Atalya,F,100,125,0,125
Atleigh,F,100,125,0,125
Azarion,M,100,0,125,125
Blakelynn,F,100,125,0,125
Brax,M,100,0,125,125
Caisen,M,100,0,125,125
Christabella,F,100,125,0,125
Ciela,F,100,125,0,125
Corretta,F,100,125,0,125
Cortlin,M,100,0,125,125
Derra,F,100,125,0,125
Deunte,M,100,0,125,125
Devaunte,M,100,0,125,125
Dinisha,F,100,125,0,125
Dontrez,M,100,0,125,125
Eiliyah,F,100,125,0,125
Emmalise,F,100,125,0,125
Gaelan,M,100,0,125,125
Hayze,M,100,0,125,125
Isabellamarie,F,100,125,0,125
Jayanth,M,100,0,125,125
Josep,M,100,0,125,125
Kalima,F,100,125,0,125
Kanitra,F,100,125,0,125
Karmah,F,100,125,0,125
Katalaya,F,100,125,0,125
Keiandra,F,100,125,0,125
Kelvis,M,100,0,125,125
Kethan,M,100,0,125,125
Kewanda,F,100,125,0,125
Latavion,M,100,0,125,125
Lekeith,M,100,0,125,125
Lucah,M,100,0,125,125
Luise,F,96,120,5,125
Maricus,M,100,0,125,125
Marquiz,M,100,0,125,125
Maximiano,M,100,0,125,125
Mckyla,F,100,125,0,125
Meridee,F,100,125,0,125
Meygan,F,100,125,0,125
Mieko,F,100,125,0,125
Natash,F,100,125,0,125
Nazariah,F,100,125,0,125
Nekeshia,F,100,125,0,125
Nyleah,F,100,125,0,125
Oliviana,F,100,125,0,125
Oneka,F,100,125,0,125
Quasim,M,100,0,125,125
Quinntin,M,100,0,125,125
Rilley,M,55,56,69,125
Roshana,F,100,125,0,125
Ryosuke,M,100,0,125,125
Saatvik,M,100,0,125,125
Seith,M,100,0,125,125
Seynabou,F,100,125,0,125
Shakevia,F,100,125,0,125
Shalawn,F,100,125,0,125
Shanekqua,F,100,125,0,125
Shantale,F,100,125,0,125
Shantice,F,100,125,0,125
Shelanda,F,100,125,0,125
Siddiq,M,100,0,125,125
Tamirra,F,100,125,0,125
Tanique,F,100,125,0,125
Tavio,M,100,0,125,125
Teniqua,F,100,125,0,125
Thersea,F,100,125,0,125
Thresia,F,100,125,0,125
Tjay,M,100,0,125,125
Vasili,M,100,0,125,125
Xyler,M,100,0,125,125
Yancarlos,M,100,0,125,125
Zillah,F,100,125,0,125
Aaliayah,F,100,124,0,124
Aashka,F,100,124,0,124
Adelae,F,100,124,0,124
Aldwin,M,100,0,124,124
Alecea,F,100,124,0,124
Amarea,F,95,118,6,124
Anairis,F,100,124,0,124
Analycia,F,100,124,0,124
Andoni,M,100,0,124,124
Aneliese,F,100,124,0,124
Antolin,M,100,0,124,124
Areal,F,100,124,0,124
Arneisha,F,100,124,0,124
Ashaun,M,100,0,124,124
Atha,F,100,124,0,124
Atisha,F,100,124,0,124
Autumm,F,100,124,0,124
Avrielle,F,100,124,0,124
Breccan,M,100,0,124,124
Britania,F,100,124,0,124
Brithney,F,100,124,0,124
Cahlil,M,100,0,124,124
Carlia,F,100,124,0,124
Chales,M,100,0,124,124
Chelbi,F,100,124,0,124
Cheyna,F,100,124,0,124
Collan,M,100,0,124,124
Costella,F,100,124,0,124
Dakiya,F,100,124,0,124
Daveigh,F,100,124,0,124
Daysean,M,100,0,124,124
Derreon,M,100,0,124,124
Detta,F,100,124,0,124
Doral,M,71,36,88,124
Duanne,M,66,42,82,124
Fahima,F,100,124,0,124
Falana,F,100,124,0,124
Garison,M,100,0,124,124
Gavinn,M,100,0,124,124
Harel,M,100,0,124,124
Helane,F,100,124,0,124
Hever,M,100,0,124,124
Hind,F,100,124,0,124
Infantof,F,54,67,57,124
Iyania,F,100,124,0,124
Jabaree,M,100,0,124,124
Jadaya,F,100,124,0,124
Jahel,M,96,5,119,124
Janiyha,F,100,124,0,124
Jasmond,M,65,43,81,124
Jayjay,M,100,0,124,124
Jendayi,F,100,124,0,124
Jovaun,M,100,0,124,124
Katheen,F,100,124,0,124
Keshonna,F,100,124,0,124
Khyrie,M,85,18,106,124
Kilyn,F,91,113,11,124
Kinisha,F,100,124,0,124
Kiril,M,100,0,124,124
Lanijah,F,100,124,0,124
Latysha,F,100,124,0,124
Lenia,F,100,124,0,124
Lexiana,F,100,124,0,124
Lichelle,F,100,124,0,124
Linkon,M,100,0,124,124
Linnet,F,100,124,0,124
Lowery,M,100,0,124,124
Manna,F,100,124,0,124
Marji,F,100,124,0,124
Mathayus,M,100,0,124,124
Maxmilian,M,100,0,124,124
Mikayah,F,100,124,0,124
Mikita,F,100,124,0,124
Natalio,M,100,0,124,124
Nickolette,F,100,124,0,124
Ninoshka,F,100,124,0,124
Novak,M,100,0,124,124
Oak,M,100,0,124,124
Phat,M,100,0,124,124
Ramez,M,100,0,124,124
Raunak,M,100,0,124,124
Rayson,M,100,0,124,124
Reyhan,M,81,24,100,124
Romonia,F,100,124,0,124
Sanjiv,M,100,0,124,124
Seaver,M,100,0,124,124
Seira,F,100,124,0,124
Shahed,F,92,114,10,124
Shahrzad,F,100,124,0,124
Sheritha,F,100,124,0,124
Sherriann,F,100,124,0,124
Shrika,F,100,124,0,124
Skilynn,F,100,124,0,124
Suleman,M,100,0,124,124
Tanikka,F,100,124,0,124
Taydem,F,81,100,24,124
Tehran,M,96,5,119,124
Thailan,M,100,0,124,124
Theseus,M,100,0,124,124
Timmi,F,100,124,0,124
Tove,F,100,124,0,124
Trestan,M,100,0,124,124
Vala,F,100,124,0,124
Verta,F,100,124,0,124
Vong,M,100,0,124,124
Willamina,F,100,124,0,124
Yerick,M,100,0,124,124
Yomira,F,100,124,0,124
Zhanae,F,100,124,0,124
Zymier,M,100,0,124,124
Adayah,F,100,123,0,123
Adeja,F,100,123,0,123
Aiyannah,F,100,123,0,123
Akaash,M,100,0,123,123
Aliea,F,100,123,0,123
Alioune,M,100,0,123,123
Alyssabeth,F,100,123,0,123
Alyxander,M,100,0,123,123
Amayiah,F,100,123,0,123
Anatasia,F,100,123,0,123
Andora,F,100,123,0,123
Angeliyah,F,100,123,0,123
Anitha,F,100,123,0,123
Annaston,F,100,123,0,123
Arneshia,F,100,123,0,123
Asencion,M,100,0,123,123
Brailen,M,100,0,123,123
Brigg,M,100,0,123,123
Brinae,F,100,123,0,123
Brittanya,F,100,123,0,123
Calil,M,100,0,123,123
Charda,F,100,123,0,123
Chaunda,F,100,123,0,123
Claus,M,100,0,123,123
Cortlynn,F,100,123,0,123
Coumba,F,100,123,0,123
Dagmawi,M,100,0,123,123
Daimien,M,100,0,123,123
Danayah,F,100,123,0,123
Danique,F,100,123,0,123
Decorey,M,100,0,123,123
Deddrick,M,100,0,123,123
Deitrick,M,100,0,123,123
Detrich,M,91,11,112,123
Devony,F,100,123,0,123
Dniya,F,100,123,0,123
Elantra,F,100,123,0,123
Emerita,F,100,123,0,123
Franciscojavier,M,100,0,123,123
Frandy,M,100,0,123,123
Haron,M,100,0,123,123
Harrington,M,100,0,123,123
Hayzel,F,100,123,0,123
Hiren,M,100,0,123,123
Humaira,F,100,123,0,123
Jaesean,M,100,0,123,123
Jamacia,F,100,123,0,123
Jasminne,F,100,123,0,123
Jazzie,F,100,123,0,123
Jermanie,M,92,10,113,123
Johnnette,F,100,123,0,123
Jojuan,M,100,0,123,123
Jozsef,M,100,0,123,123
Kamaryn,F,100,123,0,123
Kandiss,F,100,123,0,123
Kemiah,F,100,123,0,123
Khamiya,F,100,123,0,123
Kinzleigh,F,100,123,0,123
Koah,M,100,0,123,123
Kroy,M,100,0,123,123
Laconda,F,100,123,0,123
Landynn,M,77,28,95,123
Laronica,F,100,123,0,123
Leiani,F,100,123,0,123
Lilliane,F,100,123,0,123
Linsie,F,100,123,0,123
Livy,F,100,123,0,123
Lydian,F,100,123,0,123
Maicee,F,100,123,0,123
Malary,F,100,123,0,123
Malillany,F,100,123,0,123
Mallissa,F,100,123,0,123
Marsi,F,100,123,0,123
Melizza,F,100,123,0,123
Mirai,F,100,123,0,123
Momina,F,100,123,0,123
Nahlia,F,100,123,0,123
Natalyia,F,100,123,0,123
Nieve,F,100,123,0,123
Nyaisha,F,100,123,0,123
Olliver,M,100,0,123,123
Patrese,F,100,123,0,123
Pegi,F,100,123,0,123
Rainn,F,59,72,51,123
Rakesha,F,100,123,0,123
Romir,M,100,0,123,123
Salia,F,100,123,0,123
Savanha,F,100,123,0,123
Shadaya,F,100,123,0,123
Shaquina,F,100,123,0,123
Shawneen,F,100,123,0,123
Shawonda,F,100,123,0,123
Sherilee,F,100,123,0,123
Shyrl,F,100,123,0,123
Siddalee,F,100,123,0,123
Sladen,M,100,0,123,123
Slyvester,M,100,0,123,123
Sujata,F,100,123,0,123
Sukhman,M,58,52,71,123
Synethia,F,100,123,0,123
Takeysha,F,100,123,0,123
Takiera,F,100,123,0,123
Talibah,F,100,123,0,123
Tanekia,F,100,123,0,123
Tariya,F,100,123,0,123
Tarshia,F,100,123,0,123
Tecia,F,100,123,0,123
Tinleigh,F,100,123,0,123
Toiya,F,100,123,0,123
Trenyce,F,100,123,0,123
Trinidee,F,100,123,0,123
Tymarion,M,100,0,123,123
Tysheka,F,100,123,0,123
Unika,F,100,123,0,123
Varnika,F,100,123,0,123
Whitt,M,100,0,123,123
Yarimar,F,100,123,0,123
Yorley,F,100,123,0,123
Zakariye,M,100,0,123,123
Zyairah,F,100,123,0,123
Aarik,M,100,0,122,122
Alizeh,F,100,122,0,122
Alrick,M,100,0,122,122
Amandalee,F,100,122,0,122
Amarys,F,100,122,0,122
Amilio,M,100,0,122,122
Anelis,F,100,122,0,122
Annaliyah,F,100,122,0,122
Arelia,F,100,122,0,122
Bacilio,M,100,0,122,122
Becci,F,100,122,0,122
Billey,M,100,0,122,122
Bobak,M,100,0,122,122
Brandonn,M,100,0,122,122
Branna,F,100,122,0,122
Breken,M,100,0,122,122
Cadel,M,100,0,122,122
Calvina,F,100,122,0,122
Candon,M,100,0,122,122
Castle,M,100,0,122,122
Cecia,F,100,122,0,122
Cedrik,M,100,0,122,122
Cleola,F,100,122,0,122
Cordarious,M,100,0,122,122
Correll,M,100,0,122,122
Danniell,F,100,122,0,122
Dawnisha,F,100,122,0,122
Debe,F,100,122,0,122
Delita,F,100,122,0,122
Dequavious,M,100,0,122,122
Drianna,F,100,122,0,122
Ebany,F,100,122,0,122
Eilidh,F,100,122,0,122
Emmerie,F,100,122,0,122
Errika,F,100,122,0,122
Ethanjames,M,100,0,122,122
Evoleth,F,100,122,0,122
Farheen,F,100,122,0,122
Fuller,M,100,0,122,122
Geral,M,62,46,76,122
Giordan,M,89,14,108,122
Hilberto,M,100,0,122,122
Illona,F,100,122,0,122
Isahia,M,100,0,122,122
Jeorgia,F,100,122,0,122
Jerney,F,92,112,10,122
Kamoria,F,100,122,0,122
Kanasia,F,100,122,0,122
Kawthar,F,100,122,0,122
Kayan,M,94,7,115,122
Kaziyah,F,100,122,0,122
Keina,F,100,122,0,122
Keiondre,M,100,0,122,122
Keyari,F,96,117,5,122
Kiffany,F,100,122,0,122
Kinshasa,F,95,116,6,122
Kirtis,M,100,0,122,122
Kypton,M,100,0,122,122
Lacreasha,F,100,122,0,122
Lakeisa,F,100,122,0,122
Leanord,M,100,0,122,122
Leniya,F,100,122,0,122
Lenzi,F,100,122,0,122
Lochlann,M,100,0,122,122
Marieme,F,100,122,0,122
Markiyah,F,100,122,0,122
Mayuri,F,100,122,0,122
Meria,F,100,122,0,122
Metztli,F,100,122,0,122
Molleigh,F,100,122,0,122
Mukund,M,100,0,122,122
Myndi,F,100,122,0,122
Naveya,F,100,122,0,122
Navil,F,96,117,5,122
Nazli,F,100,122,0,122
Nekoda,M,88,15,107,122
Neriyah,F,100,122,0,122
Nikolis,M,100,0,122,122
Nkenge,F,100,122,0,122
Ottie,M,84,19,103,122
Paisly,F,100,122,0,122
Pancho,M,100,0,122,122
Phoenicia,F,100,122,0,122
Quinne,F,100,122,0,122
Quirino,M,100,0,122,122
Rajvir,M,100,0,122,122
Ramatoulaye,F,100,122,0,122
Rashied,M,100,0,122,122
Reigna,F,100,122,0,122
Rocko,M,100,0,122,122
Sadeen,F,100,122,0,122
Samiksha,F,100,122,0,122
Sanja,F,100,122,0,122
Sayan,M,100,0,122,122
Seyed,M,100,0,122,122
Shanaye,F,100,122,0,122
Shavelle,F,100,122,0,122
Sherrian,F,100,122,0,122
Shonita,F,100,122,0,122
Shyah,F,96,117,5,122
Sonika,F,100,122,0,122
Tanith,F,100,122,0,122
Taraya,F,100,122,0,122
Teagon,M,90,12,110,122
Tema,F,100,122,0,122
Tilmon,M,100,0,122,122
Tirsa,F,100,122,0,122
Toniqua,F,100,122,0,122
Trashaun,M,100,0,122,122
Treylan,M,100,0,122,122
Yerachmiel,M,100,0,122,122
Aamya,F,100,121,0,121
Adrieana,F,100,121,0,121
Aleysia,F,100,121,0,121
Anacarolina,F,100,121,0,121
Analya,F,100,121,0,121
Aneisa,F,100,121,0,121
Anelia,F,100,121,0,121
Aniesha,F,100,121,0,121
Annina,F,100,121,0,121
Anuja,F,100,121,0,121
Aundreya,F,100,121,0,121
Azavier,M,100,0,121,121
Azavion,M,100,0,121,121
Barby,F,100,121,0,121
Bralon,M,100,0,121,121
Brayen,M,100,0,121,121
Brettney,F,100,121,0,121
Brewster,M,100,0,121,121
Cheila,F,100,121,0,121
Chigozie,M,95,6,115,121
Clayson,M,100,0,121,121
Coal,M,100,0,121,121
Conal,M,100,0,121,121
Consepcion,F,100,121,0,121
Costa,M,100,0,121,121
Cyrene,F,100,121,0,121
Denajah,F,100,121,0,121
Dereona,F,100,121,0,121
Derriana,F,100,121,0,121
Eligha,M,100,0,121,121
Ephrem,M,100,0,121,121
Evolette,F,100,121,0,121
Findlay,M,92,10,111,121
Florenda,F,100,121,0,121
Fredderick,M,100,0,121,121
Gabor,M,100,0,121,121
Glynna,F,100,121,0,121
Jackelynn,F,100,121,0,121
Jamiesha,F,100,121,0,121
Janaiah,F,100,121,0,121
Janiene,F,100,121,0,121
Jenevie,F,100,121,0,121
Jesicca,F,100,121,0,121
Jezabelle,F,100,121,0,121
Johnasia,F,100,121,0,121
Johnothan,M,100,0,121,121
Jolly,M,64,44,77,121
Jonluke,M,100,0,121,121
Jossiah,M,100,0,121,121
Kahlie,F,100,121,0,121
Kahmya,F,100,121,0,121
Kais,M,100,0,121,121
Kateryn,F,100,121,0,121
Kimon,M,100,0,121,121
Kyngston,M,100,0,121,121
Kyvon,M,100,0,121,121
Ladarien,M,100,0,121,121
Lakeishia,F,100,121,0,121
Latish,F,100,121,0,121
Laureano,M,100,0,121,121
Leara,F,100,121,0,121
Lineth,F,100,121,0,121
Liticia,F,100,121,0,121
Lolah,F,100,121,0,121
Malic,M,100,0,121,121
Marquasia,F,100,121,0,121
Masud,M,100,0,121,121
Mellonie,F,100,121,0,121
Merlina,F,100,121,0,121
Mollyann,F,100,121,0,121
Momoka,F,100,121,0,121
Morganna,F,100,121,0,121
Munirah,F,100,121,0,121
Mykeria,F,100,121,0,121
Nafisah,F,100,121,0,121
Neveen,F,100,121,0,121
Nimisha,F,100,121,0,121
Peggyann,F,100,121,0,121
Raidon,M,100,0,121,121
Raysa,F,100,121,0,121
Reace,M,69,37,84,121
Reeshemah,F,100,121,0,121
Remas,F,100,121,0,121
Remmi,F,100,121,0,121
Revis,M,100,0,121,121
Rickita,F,100,121,0,121
Safina,F,100,121,0,121
Sahas,M,100,0,121,121
Sharnetta,F,100,121,0,121
Shealeigh,F,100,121,0,121
Shewanda,F,100,121,0,121
Sitlaly,F,100,121,0,121
Suriyah,F,100,121,0,121
Susane,F,100,121,0,121
Tashera,F,100,121,0,121
Teiara,F,100,121,0,121
Tekela,F,100,121,0,121
Teleah,F,100,121,0,121
Terriah,F,100,121,0,121
Treonna,F,100,121,0,121
Vinayak,M,100,0,121,121
Vinetta,F,100,121,0,121
Vitor,M,100,0,121,121
Yaacov,M,100,0,121,121
Yaneisy,F,100,121,0,121
Acasia,F,100,120,0,120
Adaley,F,100,120,0,120
Adiah,F,100,120,0,120
Aerion,M,80,24,96,120
Alaira,F,100,120,0,120
Amarylis,F,100,120,0,120
Analina,F,100,120,0,120
Aniella,F,100,120,0,120
Arcangel,M,100,0,120,120
Atari,M,66,41,79,120
Babbette,F,100,120,0,120
Benedetta,F,100,120,0,120
Beyla,F,100,120,0,120
Brigitt,F,100,120,0,120
Britnay,F,100,120,0,120
Buel,M,100,0,120,120
Chalsea,F,100,120,0,120
Charlane,F,100,120,0,120
Chaselyn,F,100,120,0,120
Chavela,F,100,120,0,120
Chiann,F,100,120,0,120
Daemion,M,100,0,120,120
Daionna,F,100,120,0,120
Dajai,F,100,120,0,120
Dariane,F,100,120,0,120
Darlis,F,100,120,0,120
Daxten,M,100,0,120,120
Deleah,F,100,120,0,120
Desmund,M,100,0,120,120
Desyre,F,100,120,0,120
Eddi,M,95,6,114,120
Ellsie,F,100,120,0,120
Emony,F,100,120,0,120
Esten,M,100,0,120,120
Everado,M,100,0,120,120
Faatimah,F,100,120,0,120
Fantashia,F,100,120,0,120
Farryn,F,100,120,0,120
Fergie,F,100,120,0,120
Gyan,M,100,0,120,120
Harmani,F,100,120,0,120
Heike,F,100,120,0,120
Henrick,M,100,0,120,120
Hetal,F,100,120,0,120
Hiep,M,100,0,120,120
Hildred,F,62,75,45,120
Iasha,F,100,120,0,120
Jabes,M,100,0,120,120
Jachelle,F,100,120,0,120
Jacquise,M,61,47,73,120
Jahdai,F,64,77,43,120
Jamarquis,M,100,0,120,120
Jameek,M,100,0,120,120
Janei,F,100,120,0,120
Jaquane,M,100,0,120,120
Javarie,M,100,0,120,120
Javohn,M,100,0,120,120
Jdyn,M,100,0,120,120
Jemila,F,100,120,0,120
Joaovictor,M,100,0,120,120
Jonea,F,100,120,0,120
Kadeisha,F,100,120,0,120
Kaetlin,F,100,120,0,120
Kahleb,M,100,0,120,120
Kailia,F,100,120,0,120
Kairah,F,100,120,0,120
Kanyah,F,100,120,0,120
Karelyn,F,100,120,0,120
Karlisa,F,100,120,0,120
Keliah,F,100,120,0,120
Kelty,F,100,120,0,120
Kelwin,M,100,0,120,120
Kenzel,M,100,0,120,120
Keymora,F,100,120,0,120
Kolston,M,100,0,120,120
Lakiah,F,100,120,0,120
Latrail,M,89,13,107,120
Lavarius,M,100,0,120,120
Lenah,F,100,120,0,120
Lorenna,F,100,120,0,120
Makaley,F,100,120,0,120
Malayasia,F,100,120,0,120
Malene,F,100,120,0,120
Markala,F,100,120,0,120
Markice,M,100,0,120,120
Maryuri,F,100,120,0,120
Mashonda,F,100,120,0,120
Matteson,F,92,110,10,120
Mazy,F,100,120,0,120
Nene,F,100,120,0,120
Nicholaos,M,100,0,120,120
Nuchem,M,100,0,120,120
Oluwatoyin,F,100,120,0,120
Parneet,F,100,120,0,120
Paydon,M,100,0,120,120
Pranathi,F,100,120,0,120
Raden,M,100,0,120,120
Ramsha,F,100,120,0,120
Rayley,F,100,120,0,120
Reg,M,100,0,120,120
Rien,M,76,29,91,120
Roran,M,100,0,120,120
Samarie,F,100,120,0,120
Saryna,F,100,120,0,120
Seham,F,100,120,0,120
Shaneque,F,100,120,0,120
Sherma,F,100,120,0,120
Sheyann,F,100,120,0,120
Shiquan,M,100,0,120,120
Shiron,F,73,88,32,120
Shivan,M,100,0,120,120
Suhaila,F,100,120,0,120
Taela,F,100,120,0,120
Tahje,M,64,43,77,120
Tanyiah,F,100,120,0,120
Teagyn,F,93,112,8,120
Telesha,F,100,120,0,120
Temprance,F,100,120,0,120
Terilynn,F,100,120,0,120
Toris,M,100,0,120,120
Treyshaun,M,100,0,120,120
Tyaisha,F,100,120,0,120
Tyrhonda,F,100,120,0,120
Uzoma,M,93,8,112,120
Wane,M,100,0,120,120
Worley,M,100,0,120,120
Yailene,F,100,120,0,120
Yue,M,68,39,81,120
Zakyia,F,100,120,0,120
Zaley,F,100,120,0,120
Ziv,M,100,0,120,120
Adaisha,F,100,119,0,119
Adiya,F,100,119,0,119
Alif,M,100,0,119,119
Allea,F,100,119,0,119
Allesha,F,100,119,0,119
Ammi,F,100,119,0,119
Antowan,M,100,0,119,119
Anye,F,100,119,0,119
Aracelie,F,100,119,0,119
Arville,M,100,0,119,119
Ashwath,M,100,0,119,119
Atzin,M,82,22,97,119
Aveyah,F,100,119,0,119
Avriel,F,91,108,11,119
Ayako,F,100,119,0,119
Ayrabella,F,100,119,0,119
Barabara,F,100,119,0,119
Benicia,F,100,119,0,119
Beonka,F,100,119,0,119
Bernerd,M,100,0,119,119
Blia,F,100,119,0,119
Chalisa,F,100,119,0,119
Chamya,F,100,119,0,119
Chrisha,F,100,119,0,119
Chrisma,F,100,119,0,119
Coriann,F,100,119,0,119
Darene,F,100,119,0,119
Deaken,M,100,0,119,119
Deitrich,M,100,0,119,119
Disney,F,96,114,5,119
Dontavia,F,91,108,11,119
Eduar,M,100,0,119,119
Elide,F,100,119,0,119
Elky,F,100,119,0,119
Enas,F,100,119,0,119
Everlena,F,100,119,0,119
Fadel,M,100,0,119,119
Glenisha,F,100,119,0,119
Hermina,F,100,119,0,119
Hinton,M,100,0,119,119
Irine,F,100,119,0,119
Isaly,F,100,119,0,119
Jahon,M,100,0,119,119
Jecenia,F,100,119,0,119
Jennet,F,100,119,0,119
Jhair,M,100,0,119,119
Jillane,F,100,119,0,119
Jolyssa,F,100,119,0,119
Joselynne,F,100,119,0,119
Kadien,M,100,0,119,119
Kahiau,M,100,0,119,119
Kasch,M,100,0,119,119
Kelijah,M,90,12,107,119
Khila,F,100,119,0,119
Lacye,F,100,119,0,119
Lanyiah,F,100,119,0,119
Latissa,F,100,119,0,119
Lazariah,F,100,119,0,119
Lenward,M,100,0,119,119
Liberti,F,100,119,0,119
Lilliah,F,100,119,0,119
Lilu,F,100,119,0,119
Mackensey,F,100,119,0,119
Mariena,F,100,119,0,119
Marik,M,100,0,119,119
Martavia,F,100,119,0,119
Millena,F,100,119,0,119
Morayma,F,100,119,0,119
Naara,F,100,119,0,119
Nashya,F,100,119,0,119
Nastashia,F,100,119,0,119
Niquita,F,100,119,0,119
Petina,F,100,119,0,119
Psalm,F,58,69,50,119
Quantasia,F,100,119,0,119
Quita,F,100,119,0,119
Rafel,M,100,0,119,119
Raylea,F,100,119,0,119
Reice,M,94,7,112,119
Ridhima,F,100,119,0,119
Rigdon,M,100,0,119,119
Rileyann,F,100,119,0,119
Rindy,F,100,119,0,119
Shakerria,F,100,119,0,119
Shanera,F,100,119,0,119
Shanzay,F,100,119,0,119
Shaquera,F,100,119,0,119
Sharnise,F,100,119,0,119
Shatora,F,100,119,0,119
Shavell,F,95,113,6,119
Shawntez,M,100,0,119,119
Shelie,F,100,119,0,119
Shoaib,M,100,0,119,119
Shriyan,M,100,0,119,119
Sylwia,F,100,119,0,119
Tasheem,M,100,0,119,119
Taylinn,F,100,119,0,119
Teosha,F,100,119,0,119
Tija,F,96,114,5,119
Tomothy,M,100,0,119,119
Tradarius,M,100,0,119,119
Trana,F,100,119,0,119
Travonta,M,100,0,119,119
Tryce,M,100,0,119,119
Tzion,M,100,0,119,119
Warda,F,100,119,0,119
Wing,M,82,22,97,119
Winry,F,100,119,0,119
Yiselle,F,100,119,0,119
Yonna,F,100,119,0,119
Zaylynn,F,87,103,16,119
Aerionna,F,100,118,0,118
Aleni,F,100,118,0,118
Alondria,F,100,118,0,118
Anabia,F,100,118,0,118
Annalyce,F,100,118,0,118
Ashrith,M,100,0,118,118
Beyonka,F,100,118,0,118
Brendi,F,100,118,0,118
Brendia,F,100,118,0,118
Brittanyann,F,100,118,0,118
Bryanah,F,100,118,0,118
Cannan,M,100,0,118,118
Carlicia,F,100,118,0,118
Casara,F,100,118,0,118
Christopherjohn,M,100,0,118,118
Currie,M,54,54,64,118
Daemien,M,100,0,118,118
Dafina,F,100,118,0,118
Darleny,F,100,118,0,118
Dartanion,M,100,0,118,118
Denya,F,100,118,0,118
Ellanore,F,100,118,0,118
Emmajo,F,100,118,0,118
Enrica,F,100,118,0,118
Finbar,M,100,0,118,118
Geovonni,M,100,0,118,118
Geraldin,F,100,118,0,118
Gilmore,M,100,0,118,118
Greenly,F,100,118,0,118
Imagine,F,100,118,0,118
Jamilett,F,100,118,0,118
Jillisa,F,100,118,0,118
Johnchristopher,M,100,0,118,118
Kajuana,F,100,118,0,118
Kandon,M,100,0,118,118
Karanveer,M,100,0,118,118
Kateline,F,100,118,0,118
Katora,F,100,118,0,118
Keirstan,F,100,118,0,118
Khiem,M,100,0,118,118
Kileen,F,100,118,0,118
Kolsen,M,100,0,118,118
Kylinn,F,100,118,0,118
Kynnadi,F,100,118,0,118
Kyriaki,F,100,118,0,118
Laelani,F,100,118,0,118
Laporsche,F,100,118,0,118
Ledarrius,M,100,0,118,118
Leontae,M,100,0,118,118
Lillyona,F,100,118,0,118
Loel,M,100,0,118,118
Loreena,F,100,118,0,118
Macarena,F,100,118,0,118
Madysyn,F,100,118,0,118
Marieta,F,100,118,0,118
Marvion,M,100,0,118,118
Mattheu,M,100,0,118,118
Mckoy,M,100,0,118,118
Melisia,F,100,118,0,118
Misbah,F,96,113,5,118
Myrakle,F,100,118,0,118
Nakeysha,F,100,118,0,118
Nakkia,F,100,118,0,118
Orvel,M,100,0,118,118
Pamelyn,F,100,118,0,118
Pratyush,M,100,0,118,118
Prosper,M,100,0,118,118
Quamel,M,100,0,118,118
Quatisha,F,100,118,0,118
Ramonica,F,100,118,0,118
Reene,F,100,118,0,118
Rubee,F,100,118,0,118
Rumaisa,F,100,118,0,118
Saide,F,100,118,0,118
Saniyya,F,100,118,0,118
Sanuel,M,100,0,118,118
Sarahlynn,F,100,118,0,118
Satoya,F,100,118,0,118
Sejla,F,100,118,0,118
Serapio,M,100,0,118,118
Shahida,F,100,118,0,118
Shailene,F,100,118,0,118
Shakeita,F,100,118,0,118
Shaquelle,M,62,45,73,118
Shlonda,F,100,118,0,118
Sholonda,F,100,118,0,118
Suleyman,M,100,0,118,118
Suraiya,F,100,118,0,118
Sylvanus,M,100,0,118,118
Taffie,F,100,118,0,118
Telissa,F,100,118,0,118
Tieasha,F,100,118,0,118
Topeka,F,100,118,0,118
Treyten,M,100,0,118,118
Trine,F,91,107,11,118
Tyhesha,F,100,118,0,118
Veretta,F,100,118,0,118
Xee,F,100,118,0,118
Zadkiel,M,100,0,118,118
Zayvier,M,100,0,118,118
Zhara,F,100,118,0,118
Zlaty,F,100,118,0,118
Zyhir,M,100,0,118,118
Abanoub,M,100,0,117,117
Abdulkarim,M,100,0,117,117
Adabelle,F,100,117,0,117
Ady,F,100,117,0,117
Aengus,M,100,0,117,117
Alahni,F,100,117,0,117
Amali,F,100,117,0,117
Ameia,F,100,117,0,117
Anapaola,F,100,117,0,117
Andrya,F,100,117,0,117
Anshu,F,91,107,10,117
Armina,F,100,117,0,117
Assyria,F,100,117,0,117
Baraa,M,85,17,100,117
Bellamarie,F,100,117,0,117
Bonnye,F,100,117,0,117
Brason,M,100,0,117,117
Brityn,F,100,117,0,117
Brode,M,100,0,117,117
Cadey,F,100,117,0,117
Caly,F,100,117,0,117
Casha,F,100,117,0,117
Ceasia,F,100,117,0,117
Chirstine,F,100,117,0,117
Ciria,F,100,117,0,117
Comer,M,100,0,117,117
Deejay,M,96,5,112,117
Dorann,F,100,117,0,117
Edis,M,96,5,112,117
Emmersen,F,100,117,0,117
Florie,F,100,117,0,117
Freddi,M,60,47,70,117
Fryda,F,100,117,0,117
Gabrien,M,100,0,117,117
Garek,M,100,0,117,117
Gilmar,M,100,0,117,117
Haly,F,100,117,0,117
Hazle,F,100,117,0,117
Heli,F,87,102,15,117
Hemi,M,73,32,85,117
Henlee,F,100,117,0,117
Issaih,M,100,0,117,117
Jakita,F,100,117,0,117
Jalilah,F,100,117,0,117
Jamerion,M,100,0,117,117
Janthony,M,100,0,117,117
Jaton,F,53,62,55,117
Javelle,M,100,0,117,117
Jessah,F,100,117,0,117
Jezlyn,F,100,117,0,117
Jolane,F,100,117,0,117
Jontez,M,100,0,117,117
Joscelyne,F,100,117,0,117
Juliani,F,68,80,37,117
Kabao,F,100,117,0,117
Kadasia,F,100,117,0,117
Kaesyn,M,79,24,93,117
Kaijah,F,100,117,0,117
Kaniel,M,100,0,117,117
Keighan,M,83,20,97,117
Keshona,F,100,117,0,117
Keyaan,M,100,0,117,117
Keyanah,F,100,117,0,117
Krystol,F,100,117,0,117
Kyliana,F,100,117,0,117
Labresha,F,100,117,0,117
Ladavion,M,100,0,117,117
Leianne,F,100,117,0,117
Linas,M,100,0,117,117
Lovena,F,100,117,0,117
Loyde,M,100,0,117,117
Maela,F,100,117,0,117
Marieke,F,100,117,0,117
Marv,M,100,0,117,117
Masa,F,94,110,7,117
Mell,M,63,43,74,117
Merla,F,100,117,0,117
Messina,F,100,117,0,117
Milea,F,100,117,0,117
Milik,M,100,0,117,117
Mitali,F,100,117,0,117
Montarius,M,100,0,117,117
Myliyah,F,100,117,0,117
Naevia,F,100,117,0,117
Nekhi,M,100,0,117,117
Nobel,M,100,0,117,117
Odilon,M,100,0,117,117
Paschal,M,100,0,117,117
Pleas,M,100,0,117,117
Pragya,F,100,117,0,117
Prynce,M,100,0,117,117
Quantarius,M,100,0,117,117
Quantisha,F,100,117,0,117
Quinita,F,100,117,0,117
Quinterrius,M,100,0,117,117
Radek,M,100,0,117,117
Ralyn,F,100,117,0,117
Rasheka,F,100,117,0,117
Rayane,M,94,7,110,117
Rennae,F,100,117,0,117
Rishita,F,100,117,0,117
Rudie,M,56,52,65,117
Ryin,F,51,60,57,117
Sayward,F,100,117,0,117
Schon,M,100,0,117,117
Shalan,F,96,112,5,117
Sharmel,F,100,117,0,117
Shatonia,F,100,117,0,117
Shawnelle,F,100,117,0,117
Shivonne,F,100,117,0,117
Shonya,F,100,117,0,117
Skylur,M,59,48,69,117
Stana,F,100,117,0,117
Suan,F,77,90,27,117
Syan,F,88,103,14,117
Taliesin,M,100,0,117,117
Teion,M,100,0,117,117
Tekeya,F,100,117,0,117
Theodoro,M,100,0,117,117
Travonne,M,100,0,117,117
Trenika,F,100,117,0,117
Treyvin,M,100,0,117,117
Tyniah,F,100,117,0,117
Vallen,M,71,34,83,117
Vanden,M,100,0,117,117
Yamina,F,100,117,0,117
Yaziel,M,100,0,117,117
Yotam,M,100,0,117,117
Zahari,F,61,71,46,117
Zayana,F,100,117,0,117
Ziyanna,F,100,117,0,117
Zong,M,81,22,95,117
Aarian,M,66,40,76,116
Abrial,F,100,116,0,116
Adamarie,F,100,116,0,116
Ademola,M,100,0,116,116
Ajamu,M,100,0,116,116
Ajanee,F,100,116,0,116
Aloura,F,100,116,0,116
Amaranta,F,100,116,0,116
Amarria,F,100,116,0,116
Amorah,F,100,116,0,116
Amybeth,F,100,116,0,116
Amyrie,F,100,116,0,116
Anagabriela,F,100,116,0,116
Ananiah,F,100,116,0,116
Annella,F,100,116,0,116
Ardyce,F,100,116,0,116
Bodin,M,100,0,116,116
Bow,M,96,5,111,116
Cannen,M,100,0,116,116
Cathlin,F,100,116,0,116
Chaden,M,100,0,116,116
Charitie,F,100,116,0,116
Chianna,F,100,116,0,116
Dalaysia,F,100,116,0,116
Danarius,M,100,0,116,116
Darnise,F,100,116,0,116
Decarla,F,100,116,0,116
Deklen,M,100,0,116,116
Denina,F,100,116,0,116
Deuntae,M,100,0,116,116
Donnajean,F,100,116,0,116
Dontrae,M,100,0,116,116
Durante,M,100,0,116,116
Eaden,M,62,44,72,116
Estephan,M,100,0,116,116
Galaxy,F,100,116,0,116
Hamdan,M,100,0,116,116
Hartlee,F,100,116,0,116
Hikari,F,100,116,0,116
Hubbard,M,100,0,116,116
Huckleberry,M,100,0,116,116
Irbin,M,100,0,116,116
Jackalynn,F,100,116,0,116
Jaena,F,100,116,0,116
Jamarea,M,71,34,82,116
Jamice,F,100,116,0,116
Janilah,F,100,116,0,116
Jaquasia,F,100,116,0,116
Jasime,F,100,116,0,116
Jerlisa,F,100,116,0,116
Johany,F,57,66,50,116
Joshawn,M,100,0,116,116
Kaliann,F,100,116,0,116
Kalyan,M,100,0,116,116
Kameo,F,100,116,0,116
Katanya,F,100,116,0,116
Kennett,M,100,0,116,116
Kol,M,100,0,116,116
Kortland,M,100,0,116,116
Lakyla,F,100,116,0,116
Laniesha,F,100,116,0,116
Lashane,F,91,106,10,116
Lexxie,F,100,116,0,116
Lochlyn,F,91,105,11,116
Luccas,M,100,0,116,116
Macrae,M,100,0,116,116
Maddeline,F,100,116,0,116
Manoah,M,100,0,116,116
Marlet,F,100,116,0,116
Marquest,M,100,0,116,116
Mckinzi,F,100,116,0,116
Mischele,F,100,116,0,116
Moyses,M,100,0,116,116
Myleen,F,100,116,0,116
Oluwatamilore,F,84,98,18,116
Orlandus,M,100,0,116,116
Porchea,F,100,116,0,116
Raha,F,100,116,0,116
Ramyah,F,100,116,0,116
Rexann,F,100,116,0,116
Rolene,F,100,116,0,116
Ronniesha,F,100,116,0,116
Rosali,F,100,116,0,116
Sabriel,F,71,82,34,116
Salisa,F,100,116,0,116
Secily,F,100,116,0,116
Shaasia,F,100,116,0,116
Shalaine,F,100,116,0,116
Tacie,F,100,116,0,116
Tag,M,100,0,116,116
Taiquan,M,100,0,116,116
Tasfia,F,100,116,0,116
Teale,F,100,116,0,116
Toben,M,100,0,116,116
Trelon,M,100,0,116,116
Treyven,M,100,0,116,116
Tymika,F,100,116,0,116
Tyrian,M,95,6,110,116
Urie,M,100,0,116,116
Viviano,M,100,0,116,116
Yaritsa,F,100,116,0,116
Abyan,M,76,28,87,115
Adabella,F,100,115,0,115
Aeon,F,51,59,56,115
Aimi,F,100,115,0,115
Alizey,F,100,115,0,115
Amoura,F,100,115,0,115
Anasha,F,100,115,0,115
Anyelina,F,100,115,0,115
Ardian,M,100,0,115,115
Ariaunna,F,100,115,0,115
Arinze,M,100,0,115,115
Bartt,M,100,0,115,115
Briawna,F,100,115,0,115
Briunna,F,100,115,0,115
Bryne,M,95,6,109,115
Casanova,M,100,0,115,115
Catha,F,100,115,0,115
Ceferino,M,100,0,115,115
Chella,F,100,115,0,115
Corbet,M,100,0,115,115
Crickett,F,100,115,0,115
Cyenna,F,100,115,0,115
Dahlton,M,100,0,115,115
Dazha,F,100,115,0,115
Delisia,F,100,115,0,115
Devario,M,100,0,115,115
Dorma,F,100,115,0,115
Dragon,M,100,0,115,115
Dylyn,M,78,25,90,115
Edenilson,M,100,0,115,115
Edinson,M,100,0,115,115
Eduarda,F,100,115,0,115
Elyan,M,100,0,115,115
Esias,M,100,0,115,115
Evamaria,F,100,115,0,115
Galdino,M,100,0,115,115
Genavie,F,100,115,0,115
Geraldean,F,100,115,0,115
Geraldene,F,100,115,0,115
Ghazi,M,100,0,115,115
Haeven,F,91,105,10,115
Hiya,F,100,115,0,115
Ingeborg,F,100,115,0,115
Ivianna,F,100,115,0,115
Izadora,F,100,115,0,115
Izzabell,F,100,115,0,115
Jadriel,M,100,0,115,115
Jaely,F,100,115,0,115
Jahmad,M,100,0,115,115
Jahnaya,F,100,115,0,115
Jaquanda,F,100,115,0,115
Jaydalynn,F,100,115,0,115
Jaythen,M,100,0,115,115
Jessieca,F,100,115,0,115
Jhene,F,100,115,0,115
Joeph,M,100,0,115,115
Jolita,F,100,115,0,115
Jsaon,M,100,0,115,115
Karenann,F,100,115,0,115
Karthikeya,M,100,0,115,115
Katiya,F,100,115,0,115
Kavitha,F,100,115,0,115
Kemaria,F,100,115,0,115
Keyatta,F,100,115,0,115
Kiyoko,F,100,115,0,115
Kohana,F,100,115,0,115
Lakynn,F,100,115,0,115
Lateefa,F,100,115,0,115
Layali,F,100,115,0,115
Lesta,F,100,115,0,115
Lindel,M,95,6,109,115
Londin,F,100,115,0,115
Lorice,F,100,115,0,115
Lumen,F,94,108,7,115
Lyly,F,100,115,0,115
Lynnwood,M,100,0,115,115
Maico,M,100,0,115,115
Makaiah,F,96,110,5,115
Marsia,F,100,115,0,115
Marypat,F,100,115,0,115
Michaelpaul,M,100,0,115,115
Mileydi,F,100,115,0,115
Montravious,M,100,0,115,115
Morenike,F,100,115,0,115
Natsha,F,100,115,0,115
Noela,F,100,115,0,115
Nury,F,100,115,0,115
Olumide,M,100,0,115,115
Ondra,M,80,23,92,115
Oneta,F,100,115,0,115
Paisyn,F,100,115,0,115
Piedad,F,100,115,0,115
Pryor,M,100,0,115,115
Quandre,M,100,0,115,115
Ranie,F,100,115,0,115
Rickesha,F,100,115,0,115
Shahana,F,100,115,0,115
Sharesa,F,100,115,0,115
Shatira,F,100,115,0,115
Shiza,F,100,115,0,115
Shylin,F,100,115,0,115
Sohil,M,100,0,115,115
Tanee,F,100,115,0,115
Tanicka,F,100,115,0,115
Tarig,M,100,0,115,115
Taseen,M,100,0,115,115
Tashanti,F,100,115,0,115
Teondra,F,100,115,0,115
Verlena,F,100,115,0,115
Ximenna,F,100,115,0,115
Yoali,F,100,115,0,115
Yolette,F,100,115,0,115
Yuliet,F,100,115,0,115
Zavia,F,95,109,6,115
Abdikadir,M,100,0,114,114
Adalae,F,100,114,0,114
Aideliz,F,100,114,0,114
Alcide,M,100,0,114,114
Alenah,F,100,114,0,114
Alexina,F,100,114,0,114
Aliese,F,100,114,0,114
Amaryah,F,100,114,0,114
Analena,F,100,114,0,114
Andrius,M,100,0,114,114
Antwonette,F,100,114,0,114
Aracelly,F,100,114,0,114
Armine,F,100,114,0,114
Averly,F,100,114,0,114
Ayano,F,100,114,0,114
Ayeshia,F,100,114,0,114
Brooklee,F,100,114,0,114
Bryah,F,100,114,0,114
Chelsye,F,100,114,0,114
Ching,M,74,30,84,114
Cina,F,100,114,0,114
Clodagh,F,100,114,0,114
Coben,M,100,0,114,114
Colbe,M,95,6,108,114
Coner,M,100,0,114,114
Cordarrius,M,100,0,114,114
Crockett,M,100,0,114,114
Damarien,M,100,0,114,114
Dannis,M,100,0,114,114
Deanette,F,100,114,0,114
Dekker,M,100,0,114,114
Deondrick,M,100,0,114,114
Deovion,M,62,43,71,114
Diavion,F,87,99,15,114
Dimetri,M,100,0,114,114
Dolce,F,100,114,0,114
Donterrius,M,100,0,114,114
Edilson,M,100,0,114,114
Elany,F,100,114,0,114
Erum,F,100,114,0,114
Farin,F,85,97,17,114
Gracianna,F,100,114,0,114
Jaecob,M,100,0,114,114
Jamear,M,100,0,114,114
Jaquann,M,100,0,114,114
Jhayla,F,100,114,0,114
Jiro,M,100,0,114,114
Johathon,M,100,0,114,114
Josia,M,96,5,109,114
Jowanda,F,100,114,0,114
Joyceann,F,100,114,0,114
Kamaury,M,96,5,109,114
Kawena,F,91,104,10,114
Kaylib,M,100,0,114,114
Kayven,M,100,0,114,114
Keddrick,M,100,0,114,114
Kelso,M,100,0,114,114
Kenndra,F,100,114,0,114
Kimbella,F,100,114,0,114
Kimetha,F,100,114,0,114
Kirandeep,F,100,114,0,114
Krina,F,100,114,0,114
Kristiane,F,100,114,0,114
Kyriana,F,100,114,0,114
Laneya,F,100,114,0,114
Lavalle,M,96,5,109,114
Leani,F,100,114,0,114
Lenardo,M,100,0,114,114
Lestine,F,100,114,0,114
Lilianah,F,100,114,0,114
Lincy,F,100,114,0,114
Lurlene,F,100,114,0,114
Maame,F,100,114,0,114
Maizee,F,100,114,0,114
Malan,F,96,109,5,114
Mashelle,F,100,114,0,114
Mattelyn,F,100,114,0,114
Maye,F,100,114,0,114
Maziyah,F,100,114,0,114
Mckynna,F,100,114,0,114
Miasha,F,100,114,0,114
Mikaeel,M,100,0,114,114
Mykelle,F,96,109,5,114
Noheli,F,100,114,0,114
Ovid,M,100,0,114,114
Patryce,F,100,114,0,114
Paw,F,100,114,0,114
Pike,M,100,0,114,114
Providencia,F,100,114,0,114
Quiera,F,100,114,0,114
Quindon,M,100,0,114,114
Racquelle,F,100,114,0,114
Ranetta,F,100,114,0,114
Rangel,M,100,0,114,114
Ronnae,F,100,114,0,114
Sacoya,F,100,114,0,114
Saje,F,67,76,38,114
Samai,F,100,114,0,114
Shabrea,F,100,114,0,114
Shafer,M,100,0,114,114
Shamecka,F,100,114,0,114
Shandale,F,96,109,5,114
Shaquayla,F,100,114,0,114
Shatarra,F,100,114,0,114
Sherion,F,100,114,0,114
Shuntay,F,100,114,0,114
Simara,F,100,114,0,114
Sinaya,F,100,114,0,114
Somalia,F,100,114,0,114
Srijan,M,100,0,114,114
Suprena,F,100,114,0,114
Tadan,M,100,0,114,114
Tajee,M,70,34,80,114
Tanav,M,100,0,114,114
Tarae,F,91,104,10,114
Tiajah,F,100,114,0,114
Tiyona,F,100,114,0,114
Tonjua,F,100,114,0,114
Tristram,M,100,0,114,114
Tylek,M,100,0,114,114
Tyniesha,F,100,114,0,114
Tyronza,F,95,108,6,114
Xara,F,100,114,0,114
Xylon,M,100,0,114,114
Aashritha,F,100,113,0,113
Abdulwahab,M,100,0,113,113
Aero,M,85,17,96,113
Ambry,F,100,113,0,113
Amiera,F,100,113,0,113
Armari,M,65,39,74,113
Ashey,F,100,113,0,113
Audryanna,F,100,113,0,113
Avarey,F,100,113,0,113
Ayanni,F,100,113,0,113
Celisse,F,100,113,0,113
Chevette,F,100,113,0,113
Chrishana,F,100,113,0,113
Clayborne,M,100,0,113,113
Climmie,M,55,51,62,113
Dabid,M,100,0,113,113
Damare,M,100,0,113,113
Darchelle,F,100,113,0,113
Debbrah,F,100,113,0,113
Decklyn,M,73,30,83,113
Delrae,F,100,113,0,113
Devereaux,M,95,6,107,113
Elhadji,M,100,0,113,113
Emyah,F,100,113,0,113
Eyoel,M,100,0,113,113
Farra,F,100,113,0,113
Gabrielly,F,100,113,0,113
Geisha,F,100,113,0,113
Gurveer,M,100,0,113,113
Heer,F,100,113,0,113
Ifeanyichukwu,M,100,0,113,113
Indalecio,M,100,0,113,113
Itzamar,F,100,113,0,113
Jahbari,M,100,0,113,113
Jamylah,F,100,113,0,113
Jatia,F,100,113,0,113
Jazarah,F,100,113,0,113
Jehiel,M,100,0,113,113
Josuel,M,100,0,113,113
Julianah,F,100,113,0,113
Kache,F,50,57,56,113
Kairy,F,95,107,6,113
Kaitelyn,F,100,113,0,113
Kayd,M,100,0,113,113
Keeon,M,100,0,113,113
Keisi,F,100,113,0,113
Kelven,M,100,0,113,113
Kevona,F,100,113,0,113
Kleber,M,100,0,113,113
Klyn,F,100,113,0,113
Korrey,M,100,0,113,113
Kosha,F,100,113,0,113
Ladoris,F,100,113,0,113
Lakaisha,F,100,113,0,113
Latravion,M,100,0,113,113
Leily,F,100,113,0,113
Londan,F,100,113,0,113
Loye,M,77,26,87,113
Makayli,F,100,113,0,113
Mardelle,F,100,113,0,113
Marieann,F,100,113,0,113
Miku,F,100,113,0,113
Mylik,M,100,0,113,113
Naod,M,100,0,113,113
Navea,F,100,113,0,113
Nikala,F,100,113,0,113
Onesha,F,100,113,0,113
Overton,M,100,0,113,113
Parnika,F,100,113,0,113
Priseis,F,100,113,0,113
Rasheema,F,100,113,0,113
Ravindra,M,100,0,113,113
Reni,F,100,113,0,113
Rocquel,F,100,113,0,113
Ryelle,F,100,113,0,113
Saagar,M,100,0,113,113
Sael,M,100,0,113,113
Salimata,F,100,113,0,113
Samanthan,F,100,113,0,113
Santoria,F,100,113,0,113
Sanyla,F,100,113,0,113
Sayyid,M,100,0,113,113
Shanetha,F,100,113,0,113
Shyna,F,100,113,0,113
Smokey,M,100,0,113,113
Solan,M,100,0,113,113
Sou,M,100,0,113,113
Sybella,F,100,113,0,113
Taishawn,M,100,0,113,113
Talvin,M,100,0,113,113
Tanganyika,F,100,113,0,113
Tavaria,F,100,113,0,113
Taviana,F,100,113,0,113
Telesforo,M,100,0,113,113
Timoth,M,100,0,113,113
Tipton,M,96,5,108,113
Trenee,F,100,113,0,113
Trigger,M,100,0,113,113
Tyton,M,100,0,113,113
Ustin,M,100,0,113,113
Valerya,F,100,113,0,113
Wilmarie,F,100,113,0,113
Yaeli,F,100,113,0,113
Yalena,F,100,113,0,113
Yassmin,F,100,113,0,113
Ysabela,F,100,113,0,113
Yuette,F,100,113,0,113
Zeanna,F,100,113,0,113
Zeba,F,100,113,0,113
Zyiah,F,100,113,0,113
Aadan,M,100,0,112,112
Aadin,M,100,0,112,112
Abbagayle,F,100,112,0,112
Acelin,M,83,19,93,112
Aliz,F,100,112,0,112
Amyr,M,100,0,112,112
Analeigha,F,100,112,0,112
Andreal,F,100,112,0,112
Anitria,F,100,112,0,112
Annalisia,F,100,112,0,112
Arbie,M,91,10,102,112
Asta,F,100,112,0,112
Averyana,F,100,112,0,112
Aveya,F,100,112,0,112
Azrielle,F,100,112,0,112
Belkys,F,100,112,0,112
Bradee,F,71,79,33,112
Braxden,M,100,0,112,112
Brodin,M,100,0,112,112
Cashis,M,100,0,112,112
Chibueze,M,100,0,112,112
Clarene,F,100,112,0,112
Dejha,F,100,112,0,112
Dierks,M,100,0,112,112
Dinero,M,100,0,112,112
Ekta,F,100,112,0,112
Elayah,F,100,112,0,112
Elisabel,F,100,112,0,112
Ellianah,F,100,112,0,112
Elmina,F,100,112,0,112
Emalea,F,100,112,0,112
Emmali,F,100,112,0,112
Emmilyn,F,100,112,0,112
Fabrizzio,M,100,0,112,112
Ferrin,F,80,90,22,112
Francenia,F,100,112,0,112
Gilma,F,100,112,0,112
Gizzelle,F,100,112,0,112
Hanadi,F,100,112,0,112
Hermine,F,100,112,0,112
Imaya,F,100,112,0,112
Imre,M,100,0,112,112
Inesha,F,100,112,0,112
Iretha,F,100,112,0,112
Isham,M,100,0,112,112
Jacora,F,100,112,0,112
Jaiah,F,100,112,0,112
Jaiel,M,58,47,65,112
Jalayia,F,100,112,0,112
Jameila,F,100,112,0,112
Jaskirat,M,71,32,80,112
Jaylena,F,100,112,0,112
Jazminn,F,100,112,0,112
Joniah,F,100,112,0,112
Jury,F,95,106,6,112
Kaiyan,M,100,0,112,112
Kalven,M,100,0,112,112
Karesha,F,100,112,0,112
Karess,F,100,112,0,112
Karletta,F,100,112,0,112
Kasir,M,100,0,112,112
Kataya,F,100,112,0,112
Keaundre,M,100,0,112,112
Kelsye,F,100,112,0,112
Kester,M,100,0,112,112
Korver,M,100,0,112,112
Kron,M,100,0,112,112
Laksh,M,100,0,112,112
Leanny,F,100,112,0,112
Lira,F,100,112,0,112
Liron,M,66,38,74,112
Luberta,F,100,112,0,112
Ludmila,F,100,112,0,112
Malayjah,F,100,112,0,112
Manmeet,F,69,77,35,112
Margueritte,F,100,112,0,112
Marsella,F,100,112,0,112
Marvene,F,100,112,0,112
Mayling,F,100,112,0,112
Meldon,M,100,0,112,112
Mirjana,F,100,112,0,112
Monterrio,M,100,0,112,112
Nazifa,F,100,112,0,112
Neita,F,100,112,0,112
Nikelle,F,100,112,0,112
Nikky,F,100,112,0,112
Nirvaan,M,100,0,112,112
Nyron,M,100,0,112,112
Oaklyn,F,92,103,9,112
Ofilia,F,100,112,0,112
Phallon,F,100,112,0,112
Priyal,F,100,112,0,112
Quintavis,M,100,0,112,112
Raevon,M,90,11,101,112
Raji,M,100,0,112,112
Rakin,M,100,0,112,112
Rola,F,100,112,0,112
Safi,M,95,6,106,112
Shalay,F,100,112,0,112
Shams,F,62,70,42,112
Shatha,F,100,112,0,112
Shetara,F,100,112,0,112
Shonika,F,100,112,0,112
Siddhanth,M,100,0,112,112
Silus,M,100,0,112,112
Solina,F,100,112,0,112
Solita,F,100,112,0,112
Starletta,F,100,112,0,112
Sula,F,100,112,0,112
Sumiko,F,100,112,0,112
Syrita,F,100,112,0,112
Tagan,F,52,58,54,112
Taiyana,F,100,112,0,112
Tamani,F,100,112,0,112
Tarnesha,F,100,112,0,112
Tayvia,F,100,112,0,112
Tensley,F,100,112,0,112
Terralyn,F,100,112,0,112
Terryann,F,100,112,0,112
Tonnia,F,100,112,0,112
Treylin,M,100,0,112,112
Tylerjames,M,100,0,112,112
Tynell,M,100,0,112,112
Tyquarius,M,100,0,112,112
Valerye,F,100,112,0,112
Valin,M,96,5,107,112
Valyncia,F,100,112,0,112
Vannia,F,100,112,0,112
Varina,F,100,112,0,112
Yalexa,F,100,112,0,112
Yoceline,F,100,112,0,112
Yuvonne,F,100,112,0,112
Zoeann,F,100,112,0,112
Zsofia,F,100,112,0,112
Aalaya,F,100,111,0,111
Addilee,F,100,111,0,111
Ajahnae,F,100,111,0,111
Akshath,M,100,0,111,111
Akya,F,100,111,0,111
Alexios,M,100,0,111,111
Anterrio,M,100,0,111,111
Arriona,F,100,111,0,111
Avalynne,F,100,111,0,111
Averyanna,F,100,111,0,111
Azizah,F,100,111,0,111
Bastien,M,100,0,111,111
Benjerman,M,100,0,111,111
Beyza,F,100,111,0,111
Bomani,M,100,0,111,111
Brandilynn,F,100,111,0,111
Broghan,M,81,21,90,111
Bryor,M,100,0,111,111
Caci,F,100,111,0,111
Cadince,F,100,111,0,111
Cahterine,F,100,111,0,111
Candita,F,100,111,0,111
Carliyah,F,100,111,0,111
Cheyrl,F,100,111,0,111
Chonita,F,100,111,0,111
Circe,F,100,111,0,111
Clydia,F,100,111,0,111
Cray,M,100,0,111,111
Daijanae,F,100,111,0,111
Dariush,M,100,0,111,111
Darrek,M,100,0,111,111
Darryon,M,100,0,111,111
Dayvin,M,100,0,111,111
Demarkis,M,100,0,111,111
Deshanda,F,100,111,0,111
Desiraye,F,100,111,0,111
Desirre,F,100,111,0,111
Dianelys,F,100,111,0,111
Doniven,M,100,0,111,111
Eirene,F,100,111,0,111
Ellesse,F,100,111,0,111
Garlan,M,100,0,111,111
Gerrianne,F,100,111,0,111
Gordie,M,100,0,111,111
Greogry,M,100,0,111,111
Hagar,F,100,111,0,111
Hamzeh,M,100,0,111,111
Hodaya,F,100,111,0,111
Isaiahs,M,100,0,111,111
Jacobus,M,100,0,111,111
Jaiveer,M,100,0,111,111
Jarmon,M,100,0,111,111
Jataya,F,100,111,0,111
Jenniferlynn,F,100,111,0,111
Jetson,M,100,0,111,111
Johanthan,M,100,0,111,111
Jontue,M,69,34,77,111
Julea,F,100,111,0,111
Juliahna,F,100,111,0,111
Julicia,F,100,111,0,111
Julyanna,F,100,111,0,111
Kamy,F,100,111,0,111
Kasarah,F,100,111,0,111
Kataryna,F,100,111,0,111
Keimya,F,100,111,0,111
Khaalid,M,100,0,111,111
Kollins,F,89,99,12,111
Kordel,M,100,0,111,111
Kyilee,F,100,111,0,111
Labrina,F,100,111,0,111
Lakeva,F,100,111,0,111
Lanina,F,100,111,0,111
Lavida,F,100,111,0,111
Ledora,F,100,111,0,111
Lennell,M,95,5,106,111
Lilyahna,F,100,111,0,111
Lion,M,100,0,111,111
Liviya,F,100,111,0,111
Luiscarlos,M,100,0,111,111
Manolito,M,100,0,111,111
Marcille,F,100,111,0,111
Mashal,F,100,111,0,111
Melbourne,M,100,0,111,111
Mikhai,M,100,0,111,111
Mikle,M,100,0,111,111
Namiah,F,100,111,0,111
Nevyn,M,95,5,106,111
Niaomi,F,100,111,0,111
Nuno,M,100,0,111,111
Nyajah,F,100,111,0,111
Orit,F,100,111,0,111
Osmel,M,100,0,111,111
Particia,F,100,111,0,111
Peightyn,F,100,111,0,111
Quy,M,100,0,111,111
Rad,M,100,0,111,111
Relda,F,100,111,0,111
Rhylin,F,69,77,34,111
Rielynn,F,100,111,0,111
Robben,M,59,45,66,111
Roxine,F,100,111,0,111
Royston,M,100,0,111,111
Shabree,F,100,111,0,111
Shantil,F,100,111,0,111
Shaton,F,91,101,10,111
Siniya,F,100,111,0,111
Suprina,F,100,111,0,111
Taiwana,F,100,111,0,111
Tanazia,F,100,111,0,111
Tavonna,F,100,111,0,111
Tayra,F,100,111,0,111
Tykel,M,100,0,111,111
Valeda,F,100,111,0,111
Veatrice,F,100,111,0,111
Yalissa,F,100,111,0,111
Yarexi,F,100,111,0,111
Aalyssa,F,100,110,0,110
Abdoulie,M,100,0,110,110
Adalid,M,90,11,99,110
Alfonzia,M,100,0,110,110
Alija,M,60,44,66,110
Amyre,F,89,98,12,110
Anaija,F,100,110,0,110
Areesha,F,100,110,0,110
Arilynn,F,100,110,0,110
Arrayah,F,100,110,0,110
Athenia,F,100,110,0,110
Aunya,F,100,110,0,110
Bence,M,100,0,110,110
Benford,M,100,0,110,110
Bohdi,M,100,0,110,110
Breean,F,100,110,0,110
Brenisha,F,100,110,0,110
Callin,M,94,7,103,110
Cardale,M,100,0,110,110
Ceniyah,F,100,110,0,110
Chanc,M,100,0,110,110
Chanley,F,100,110,0,110
Chanti,F,100,110,0,110
Charina,F,100,110,0,110
Charlissa,F,100,110,0,110
Chenae,F,100,110,0,110
Chizaram,F,95,104,6,110
Claudetta,F,100,110,0,110
Cythina,F,100,110,0,110
Dailin,F,76,84,26,110
Dajion,M,100,0,110,110
Daphyne,F,100,110,0,110
Devynne,F,100,110,0,110
Dezhane,F,100,110,0,110
Dianca,F,100,110,0,110
Doylene,F,100,110,0,110
Eylin,F,100,110,0,110
Fauna,F,100,110,0,110
Greenleigh,F,100,110,0,110
Gwenneth,F,100,110,0,110
Haddy,F,95,105,5,110
Harlea,F,100,110,0,110
Hau,M,88,13,97,110
Hyde,M,100,0,110,110
Jadalee,F,100,110,0,110
Janavia,F,100,110,0,110
Jaquavian,M,100,0,110,110
Jaquese,M,72,31,79,110
Jayleah,F,100,110,0,110
Jazier,M,100,0,110,110
Jemarion,M,100,0,110,110
Jenniferann,F,100,110,0,110
Jermery,M,100,0,110,110
Jewelianna,F,100,110,0,110
Jhordyn,F,86,95,15,110
Jillana,F,100,110,0,110
Joud,F,80,88,22,110
Jovin,M,100,0,110,110
Juri,F,95,105,5,110
Karalina,F,100,110,0,110
Karmela,F,100,110,0,110
Karolyna,F,100,110,0,110
Kavari,M,100,0,110,110
Kayline,F,100,110,0,110
Koben,M,100,0,110,110
Krystn,F,100,110,0,110
Kyliyah,F,100,110,0,110
Larna,F,100,110,0,110
Larosa,F,100,110,0,110
Lilac,F,100,110,0,110
Lorelee,F,100,110,0,110
Maansi,F,100,110,0,110
Madisin,F,100,110,0,110
Maebry,F,100,110,0,110
Magally,F,100,110,0,110
Malicia,F,100,110,0,110
Marissah,F,100,110,0,110
Markevion,M,100,0,110,110
Maxemiliano,M,100,0,110,110
Maybree,F,100,110,0,110
Merric,M,100,0,110,110
Mohmmad,M,100,0,110,110
Mong,M,84,18,92,110
Monicia,F,100,110,0,110
Mortimer,M,100,0,110,110
Nakari,F,60,66,44,110
Nakhi,M,100,0,110,110
Naylin,F,100,110,0,110
Neleh,F,100,110,0,110
Niang,F,100,110,0,110
Nikoletta,F,100,110,0,110
Noretta,F,100,110,0,110
Nupur,F,100,110,0,110
Nylee,F,100,110,0,110
Olden,M,100,0,110,110
Osmany,M,100,0,110,110
Pema,F,100,110,0,110
Ramani,F,100,110,0,110
Randye,F,100,110,0,110
Rawn,M,100,0,110,110
Rikia,F,100,110,0,110
Rodgerick,M,100,0,110,110
Sanaiyah,F,100,110,0,110
Serrena,F,100,110,0,110
Shadavia,F,100,110,0,110
Shadrack,M,100,0,110,110
Sharine,F,100,110,0,110
Shiah,F,66,73,37,110
Skylier,M,56,48,62,110
Sruti,F,100,110,0,110
Tahari,F,57,63,47,110
Tahtiana,F,100,110,0,110
Taisei,M,100,0,110,110
Tanairy,F,100,110,0,110
Taraneh,F,100,110,0,110
Taziyah,F,89,98,12,110
Theoden,M,100,0,110,110
Tiffanni,F,100,110,0,110
Tniyah,F,100,110,0,110
Torrez,M,100,0,110,110
Tyr,M,100,0,110,110
Yemaya,F,100,110,0,110
Yogi,M,100,0,110,110
Yosmar,M,100,0,110,110
Yussuf,M,100,0,110,110
Zaryan,M,100,0,110,110
Aalaysia,F,100,109,0,109
Abenezer,M,100,0,109,109
Addalee,F,100,109,0,109
Adreanne,F,100,109,0,109
Aftan,F,100,109,0,109
Aily,F,100,109,0,109
Alejah,F,100,109,0,109
Almond,M,100,0,109,109
Altin,M,100,0,109,109
Anastasija,F,100,109,0,109
Andri,M,95,5,104,109
Aqua,F,100,109,0,109
Arita,F,100,109,0,109
Bannon,M,100,0,109,109
Barett,M,100,0,109,109
Bhavana,F,100,109,0,109
Breniyah,F,100,109,0,109
Caliya,F,100,109,0,109
Camyla,F,100,109,0,109
Chantea,F,100,109,0,109
Charne,F,100,109,0,109
Chelbie,F,100,109,0,109
Cleda,F,100,109,0,109
Criston,M,83,19,90,109
Damaree,M,100,0,109,109
Dareion,M,100,0,109,109
Deidrick,M,100,0,109,109
Demitrios,M,100,0,109,109
Deontez,M,100,0,109,109
Emireth,F,100,109,0,109
Endora,F,100,109,0,109
Feliza,F,100,109,0,109
Franceen,F,100,109,0,109
Fynlee,F,100,109,0,109
Hadja,F,100,109,0,109
Halah,F,100,109,0,109
Halaina,F,100,109,0,109
Harl,M,100,0,109,109
Hernandez,M,100,0,109,109
Jahlon,M,100,0,109,109
Jaja,M,100,0,109,109
Jakory,M,100,0,109,109
Janaysha,F,100,109,0,109
Jarious,M,100,0,109,109
Jash,M,100,0,109,109
Jaynell,F,100,109,0,109
Jazma,F,100,109,0,109
Jazsmine,F,100,109,0,109
Jeiden,M,100,0,109,109
Jemya,F,100,109,0,109
Jenesa,F,100,109,0,109
Jermesha,F,100,109,0,109
Jernard,M,100,0,109,109
Jyden,M,100,0,109,109
Jyssica,F,100,109,0,109
Kada,F,100,109,0,109
Kahle,M,100,0,109,109
Kenniyah,F,100,109,0,109
Keyshawna,F,100,109,0,109
Kraven,M,100,0,109,109
Kruti,F,100,109,0,109
Kyira,F,100,109,0,109
Lache,F,100,109,0,109
Lamyra,F,100,109,0,109
Landi,F,100,109,0,109
Lataysha,F,100,109,0,109
Lennyn,M,60,44,65,109
Lilou,F,100,109,0,109
Lirio,F,100,109,0,109
Lizbett,F,100,109,0,109
Maclin,M,100,0,109,109
Mahaila,F,100,109,0,109
Mahogony,F,100,109,0,109
Maigen,F,100,109,0,109
Makhya,F,100,109,0,109
Malita,F,100,109,0,109
Marilea,F,100,109,0,109
Marisah,F,100,109,0,109
Marise,F,100,109,0,109
Martise,M,100,0,109,109
Mikaele,M,100,0,109,109
Mumtaz,F,100,109,0,109
Myshawn,M,100,0,109,109
Nattaly,F,100,109,0,109
Nesta,M,80,22,87,109
Nikcole,F,100,109,0,109
Nikeshia,F,100,109,0,109
Nyriah,F,100,109,0,109
Onesty,F,100,109,0,109
Philisha,F,100,109,0,109
Primrose,F,100,109,0,109
Raianna,F,100,109,0,109
Rasool,M,100,0,109,109
Rino,M,95,5,104,109
Ronte,M,100,0,109,109
Sartaj,M,100,0,109,109
Sava,M,95,5,104,109
Shadana,F,100,109,0,109
Shalika,F,100,109,0,109
Shima,F,100,109,0,109
Stpehanie,F,100,109,0,109
Taimane,F,100,109,0,109
Tarrie,F,95,104,5,109
Tavaughn,M,100,0,109,109
Taym,M,100,0,109,109
Terik,M,100,0,109,109
Tikesha,F,100,109,0,109
Tinaya,F,100,109,0,109
Tobechukwu,M,100,0,109,109
Travor,M,100,0,109,109
Twala,F,100,109,0,109
Ulysees,M,100,0,109,109
Umeka,F,100,109,0,109
Vue,M,100,0,109,109
Zacharius,M,100,0,109,109
Zeric,M,100,0,109,109
Aiyla,F,100,108,0,108
Akeema,F,100,108,0,108
Alexiya,F,100,108,0,108
Amarrion,M,100,0,108,108
Amilliana,F,100,108,0,108
Amunique,F,100,108,0,108
Anaclara,F,100,108,0,108
Anaisabel,F,100,108,0,108
Anajulia,F,100,108,0,108
Andric,M,100,0,108,108
Arijana,F,100,108,0,108
Ashonte,F,100,108,0,108
Aunica,F,100,108,0,108
Aydrien,M,100,0,108,108
Breylen,M,100,0,108,108
Cabria,F,100,108,0,108
Carizma,F,100,108,0,108
Cassadi,F,100,108,0,108
Chasmine,F,100,108,0,108
Chatham,M,75,27,81,108
Cheresa,F,100,108,0,108
Chizara,F,100,108,0,108
Chrisotpher,M,100,0,108,108
Chun,M,91,10,98,108
Cythnia,F,100,108,0,108
Dacotah,M,70,32,76,108
Dailan,M,100,0,108,108
Davyd,M,100,0,108,108
Delainee,F,100,108,0,108
Diamonds,F,100,108,0,108
Doha,F,100,108,0,108
Doraine,F,100,108,0,108
Eldar,M,100,0,108,108
Elester,M,100,0,108,108
Ellina,F,100,108,0,108
Erilyn,F,100,108,0,108
Evrett,M,100,0,108,108
Ewelina,F,100,108,0,108
Famous,M,100,0,108,108
Farha,F,100,108,0,108
Giovanne,M,100,0,108,108
Goran,M,100,0,108,108
Grantland,M,100,0,108,108
Gwendolyne,F,100,108,0,108
Harim,M,100,0,108,108
Harneet,F,100,108,0,108
Hedi,F,100,108,0,108
Icess,F,100,108,0,108
Idaliz,F,100,108,0,108
Ilija,M,100,0,108,108
Isbella,F,100,108,0,108
Itxel,F,100,108,0,108
Itzabella,F,100,108,0,108
Jacorion,M,100,0,108,108
Jahden,M,100,0,108,108
Jahnai,F,90,97,11,108
Jakaiden,M,100,0,108,108
Jazsmin,F,100,108,0,108
Jedaiah,M,100,0,108,108
Jefferie,M,100,0,108,108
Jhanvi,F,100,108,0,108
Kalim,M,100,0,108,108
Kamarian,M,100,0,108,108
Kanija,F,100,108,0,108
Katelee,F,100,108,0,108
Kemonie,F,84,91,17,108
Kenijah,F,100,108,0,108
Khush,M,100,0,108,108
Kiira,F,100,108,0,108
Kimmora,F,100,108,0,108
Kioni,F,100,108,0,108
Koki,M,100,0,108,108
Lakeyshia,F,100,108,0,108
Laquon,M,100,0,108,108
Lavella,F,100,108,0,108
Leshea,F,100,108,0,108
Leshon,M,74,28,80,108
Levone,M,78,24,84,108
Libbey,F,100,108,0,108
Linetta,F,100,108,0,108
Lionardo,M,100,0,108,108
Lissandro,M,100,0,108,108
Lovenia,F,100,108,0,108
Lynisha,F,100,108,0,108
Maanav,M,100,0,108,108
Maddock,M,100,0,108,108
Maelani,F,100,108,0,108
Maghen,F,100,108,0,108
Marnette,F,100,108,0,108
Mega,F,100,108,0,108
Menna,F,100,108,0,108
Meric,M,100,0,108,108
Mizraim,M,100,0,108,108
Naava,F,100,108,0,108
Narely,F,100,108,0,108
Nashea,F,100,108,0,108
Navah,F,100,108,0,108
Neelah,F,100,108,0,108
Neeta,F,100,108,0,108
Nejla,F,100,108,0,108
Nicolae,M,100,0,108,108
Nicolet,F,100,108,0,108
Nioka,F,100,108,0,108
Onur,M,100,0,108,108
Poet,F,81,87,21,108
Princetta,F,100,108,0,108
Quinlynn,F,100,108,0,108
Radiah,F,100,108,0,108
Raffaela,F,100,108,0,108
Rajat,M,100,0,108,108
Raymound,M,100,0,108,108
Rembert,M,100,0,108,108
Rhena,F,100,108,0,108
Sarissa,F,100,108,0,108
Sedale,M,100,0,108,108
Senya,F,100,108,0,108
Shakyia,F,100,108,0,108
Shalona,F,100,108,0,108
Shalunda,F,100,108,0,108
Shaquela,F,100,108,0,108
Shaquisha,F,100,108,0,108
Sherlyne,F,100,108,0,108
Shuna,F,100,108,0,108
Sola,F,95,103,5,108
Sorayah,F,100,108,0,108
Soul,M,80,22,86,108
Taesean,M,100,0,108,108
Tajanay,F,100,108,0,108
Tamasha,F,100,108,0,108
Telesa,F,100,108,0,108
Tine,F,100,108,0,108
Tomicka,F,100,108,0,108
Traevion,M,100,0,108,108
Trelyn,M,100,0,108,108
Ulysee,M,100,0,108,108
Wania,F,100,108,0,108
Wille,M,100,0,108,108
Yacob,M,100,0,108,108
Yaniris,F,100,108,0,108
Yasaman,F,100,108,0,108
Yeny,F,100,108,0,108
Zailynn,F,100,108,0,108
Abdiaziz,M,100,0,107,107
Abron,M,100,0,107,107
Adline,F,100,107,0,107
Ahja,F,100,107,0,107
Alezandra,F,100,107,0,107
Aliviya,F,100,107,0,107
Alleen,F,100,107,0,107
Alyria,F,100,107,0,107
Annamary,F,100,107,0,107
Areen,F,95,102,5,107
Awais,M,100,0,107,107
Bani,F,100,107,0,107
Belenda,F,100,107,0,107
Bita,F,100,107,0,107
Breely,F,100,107,0,107
Brentney,F,100,107,0,107
Brielyn,F,100,107,0,107
Brynlea,F,100,107,0,107
Calloway,M,89,12,95,107
Camelle,F,100,107,0,107
Capucine,F,100,107,0,107
Ceilidh,F,100,107,0,107
Champayne,F,100,107,0,107
Charmon,F,100,107,0,107
Chino,M,100,0,107,107
Cierah,F,100,107,0,107
Corita,F,100,107,0,107
Dachelle,F,100,107,0,107
Daxtyn,M,100,0,107,107
Delquan,M,100,0,107,107
Denora,F,100,107,0,107
Deysha,F,100,107,0,107
Dondrell,M,100,0,107,107
Donnice,F,100,107,0,107
Duchess,F,100,107,0,107
Emaree,F,100,107,0,107
Emauri,M,83,18,89,107
Emmanuell,M,100,0,107,107
Emoree,F,100,107,0,107
Fantasy,F,100,107,0,107
Galit,F,100,107,0,107
Garan,M,100,0,107,107
Gerardine,F,100,107,0,107
Giulian,M,100,0,107,107
Haliyah,F,100,107,0,107
Hedwig,F,100,107,0,107
Hitomi,F,100,107,0,107
Ido,M,100,0,107,107
Irl,M,100,0,107,107
Isaack,M,100,0,107,107
Izmael,M,100,0,107,107
Jaidev,M,100,0,107,107
Jaiyla,F,100,107,0,107
Jakarie,M,100,0,107,107
Jalexus,F,100,107,0,107
Jalyiah,F,100,107,0,107
Jamerius,M,100,0,107,107
Jaqualyn,M,90,11,96,107
Jaquayla,F,100,107,0,107
Jaydian,M,100,0,107,107
Jaymir,M,100,0,107,107
Jermeka,F,100,107,0,107
Johnika,F,100,107,0,107
Jowana,F,100,107,0,107
Judeth,F,100,107,0,107
Julanne,F,100,107,0,107
Jyra,F,100,107,0,107
Kanae,F,100,107,0,107
Karilynn,F,100,107,0,107
Kasheem,M,100,0,107,107
Kayveon,M,100,0,107,107
Kellina,F,100,107,0,107
Kerrilyn,F,100,107,0,107
Khaleelah,F,100,107,0,107
Kierstynn,F,100,107,0,107
Krisna,F,88,94,13,107
Laporscha,F,100,107,0,107
Latonyia,F,100,107,0,107
Letzy,F,100,107,0,107
Lilyian,F,100,107,0,107
Lovelle,M,70,32,75,107
Madicyn,F,100,107,0,107
Makahla,F,100,107,0,107
Marquin,M,100,0,107,107
Marston,M,100,0,107,107
Melainie,F,100,107,0,107
Myna,F,100,107,0,107
Myrtie,F,100,107,0,107
Neomia,F,100,107,0,107
Olsen,M,100,0,107,107
Raeonna,F,100,107,0,107
Raymonda,F,100,107,0,107
Rimsha,F,100,107,0,107
Romaldo,M,100,0,107,107
Rubby,F,100,107,0,107
Schelly,F,100,107,0,107
Semiyah,F,100,107,0,107
Shaleta,F,100,107,0,107
Shaquella,F,100,107,0,107
Shlomie,M,100,0,107,107
Sreeja,F,100,107,0,107
Srihitha,F,100,107,0,107
Sua,F,100,107,0,107
Sylver,F,95,102,5,107
Takeira,F,100,107,0,107
Takhia,F,100,107,0,107
Takiah,F,100,107,0,107
Tarvaris,M,100,0,107,107
Tavarion,M,100,0,107,107
Teniola,F,95,102,5,107
Tereka,F,100,107,0,107
Timica,F,100,107,0,107
Trask,M,100,0,107,107
Vail,F,68,73,34,107
Vali,F,95,102,5,107
Victorine,F,100,107,0,107
Witt,M,100,0,107,107
Yanelle,F,100,107,0,107
Yomaris,F,100,107,0,107
Zebastian,M,100,0,107,107
Adreona,F,100,106,0,106
Aleaya,F,100,106,0,106
Alexxia,F,100,106,0,106
Alsha,F,100,106,0,106
Amario,M,100,0,106,106
Amariz,F,100,106,0,106
Amayrany,F,100,106,0,106
Amilah,F,100,106,0,106
Ammanda,F,100,106,0,106
Anderia,F,100,106,0,106
Anelle,F,100,106,0,106
Azir,M,100,0,106,106
Babs,F,100,106,0,106
Bolton,M,100,0,106,106
Calianna,F,100,106,0,106
Camera,F,100,106,0,106
Cella,F,100,106,0,106
Cheridan,F,100,106,0,106
Damarko,M,100,0,106,106
Diala,F,100,106,0,106
Dvontae,M,100,0,106,106
Dvora,F,100,106,0,106
Ebonye,F,100,106,0,106
Eilee,F,100,106,0,106
Emunah,F,100,106,0,106
Fard,M,100,0,106,106
Feliberto,M,100,0,106,106
Fizza,F,100,106,0,106
Genoa,F,100,106,0,106
Glorious,F,100,106,0,106
Gracious,F,100,106,0,106
Greco,M,100,0,106,106
Hanalei,F,100,106,0,106
Hardie,M,100,0,106,106
Hilma,F,100,106,0,106
Izzak,M,100,0,106,106
Jackye,F,100,106,0,106
Jahzir,M,100,0,106,106
Jaramie,M,100,0,106,106
Jazzmon,F,100,106,0,106
Jennifr,F,100,106,0,106
Jerianne,F,100,106,0,106
Jerriah,F,100,106,0,106
Joelee,F,100,106,0,106
Kafi,F,100,106,0,106
Kaushal,M,100,0,106,106
Kenora,F,100,106,0,106
Keontre,M,100,0,106,106
Keval,M,100,0,106,106
Keyle,F,100,106,0,106
Kinston,M,100,0,106,106
Knoah,M,100,0,106,106
Korby,M,89,12,94,106
Kyleeann,F,100,106,0,106
Kymberley,F,100,106,0,106
Lafreda,F,100,106,0,106
Lajeana,F,100,106,0,106
Lakesa,F,100,106,0,106
Lashunta,F,100,106,0,106
Lateia,F,100,106,0,106
Leam,M,100,0,106,106
Loretto,F,100,106,0,106
Malai,F,100,106,0,106
Marquasha,F,100,106,0,106
Marrell,M,100,0,106,106
Marsheila,F,100,106,0,106
Mekisha,F,100,106,0,106
Michoel,M,100,0,106,106
Mikele,F,60,64,42,106
Mirko,M,100,0,106,106
Naliya,F,100,106,0,106
Ninoska,F,100,106,0,106
Nivek,M,100,0,106,106
Olaoluwa,M,100,0,106,106
Omaree,M,100,0,106,106
Omeka,F,100,106,0,106
Omolola,F,100,106,0,106
Philis,F,100,106,0,106
Renella,F,100,106,0,106
Reynald,M,100,0,106,106
Rhyker,M,100,0,106,106
Rishit,M,100,0,106,106
Robson,M,100,0,106,106
Romanda,F,100,106,0,106
Ronith,M,100,0,106,106
Sabrie,F,100,106,0,106
Saiquan,M,100,0,106,106
Shantika,F,100,106,0,106
Shawnique,F,100,106,0,106
Shaynah,F,100,106,0,106
Sparsh,M,100,0,106,106
Taichi,M,100,0,106,106
Takeyla,F,100,106,0,106
Tallis,M,61,41,65,106
Totiana,F,100,106,0,106
Trenita,F,100,106,0,106
Tysin,M,100,0,106,106
Ugochi,F,100,106,0,106
Umaiza,F,100,106,0,106
Venkat,M,100,0,106,106
Vianny,F,100,106,0,106
Xavyer,M,100,0,106,106
Yacine,M,57,46,60,106
Yordan,M,100,0,106,106
Zared,M,100,0,106,106
Zera,F,100,106,0,106
Aleli,F,100,105,0,105
Anastasya,F,100,105,0,105
Anedra,F,100,105,0,105
Anvika,F,100,105,0,105
Anzley,F,100,105,0,105
Ariday,F,100,105,0,105
Arienna,F,100,105,0,105
Aroldo,M,100,0,105,105
Austina,F,100,105,0,105
Aviendha,F,100,105,0,105
Azuree,F,100,105,0,105
Beaulah,F,100,105,0,105
Brandol,M,100,0,105,105
Brinklee,F,100,105,0,105
Caran,F,100,105,0,105
Carriann,F,100,105,0,105
Ceniya,F,100,105,0,105
Cervando,M,100,0,105,105
Channin,M,57,45,60,105
Chantella,F,100,105,0,105
Chareese,F,100,105,0,105
Cherrise,F,100,105,0,105
Cordarro,M,100,0,105,105
Corneluis,M,100,0,105,105
Cortavius,M,100,0,105,105
Czar,M,100,0,105,105
Damarri,M,100,0,105,105
Danilyn,F,100,105,0,105
Darsi,F,100,105,0,105
Daryana,F,100,105,0,105
Demarr,M,100,0,105,105
Destenee,F,100,105,0,105
Dhana,F,100,105,0,105
Dicie,F,100,105,0,105
Djeneba,F,100,105,0,105
Drako,M,100,0,105,105
Duha,F,100,105,0,105
Dulcey,F,100,105,0,105
Earma,F,100,105,0,105
Elai,M,100,0,105,105
Elania,F,100,105,0,105
Emmajane,F,100,105,0,105
Emmer,F,100,105,0,105
Geniyah,F,100,105,0,105
Geryl,F,90,95,10,105
Grayer,M,100,0,105,105
Gwendoline,F,100,105,0,105
Halynn,F,100,105,0,105
Hikeem,M,100,0,105,105
Ilayda,F,100,105,0,105
Issiac,M,100,0,105,105
Jeffree,M,100,0,105,105
Jenisis,F,100,105,0,105
Jennene,F,100,105,0,105
Jennessy,F,100,105,0,105
Jimel,M,100,0,105,105
Jiovanna,F,100,105,0,105
Jonaven,M,100,0,105,105
Junko,F,100,105,0,105
Kaedance,F,100,105,0,105
Kalev,M,100,0,105,105
Kaydynce,F,100,105,0,105
Keiarah,F,100,105,0,105
Kenidi,F,100,105,0,105
Ketrina,F,100,105,0,105
Khaliel,M,100,0,105,105
Khyron,M,100,0,105,105
Kimiyah,F,100,105,0,105
Kiree,M,85,16,89,105
Kosisochukwu,F,56,59,46,105
Labrian,M,100,0,105,105
Labrittany,F,100,105,0,105
Lachina,F,100,105,0,105
Lataja,F,100,105,0,105
Levonia,F,100,105,0,105
Lorrinda,F,100,105,0,105
Lubertha,F,100,105,0,105
Macai,M,100,0,105,105
Madalen,F,100,105,0,105
Marijke,F,100,105,0,105
Marisue,F,100,105,0,105
Media,F,100,105,0,105
Meily,F,100,105,0,105
Mekaela,F,100,105,0,105
Mihail,M,100,0,105,105
Miia,F,100,105,0,105
Mikaia,F,100,105,0,105
Milika,F,100,105,0,105
Millan,M,95,5,100,105
Miria,F,100,105,0,105
Moksha,F,100,105,0,105
Myreon,M,100,0,105,105
Myrikal,F,100,105,0,105
Nikira,F,100,105,0,105
Olayinka,F,58,61,44,105
Oluwatoni,F,75,79,26,105
Osborn,M,100,0,105,105
Payzlee,F,100,105,0,105
Praneeth,M,100,0,105,105
Raivyn,F,100,105,0,105
Ramal,M,100,0,105,105
Raschelle,F,100,105,0,105
Reola,F,100,105,0,105
Rodrigues,M,100,0,105,105
Sacheen,F,100,105,0,105
Sadler,M,100,0,105,105
Samin,M,100,0,105,105
Samvel,M,100,0,105,105
Sedra,F,100,105,0,105
Shalandria,F,100,105,0,105
Shaliah,F,100,105,0,105
Shamela,F,100,105,0,105
Shannia,F,100,105,0,105
Shanquita,F,100,105,0,105
Sharad,M,100,0,105,105
Shevaun,F,100,105,0,105
Shirlena,F,100,105,0,105
Solangel,F,100,105,0,105
Suriah,F,100,105,0,105
Takoya,F,100,105,0,105
Teejay,M,100,0,105,105
Tyliek,M,100,0,105,105
Tzippy,F,100,105,0,105
Vedha,F,100,105,0,105
Viraaj,M,100,0,105,105
Vishruth,M,100,0,105,105
Wash,M,100,0,105,105
Willo,F,100,105,0,105
Xxavier,M,100,0,105,105
Yobana,F,100,105,0,105
Yousaf,M,100,0,105,105
Yovan,M,100,0,105,105
Yurika,F,100,105,0,105
Zi,F,54,57,48,105
Aarthi,F,100,104,0,104
Adebayo,M,100,0,104,104
Aditri,F,100,104,0,104
Algis,M,100,0,104,104
Allenmichael,M,100,0,104,104
Amdrew,M,100,0,104,104
Ameri,F,94,98,6,104
Anselm,M,100,0,104,104
Aryella,F,100,104,0,104
Ashantae,F,100,104,0,104
Ashlley,F,100,104,0,104
Atilano,M,100,0,104,104
Audrielle,F,100,104,0,104
Awad,M,100,0,104,104
Azyah,F,100,104,0,104
Baeleigh,F,100,104,0,104
Bland,M,100,0,104,104
Bralin,M,100,0,104,104
Breckan,M,100,0,104,104
Breshay,F,100,104,0,104
Breyson,M,100,0,104,104
Brittian,M,75,26,78,104
Bryauna,F,100,104,0,104
Burns,M,100,0,104,104
Cartina,F,100,104,0,104
Ceria,F,100,104,0,104
Cerita,F,100,104,0,104
Chandell,F,100,104,0,104
Charmeka,F,100,104,0,104
Chijioke,M,100,0,104,104
Christna,F,100,104,0,104
Curlee,M,100,0,104,104
Daemyn,M,100,0,104,104
Danyetta,F,100,104,0,104
Dearia,F,100,104,0,104
Delberta,F,100,104,0,104
Deneane,F,100,104,0,104
Derec,M,100,0,104,104
Dorianna,F,100,104,0,104
Dravon,M,100,0,104,104
Dyesha,F,100,104,0,104
Earley,M,100,0,104,104
Ezekeil,M,100,0,104,104
Fardeen,M,100,0,104,104
Gerik,M,100,0,104,104
Hanifa,F,100,104,0,104
Hinata,F,94,98,6,104
Icker,M,100,0,104,104
Izacc,M,100,0,104,104
Jaevin,M,100,0,104,104
Jahmia,F,100,104,0,104
Jaiona,F,100,104,0,104
Jaleisa,F,100,104,0,104
Janequa,F,100,104,0,104
Janus,F,75,78,26,104
Jany,F,100,104,0,104
Jennavie,F,100,104,0,104
Jie,M,83,18,86,104
Joal,M,81,20,84,104
Jovann,M,94,6,98,104
Kaelea,F,100,104,0,104
Kanishk,M,100,0,104,104
Kare,F,100,104,0,104
Kashina,F,100,104,0,104
Katheren,F,100,104,0,104
Katianne,F,100,104,0,104
Kaysin,M,95,5,99,104
Kemara,F,100,104,0,104
Keyion,M,100,0,104,104
Khamron,M,100,0,104,104
Kie,M,95,5,99,104
Kimika,F,100,104,0,104
Kohner,M,100,0,104,104
Lamarco,M,100,0,104,104
Larrisha,F,100,104,0,104
Lexii,F,100,104,0,104
Liala,F,100,104,0,104
Lorane,F,100,104,0,104
Lorann,F,100,104,0,104
Maclaine,F,82,85,19,104
Madoc,M,100,0,104,104
Mainor,M,100,0,104,104
Mairim,F,100,104,0,104
Malashia,F,100,104,0,104
Manami,F,100,104,0,104
Marcelis,M,100,0,104,104
Marijah,F,100,104,0,104
Marvine,F,92,96,8,104
Matyas,M,100,0,104,104
Maycen,M,55,47,57,104
Mehkai,M,100,0,104,104
Milanna,F,100,104,0,104
Nayeliz,F,100,104,0,104
Ndrew,M,100,0,104,104
Ourania,F,100,104,0,104
Pape,M,100,0,104,104
Qiara,F,100,104,0,104
Rabab,F,100,104,0,104
Ranette,F,100,104,0,104
Rayni,F,100,104,0,104
Richel,F,100,104,0,104
Rithwik,M,100,0,104,104
Rotunda,F,100,104,0,104
Rubens,M,100,0,104,104
Sajjad,M,100,0,104,104
Satrina,F,100,104,0,104
Shadawn,F,100,104,0,104
Shalicia,F,100,104,0,104
Shayon,M,93,7,97,104
Sloka,F,100,104,0,104
Sonnia,F,100,104,0,104
Talishia,F,100,104,0,104
Tarini,F,100,104,0,104
Tatsuya,M,100,0,104,104
Tayjah,F,100,104,0,104
Temisha,F,100,104,0,104
Teonia,F,100,104,0,104
Tniya,F,100,104,0,104
Trayven,M,100,0,104,104
Undray,M,100,0,104,104
Vernadine,F,100,104,0,104
Vernesha,F,100,104,0,104
Whitfield,M,100,0,104,104
Yacoub,M,100,0,104,104
Yannet,F,100,104,0,104
Yoon,M,72,29,75,104
Zerenity,F,100,104,0,104
Ziasia,F,100,104,0,104
Zimri,M,94,6,98,104
Adden,M,100,0,103,103
Adreena,F,100,103,0,103
Ahlaya,F,100,103,0,103
Alamin,M,100,0,103,103
Alanea,F,100,103,0,103
Allahna,F,100,103,0,103
Amabel,F,100,103,0,103
Amitai,M,100,0,103,103
Anadalay,F,100,103,0,103
Anes,M,100,0,103,103
Angelyse,F,100,103,0,103
Anisten,F,100,103,0,103
Aronda,F,100,103,0,103
Arshiya,F,100,103,0,103
Aryaan,M,100,0,103,103
Asuncion,M,53,48,55,103
Awab,M,100,0,103,103
Axyl,M,100,0,103,103
Azyria,F,100,103,0,103
Beckem,M,100,0,103,103
Benna,F,100,103,0,103
Brightyn,F,100,103,0,103
Brittley,F,100,103,0,103
Brytney,F,100,103,0,103
Cabella,F,100,103,0,103
Camilah,F,100,103,0,103
Cashe,F,66,68,35,103
Cashlyn,F,100,103,0,103
Cederic,M,100,0,103,103
Cenia,F,100,103,0,103
Cortlan,M,100,0,103,103
Daril,M,100,0,103,103
Dayannara,F,100,103,0,103
Deiontae,M,100,0,103,103
Demetres,M,94,6,97,103
Donyetta,F,100,103,0,103
Drevin,M,100,0,103,103
Elleen,F,100,103,0,103
Emine,F,100,103,0,103
Evalynne,F,100,103,0,103
Evelene,F,100,103,0,103
Furkan,M,100,0,103,103
Gailyn,F,100,103,0,103
Govind,M,100,0,103,103
Gurman,M,94,6,97,103
Harden,M,100,0,103,103
Haru,M,83,18,85,103
Heberto,M,100,0,103,103
Holleigh,F,100,103,0,103
Jaan,M,100,0,103,103
Jakyrah,F,100,103,0,103
Jamala,F,100,103,0,103
Jamillia,F,100,103,0,103
Jaqwon,M,100,0,103,103
Jasslyn,F,100,103,0,103
Jaymond,M,100,0,103,103
Jkayla,F,100,103,0,103
Johnavon,M,100,0,103,103
Joleena,F,100,103,0,103
Josip,M,100,0,103,103
Joyice,F,100,103,0,103
Juanette,F,100,103,0,103
Junette,F,100,103,0,103
Jylian,F,100,103,0,103
Katria,F,100,103,0,103
Khoury,M,100,0,103,103
Khristin,F,100,103,0,103
Kiamesha,F,100,103,0,103
Kili,F,100,103,0,103
Korde,M,100,0,103,103
Laronn,M,100,0,103,103
Lijah,M,90,10,93,103
Liliah,F,100,103,0,103
Lisvet,F,100,103,0,103
Lizann,F,100,103,0,103
Lizzete,F,100,103,0,103
Ludie,F,84,87,16,103
Lynise,F,100,103,0,103
Lynnsie,F,100,103,0,103
Maeci,F,100,103,0,103
Maeley,F,100,103,0,103
Makiyla,F,100,103,0,103
Margareth,F,100,103,0,103
Mariyana,F,100,103,0,103
Marlos,M,100,0,103,103
Marylynne,F,100,103,0,103
Meer,M,100,0,103,103
Meredeth,F,100,103,0,103
Milas,M,100,0,103,103
Mordche,M,100,0,103,103
Muriah,F,100,103,0,103
Mylez,M,100,0,103,103
Namiyah,F,100,103,0,103
Nathanyl,M,100,0,103,103
Nickola,F,100,103,0,103
Nicoles,M,100,0,103,103
Nimo,F,100,103,0,103
Nocholas,M,100,0,103,103
Pasty,F,100,103,0,103
Persephanie,F,100,103,0,103
Quamere,M,100,0,103,103
Quintara,F,100,103,0,103
Quitman,M,100,0,103,103
Rachard,M,100,0,103,103
Ramandeep,F,84,87,16,103
Ramata,F,100,103,0,103
Reather,F,100,103,0,103
Ronnita,F,100,103,0,103
Sakira,F,100,103,0,103
Samauri,F,56,58,45,103
Shadie,F,84,87,16,103
Shaft,M,100,0,103,103
Shanoah,F,100,103,0,103
Sharisa,F,100,103,0,103
Simrat,F,100,103,0,103
Solae,F,100,103,0,103
Sundiata,M,100,0,103,103
Tacia,F,100,103,0,103
Taige,M,77,24,79,103
Takyah,F,100,103,0,103
Tekeshia,F,100,103,0,103
Tierrah,F,100,103,0,103
Tomoko,F,100,103,0,103
Tracina,F,100,103,0,103
Tramya,F,100,103,0,103
Travarius,M,100,0,103,103
Tuere,F,100,103,0,103
Valley,F,100,103,0,103
Vincen,M,100,0,103,103
Welford,M,100,0,103,103
Win,M,89,11,92,103
Winni,F,100,103,0,103
Yadir,M,100,0,103,103
Yessika,F,100,103,0,103
Yuridiana,F,100,103,0,103
Zayin,M,100,0,103,103
Aadhav,M,100,0,102,102
Adeyemi,M,100,0,102,102
Aften,F,100,102,0,102
Allexa,F,100,102,0,102
Amazing,F,100,102,0,102
Amrie,F,100,102,0,102
Andyn,M,100,0,102,102
Aniqua,F,100,102,0,102
Annebelle,F,100,102,0,102
Antanisha,F,100,102,0,102
Araiya,F,100,102,0,102
Arayna,F,100,102,0,102
Arthurine,F,100,102,0,102
Ashyra,F,100,102,0,102
Audris,F,100,102,0,102
Aviella,F,100,102,0,102
Aylinn,F,100,102,0,102
Behr,M,100,0,102,102
Bernarda,F,100,102,0,102
Bettyjean,F,100,102,0,102
Carely,F,100,102,0,102
Cerria,F,100,102,0,102
Challis,F,85,87,15,102
Charlies,M,100,0,102,102
Chatara,F,100,102,0,102
Cheo,M,100,0,102,102
Chihiro,F,100,102,0,102
Clois,M,100,0,102,102
Dakia,F,100,102,0,102
Dalayla,F,100,102,0,102
Deannah,F,100,102,0,102
Derrico,M,100,0,102,102
Deveney,F,100,102,0,102
Donja,F,100,102,0,102
Dontarious,M,100,0,102,102
Durenda,F,100,102,0,102
Dyshon,M,100,0,102,102
Elijan,M,100,0,102,102
Elray,M,100,0,102,102
Emet,M,100,0,102,102
Erla,F,100,102,0,102
Evanny,F,100,102,0,102
Franchelle,F,100,102,0,102
Guage,M,100,0,102,102
Handy,M,95,5,97,102
Idil,F,100,102,0,102
Ikeya,F,100,102,0,102
Iley,F,90,92,10,102
Izzie,F,100,102,0,102
Jaasia,F,100,102,0,102
Jacklyne,F,100,102,0,102
Jahshua,M,100,0,102,102
Jaline,F,100,102,0,102
Jasraj,M,100,0,102,102
Jaszmine,F,100,102,0,102
Jaylianna,F,100,102,0,102
Jesua,M,100,0,102,102
Jilliam,F,100,102,0,102
Johnnye,F,95,97,5,102
Johonna,F,100,102,0,102
Jood,F,92,94,8,102
Joseff,M,100,0,102,102
Josehua,M,100,0,102,102
Joyia,F,100,102,0,102
Jupiter,M,89,11,91,102
Kacyn,M,63,38,64,102
Katalena,F,100,102,0,102
Keondria,F,100,102,0,102
Kerline,F,100,102,0,102
Keyoni,F,95,97,5,102
Khyleigh,F,100,102,0,102
Kimley,F,100,102,0,102
Laurrie,F,100,102,0,102
Leanard,M,100,0,102,102
Lemond,M,100,0,102,102
Louellen,F,100,102,0,102
Makylee,F,100,102,0,102
Marchele,F,100,102,0,102
Marrie,F,100,102,0,102
Marshel,M,88,12,90,102
Matas,M,100,0,102,102
Mercedies,F,100,102,0,102
Merryn,F,100,102,0,102
Meshawn,F,100,102,0,102
Miking,M,100,0,102,102
Milda,F,100,102,0,102
Million,M,100,0,102,102
Montrelle,M,100,0,102,102
Myosha,F,100,102,0,102
Nahima,F,100,102,0,102
Nayanna,F,100,102,0,102
Niala,F,100,102,0,102
Norelle,F,100,102,0,102
Nusaybah,F,100,102,0,102
Ojani,M,100,0,102,102
Osias,M,100,0,102,102
Pasqualina,F,100,102,0,102
Paylin,F,100,102,0,102
Pualani,F,100,102,0,102
Quantia,F,100,102,0,102
Rainelle,F,100,102,0,102
Ranen,M,100,0,102,102
Rannie,M,85,15,87,102
Reianna,F,100,102,0,102
Reveca,F,100,102,0,102
Rexanna,F,100,102,0,102
Saahir,M,100,0,102,102
Saben,M,100,0,102,102
Saesha,F,100,102,0,102
Sameen,F,90,92,10,102
Savalas,M,100,0,102,102
Savita,F,100,102,0,102
Shametra,F,100,102,0,102
Sharley,F,100,102,0,102
Sharnee,F,100,102,0,102
Sheralee,F,100,102,0,102
Siler,M,100,0,102,102
Spyros,M,100,0,102,102
Sunaina,F,100,102,0,102
Taejah,F,100,102,0,102
Tayli,F,100,102,0,102
Tonji,F,100,102,0,102
Trevaris,M,100,0,102,102
Vickii,F,100,102,0,102
Weslyn,F,84,86,16,102
Zanita,F,100,102,0,102
Zarif,M,100,0,102,102
Zebulan,M,100,0,102,102
Zhoe,F,100,102,0,102
Zorana,F,100,102,0,102
Adiba,F,100,101,0,101
Akaya,F,100,101,0,101
Alejandria,F,100,101,0,101
Alencia,F,100,101,0,101
Alizaya,F,100,101,0,101
Ameliana,F,100,101,0,101
Annalynne,F,100,101,0,101
Annastyn,F,100,101,0,101
Anshi,F,100,101,0,101
Argelio,M,100,0,101,101
Arhum,M,100,0,101,101
Aroush,F,100,101,0,101
Ashawna,F,100,101,0,101
Avea,F,100,101,0,101
Axavier,M,100,0,101,101
Ayuub,M,100,0,101,101
Azarria,F,100,101,0,101
Bana,F,100,101,0,101
Berneta,F,100,101,0,101
Bradden,M,100,0,101,101
Britainy,F,100,101,0,101
Brodric,M,100,0,101,101
Burnadette,F,100,101,0,101
Carrell,M,72,28,73,101
Charmelle,F,100,101,0,101
Chaunce,M,100,0,101,101
Chereese,F,100,101,0,101
Cheveyo,M,100,0,101,101
Coe,M,100,0,101,101
Corran,M,100,0,101,101
Darlys,F,100,101,0,101
Davarious,M,100,0,101,101
Davionte,M,100,0,101,101
Delailah,F,100,101,0,101
Derhonda,F,100,101,0,101
Devanshi,F,100,101,0,101
Dontravious,M,100,0,101,101
Dorrien,M,100,0,101,101
Draeden,M,100,0,101,101
Elridge,M,100,0,101,101
Ezechiel,M,100,0,101,101
Felicite,F,100,101,0,101
Gaetan,M,100,0,101,101
Geanie,F,100,101,0,101
Gevon,M,100,0,101,101
Hajer,F,100,101,0,101
Hammond,M,100,0,101,101
Ismelda,F,100,101,0,101
Iwalani,F,100,101,0,101
Jacarius,M,100,0,101,101
Jackob,M,100,0,101,101
Jadakiss,M,87,13,88,101
Jaleeya,F,100,101,0,101
Jaliza,F,100,101,0,101
Jasmene,F,100,101,0,101
Jatavian,M,100,0,101,101
Jaydi,F,100,101,0,101
Jeanet,F,100,101,0,101
Jessikah,F,100,101,0,101
Jimeka,F,100,101,0,101
Jonathin,M,100,0,101,101
Jshon,M,100,0,101,101
Julen,M,100,0,101,101
Juliany,F,100,101,0,101
Kaelei,F,100,101,0,101
Kaileena,F,100,101,0,101
Kaimen,M,100,0,101,101
Kalese,F,100,101,0,101
Karmina,F,100,101,0,101
Kathrene,F,100,101,0,101
Keyah,F,100,101,0,101
Keyira,F,100,101,0,101
Keymoni,F,63,64,37,101
Kingstin,M,100,0,101,101
Kolbee,M,53,47,54,101
Kyung,F,73,74,27,101
Lacharles,M,100,0,101,101
Ladarrian,M,100,0,101,101
Lailyn,F,100,101,0,101
Larayne,F,100,101,0,101
Lason,M,100,0,101,101
Laurajean,F,100,101,0,101
Leenah,F,100,101,0,101
Legaci,F,100,101,0,101
Lillieann,F,100,101,0,101
Ludwika,F,100,101,0,101
Luismanuel,M,100,0,101,101
Lynnel,F,100,101,0,101
Mabrey,F,100,101,0,101
Magdalynn,F,100,101,0,101
Maitlyn,F,100,101,0,101
Makylie,F,100,101,0,101
Mando,M,100,0,101,101
Maor,M,100,0,101,101
Maricsa,F,100,101,0,101
Maripat,F,100,101,0,101
Marthe,F,100,101,0,101
Martita,F,100,101,0,101
Marzetta,F,100,101,0,101
Maudine,F,100,101,0,101
Melvena,F,100,101,0,101
Mikisha,F,100,101,0,101
Nayib,M,100,0,101,101
Nicolemarie,F,100,101,0,101
Omolara,F,100,101,0,101
Onaje,M,100,0,101,101
Owain,M,100,0,101,101
Pammie,F,100,101,0,101
Petro,M,100,0,101,101
Phynix,F,69,70,31,101
Portland,F,84,85,16,101
Quantavis,M,100,0,101,101
Quinterious,M,100,0,101,101
Ranbir,M,100,0,101,101
Rhina,F,100,101,0,101
Roiza,F,100,101,0,101
Romonda,F,100,101,0,101
Ruven,M,100,0,101,101
Sair,M,100,0,101,101
Sanay,M,76,24,77,101
Saphyre,F,100,101,0,101
Sashay,F,100,101,0,101
Schae,F,100,101,0,101
Seattle,F,95,96,5,101
Shakedra,F,100,101,0,101
Shamarra,F,100,101,0,101
Sharilynn,F,100,101,0,101
Shavette,F,100,101,0,101
Shawntina,F,100,101,0,101
Shelaine,F,100,101,0,101
Sherran,F,100,101,0,101
Skyanne,F,100,101,0,101
Stonewall,M,100,0,101,101
Suhaan,M,100,0,101,101
Taim,M,100,0,101,101
Taiven,M,100,0,101,101
Tamilyn,F,100,101,0,101
Tashica,F,100,101,0,101
Tifini,F,100,101,0,101
Titilayo,F,100,101,0,101
Tonae,F,100,101,0,101
Tyrea,F,87,88,13,101
Wanza,F,100,101,0,101
Williette,F,100,101,0,101
Wolfe,M,100,0,101,101
Yaslyn,F,100,101,0,101
Yossef,M,100,0,101,101
Zionah,F,100,101,0,101
Zyshonne,M,100,0,101,101
Aadon,M,100,0,100,100
Abdulkadir,M,100,0,100,100
Adaja,F,100,100,0,100
Addasyn,F,100,100,0,100
Alixandrea,F,100,100,0,100
Alvon,M,100,0,100,100
Amnah,F,100,100,0,100
Annaliz,F,100,100,0,100
Anushree,F,100,100,0,100
Areta,F,100,100,0,100
Aubrionna,F,100,100,0,100
Bahja,F,100,100,0,100
Bekka,F,100,100,0,100
Bereket,M,100,0,100,100
Bijon,M,80,20,80,100
Brandyce,F,100,100,0,100
Cailah,F,100,100,0,100
Calandria,F,100,100,0,100
Carleena,F,100,100,0,100
Cassiel,M,79,21,79,100
Chariah,F,100,100,0,100
Christiona,F,100,100,0,100
Daisja,F,100,100,0,100
Dajsha,F,100,100,0,100
Danicia,F,100,100,0,100
Darric,M,100,0,100,100
Dejanira,F,100,100,0,100
Deral,M,100,0,100,100
Docia,F,100,100,0,100
Domnic,M,100,0,100,100
Dontavion,M,100,0,100,100
Drinda,F,100,100,0,100
Eilyn,F,100,100,0,100
Elber,M,100,0,100,100
Elizabth,F,100,100,0,100
Engelbert,M,100,0,100,100
Erine,F,88,88,12,100
Evellyn,F,100,100,0,100
Fendi,F,100,100,0,100
Fey,F,100,100,0,100
Galena,F,100,100,0,100
Gatha,F,100,100,0,100
Gem,F,100,100,0,100
Germani,F,100,100,0,100
Ghazal,F,100,100,0,100
Ilee,F,100,100,0,100
Itay,M,100,0,100,100
Jacalynn,F,100,100,0,100
Jahmani,M,100,0,100,100
Jakota,M,100,0,100,100
Jamarria,F,100,100,0,100
Jaonna,F,100,100,0,100
Jariana,F,100,100,0,100
Jaslynne,F,100,100,0,100
Jeanifer,F,100,100,0,100
Jedi,M,100,0,100,100
Jeralynn,F,100,100,0,100
Jonavin,M,100,0,100,100
Kamalei,F,81,81,19,100
Kardell,M,100,0,100,100
Kaylenn,F,100,100,0,100
Keen,M,100,0,100,100
Kelicia,F,100,100,0,100
Kemyah,F,100,100,0,100
Kenyette,F,100,100,0,100
Khiree,M,100,0,100,100
Kissie,F,100,100,0,100
Kurstyn,F,100,100,0,100
Kyion,M,100,0,100,100
Laira,F,100,100,0,100
Lemonte,M,100,0,100,100
Levana,F,100,100,0,100
Liliani,F,100,100,0,100
Linville,M,100,0,100,100
Lokelani,F,100,100,0,100
Lorynn,F,100,100,0,100
Madlynn,F,100,100,0,100
Malekai,M,100,0,100,100
Marlaysia,F,100,100,0,100
Maronda,F,100,100,0,100
Maryse,F,100,100,0,100
Okechukwu,M,100,0,100,100
Reylene,F,100,100,0,100
Rickeya,F,100,100,0,100
Rutledge,M,100,0,100,100
Ryer,M,100,0,100,100
Sanye,F,100,100,0,100
Sashia,F,100,100,0,100
Seleta,F,100,100,0,100
Shirely,F,100,100,0,100
Siniyah,F,100,100,0,100
Slaton,M,100,0,100,100
Spike,M,100,0,100,100
Stein,M,100,0,100,100
Suvan,M,100,0,100,100
Syaire,M,94,6,94,100
Syleena,F,100,100,0,100
Talayia,F,100,100,0,100
Tarez,M,100,0,100,100
Tawyna,F,100,100,0,100
Thandiwe,F,100,100,0,100
Ticia,F,100,100,0,100
Tiombe,F,100,100,0,100
Tippi,F,100,100,0,100
Trachelle,F,100,100,0,100
Traeh,F,71,71,29,100
Tremeka,F,100,100,0,100
Trenace,F,100,100,0,100
Tyianna,F,100,100,0,100
Tyland,M,100,0,100,100
Unice,F,95,95,5,100
Verina,F,100,100,0,100
Veryl,M,100,0,100,100
Wandy,F,100,100,0,100
Xochilth,F,100,100,0,100
Yarieliz,F,100,100,0,100
Zoa,F,100,100,0,100
Zorianna,F,100,100,0,100
Aayana,F,100,99,0,99
Adelise,F,100,99,0,99
Ailana,F,100,99,0,99
Ajane,F,100,99,0,99
Aleayah,F,100,99,0,99
Alexsus,F,100,99,0,99
Amylah,F,100,99,0,99
Anaysha,F,100,99,0,99
Aneudy,M,100,0,99,99
Aradia,F,100,99,0,99
Auriella,F,100,99,0,99
Ayce,M,100,0,99,99
Barbera,F,100,99,0,99
Berenize,F,100,99,0,99
Berklie,F,100,99,0,99
Brach,M,100,0,99,99
Brandun,M,100,0,99,99
Brindy,F,100,99,0,99
Clairessa,F,100,99,0,99
Clearance,M,100,0,99,99
Daanish,M,100,0,99,99
Dahir,M,100,0,99,99
Dailee,F,100,99,0,99
Damante,M,100,0,99,99
Dazaria,F,100,99,0,99
Deaveon,M,70,30,69,99
Deshanti,F,100,99,0,99
Djon,M,100,0,99,99
Donterius,M,100,0,99,99
Dusan,M,100,0,99,99
Elianne,F,100,99,0,99
Enda,F,100,99,0,99
Erryn,F,100,99,0,99
Evagelia,F,100,99,0,99
Evalise,F,100,99,0,99
Evolett,F,100,99,0,99
Faylene,F,100,99,0,99
Greidy,F,100,99,0,99
Hadessah,F,100,99,0,99
Herold,M,100,0,99,99
Idelle,F,100,99,0,99
Imir,M,100,0,99,99
Isabellarose,F,100,99,0,99
Ismar,M,89,11,88,99
Jacqeline,F,100,99,0,99
Jadda,F,100,99,0,99
Jaegar,M,100,0,99,99
Jakeia,F,100,99,0,99
Jalaiya,F,100,99,0,99
Jamair,M,100,0,99,99
Jasiri,M,93,7,92,99
Jayko,M,100,0,99,99
Jaylina,F,100,99,0,99
Jearline,F,100,99,0,99
Jisell,F,100,99,0,99
Joneric,M,100,0,99,99
Josiephine,F,100,99,0,99
Juma,M,100,0,99,99
Justn,M,100,0,99,99
Kaitlynd,F,100,99,0,99
Kaleesi,F,100,99,0,99
Kameria,F,100,99,0,99
Kebrina,F,100,99,0,99
Keiandre,M,100,0,99,99
Keimora,F,100,99,0,99
Kenidy,F,100,99,0,99
Kennidee,F,100,99,0,99
Keydi,F,100,99,0,99
Khamiyah,F,100,99,0,99
Kristyana,F,100,99,0,99
Kyndahl,F,100,99,0,99
Lailany,F,100,99,0,99
Leaf,M,100,0,99,99
Lilyona,F,100,99,0,99
Lisle,M,84,16,83,99
Magdalina,F,100,99,0,99
Maiko,F,72,71,28,99
Mallisa,F,100,99,0,99
Marianita,F,100,99,0,99
Markitta,F,100,99,0,99
Maryela,F,100,99,0,99
Mashawn,F,63,62,37,99
Mccade,M,100,0,99,99
Michi,F,92,91,8,99
Monetta,F,100,99,0,99
Mouhamad,M,100,0,99,99
Myya,F,100,99,0,99
Nakeeta,F,100,99,0,99
Nema,F,82,81,18,99
Oprah,F,100,99,0,99
Pedrohenrique,M,100,0,99,99
Phoua,F,100,99,0,99
Ramces,M,100,0,99,99
Ranulfo,M,100,0,99,99
Reyden,M,100,0,99,99
Reyonna,F,100,99,0,99
Rhylen,M,74,26,73,99
Riaz,M,100,0,99,99
Rustyn,M,100,0,99,99
Schwanda,F,100,99,0,99
Senica,M,73,27,72,99
Shahla,F,100,99,0,99
Shamiracle,F,100,99,0,99
Shanora,F,100,99,0,99
Shashana,F,100,99,0,99
Shavontae,F,95,94,5,99
Sirenia,F,100,99,0,99
Skarleth,F,100,99,0,99
Stela,F,100,99,0,99
Taevin,M,100,0,99,99
Tarica,F,100,99,0,99
Tashiya,F,100,99,0,99
Tiburcio,M,100,0,99,99
Tiersa,F,100,99,0,99
Tinita,F,100,99,0,99
Torryn,F,77,76,23,99
Tricha,F,100,99,0,99
Tuck,M,100,0,99,99
Tysheena,F,100,99,0,99
Vayden,M,100,0,99,99
Venda,F,100,99,0,99
Wanna,F,100,99,0,99
Wyona,F,100,99,0,99
Xachary,M,100,0,99,99
Yania,F,100,99,0,99
Yarithza,F,100,99,0,99
Yashar,M,100,0,99,99
Yosgar,M,100,0,99,99
Yun,F,74,73,26,99
Zoejane,F,100,99,0,99
Adaria,F,100,98,0,98
Adonias,M,100,0,98,98
Aelyn,F,100,98,0,98
Ailah,F,100,98,0,98
Akoni,M,100,0,98,98
Aliyanah,F,100,98,0,98
Althia,F,100,98,0,98
Alyzae,F,100,98,0,98
Amiliana,F,100,98,0,98
Angellee,F,100,98,0,98
Annaleese,F,100,98,0,98
Annasofia,F,100,98,0,98
Areebah,F,100,98,0,98
Arish,M,100,0,98,98
Armarion,M,100,0,98,98
Arva,F,100,98,0,98
Avondre,M,100,0,98,98
Brylyn,F,78,76,22,98
Brysan,M,100,0,98,98
Caretha,F,100,98,0,98
Chukwuebuka,M,100,0,98,98
Clent,M,100,0,98,98
Clydell,M,94,6,92,98
Connee,F,100,98,0,98
Craigory,M,100,0,98,98
Daielle,F,100,98,0,98
Dandy,M,95,5,93,98
Danyon,M,100,0,98,98
Dartanyon,M,100,0,98,98
Deniesha,F,100,98,0,98
Deverick,M,100,0,98,98
Dontea,M,100,0,98,98
Earlisha,F,100,98,0,98
Elliemae,F,100,98,0,98
Elliyah,F,100,98,0,98
Ellizabeth,F,100,98,0,98
Elonzo,M,100,0,98,98
Emali,F,100,98,0,98
Etana,F,100,98,0,98
Gaynel,F,100,98,0,98
Ghada,F,100,98,0,98
Gianelle,F,100,98,0,98
Giomar,M,100,0,98,98
Grae,F,52,51,47,98
Heiley,F,100,98,0,98
Ignazio,M,100,0,98,98
Jaanai,F,100,98,0,98
Jaleea,F,100,98,0,98
Jamarii,M,100,0,98,98
Jametta,F,100,98,0,98
Jamus,M,100,0,98,98
Jemario,M,100,0,98,98
Jentzen,M,100,0,98,98
Kable,M,100,0,98,98
Kahil,M,100,0,98,98
Kahlee,F,71,70,28,98
Kaleiah,F,100,98,0,98
Karuna,F,100,98,0,98
Kelten,M,100,0,98,98
Khrystian,M,85,15,83,98
Khylin,M,74,25,73,98
Kiora,F,100,98,0,98
Kiwanna,F,100,98,0,98
Knoxx,M,100,0,98,98
Kuba,M,100,0,98,98
Kuper,M,100,0,98,98
Kynzlie,F,100,98,0,98
Lailee,F,100,98,0,98
Lakera,F,100,98,0,98
Latandra,F,100,98,0,98
Latera,F,100,98,0,98
Lavontay,M,100,0,98,98
Layney,F,100,98,0,98
Leomar,M,100,0,98,98
Lexander,M,100,0,98,98
Lilleigh,F,100,98,0,98
Maicol,M,100,0,98,98
Makaelah,F,100,98,0,98
Makeshia,F,100,98,0,98
Marjani,F,100,98,0,98
Marvelle,M,63,36,62,98
Maryruth,F,100,98,0,98
Mayerly,F,100,98,0,98
Mcihael,M,100,0,98,98
Meghanne,F,100,98,0,98
Melvenia,F,100,98,0,98
Milady,F,100,98,0,98
Nicolaos,M,100,0,98,98
Nicolus,M,100,0,98,98
Nikalas,M,100,0,98,98
Nyonna,F,100,98,0,98
Parul,F,100,98,0,98
Pattye,F,100,98,0,98
Quetzal,F,59,58,40,98
Ravinder,M,95,5,93,98
Rawlin,M,100,0,98,98
Raysha,F,100,98,0,98
Rhilee,F,100,98,0,98
Rin,F,100,98,0,98
Rohen,M,100,0,98,98
Rubbie,F,100,98,0,98
Ryaan,M,100,0,98,98
Sadrac,M,100,0,98,98
Sahith,M,100,0,98,98
Sahiti,F,100,98,0,98
Samariya,F,100,98,0,98
Samba,M,100,0,98,98
Shaketta,F,100,98,0,98
Shakhia,F,100,98,0,98
Shamonique,F,100,98,0,98
Shaneece,F,100,98,0,98
Shaneisha,F,100,98,0,98
Sondi,F,100,98,0,98
Sybrina,F,100,98,0,98
Tahjai,M,71,28,70,98
Taiz,F,100,98,0,98
Tashe,F,100,98,0,98
Temprence,F,100,98,0,98
Trinten,M,100,0,98,98
Tymier,M,100,0,98,98
Udell,M,100,0,98,98
Vahan,M,100,0,98,98
Victorian,F,100,98,0,98
Victorious,M,54,45,53,98
Vonzella,F,100,98,0,98
Wiatt,M,100,0,98,98
Wrenn,F,95,93,5,98
Yesika,F,100,98,0,98
Zaydyn,M,100,0,98,98
Aaliyan,F,100,97,0,97
Aceson,M,100,0,97,97
Adarrius,M,100,0,97,97
Adely,F,100,97,0,97
Adreyan,M,100,0,97,97
Afsana,F,100,97,0,97
Afsheen,F,85,82,15,97
Ahyan,M,100,0,97,97
Aldona,F,100,97,0,97
Alexarae,F,100,97,0,97
Allis,F,100,97,0,97
Alto,M,100,0,97,97
Amaka,F,100,97,0,97
Anola,F,100,97,0,97
Anysha,F,100,97,0,97
Aoki,F,100,97,0,97
Apolo,M,100,0,97,97
Arnitra,F,100,97,0,97
Arrian,M,78,21,76,97
Astha,F,100,97,0,97
Brinden,M,100,0,97,97
Brittnye,F,100,97,0,97
Calaya,F,100,97,0,97
Cassundra,F,100,97,0,97
Cesily,F,100,97,0,97
Chantavia,F,100,97,0,97
Charistopher,M,100,0,97,97
Chazlyn,F,100,97,0,97
Chrisoula,F,100,97,0,97
Cinch,M,100,0,97,97
Consandra,F,100,97,0,97
Cosima,F,100,97,0,97
Crescent,F,100,97,0,97
Crespin,M,100,0,97,97
Cyprus,M,90,10,87,97
Dainel,M,100,0,97,97
Dayven,M,100,0,97,97
Deionna,F,100,97,0,97
Delmont,M,100,0,97,97
Delsy,F,100,97,0,97
Deontrey,M,100,0,97,97
Dewarren,M,100,0,97,97
Dirck,M,100,0,97,97
Domonik,M,100,0,97,97
Ege,M,100,0,97,97
Ellason,F,100,97,0,97
Faun,F,100,97,0,97
Ferron,M,88,12,85,97
Fitz,M,100,0,97,97
Haniah,F,100,97,0,97
Hardeep,M,74,25,72,97
Helyn,F,100,97,0,97
Hoke,M,100,0,97,97
Houda,F,100,97,0,97
Ilisha,F,100,97,0,97
Isaid,M,100,0,97,97
Jadamarie,F,100,97,0,97
Jamesen,M,95,5,92,97
Jandiel,M,100,0,97,97
Jasten,M,100,0,97,97
Jomarion,M,100,0,97,97
Josephmichael,M,100,0,97,97
Joshoa,M,100,0,97,97
Jove,M,100,0,97,97
Joycie,F,100,97,0,97
Jullia,F,100,97,0,97
Kaesha,F,100,97,0,97
Kahleah,F,100,97,0,97
Kahner,M,100,0,97,97
Kamilo,M,100,0,97,97
Kamyrah,F,100,97,0,97
Kentley,F,60,58,39,97
Khaidyn,M,100,0,97,97
Khamille,F,100,97,0,97
Khrystyne,F,100,97,0,97
Khyre,M,100,0,97,97
Kirklin,M,100,0,97,97
Kiwan,M,100,0,97,97
Kymberlyn,F,100,97,0,97
Kyrene,F,100,97,0,97
Lachrista,F,100,97,0,97
Laconya,F,100,97,0,97
Lakeyta,F,100,97,0,97
Lindzee,F,100,97,0,97
Lititia,F,100,97,0,97
Loney,M,100,0,97,97
Loranda,F,100,97,0,97
Loudon,M,100,0,97,97
Luv,F,66,64,33,97
Makhayla,F,100,97,0,97
Mateya,F,100,97,0,97
Maty,F,100,97,0,97
Mcgwire,M,100,0,97,97
Mercury,M,94,6,91,97
Mersadez,F,100,97,0,97
Micharl,M,100,0,97,97
Naomia,F,100,97,0,97
Nevia,F,100,97,0,97
Nil,M,89,11,86,97
Nyeli,F,100,97,0,97
Osamah,M,100,0,97,97
Pamlea,F,100,97,0,97
Panhia,F,100,97,0,97
Paralee,F,100,97,0,97
Pegge,F,100,97,0,97
Quaniya,F,100,97,0,97
Rahi,F,79,77,20,97
Retaj,F,100,97,0,97
Ripken,M,100,0,97,97
Rodel,M,100,0,97,97
Rokhaya,F,100,97,0,97
Ronasia,F,100,97,0,97
Santrice,F,100,97,0,97
Savan,M,100,0,97,97
Shalayna,F,100,97,0,97
Shawndel,M,53,46,51,97
Shervon,F,100,97,0,97
Shron,F,100,97,0,97
Sudais,M,100,0,97,97
Tangala,F,100,97,0,97
Tejah,F,100,97,0,97
Temitayo,M,60,39,58,97
Timiko,F,100,97,0,97
Tinnie,F,100,97,0,97
Traye,M,100,0,97,97
Triva,F,100,97,0,97
Troye,M,77,22,75,97
Tynesia,F,100,97,0,97
Uchechi,F,100,97,0,97
Uilani,F,100,97,0,97
Vickki,F,100,97,0,97
Vimal,M,100,0,97,97
Volanda,F,100,97,0,97
Wendal,M,100,0,97,97
Won,M,100,0,97,97
Yeily,F,100,97,0,97
Yunique,F,100,97,0,97
Zyad,M,100,0,97,97
Addysyn,F,100,96,0,96
Adedamola,M,100,0,96,96
Adie,F,95,91,5,96
Adine,F,100,96,0,96
Alassane,M,100,0,96,96
Anadelia,F,100,96,0,96
Arelie,F,100,96,0,96
Arpita,F,100,96,0,96
Arrabella,F,100,96,0,96
Audrena,F,100,96,0,96
Aylyn,F,100,96,0,96
Banita,F,100,96,0,96
Bernd,M,100,0,96,96
Besnik,M,100,0,96,96
Brevon,M,100,0,96,96
Briyan,M,100,0,96,96
Buffey,F,100,96,0,96
Caitland,F,100,96,0,96
Caroly,F,100,96,0,96
Carr,M,100,0,96,96
Chandani,F,100,96,0,96
Channie,F,100,96,0,96
Chelisa,F,100,96,0,96
Corleone,M,100,0,96,96
Daishia,F,100,96,0,96
Dallie,F,100,96,0,96
Damione,M,100,0,96,96
Darletta,F,100,96,0,96
Dashanique,F,100,96,0,96
Dejay,M,100,0,96,96
Demeshia,F,100,96,0,96
Diamone,F,100,96,0,96
Donney,M,100,0,96,96
Donnielle,F,100,96,0,96
Drae,M,100,0,96,96
Durelle,M,100,0,96,96
Dymir,M,100,0,96,96
Eisen,M,100,0,96,96
Emilya,F,100,96,0,96
Emmaclaire,F,100,96,0,96
Endi,M,100,0,96,96
Erabella,F,100,96,0,96
Gargi,F,100,96,0,96
Gerrica,F,100,96,0,96
Gesselle,F,100,96,0,96
Gevin,M,100,0,96,96
Gizell,F,100,96,0,96
Hlee,F,100,96,0,96
Hodges,M,100,0,96,96
Hokulani,F,100,96,0,96
Izola,F,100,96,0,96
Jahne,F,100,96,0,96
Jaleeah,F,100,96,0,96
Jceon,M,100,0,96,96
Jennylee,F,100,96,0,96
Jerah,F,100,96,0,96
Jermisha,F,100,96,0,96
Jerriann,F,100,96,0,96
Jhana,F,100,96,0,96
Jillianna,F,100,96,0,96
Jonice,F,100,96,0,96
Joshu,M,100,0,96,96
Journii,F,100,96,0,96
Jozelynn,F,100,96,0,96
Kaisey,F,100,96,0,96
Karell,M,100,0,96,96
Kimila,F,100,96,0,96
Kiondre,M,100,0,96,96
Klohe,F,100,96,0,96
Kodah,M,100,0,96,96
Krisinda,F,100,96,0,96
Krystyne,F,100,96,0,96
Ladanian,M,100,0,96,96
Lajarvis,M,100,0,96,96
Lametria,F,100,96,0,96
Lamis,F,100,96,0,96
Larose,F,100,96,0,96
Laroyce,M,57,41,55,96
Larren,M,77,22,74,96
Letita,F,100,96,0,96
Lillah,F,100,96,0,96
Lilton,M,100,0,96,96
Lolitha,F,100,96,0,96
Lynard,M,100,0,96,96
Maikel,M,100,0,96,96
Makaleigh,F,100,96,0,96
Makenize,F,100,96,0,96
Makeya,F,100,96,0,96
Mareon,M,100,0,96,96
Marianny,F,100,96,0,96
Maridee,F,100,96,0,96
Maryln,F,100,96,0,96
Medford,M,100,0,96,96
Melitza,F,100,96,0,96
Michaeljoseph,M,100,0,96,96
Mico,M,81,18,78,96
Milicent,F,100,96,0,96
Mishika,F,100,96,0,96
Mycheal,M,100,0,96,96
Najat,F,100,96,0,96
Najir,M,100,0,96,96
Opie,M,100,0,96,96
Paarth,M,100,0,96,96
Patsie,F,100,96,0,96
Peregrine,M,80,19,77,96
Quinterius,M,100,0,96,96
Randilyn,F,100,96,0,96
Raneshia,F,100,96,0,96
Reon,M,100,0,96,96
Rucha,F,100,96,0,96
Saryiah,F,100,96,0,96
Sebastiana,F,100,96,0,96
Shakoya,F,100,96,0,96
Shaquaya,F,100,96,0,96
Shaughnessy,F,95,91,5,96
Swan,F,76,73,23,96
Tacari,M,82,17,79,96
Tahsin,M,80,19,77,96
Tamas,M,100,0,96,96
Taniela,M,100,0,96,96
Tayen,F,68,65,31,96
Terita,F,100,96,0,96
Tyja,F,100,96,0,96
Tyquisha,F,100,96,0,96
Tyshan,M,100,0,96,96
Tyvion,M,100,0,96,96
Valeree,F,100,96,0,96
Valina,F,100,96,0,96
Venesha,F,100,96,0,96
Xana,F,100,96,0,96
Yaniah,F,100,96,0,96
Zacharee,M,95,5,91,96
Zyona,F,100,96,0,96
Zyrell,M,100,0,96,96
Aarica,F,100,95,0,95
Aariv,M,100,0,95,95
Aaronjames,M,100,0,95,95
Aikeem,M,100,0,95,95
Aleanna,F,100,95,0,95
Amarya,F,100,95,0,95
Amritha,F,100,95,0,95
Andriea,F,100,95,0,95
Anet,F,100,95,0,95
Aradhya,F,95,90,5,95
Ardra,F,100,95,0,95
Arthor,M,100,0,95,95
Ashaz,M,100,0,95,95
Ashwika,F,100,95,0,95
Aubrynn,F,100,95,0,95
Ausar,M,100,0,95,95
Aydien,M,100,0,95,95
Aysel,F,100,95,0,95
Basem,M,100,0,95,95
Beaumont,M,100,0,95,95
Bernetha,F,100,95,0,95
Bevely,F,100,95,0,95
Boluwatife,M,59,39,56,95
Caelie,F,100,95,0,95
Cathye,F,100,95,0,95
Chabeli,F,100,95,0,95
Chandlor,M,100,0,95,95
Chea,F,84,80,15,95
Chyane,F,100,95,0,95
Cleora,F,100,95,0,95
Cristofher,M,100,0,95,95
Daiki,M,100,0,95,95
Daquana,F,100,95,0,95
Debrina,F,100,95,0,95
Delance,M,100,0,95,95
Demetry,M,100,0,95,95
Demiana,F,100,95,0,95
Denario,M,100,0,95,95
Derrall,M,100,0,95,95
Deyona,F,100,95,0,95
Dionis,M,100,0,95,95
Dynastee,F,100,95,0,95
Ejay,M,100,0,95,95
Eletha,F,100,95,0,95
Ellanora,F,100,95,0,95
Ellouise,F,100,95,0,95
Emmaleah,F,100,95,0,95
Erby,M,100,0,95,95
Ethne,F,100,95,0,95
Fareeda,F,100,95,0,95
Frans,M,100,0,95,95
Gelena,F,100,95,0,95
Haik,M,100,0,95,95
Haillee,F,100,95,0,95
Hara,F,100,95,0,95
Havish,M,100,0,95,95
Haylynn,F,100,95,0,95
Heidemarie,F,100,95,0,95
Hiilani,F,100,95,0,95
Idrissa,M,94,6,89,95
Imonie,F,100,95,0,95
Itzy,F,100,95,0,95
Jacarra,F,100,95,0,95
Jadarion,M,100,0,95,95
Jahnessa,F,100,95,0,95
Jamicah,M,100,0,95,95
Jamont,M,100,0,95,95
Jauna,F,100,95,0,95
Jaxsin,M,100,0,95,95
Jaylend,M,100,0,95,95
Jayr,M,100,0,95,95
Jeramine,M,100,0,95,95
Jessilynn,F,100,95,0,95
Jinx,F,100,95,0,95
Joanthony,M,100,0,95,95
Jonia,F,100,95,0,95
Kaho,F,100,95,0,95
Kaide,M,100,0,95,95
Karmine,M,100,0,95,95
Kayvan,M,100,0,95,95
Keiston,M,100,0,95,95
Keyry,F,100,95,0,95
Keywon,M,100,0,95,95
Kingstyn,M,100,0,95,95
Kipper,M,100,0,95,95
Kohler,M,100,0,95,95
Kristl,F,100,95,0,95
Kule,M,100,0,95,95
Kyce,M,100,0,95,95
Kylani,F,100,95,0,95
Kymia,F,100,95,0,95
Lakashia,F,100,95,0,95
Layci,F,100,95,0,95
Leahanna,F,100,95,0,95
Leelynn,M,62,36,59,95
Lilyauna,F,100,95,0,95
Loranzo,M,100,0,95,95
Macdonald,M,100,0,95,95
Maitri,F,100,95,0,95
Makaylen,F,100,95,0,95
Makenly,F,100,95,0,95
Malyiah,F,100,95,0,95
Margaree,F,100,95,0,95
Matika,F,100,95,0,95
Mayline,F,100,95,0,95
Maysun,F,95,90,5,95
Melenda,F,100,95,0,95
Merve,F,100,95,0,95
Miho,F,100,95,0,95
Mitul,M,100,0,95,95
Mohamedamin,M,100,0,95,95
Moritz,M,100,0,95,95
Nao,F,89,85,10,95
Nataliyah,F,100,95,0,95
Neave,F,100,95,0,95
Nesa,F,100,95,0,95
Nishtha,F,100,95,0,95
Oshua,M,100,0,95,95
Paddy,F,60,57,38,95
Pius,M,100,0,95,95
Preslea,F,100,95,0,95
Rada,F,100,95,0,95
Rahima,F,100,95,0,95
Rein,M,73,26,69,95
Rhodesia,F,100,95,0,95
Rhone,M,100,0,95,95
Riko,F,63,60,35,95
Rohail,M,100,0,95,95
Salar,M,100,0,95,95
Samier,M,100,0,95,95
Sebron,M,100,0,95,95
Shaquavia,F,100,95,0,95
Shaquoya,F,100,95,0,95
Shateka,F,100,95,0,95
Sheniya,F,100,95,0,95
Shiniqua,F,100,95,0,95
Shyniece,F,100,95,0,95
Sianne,F,100,95,0,95
Ski,F,95,90,5,95
Squire,M,100,0,95,95
Stephanieann,F,100,95,0,95
Stephanos,M,100,0,95,95
Sundy,F,100,95,0,95
Takima,F,100,95,0,95
Tiawanna,F,100,95,0,95
Tiffny,F,100,95,0,95
Tranesha,F,100,95,0,95
Traniece,F,100,95,0,95
Trishna,F,100,95,0,95
Tsering,F,76,72,23,95
Turon,M,100,0,95,95
Tyashia,F,100,95,0,95
Tylique,M,100,0,95,95
Tyrena,F,100,95,0,95
Tyri,M,100,0,95,95
Ural,M,100,0,95,95
Utah,M,100,0,95,95
Victoriya,F,100,95,0,95
Vika,F,100,95,0,95
Wakeelah,F,100,95,0,95
Wallie,M,95,5,90,95
Warnell,M,94,6,89,95
Wasif,M,100,0,95,95
Wilhelmena,F,100,95,0,95
Willisha,F,100,95,0,95
Yanick,M,53,45,50,95
Yanixan,M,100,0,95,95
Zael,M,100,0,95,95
Zanaiya,F,100,95,0,95
Zenya,F,100,95,0,95
Zeven,M,100,0,95,95
Akyah,F,100,94,0,94
Alayasia,F,100,94,0,94
Alazar,M,100,0,94,94
Amahri,M,66,32,62,94
Anael,F,84,79,15,94
Aryav,M,100,0,94,94
Ashanna,F,100,94,0,94
Avonda,F,100,94,0,94
Aydian,M,100,0,94,94
Ayyan,M,100,0,94,94
Brekyn,F,68,64,30,94
Briante,F,95,89,5,94
Bryanda,F,100,94,0,94
Caleen,F,100,94,0,94
Candiace,F,100,94,0,94
Catilyn,F,100,94,0,94
Ceazia,F,100,94,0,94
Celvin,M,100,0,94,94
Chibuike,M,100,0,94,94
Chrysa,F,100,94,0,94
Clancey,M,76,23,71,94
Dago,M,100,0,94,94
Daleon,M,100,0,94,94
Daronte,M,100,0,94,94
Davari,M,100,0,94,94
Davelle,M,95,5,89,94
Deanta,M,100,0,94,94
Deina,F,100,94,0,94
Derl,M,100,0,94,94
Detrell,M,100,0,94,94
Dhaval,M,100,0,94,94
Dontee,M,100,0,94,94
Dystany,F,100,94,0,94
Ecko,F,95,89,5,94
Eeshan,M,100,0,94,94
Eileene,F,100,94,0,94
Eimi,F,100,94,0,94
Fionnuala,F,100,94,0,94
Gennette,F,100,94,0,94
Graceanna,F,100,94,0,94
Harvard,M,100,0,94,94
Hassaan,M,100,0,94,94
Heloise,F,100,94,0,94
Henleigh,F,100,94,0,94
Iam,M,100,0,94,94
Ifeanyi,M,100,0,94,94
Ilina,F,100,94,0,94
Ithan,M,100,0,94,94
Jaculin,F,100,94,0,94
Jag,M,100,0,94,94
Jamaira,F,100,94,0,94
Jaman,M,100,0,94,94
Janyra,F,100,94,0,94
Jaylyne,F,95,89,5,94
Jayshun,M,100,0,94,94
Jazmene,F,100,94,0,94
Jesper,M,100,0,94,94
Jesyka,F,100,94,0,94
Joleah,F,100,94,0,94
Jovee,F,100,94,0,94
Kashira,F,100,94,0,94
Kazimir,M,100,0,94,94
Keawe,M,100,0,94,94
Kelsen,M,100,0,94,94
Keniesha,F,100,94,0,94
Ketih,M,100,0,94,94
Ketzia,F,100,94,0,94
Keziyah,F,100,94,0,94
Khrystina,F,100,94,0,94
Kitiara,F,100,94,0,94
Kjirsten,F,100,94,0,94
Kollen,M,100,0,94,94
Koray,M,100,0,94,94
Lakindra,F,100,94,0,94
Laquiesha,F,100,94,0,94
Leba,F,100,94,0,94
Lelend,M,100,0,94,94
Leshae,F,100,94,0,94
Leul,M,100,0,94,94
Liddie,F,100,94,0,94
Lil,F,100,94,0,94
Linnell,F,55,52,42,94
Livian,F,100,94,0,94
Mackensi,F,100,94,0,94
Matheson,M,100,0,94,94
Maurina,F,100,94,0,94
Mazey,F,100,94,0,94
Milessa,F,100,94,0,94
Mylisa,F,100,94,0,94
Nandan,M,100,0,94,94
Naome,F,100,94,0,94
Natane,F,100,94,0,94
Nathian,M,100,0,94,94
Nickholas,M,100,0,94,94
Obediah,M,100,0,94,94
Oneika,F,100,94,0,94
Patrcia,F,100,94,0,94
Rafia,F,100,94,0,94
Reilynn,F,100,94,0,94
Salahuddin,M,100,0,94,94
Sankalp,M,100,0,94,94
Shaivi,F,100,94,0,94
Shakeerah,F,100,94,0,94
Sharalee,F,100,94,0,94
Sharlize,F,100,94,0,94
Sharne,F,100,94,0,94
Sherald,F,100,94,0,94
Sheyli,F,100,94,0,94
Shikita,F,100,94,0,94
Shirleyann,F,100,94,0,94
Starkisha,F,100,94,0,94
Suren,M,100,0,94,94
Surena,F,100,94,0,94
Tacori,F,62,58,36,94
Takahiro,M,100,0,94,94
Tamella,F,100,94,0,94
Tarhonda,F,100,94,0,94
Thailand,M,89,10,84,94
Thoma,M,84,15,79,94
Tijah,F,95,89,5,94
Tonyetta,F,100,94,0,94
Tytionna,F,100,94,0,94
Xavious,M,100,0,94,94
Xoie,F,100,94,0,94
Yassmine,F,100,94,0,94
Zanden,M,100,0,94,94
Zelig,M,100,0,94,94
Zniya,F,100,94,0,94
Zymarion,M,100,0,94,94
Zymire,M,100,0,94,94
Aaleeyah,F,100,93,0,93
Aaliyana,F,100,93,0,93
Adalei,F,100,93,0,93
Adesuwa,F,100,93,0,93
Adjoa,F,100,93,0,93
Airis,F,95,88,5,93
Almando,M,100,0,93,93
Amijah,F,100,93,0,93
Amoria,F,100,93,0,93
Anaelle,F,100,93,0,93
Anaissa,F,100,93,0,93
Anntionette,F,100,93,0,93
Artrice,F,100,93,0,93
Azaylia,F,100,93,0,93
Baneen,F,100,93,0,93
Bawi,M,87,12,81,93
Brookelle,F,100,93,0,93
Cambre,F,100,93,0,93
Charlesa,F,100,93,0,93
Chavie,F,100,93,0,93
Clinten,M,100,0,93,93
Colandra,F,100,93,0,93
Daden,M,100,0,93,93
Dametri,M,100,0,93,93
Dearis,M,100,0,93,93
Deletha,F,100,93,0,93
Devlon,M,100,0,93,93
Dezarai,F,100,93,0,93
Dondrea,F,82,76,17,93
Donnica,F,100,93,0,93
Dymphna,F,100,93,0,93
Eaven,M,100,0,93,93
Emeree,F,100,93,0,93
Eshani,F,100,93,0,93
Ethyl,F,100,93,0,93
Eura,F,95,88,5,93
Everrett,M,100,0,93,93
Faline,F,100,93,0,93
Genevra,F,100,93,0,93
Gennavieve,F,100,93,0,93
Gerrald,M,100,0,93,93
Gianah,F,100,93,0,93
Graciemae,F,100,93,0,93
Gwynevere,F,100,93,0,93
Harles,M,100,0,93,93
Helmer,M,100,0,93,93
Hurbert,M,100,0,93,93
Imanni,F,100,93,0,93
Izaias,M,100,0,93,93
Izora,F,100,93,0,93
Jaeshaun,M,100,0,93,93
Jahmarion,M,100,0,93,93
Jahmire,M,100,0,93,93
Jailynne,F,100,93,0,93
Jakyri,M,100,0,93,93
Janeann,F,100,93,0,93
Jaquail,M,100,0,93,93
Jasminemarie,F,100,93,0,93
Javaria,F,100,93,0,93
Javonnie,M,89,10,83,93
Jem,F,67,62,31,93
Jenavee,F,100,93,0,93
Jensy,M,58,39,54,93
Jobin,M,100,0,93,93
Jonessa,F,100,93,0,93
Joshuajames,M,100,0,93,93
Jovanne,M,69,29,64,93
Julena,F,100,93,0,93
Juliyah,F,100,93,0,93
Kathlee,F,100,93,0,93
Keitra,F,100,93,0,93
Kenaz,M,100,0,93,93
Kennley,F,100,93,0,93
Kevante,M,100,0,93,93
Kha,M,95,5,88,93
Kidada,F,100,93,0,93
Klover,F,100,93,0,93
Laityn,F,100,93,0,93
Larrell,M,100,0,93,93
Lashann,F,100,93,0,93
Leslieanne,F,100,93,0,93
Leylany,F,100,93,0,93
Lidiya,F,100,93,0,93
Lilliauna,F,100,93,0,93
Linkyn,M,95,5,88,93
Mahreen,F,100,93,0,93
Makendra,F,100,93,0,93
Maliik,M,100,0,93,93
Marcena,F,100,93,0,93
Marieliz,F,100,93,0,93
Marytza,F,100,93,0,93
Maylon,M,92,7,86,93
Mazi,F,75,70,23,93
Mccayla,F,100,93,0,93
Melaysia,F,100,93,0,93
Mistina,F,100,93,0,93
Mliss,F,100,93,0,93
Moon,F,77,72,21,93
Nabria,F,100,93,0,93
Nahsir,M,100,0,93,93
Nahzir,M,100,0,93,93
Nazaire,M,100,0,93,93
Nealie,F,100,93,0,93
Nicolena,F,100,93,0,93
Nitzia,F,100,93,0,93
Olson,M,100,0,93,93
Owynn,M,95,5,88,93
Qaadir,M,100,0,93,93
Raiana,F,100,93,0,93
Raykwon,M,100,0,93,93
Rhia,F,100,93,0,93
Rikita,F,100,93,0,93
Rudine,F,100,93,0,93
Rushawn,M,100,0,93,93
Russia,F,100,93,0,93
Sadik,M,100,0,93,93
Sanjith,M,100,0,93,93
Sanoe,F,100,93,0,93
Sarabi,F,100,93,0,93
Saranda,F,100,93,0,93
Saw,M,100,0,93,93
Shakiara,F,100,93,0,93
Shali,F,100,93,0,93
Shermar,M,100,0,93,93
Shiasia,F,100,93,0,93
Shin,M,87,12,81,93
Tamario,M,100,0,93,93
Tecora,F,100,93,0,93
Temeca,F,100,93,0,93
Tryphena,F,100,93,0,93
Tylicia,F,100,93,0,93
Tyner,M,100,0,93,93
Uziah,M,100,0,93,93
Vallorie,F,100,93,0,93
Vandana,F,100,93,0,93
Westlee,M,100,0,93,93
Windel,M,100,0,93,93
Yariah,F,100,93,0,93
Yosiah,M,100,0,93,93
Aarish,M,100,0,92,92
Aashrith,M,100,0,92,92
Akiba,F,95,87,5,92
Alano,M,100,0,92,92
Anntonette,F,100,92,0,92
Araly,F,100,92,0,92
Ardelle,F,100,92,0,92
Aspynn,F,100,92,0,92
Asuka,F,100,92,0,92
Aury,F,95,87,5,92
Avaline,F,100,92,0,92
Avilene,F,100,92,0,92
Bandy,M,67,30,62,92
Belanna,F,100,92,0,92
Beza,F,100,92,0,92
Brandell,M,93,6,86,92
Britiney,F,100,92,0,92
Charlesia,F,100,92,0,92
Charniece,F,100,92,0,92
Charvez,M,100,0,92,92
Chasty,F,100,92,0,92
Chikita,F,100,92,0,92
Chrisa,F,100,92,0,92
Christinea,F,100,92,0,92
Christopherjame,M,100,0,92,92
Cigi,F,100,92,0,92
Corean,F,100,92,0,92
Courtez,M,100,0,92,92
Damichael,M,100,0,92,92
Danis,M,84,15,77,92
Dayane,F,100,92,0,92
Deago,M,100,0,92,92
Dearies,M,100,0,92,92
Demetrion,M,100,0,92,92
Deseri,F,100,92,0,92
Deshondra,F,100,92,0,92
Dianely,F,100,92,0,92
Doninique,F,79,73,19,92
Donshay,M,70,28,64,92
Evangaline,F,100,92,0,92
Gavriela,F,100,92,0,92
Genean,F,100,92,0,92
Gerrett,M,100,0,92,92
Ginnette,F,100,92,0,92
Gregorey,M,100,0,92,92
Guled,M,100,0,92,92
Hayly,F,100,92,0,92
Helios,M,100,0,92,92
Hellena,F,100,92,0,92
Hulda,F,100,92,0,92
Imanii,F,100,92,0,92
Ireanna,F,100,92,0,92
Iysha,F,100,92,0,92
Jaceion,M,100,0,92,92
Jacia,F,100,92,0,92
Jaelie,F,100,92,0,92
Jahlen,M,100,0,92,92
Jamorion,M,100,0,92,92
Janesia,F,100,92,0,92
Jasilyn,F,100,92,0,92
Jaylnn,F,100,92,0,92
Jersee,F,100,92,0,92
Jhostin,M,100,0,92,92
Jimia,F,100,92,0,92
Jisele,F,100,92,0,92
Joanathan,M,100,0,92,92
Joci,F,100,92,0,92
Josede,M,100,0,92,92
Judene,F,100,92,0,92
Junetta,F,100,92,0,92
Kaiesha,F,100,92,0,92
Kalkidan,F,100,92,0,92
Kambryn,F,100,92,0,92
Karinda,F,100,92,0,92
Kaspar,M,100,0,92,92
Kiko,M,63,34,58,92
Koden,M,100,0,92,92
Kripa,F,100,92,0,92
Krystena,F,100,92,0,92
Kymiah,F,100,92,0,92
Kyreese,M,100,0,92,92
Lajuane,M,100,0,92,92
Lalisa,F,100,92,0,92
Lanissa,F,100,92,0,92
Latash,F,100,92,0,92
Latrel,M,100,0,92,92
Lauriana,F,100,92,0,92
Letanya,F,100,92,0,92
Litsy,F,100,92,0,92
Loras,M,100,0,92,92
Maekayla,F,100,92,0,92
Mande,F,100,92,0,92
Marcelles,M,100,0,92,92
Margan,F,100,92,0,92
Marvon,M,100,0,92,92
Mayley,F,100,92,0,92
Mekaylah,F,100,92,0,92
Miosha,F,100,92,0,92
Miral,F,100,92,0,92
Moriya,F,100,92,0,92
Murlene,F,100,92,0,92
Muzammil,M,100,0,92,92
Myeasha,F,100,92,0,92
Mykaylah,F,100,92,0,92
Neeva,F,100,92,0,92
Nichael,M,100,0,92,92
Nicholson,M,100,0,92,92
Nyheem,M,100,0,92,92
Olawale,M,100,0,92,92
Onyinyechi,F,100,92,0,92
Patrena,F,100,92,0,92
Pavlos,M,100,0,92,92
Polette,F,100,92,0,92
Reilyn,F,100,92,0,92
Rimas,M,71,27,65,92
Rindi,F,100,92,0,92
Ritamarie,F,100,92,0,92
Samamtha,F,100,92,0,92
Samik,M,100,0,92,92
Semaya,F,100,92,0,92
Senovia,F,100,92,0,92
Shakora,F,100,92,0,92
Shandelle,F,100,92,0,92
Shandie,F,100,92,0,92
Shanecia,F,100,92,0,92
Shavaun,F,100,92,0,92
Shawnise,F,100,92,0,92
Shene,F,100,92,0,92
Shereece,F,100,92,0,92
Sherissa,F,100,92,0,92
Shulamis,F,100,92,0,92
Smaran,M,100,0,92,92
Staysha,F,100,92,0,92
Stephanne,F,100,92,0,92
Taetum,F,89,82,10,92
Taiten,M,100,0,92,92
Tamakia,F,100,92,0,92
Tammee,F,100,92,0,92
Taray,M,100,0,92,92
Tarris,M,100,0,92,92
Terianna,F,100,92,0,92
Terrea,F,100,92,0,92
Thaila,F,100,92,0,92
Thaxton,M,100,0,92,92
Tiaria,F,100,92,0,92
Tida,F,100,92,0,92
Tineshia,F,100,92,0,92
Trew,M,88,11,81,92
Treylen,M,100,0,92,92
Ursala,F,100,92,0,92
Vanice,F,100,92,0,92
Vaniya,F,100,92,0,92
Vernee,F,100,92,0,92
Viann,F,100,92,0,92
Victoriah,F,100,92,0,92
Vuk,M,100,0,92,92
Yesha,F,100,92,0,92
Zamani,F,87,80,12,92
Zayanna,F,100,92,0,92
Zeek,M,100,0,92,92
Abbigaile,F,100,91,0,91
Addisson,F,100,91,0,91
Addysin,F,100,91,0,91
Adeleigh,F,100,91,0,91
Aeric,M,100,0,91,91
Alaisa,F,100,91,0,91
Albi,M,100,0,91,91
Aleicia,F,100,91,0,91
Amareon,M,100,0,91,91
Ambreen,F,100,91,0,91
Analyce,F,100,91,0,91
Annete,F,100,91,0,91
Annjeanette,F,100,91,0,91
Arbor,F,81,74,17,91
Ashaunte,F,100,91,0,91
Avey,F,100,91,0,91
Ayahna,F,100,91,0,91
Aydden,M,100,0,91,91
Azyiah,F,100,91,0,91
Balthazar,M,100,0,91,91
Benisha,F,100,91,0,91
Bernis,M,100,0,91,91
Bhavesh,M,100,0,91,91
Blaiden,M,100,0,91,91
Brayli,F,100,91,0,91
Breyer,M,92,7,84,91
Brielynn,F,100,91,0,91
Briggitte,F,100,91,0,91
Bronc,M,100,0,91,91
Brynja,F,100,91,0,91
Caroleen,F,100,91,0,91
Carrolyn,F,100,91,0,91
Caswell,M,100,0,91,91
Caylei,F,100,91,0,91
Chamberlain,M,93,6,85,91
Chandy,F,100,91,0,91
Cleotilde,F,100,91,0,91
Clydene,F,100,91,0,91
Corlette,F,100,91,0,91
Corrissa,F,100,91,0,91
Countess,F,100,91,0,91
Daianna,F,100,91,0,91
Danissa,F,100,91,0,91
Darrelyn,F,100,91,0,91
Davanna,F,100,91,0,91
Delancey,F,69,63,28,91
Derrious,M,100,0,91,91
Deshia,F,100,91,0,91
Devri,F,100,91,0,91
Doryan,M,100,0,91,91
Dreux,M,100,0,91,91
Eather,F,100,91,0,91
Eiman,F,100,91,0,91
Ellicia,F,100,91,0,91
Ferlando,M,100,0,91,91
Franchon,F,100,91,0,91
Furious,M,100,0,91,91
Gailen,M,93,6,85,91
Ghadeer,F,100,91,0,91
Giulietta,F,100,91,0,91
Gorje,M,100,0,91,91
Harvin,M,92,7,84,91
Hazell,F,100,91,0,91
Hollister,M,73,25,66,91
Hurshel,M,100,0,91,91
Ijanae,F,100,91,0,91
Ikhlas,F,100,91,0,91
Io,F,93,85,6,91
Itali,F,100,91,0,91
Jacayla,F,100,91,0,91
Jaeveon,M,100,0,91,91
Jahzaria,F,100,91,0,91
Jaicey,F,100,91,0,91
Jamicia,F,100,91,0,91
Jamyron,M,100,0,91,91
Jaqua,M,69,28,63,91
Jaycub,M,100,0,91,91
Jelitza,F,100,91,0,91
Jenet,F,100,91,0,91
Jesenya,F,100,91,0,91
Johnattan,M,100,0,91,91
Johniya,F,100,91,0,91
Jolon,M,100,0,91,91
Jyasia,F,100,91,0,91
Jyll,F,100,91,0,91
Kadesia,F,100,91,0,91
Kandance,F,100,91,0,91
Kartier,M,95,5,86,91
Keiji,M,100,0,91,91
Kelse,F,100,91,0,91
Kenyia,F,100,91,0,91
Krimson,F,95,86,5,91
Lagretta,F,100,91,0,91
Lajoya,F,100,91,0,91
Lakyia,F,100,91,0,91
Lavora,F,100,91,0,91
Leanza,F,100,91,0,91
Lylee,F,100,91,0,91
Marcelia,F,100,91,0,91
Mariabelen,F,100,91,0,91
Maryjayne,F,100,91,0,91
Mattisen,F,100,91,0,91
Mccabe,M,100,0,91,91
Meet,M,100,0,91,91
Megham,F,100,91,0,91
Mirela,F,100,91,0,91
Missouri,F,100,91,0,91
Mohannad,M,100,0,91,91
Montario,M,100,0,91,91
Monterius,M,100,0,91,91
Mumin,M,100,0,91,91
Najeh,M,100,0,91,91
Nigil,M,100,0,91,91
Ponce,M,100,0,91,91
Rachella,F,100,91,0,91
Rankin,M,100,0,91,91
Rasa,F,100,91,0,91
Rett,M,100,0,91,91
Riese,M,65,32,59,91
Ritha,F,100,91,0,91
Rollo,M,100,0,91,91
Rula,F,100,91,0,91
Saramarie,F,100,91,0,91
Sarea,F,100,91,0,91
Savvy,F,100,91,0,91
Seaton,M,100,0,91,91
Sebastin,M,100,0,91,91
Sesilia,F,100,91,0,91
Shaketha,F,100,91,0,91
Shakti,F,95,86,5,91
Shalla,F,100,91,0,91
Shannie,F,100,91,0,91
Shantinique,F,100,91,0,91
Sharmeka,F,100,91,0,91
Shemeca,F,100,91,0,91
Shondale,M,85,14,77,91
Shonice,F,100,91,0,91
Simrin,F,100,91,0,91
Smiley,M,100,0,91,91
Smrithi,F,100,91,0,91
Soley,F,100,91,0,91
Soma,F,57,52,39,91
Sukari,F,100,91,0,91
Tabrina,F,100,91,0,91
Taheera,F,100,91,0,91
Tajana,F,100,91,0,91
Tank,M,100,0,91,91
Tarahji,F,92,84,7,91
Tenee,F,100,91,0,91
Terecia,F,100,91,0,91
Tereso,M,100,0,91,91
Tiffanyann,F,100,91,0,91
Toluwani,F,53,48,43,91
Toneshia,F,100,91,0,91
Trammell,M,100,0,91,91
Trindon,M,100,0,91,91
Tuleen,F,100,91,0,91
Unkown,M,54,42,49,91
Wilman,M,100,0,91,91
Yuan,M,85,14,77,91
Zenith,F,60,55,36,91
Abhijay,M,100,0,90,90
Airyn,F,94,85,5,90
Altamese,F,100,90,0,90
Amalee,F,100,90,0,90
Amarisa,F,100,90,0,90
Anndee,F,100,90,0,90
Anquanette,F,100,90,0,90
Ardit,M,100,0,90,90
Ariq,M,100,0,90,90
Artist,M,100,0,90,90
Auren,M,56,40,50,90
Bakary,M,100,0,90,90
Beena,F,100,90,0,90
Beverlie,F,100,90,0,90
Breda,F,100,90,0,90
Brendolyn,F,100,90,0,90
Brittlyn,F,100,90,0,90
Brizza,F,100,90,0,90
Carollyn,F,100,90,0,90
Casilda,F,100,90,0,90
Cavion,M,100,0,90,90
Chaitra,F,100,90,0,90
Charan,M,100,0,90,90
Crystie,F,100,90,0,90
Daeron,M,100,0,90,90
Daneli,F,100,90,0,90
Danyia,F,100,90,0,90
Daveena,F,100,90,0,90
Daziya,F,100,90,0,90
Delayni,F,100,90,0,90
Delvis,M,100,0,90,90
Dnasia,F,100,90,0,90
Domitila,F,100,90,0,90
Edee,F,100,90,0,90
Elaisha,F,100,90,0,90
Eliyohu,M,100,0,90,90
Emrah,M,100,0,90,90
Fleta,F,100,90,0,90
Free,M,51,44,46,90
Garik,M,100,0,90,90
Geanette,F,100,90,0,90
Gowri,F,100,90,0,90
Graviel,M,100,0,90,90
Grayton,M,100,0,90,90
Hailly,F,100,90,0,90
Hamna,F,100,90,0,90
Hansini,F,100,90,0,90
Idriss,M,100,0,90,90
Isaiyah,M,100,0,90,90
Izela,F,100,90,0,90
Jacon,M,100,0,90,90
Jakavion,M,100,0,90,90
Jaken,M,100,0,90,90
Jakevion,M,100,0,90,90
Jakorian,M,100,0,90,90
Jakyria,F,100,90,0,90
Jamarques,M,100,0,90,90
Janiylah,F,100,90,0,90
Jaquilla,F,100,90,0,90
Jarry,M,100,0,90,90
Jaydalyn,F,100,90,0,90
Jayvan,M,100,0,90,90
Jemina,F,100,90,0,90
Joushua,M,100,0,90,90
Joyous,F,100,90,0,90
Kabella,F,100,90,0,90
Karielle,F,100,90,0,90
Kayshaun,M,100,0,90,90
Keison,M,100,0,90,90
Kenichi,M,100,0,90,90
Keyler,M,100,0,90,90
Kharizma,F,100,90,0,90
Khilee,F,100,90,0,90
Kimyah,F,100,90,0,90
Klever,M,100,0,90,90
Kohle,M,100,0,90,90
Koreena,F,100,90,0,90
Kyrel,M,100,0,90,90
Kyro,M,100,0,90,90
Lailanie,F,100,90,0,90
Lanetra,F,100,90,0,90
Lawsen,M,100,0,90,90
Leoma,F,100,90,0,90
Lorrena,F,100,90,0,90
Lucciana,F,100,90,0,90
Maisee,F,100,90,0,90
Makayia,F,100,90,0,90
Malasha,F,100,90,0,90
Mardel,F,100,90,0,90
Martesha,F,100,90,0,90
Marteze,M,100,0,90,90
Matelyn,F,100,90,0,90
Mayelin,F,100,90,0,90
Mikaili,F,100,90,0,90
Moncerrath,F,100,90,0,90
Mykle,M,100,0,90,90
Mylani,F,100,90,0,90
Naylene,F,100,90,0,90
Nikai,M,94,5,85,90
Nolita,F,100,90,0,90
Nozomi,F,100,90,0,90
Nuh,M,100,0,90,90
Phinneas,M,100,0,90,90
Rahshawn,M,100,0,90,90
Rakwon,M,100,0,90,90
Rashidi,M,100,0,90,90
Rebacca,F,100,90,0,90
Refoel,M,100,0,90,90
Renuka,F,100,90,0,90
Rilen,M,100,0,90,90
Ruwayda,F,100,90,0,90
Sahmir,M,100,0,90,90
Samani,F,100,90,0,90
Santosha,F,100,90,0,90
Sarie,F,100,90,0,90
Shanaiya,F,100,90,0,90
Shaneese,F,100,90,0,90
Shariq,M,100,0,90,90
Shastina,F,100,90,0,90
Shatana,F,100,90,0,90
Shawneequa,F,100,90,0,90
Sidda,F,100,90,0,90
Siyana,F,100,90,0,90
Somara,F,100,90,0,90
Somtochukwu,M,78,20,70,90
Sophiarose,F,100,90,0,90
Stacyann,F,100,90,0,90
Sudiksha,F,100,90,0,90
Tamre,F,100,90,0,90
Tarisa,F,100,90,0,90
Taunja,F,100,90,0,90
Telesia,F,100,90,0,90
Tequisha,F,100,90,0,90
Terree,F,100,90,0,90
Thamar,F,94,85,5,90
Tieisha,F,100,90,0,90
Todrick,M,100,0,90,90
Torez,M,100,0,90,90
Trayquan,M,100,0,90,90
Trejan,M,100,0,90,90
Tychelle,F,100,90,0,90
Tykeshia,F,100,90,0,90
Tyreque,M,100,0,90,90
Usbaldo,M,100,0,90,90
Vondra,F,100,90,0,90
Waunita,F,100,90,0,90
Whittaker,M,100,0,90,90
Yazir,M,100,0,90,90
Yeva,F,100,90,0,90
Zani,F,78,70,20,90
Zivah,F,100,90,0,90
Zymeir,M,100,0,90,90
Adasha,F,100,89,0,89
Adetokunbo,M,94,5,84,89
Ahilyn,F,100,89,0,89
Ahmia,F,100,89,0,89
Aiyah,F,100,89,0,89
Aldyn,M,65,31,58,89
Amica,F,100,89,0,89
Analysse,F,100,89,0,89
Anarely,F,100,89,0,89
Angeldejesus,M,100,0,89,89
Anihya,F,100,89,0,89
Aniqa,F,100,89,0,89
Ankith,M,100,0,89,89
Annikah,F,100,89,0,89
Antonae,F,100,89,0,89
Ayeden,M,100,0,89,89
Azoria,F,100,89,0,89
Berel,M,100,0,89,89
Betzaira,F,100,89,0,89
Bobbyjoe,M,100,0,89,89
Breckon,M,100,0,89,89
Briseidy,F,100,89,0,89
Caellum,M,100,0,89,89
Cambren,M,100,0,89,89
Camdan,M,100,0,89,89
Carnelius,M,100,0,89,89
Cedarius,M,100,0,89,89
Choya,M,82,16,73,89
Cordai,M,100,0,89,89
Cordelle,M,100,0,89,89
Cristella,F,100,89,0,89
Crytal,F,100,89,0,89
Dakotta,M,63,33,56,89
Dakwon,M,100,0,89,89
Damany,M,100,0,89,89
Danyiel,F,100,89,0,89
Darrik,M,100,0,89,89
Daysie,F,100,89,0,89
Deasiah,F,100,89,0,89
Deslyn,F,100,89,0,89
Ebba,F,94,84,5,89
Ebelyn,F,100,89,0,89
Eladia,F,100,89,0,89
Elainah,F,100,89,0,89
Ellarie,F,100,89,0,89
Elloise,F,100,89,0,89
Elmon,M,100,0,89,89
Emaad,M,100,0,89,89
Emillee,F,100,89,0,89
Estevon,M,100,0,89,89
Ezariah,M,63,33,56,89
Gayna,F,100,89,0,89
Gresia,F,100,89,0,89
Hamsini,F,100,89,0,89
Hanin,F,100,89,0,89
Hasana,F,100,89,0,89
Hiral,F,100,89,0,89
Honestee,F,100,89,0,89
Izaia,M,100,0,89,89
Jabreel,M,100,0,89,89
Jaclene,F,100,89,0,89
Jalyah,F,100,89,0,89
Jamerica,F,100,89,0,89
Janeese,F,100,89,0,89
Jarelis,F,100,89,0,89
Jasmia,F,100,89,0,89
Javeria,F,100,89,0,89
Jaynia,F,100,89,0,89
Jerita,F,100,89,0,89
Jerni,F,100,89,0,89
Jery,M,100,0,89,89
Jguadalupe,M,100,0,89,89
Joden,M,100,0,89,89
Joee,F,94,84,5,89
Joniqua,F,100,89,0,89
Joyell,F,100,89,0,89
Julez,M,88,11,78,89
Kaarin,F,100,89,0,89
Kacelyn,F,100,89,0,89
Kailly,F,100,89,0,89
Kalvyn,M,100,0,89,89
Kamee,F,100,89,0,89
Kanetra,F,100,89,0,89
Kathalina,F,100,89,0,89
Kavian,M,100,0,89,89
Keerstin,F,100,89,0,89
Keino,M,100,0,89,89
Khayman,M,100,0,89,89
Kishana,F,100,89,0,89
Koriana,F,100,89,0,89
Ladrea,F,100,89,0,89
Latica,F,100,89,0,89
Lauralynn,F,100,89,0,89
Lavaya,F,100,89,0,89
Leightyn,F,100,89,0,89
Leisel,F,100,89,0,89
Letina,F,100,89,0,89
Lisel,F,100,89,0,89
Lourdez,F,100,89,0,89
Lynesha,F,100,89,0,89
Lynessa,F,100,89,0,89
Maicie,F,100,89,0,89
Maicy,F,100,89,0,89
Marien,F,100,89,0,89
Marios,M,100,0,89,89
Mashanda,F,100,89,0,89
Matej,M,100,0,89,89
Mattalynn,F,100,89,0,89
Maxum,M,100,0,89,89
Maythe,F,100,89,0,89
Miyoko,F,100,89,0,89
Morley,M,75,22,67,89
Myeesha,F,100,89,0,89
Mykelti,F,58,52,37,89
Natajah,F,100,89,0,89
Nelma,F,100,89,0,89
Nevae,F,100,89,0,89
Nitara,F,100,89,0,89
Niyonna,F,100,89,0,89
Nnaemeka,M,100,0,89,89
Onisha,F,100,89,0,89
Osric,M,100,0,89,89
Pattrick,M,100,0,89,89
Peirce,M,100,0,89,89
Pilot,M,100,0,89,89
Prima,F,100,89,0,89
Raiquan,M,100,0,89,89
Ramondo,M,100,0,89,89
Ranay,F,100,89,0,89
Robley,M,100,0,89,89
Rolen,M,100,0,89,89
Roxas,M,100,0,89,89
Saraphina,F,100,89,0,89
Satonya,F,100,89,0,89
Shahir,M,100,0,89,89
Shalissa,F,100,89,0,89
Shaquell,F,55,49,40,89
Snyder,M,100,0,89,89
Sumedh,M,100,0,89,89
Sunshyne,F,100,89,0,89
Tahirih,F,100,89,0,89
Taima,F,100,89,0,89
Takina,F,100,89,0,89
Tamsyn,F,100,89,0,89
Tekeyah,F,100,89,0,89
Thijs,M,100,0,89,89
Timmia,F,100,89,0,89
Tiyah,F,100,89,0,89
Tone,F,55,49,40,89
Traylen,M,100,0,89,89
Trek,M,100,0,89,89
Tryson,M,100,0,89,89
Tyrene,F,100,89,0,89
Ugo,M,100,0,89,89
Valine,F,100,89,0,89
Vannie,F,55,49,40,89
Vasilisa,F,100,89,0,89
Veleta,F,100,89,0,89
Viktorya,F,100,89,0,89
Yamato,M,100,0,89,89
Yarlin,F,100,89,0,89
Yehudit,F,100,89,0,89
Zackeriah,M,100,0,89,89
Zalma,F,100,89,0,89
Zandon,M,100,0,89,89
Zawadi,F,100,89,0,89
Zaylyn,M,62,34,55,89
Aaryana,F,100,88,0,88
Aberdeen,F,100,88,0,88
Adanely,F,100,88,0,88
Ailea,F,100,88,0,88
Akasia,F,100,88,0,88
Aliou,M,100,0,88,88
Alyanah,F,100,88,0,88
Angeletta,F,100,88,0,88
Arshawn,M,100,0,88,88
Ashyla,F,100,88,0,88
Ataya,F,100,88,0,88
Avyukt,M,100,0,88,88
Azhia,F,100,88,0,88
Babbie,F,100,88,0,88
Bailynn,F,100,88,0,88
Baylynn,F,100,88,0,88
Bernadetta,F,100,88,0,88
Bernisha,F,100,88,0,88
Boss,M,100,0,88,88
Breiona,F,100,88,0,88
Carolan,F,100,88,0,88
Ceyda,F,100,88,0,88
Chanon,F,70,62,26,88
Chayim,M,100,0,88,88
Chibuikem,M,100,0,88,88
Chloeann,F,100,88,0,88
Christhoper,M,100,0,88,88
Clavin,M,100,0,88,88
Cyruss,M,100,0,88,88
Dalaya,F,100,88,0,88
Damascus,M,100,0,88,88
Dameisha,F,100,88,0,88
Dandria,F,100,88,0,88
Danikah,F,100,88,0,88
Daton,M,100,0,88,88
Decoda,M,100,0,88,88
Desare,F,100,88,0,88
Detavious,M,100,0,88,88
Diera,F,100,88,0,88
Dola,F,100,88,0,88
Dreshon,M,100,0,88,88
Duglas,M,100,0,88,88
Durk,M,100,0,88,88
Furqan,M,100,0,88,88
Garhett,M,100,0,88,88
Guilford,M,100,0,88,88
Gwendloyn,F,100,88,0,88
Husein,M,100,0,88,88
Ikesha,F,100,88,0,88
Jaanvi,F,100,88,0,88
Jacqulene,F,100,88,0,88
Jaelani,F,100,88,0,88
Jakevious,M,100,0,88,88
Jashawna,F,100,88,0,88
Jayion,M,100,0,88,88
Jemery,M,100,0,88,88
Jenasia,F,100,88,0,88
Jlen,M,100,0,88,88
Jordanny,M,100,0,88,88
Juergen,M,100,0,88,88
Kamonte,M,100,0,88,88
Kashus,M,100,0,88,88
Katrinna,F,100,88,0,88
Kayleana,F,100,88,0,88
Keajah,F,100,88,0,88
Kealohilani,F,100,88,0,88
Keelon,M,100,0,88,88
Kemyra,F,100,88,0,88
Kevionna,F,100,88,0,88
Kielan,M,100,0,88,88
Kinan,M,100,0,88,88
Kiyra,F,100,88,0,88
Krystyl,F,100,88,0,88
Labrenda,F,100,88,0,88
Laneta,F,100,88,0,88
Latalia,F,100,88,0,88
Latese,F,100,88,0,88
Latoi,F,100,88,0,88
Laysa,F,100,88,0,88
Lilinoe,F,100,88,0,88
Lio,M,100,0,88,88
Lucyann,F,100,88,0,88
Maanasa,F,100,88,0,88
Macall,F,100,88,0,88
Madylyn,F,100,88,0,88
Mahiya,F,100,88,0,88
Mahonri,M,100,0,88,88
Marialice,F,100,88,0,88
Markeria,F,100,88,0,88
Marq,M,100,0,88,88
Mckennon,M,100,0,88,88
Melquisedec,M,100,0,88,88
Meoshia,F,100,88,0,88
Mikalia,F,100,88,0,88
Miro,M,100,0,88,88
Nandana,F,100,88,0,88
Narmeen,F,100,88,0,88
Nayali,F,100,88,0,88
Nechuma,F,100,88,0,88
Neiva,F,100,88,0,88
Nikesh,M,100,0,88,88
Nikitia,F,100,88,0,88
Noelly,F,100,88,0,88
Nykayla,F,100,88,0,88
Obbie,M,100,0,88,88
Ossiel,M,100,0,88,88
Panda,F,100,88,0,88
Pattijo,F,100,88,0,88
Raksha,F,100,88,0,88
Ralphie,M,100,0,88,88
Ryian,M,58,37,51,88
Rynn,F,89,78,10,88
Saamiya,F,100,88,0,88
Sebasthian,M,100,0,88,88
Shatona,F,100,88,0,88
Shatori,F,100,88,0,88
Shelsie,F,100,88,0,88
Sherial,F,100,88,0,88
Shondrika,F,100,88,0,88
Sidhant,M,100,0,88,88
Sinahi,F,100,88,0,88
Sota,M,100,0,88,88
Taishaun,M,100,0,88,88
Tammala,F,100,88,0,88
Taneasha,F,100,88,0,88
Ting,F,83,73,15,88
Valari,F,100,88,0,88
Varnell,M,76,21,67,88
Wahid,M,100,0,88,88
Yader,M,100,0,88,88
Zamyia,F,100,88,0,88
Zayli,F,100,88,0,88
Zelena,F,100,88,0,88
Zikeria,F,100,88,0,88
Zoiee,F,100,88,0,88
Zykiria,F,100,88,0,88
Aamori,F,100,87,0,87
Abdelaziz,M,100,0,87,87
Abdulrahim,M,100,0,87,87
Abundio,M,100,0,87,87
Adalay,F,100,87,0,87
Adoria,F,100,87,0,87
Aerica,F,100,87,0,87
Aleksi,M,68,28,59,87
Alexee,F,100,87,0,87
Aliany,F,100,87,0,87
Alisea,F,100,87,0,87
Ameli,F,100,87,0,87
Amman,M,100,0,87,87
Arabela,F,100,87,0,87
Arlanda,F,77,67,20,87
Ashyah,F,100,87,0,87
Audrionna,F,100,87,0,87
Aviyana,F,100,87,0,87
Axelle,F,100,87,0,87
Belina,F,100,87,0,87
Berdina,F,100,87,0,87
Bianney,F,100,87,0,87
Blyss,F,100,87,0,87
Braelynne,F,100,87,0,87
Britian,M,89,10,77,87
Cathan,M,100,0,87,87
Ceci,F,100,87,0,87
Daana,F,100,87,0,87
Daje,F,100,87,0,87
Danelia,F,100,87,0,87
Daouda,M,100,0,87,87
Dasmine,F,59,51,36,87
Daymein,M,100,0,87,87
Dejion,M,100,0,87,87
Demyah,F,100,87,0,87
Deshante,F,78,68,19,87
Dessire,F,100,87,0,87
Devrin,M,100,0,87,87
Dhanvi,F,100,87,0,87
Domingue,F,78,68,19,87
Drayk,M,100,0,87,87
Duquan,M,100,0,87,87
Elaya,F,100,87,0,87
Elizer,M,100,0,87,87
Evalin,F,100,87,0,87
Fareeha,F,100,87,0,87
Felesia,F,100,87,0,87
Future,M,76,21,66,87
Garlin,M,100,0,87,87
Gatlyn,M,100,0,87,87
Gerldine,F,100,87,0,87
Grainne,F,100,87,0,87
Harika,F,100,87,0,87
Hawthorne,M,100,0,87,87
Hedda,F,100,87,0,87
Herberto,M,100,0,87,87
Hollan,F,89,77,10,87
Huan,M,100,0,87,87
Izella,F,100,87,0,87
Jacquis,M,89,10,77,87
Jaevian,M,100,0,87,87
Jaleiah,F,100,87,0,87
Janiesha,F,100,87,0,87
Janin,F,100,87,0,87
Jebidiah,M,100,0,87,87
Jeidi,F,100,87,0,87
Jenayah,F,100,87,0,87
Jenina,F,100,87,0,87
Jesilyn,F,100,87,0,87
Jeslin,F,100,87,0,87
Jhade,F,100,87,0,87
Jhaniya,F,100,87,0,87
Johnica,F,100,87,0,87
Kaizley,F,100,87,0,87
Kassadie,F,100,87,0,87
Katriona,F,100,87,0,87
Kavaughn,M,100,0,87,87
Kaylean,F,100,87,0,87
Kaytlan,F,100,87,0,87
Keilynn,F,100,87,0,87
Kemia,F,100,87,0,87
Kendrew,M,100,0,87,87
Kenetha,F,100,87,0,87
Kensy,F,100,87,0,87
Keonda,F,100,87,0,87
Khallid,M,100,0,87,87
Kingdavid,M,100,0,87,87
Kinjal,F,100,87,0,87
Kinta,M,84,14,73,87
Kyo,M,100,0,87,87
Laniqua,F,100,87,0,87
Latarra,F,100,87,0,87
Latronda,F,100,87,0,87
Laylia,F,100,87,0,87
Lennart,M,100,0,87,87
Levaughn,M,100,0,87,87
Loden,M,100,0,87,87
Lorah,F,100,87,0,87
Mackena,F,100,87,0,87
Mada,F,100,87,0,87
Madysun,F,100,87,0,87
Mahasin,F,100,87,0,87
Malaijah,F,100,87,0,87
Matrice,F,100,87,0,87
Mavric,M,100,0,87,87
Mayerli,F,100,87,0,87
Mccauley,M,76,21,66,87
Meital,F,100,87,0,87
Melaya,F,100,87,0,87
Miski,F,100,87,0,87
Mohd,M,100,0,87,87
Monaca,F,100,87,0,87
Murrel,M,100,0,87,87
Mycala,F,100,87,0,87
Mykira,F,100,87,0,87
Naesha,F,100,87,0,87
Naika,F,100,87,0,87
Navraj,M,100,0,87,87
Nayden,M,100,0,87,87
Nicle,F,100,87,0,87
Nyzier,M,100,0,87,87
Palyn,F,100,87,0,87
Pami,F,100,87,0,87
Parissa,F,100,87,0,87
Pebble,F,100,87,0,87
Petr,M,100,0,87,87
Phyllip,M,100,0,87,87
Poetry,F,100,87,0,87
Quaniyah,F,100,87,0,87
Reginna,F,100,87,0,87
Rishikesh,M,100,0,87,87
Roniel,M,100,0,87,87
Ronzell,M,100,0,87,87
Rushton,M,100,0,87,87
Sabastien,M,100,0,87,87
Sadat,M,100,0,87,87
Samyria,F,100,87,0,87
Sedonia,F,100,87,0,87
Selen,F,100,87,0,87
Selita,F,100,87,0,87
Shalaina,F,100,87,0,87
Shanikia,F,100,87,0,87
Shawny,F,100,87,0,87
Sheridyn,F,100,87,0,87
Shuron,M,54,40,47,87
Shuronda,F,100,87,0,87
Starlit,F,100,87,0,87
Syvanna,F,100,87,0,87
Tacuma,M,100,0,87,87
Taelyr,F,100,87,0,87
Taino,M,100,0,87,87
Tallula,F,100,87,0,87
Tallyn,F,59,51,36,87
Terius,M,100,0,87,87
Terreon,M,100,0,87,87
Thomasene,F,100,87,0,87
Tonishia,F,100,87,0,87
Toniyah,F,100,87,0,87
Tremond,M,100,0,87,87
Trusten,M,100,0,87,87
Tyreanna,F,100,87,0,87
Vishaal,M,100,0,87,87
Viveka,F,100,87,0,87
Willma,F,100,87,0,87
Xcaret,F,100,87,0,87
Xhaiden,M,100,0,87,87
Yarielys,F,100,87,0,87
Yasheka,F,100,87,0,87
Ynez,F,100,87,0,87
Yon,M,100,0,87,87
Zamier,M,100,0,87,87
Zyara,F,100,87,0,87
Abigaelle,F,100,86,0,86
Adalind,F,100,86,0,86
Addley,F,100,86,0,86
Adisson,F,94,81,5,86
Aileena,F,100,86,0,86
Almalik,M,100,0,86,86
Anays,F,100,86,0,86
Anterio,M,100,0,86,86
Aquinnah,F,100,86,0,86
Arlesia,F,100,86,0,86
Arlita,F,100,86,0,86
Armstead,M,100,0,86,86
Arnol,M,100,0,86,86
Arsal,M,100,0,86,86
Ashvik,M,100,0,86,86
Athaliah,F,100,86,0,86
Aunesti,F,100,86,0,86
Aviyah,F,100,86,0,86
Ayaana,F,100,86,0,86
Ayaat,F,100,86,0,86
Azizi,F,83,71,15,86
Biance,F,100,86,0,86
Blessen,F,100,86,0,86
Brayln,M,100,0,86,86
Caitlyne,F,100,86,0,86
Caleigha,F,100,86,0,86
Candies,F,100,86,0,86
Caoilainn,F,100,86,0,86
Carigan,F,100,86,0,86
Caz,M,100,0,86,86
Cem,M,100,0,86,86
Chele,F,100,86,0,86
Chelli,F,100,86,0,86
Chessica,F,100,86,0,86
Chiniqua,F,100,86,0,86
Chioke,M,100,0,86,86
Christyanna,F,100,86,0,86
Claudis,M,100,0,86,86
Corsica,F,100,86,0,86
Cortana,F,100,86,0,86
Dalyce,F,100,86,0,86
Damyn,M,100,0,86,86
Davanta,M,100,0,86,86
Deaunna,F,100,86,0,86
Dequita,F,100,86,0,86
Doshia,F,100,86,0,86
Dreonna,F,100,86,0,86
Dvaughn,M,100,0,86,86
Elaria,F,100,86,0,86
Emmry,F,100,86,0,86
Ermin,M,100,0,86,86
Escarlet,F,100,86,0,86
Euphemia,F,100,86,0,86
Everlie,F,100,86,0,86
Fatim,F,100,86,0,86
Georgean,F,100,86,0,86
Gerline,F,100,86,0,86
Giannie,F,100,86,0,86
Glennette,F,100,86,0,86
Gracynn,F,100,86,0,86
Hayzen,M,100,0,86,86
Heatherly,F,100,86,0,86
Hildegarde,F,100,86,0,86
Hrishikesh,M,100,0,86,86
Indio,M,100,0,86,86
Inri,M,100,0,86,86
Isaish,M,100,0,86,86
Isebella,F,100,86,0,86
Ixel,F,100,86,0,86
Jackolyn,F,100,86,0,86
Jamesyn,F,60,52,34,86
Jannatul,F,100,86,0,86
Jashay,F,100,86,0,86
Javani,M,100,0,86,86
Jaymarie,F,100,86,0,86
Jernee,F,100,86,0,86
Jeshawn,M,100,0,86,86
Jeydi,F,100,86,0,86
Jolynda,F,100,86,0,86
Kaliel,M,100,0,86,86
Karlissa,F,100,86,0,86
Kasiyah,F,100,86,0,86
Katalia,F,100,86,0,86
Kaytelynn,F,100,86,0,86
Kazim,M,100,0,86,86
Khylei,F,100,86,0,86
Lacorey,M,100,0,86,86
Ladavia,F,100,86,0,86
Lakechia,F,100,86,0,86
Laneah,F,100,86,0,86
Lanis,M,70,26,60,86
Laryah,F,100,86,0,86
Latayvia,F,100,86,0,86
Latrish,F,100,86,0,86
Laurelyn,F,100,86,0,86
Lavaeh,F,100,86,0,86
Laylonie,F,100,86,0,86
Leilan,M,100,0,86,86
Lekeya,F,100,86,0,86
Lesleyann,F,100,86,0,86
Letonia,F,100,86,0,86
Lexianna,F,100,86,0,86
Lillionna,F,100,86,0,86
Luisdavid,M,100,0,86,86
Madyx,M,73,23,63,86
Malaiah,F,100,86,0,86
Marguetta,F,100,86,0,86
Marialy,F,100,86,0,86
Mariapaula,F,100,86,0,86
Mateja,F,78,67,19,86
Meco,F,50,43,43,86
Mekesha,F,100,86,0,86
Meleni,F,100,86,0,86
Messi,M,100,0,86,86
Mikayela,F,100,86,0,86
Millenia,F,100,86,0,86
Millette,F,100,86,0,86
Mlissa,F,100,86,0,86
Morrissa,F,100,86,0,86
Muadh,M,100,0,86,86
Naheim,M,100,0,86,86
Nayellie,F,100,86,0,86
Nithila,F,100,86,0,86
Panayiota,F,100,86,0,86
Pantera,F,100,86,0,86
Pharrah,F,100,86,0,86
Phelix,M,100,0,86,86
Raechal,F,100,86,0,86
Ravonda,F,100,86,0,86
Raydel,M,100,0,86,86
Rehema,F,100,86,0,86
Reighan,F,100,86,0,86
Reika,F,100,86,0,86
Rejoice,F,100,86,0,86
Reyann,F,100,86,0,86
Rocklin,M,100,0,86,86
Rohil,M,100,0,86,86
Roosvelt,M,100,0,86,86
Rukia,F,100,86,0,86
Sahej,F,53,46,40,86
Shadiyah,F,100,86,0,86
Shameer,M,100,0,86,86
Shanautica,F,100,86,0,86
Shandrell,F,100,86,0,86
Shanyiah,F,100,86,0,86
Sheenah,F,100,86,0,86
Shelitha,F,100,86,0,86
Shray,M,100,0,86,86
Shulamit,F,100,86,0,86
Shykeem,M,100,0,86,86
Sidi,M,100,0,86,86
Soffia,F,100,86,0,86
Stamatia,F,100,86,0,86
Talah,F,100,86,0,86
Talis,M,87,11,75,86
Tamaj,M,100,0,86,86
Tamana,F,100,86,0,86
Tazaria,F,100,86,0,86
Teletha,F,100,86,0,86
Toleen,F,100,86,0,86
Toluwanimi,F,64,55,31,86
Tore,M,87,11,75,86
Traxton,M,100,0,86,86
Trinitey,F,100,86,0,86
Tyjay,M,100,0,86,86
Wakisha,F,100,86,0,86
Whalen,M,100,0,86,86
Xzavia,F,70,60,26,86
Yashas,M,100,0,86,86
Yicel,F,100,86,0,86
Ahleah,F,100,85,0,85
Ahmadou,M,100,0,85,85
Aliegha,F,100,85,0,85
Amadea,F,100,85,0,85
Amritpal,M,100,0,85,85
Anamari,F,100,85,0,85
Anayi,F,100,85,0,85
Aniesa,F,100,85,0,85
Anthonny,M,100,0,85,85
Arleatha,F,100,85,0,85
Arthi,F,100,85,0,85
Ashaya,F,100,85,0,85
Asuzena,F,100,85,0,85
Audryana,F,100,85,0,85
Avyay,M,100,0,85,85
Azarie,F,94,80,5,85
Baelyn,F,87,74,11,85
Bertrum,M,100,0,85,85
Bonner,M,100,0,85,85
Breeley,F,100,85,0,85
Cadell,M,100,0,85,85
Cailean,M,80,17,68,85
Caliegh,F,100,85,0,85
Careem,M,100,0,85,85
Carleta,F,100,85,0,85
Cherylee,F,100,85,0,85
Chirsty,F,100,85,0,85
Chuong,M,100,0,85,85
Dalante,M,100,0,85,85
Dhanush,M,100,0,85,85
Donnae,F,100,85,0,85
Drezden,M,100,0,85,85
Duwane,M,100,0,85,85
Dwyne,M,100,0,85,85
Eliazer,M,100,0,85,85
Ellowyn,F,100,85,0,85
Elsworth,M,100,0,85,85
Emmani,F,100,85,0,85
Enma,F,100,85,0,85
Ewen,M,100,0,85,85
Farzad,M,100,0,85,85
Fin,M,100,0,85,85
Forestine,F,100,85,0,85
Franny,F,100,85,0,85
Geraldina,F,100,85,0,85
Hanni,F,100,85,0,85
Hetty,F,100,85,0,85
Ismeal,M,100,0,85,85
Issai,M,100,0,85,85
Jahnasia,F,100,85,0,85
Jamiria,F,100,85,0,85
Janisse,F,100,85,0,85
Jarelly,F,100,85,0,85
Jasaiah,M,88,10,75,85
Jedrick,M,100,0,85,85
Jekhi,M,100,0,85,85
Jenaveve,F,100,85,0,85
Jenesys,F,100,85,0,85
Jesson,M,100,0,85,85
Jiah,F,100,85,0,85
Jnaya,F,100,85,0,85
Johnnay,F,100,85,0,85
Jozeph,M,100,0,85,85
Judieth,F,100,85,0,85
Jyquan,M,100,0,85,85
Kaleeyah,F,100,85,0,85
Kalsey,F,100,85,0,85
Kathrynne,F,100,85,0,85
Keeya,F,100,85,0,85
Keiasha,F,100,85,0,85
Kimba,F,100,85,0,85
Kire,M,94,5,80,85
Lahari,F,100,85,0,85
Lakena,F,100,85,0,85
Lanore,F,100,85,0,85
Lanson,M,100,0,85,85
Lareen,F,100,85,0,85
Lauralie,F,100,85,0,85
Laurren,F,100,85,0,85
Lizania,F,100,85,0,85
Luma,F,100,85,0,85
Lusine,F,100,85,0,85
Lydie,F,100,85,0,85
Lynnzie,F,100,85,0,85
Lyrique,F,100,85,0,85
Maccoy,M,100,0,85,85
Mairany,F,100,85,0,85
Makina,F,100,85,0,85
Maloni,F,100,85,0,85
Manreet,F,100,85,0,85
Mardella,F,100,85,0,85
Margalit,F,100,85,0,85
Markies,M,100,0,85,85
Matraca,F,100,85,0,85
Melady,F,100,85,0,85
Micheale,F,100,85,0,85
Montserrath,F,100,85,0,85
Mrk,M,100,0,85,85
Nahun,M,100,0,85,85
Najja,M,52,41,44,85
Nilton,M,100,0,85,85
Nivedita,F,100,85,0,85
Noraa,F,100,85,0,85
Nyellie,F,100,85,0,85
Oaklynn,F,100,85,0,85
Olman,M,100,0,85,85
Ondria,F,100,85,0,85
Orlandria,F,100,85,0,85
Patriece,F,100,85,0,85
Pele,M,53,40,45,85
Pinkey,F,100,85,0,85
Piya,F,100,85,0,85
Pura,F,100,85,0,85
Quinnetta,F,100,85,0,85
Quinteria,F,100,85,0,85
Qunisha,F,100,85,0,85
Rachelanne,F,100,85,0,85
Rahkim,M,100,0,85,85
Rajohn,M,100,0,85,85
Rayli,F,76,65,20,85
Razi,M,100,0,85,85
Rinnah,F,100,85,0,85
Rosbel,M,100,0,85,85
Saleha,F,100,85,0,85
Samadhi,F,100,85,0,85
Sanari,F,100,85,0,85
Savyon,M,100,0,85,85
Sayeed,M,100,0,85,85
Seger,M,100,0,85,85
Shaconda,F,100,85,0,85
Shallyn,F,100,85,0,85
Shanikwa,F,100,85,0,85
Sheriff,M,100,0,85,85
Sheylin,F,100,85,0,85
Sinia,F,100,85,0,85
Sircharles,M,100,0,85,85
Sreekar,M,100,0,85,85
Stalin,M,100,0,85,85
Stina,F,100,85,0,85
Sufyaan,M,100,0,85,85
Takyia,F,100,85,0,85
Talecia,F,100,85,0,85
Talyssa,F,100,85,0,85
Tametha,F,100,85,0,85
Tamico,F,100,85,0,85
Tareek,M,100,0,85,85
Tareva,F,100,85,0,85
Tashya,F,100,85,0,85
Tayari,M,85,13,72,85
Theodus,M,100,0,85,85
Timberlyn,F,100,85,0,85
Travares,M,100,0,85,85
Travus,M,100,0,85,85
Tyannah,F,100,85,0,85
Ulrick,M,100,0,85,85
Vershawn,M,94,5,80,85
Vint,M,100,0,85,85
Yorel,M,100,0,85,85
Zaccheaus,M,100,0,85,85
Zaeda,F,100,85,0,85
Zaim,M,100,0,85,85
Zhaire,M,100,0,85,85
Aarilyn,F,100,84,0,84
Aashir,M,100,0,84,84
Abimbola,F,94,79,5,84
Alaze,F,100,84,0,84
Alece,F,100,84,0,84
Alexine,F,100,84,0,84
Amberli,F,100,84,0,84
Amyriah,F,100,84,0,84
Angeni,F,100,84,0,84
Anyjah,F,100,84,0,84
Aurorah,F,100,84,0,84
Avianah,F,100,84,0,84
Avleen,F,100,84,0,84
Bethan,F,100,84,0,84
Caidin,M,100,0,84,84
Caitlain,F,100,84,0,84
Caliann,F,100,84,0,84
Cariah,F,100,84,0,84
Carlosdaniel,M,100,0,84,84
Chamari,F,100,84,0,84
Cordella,F,100,84,0,84
Coron,M,100,0,84,84
Corrion,M,100,0,84,84
Cristianna,F,100,84,0,84
Dafney,F,100,84,0,84
Darus,M,100,0,84,84
Dashea,F,100,84,0,84
Deauna,F,100,84,0,84
Delenn,F,100,84,0,84
Demecia,F,100,84,0,84
Demitrious,M,100,0,84,84
Dhiya,F,100,84,0,84
Divonte,M,100,0,84,84
Doneta,F,100,84,0,84
Dutchess,F,100,84,0,84
Ericah,F,100,84,0,84
Erman,M,100,0,84,84
Estera,F,100,84,0,84
Ettel,F,100,84,0,84
Fadil,M,100,0,84,84
Felecity,F,100,84,0,84
Fredna,F,100,84,0,84
Gedalya,M,100,0,84,84
Genavive,F,100,84,0,84
Gennell,F,100,84,0,84
Geovanie,M,100,0,84,84
Giordana,F,100,84,0,84
Gleb,M,100,0,84,84
Haylyn,F,100,84,0,84
Herchel,M,100,0,84,84
Hoby,M,100,0,84,84
Ison,M,100,0,84,84
Jahniah,F,100,84,0,84
Jakaree,M,100,0,84,84
Jakeim,M,100,0,84,84
Jakerra,F,100,84,0,84
Jamelyn,F,100,84,0,84
Jamesina,F,100,84,0,84
Jamonta,M,100,0,84,84
Jandy,F,92,77,7,84
Jannelly,F,100,84,0,84
Jashae,F,100,84,0,84
Jashiya,F,100,84,0,84
Javarian,M,100,0,84,84
Jayceion,M,100,0,84,84
Jayra,F,100,84,0,84
Jeanise,F,100,84,0,84
Jesyca,F,100,84,0,84
Jnyah,F,100,84,0,84
Johncharles,M,100,0,84,84
Jordayn,F,100,84,0,84
Jylan,M,100,0,84,84
Kambrea,F,100,84,0,84
Kashena,F,100,84,0,84
Kebin,M,100,0,84,84
Keiland,M,100,0,84,84
Kenishia,F,100,84,0,84
Kensli,F,100,84,0,84
Khaleef,M,100,0,84,84
Kyen,M,100,0,84,84
Kynlea,F,100,84,0,84
Lakitha,F,100,84,0,84
Lashawnta,F,100,84,0,84
Lashica,F,100,84,0,84
Latajah,F,100,84,0,84
Latorsha,F,100,84,0,84
Laurali,F,100,84,0,84
Lianette,F,100,84,0,84
Lilliona,F,100,84,0,84
Lional,M,100,0,84,84
Lopez,M,100,0,84,84
Lylianna,F,100,84,0,84
Marisal,F,100,84,0,84
Marnesha,F,100,84,0,84
Marvia,F,100,84,0,84
Mckaylie,F,100,84,0,84
Micai,M,100,0,84,84
Miriana,F,100,84,0,84
Mishon,M,67,28,56,84
Mohmed,M,100,0,84,84
Mounir,M,100,0,84,84
Myalynn,F,100,84,0,84
Nedim,M,100,0,84,84
Neelie,F,100,84,0,84
Nollie,F,92,77,7,84
Nymir,M,100,0,84,84
Oliana,F,100,84,0,84
Pailyn,F,100,84,0,84
Peja,F,73,61,23,84
Quadasia,F,100,84,0,84
Ra,M,76,20,64,84
Rakeen,M,100,0,84,84
Reizel,F,100,84,0,84
Ricka,F,100,84,0,84
Rolondo,M,100,0,84,84
Rosezetta,F,100,84,0,84
Sahiba,F,100,84,0,84
Sangita,F,100,84,0,84
Shantera,F,100,84,0,84
Shareeka,F,100,84,0,84
Sheketa,F,100,84,0,84
Shriyans,M,100,0,84,84
Simranjit,F,83,70,14,84
Soriyah,F,100,84,0,84
Spyridon,M,100,0,84,84
Srah,F,100,84,0,84
Sri,F,94,79,5,84
Syna,F,100,84,0,84
Tametra,F,100,84,0,84
Tashaya,F,100,84,0,84
Tawsha,F,100,84,0,84
Trenden,M,100,0,84,84
Trevel,M,100,0,84,84
Trinisha,F,100,84,0,84
Twinkle,F,100,84,0,84
Tyah,F,100,84,0,84
Tyquasia,F,100,84,0,84
Valeriano,M,100,0,84,84
Valita,F,100,84,0,84
Veniamin,M,100,0,84,84
Vernecia,F,100,84,0,84
Vicie,F,100,84,0,84
Vonya,F,100,84,0,84
Ylianna,F,100,84,0,84
Zarea,F,100,84,0,84
Zavannah,F,100,84,0,84
Zayvon,M,100,0,84,84
Zyanne,F,100,84,0,84
Zyian,F,58,49,35,84
Zyren,M,100,0,84,84
Zyrion,M,100,0,84,84
Abbrielle,F,100,83,0,83
Adea,F,100,83,0,83
Adiva,F,100,83,0,83
Ahlani,F,100,83,0,83
Aisia,F,100,83,0,83
Alayziah,F,100,83,0,83
Albeiro,M,100,0,83,83
Anginette,F,100,83,0,83
Antionetta,F,100,83,0,83
Arlester,M,100,0,83,83
Ashauna,F,100,83,0,83
Atonya,F,100,83,0,83
Ayjah,F,100,83,0,83
Azarian,M,100,0,83,83
Bellina,F,100,83,0,83
Birgitta,F,100,83,0,83
Blayre,F,100,83,0,83
Brecklynn,F,100,83,0,83
Brisha,F,100,83,0,83
Broady,M,100,0,83,83
Buell,M,100,0,83,83
Carynn,F,100,83,0,83
Catalia,F,100,83,0,83
Cedricka,F,100,83,0,83
Charnee,F,100,83,0,83
Charnese,F,100,83,0,83
Chenel,F,100,83,0,83
Conn,M,100,0,83,83
Cyriah,F,100,83,0,83
Daison,M,100,0,83,83
Damiel,M,100,0,83,83
Darsha,F,100,83,0,83
Darshay,F,100,83,0,83
Dayln,M,93,6,77,83
Decklin,M,100,0,83,83
Deiondra,F,100,83,0,83
Delesha,F,100,83,0,83
Delesia,F,100,83,0,83
Devyon,M,100,0,83,83
Dimarco,M,100,0,83,83
Diora,F,100,83,0,83
Donneisha,F,100,83,0,83
Driana,F,100,83,0,83
Dylynn,F,100,83,0,83
Elliet,F,100,83,0,83
Emonni,F,100,83,0,83
Ethanael,M,100,0,83,83
Filicia,F,100,83,0,83
Galyn,F,63,52,31,83
Gerhardt,M,100,0,83,83
Giovanie,M,100,0,83,83
Hartwell,M,100,0,83,83
Hennesy,F,100,83,0,83
Hopie,F,100,83,0,83
Indonesia,F,100,83,0,83
Jahaan,M,94,5,78,83
Jakyiah,F,100,83,0,83
Jamarrius,M,100,0,83,83
Janashia,F,100,83,0,83
Jasier,M,100,0,83,83
Jaxiel,M,100,0,83,83
Jermika,F,100,83,0,83
Johndaniel,M,100,0,83,83
Johntavius,M,100,0,83,83
Joleene,F,100,83,0,83
Jyren,M,100,0,83,83
Kaisy,F,100,83,0,83
Kalayla,F,100,83,0,83
Kamsiyochukwu,M,76,20,63,83
Kaulin,M,100,0,83,83
Kayani,F,100,83,0,83
Kealie,F,100,83,0,83
Keeyon,M,100,0,83,83
Keghan,M,100,0,83,83
Keyshla,F,100,83,0,83
Khalee,M,88,10,73,83
Kimmerly,F,100,83,0,83
Kirsi,F,100,83,0,83
Koraline,F,100,83,0,83
Krishauna,F,100,83,0,83
Kru,M,100,0,83,83
Kynsie,F,100,83,0,83
Lafawn,F,100,83,0,83
Laporshia,F,100,83,0,83
Lasharn,F,100,83,0,83
Lathon,M,100,0,83,83
Laylaa,F,100,83,0,83
Leean,F,100,83,0,83
Leiliana,F,100,83,0,83
Loral,F,100,83,0,83
Madhavi,F,100,83,0,83
Magalene,F,100,83,0,83
Malay,F,100,83,0,83
Malkie,F,100,83,0,83
Markesia,F,100,83,0,83
Marky,M,100,0,83,83
Marykathleen,F,100,83,0,83
Maryori,F,100,83,0,83
Melitta,F,100,83,0,83
Melvinia,F,100,83,0,83
Michalina,F,100,83,0,83
Milayah,F,100,83,0,83
Milynn,F,100,83,0,83
Money,F,82,68,15,83
Nashiya,F,100,83,0,83
Navie,F,100,83,0,83
Neng,M,94,5,78,83
Nitish,M,100,0,83,83
Noeh,M,100,0,83,83
Omauri,M,100,0,83,83
Otniel,M,100,0,83,83
Ricketta,F,100,83,0,83
Rickiya,F,100,83,0,83
Righteous,M,94,5,78,83
Rikayla,F,100,83,0,83
Rokia,F,100,83,0,83
Rynell,M,100,0,83,83
Sabena,F,100,83,0,83
Sadeel,F,100,83,0,83
Salimatou,F,100,83,0,83
Saliou,M,100,0,83,83
Samuella,F,100,83,0,83
Sarinity,F,100,83,0,83
Seaborn,M,100,0,83,83
Selisa,F,100,83,0,83
Sevrin,M,100,0,83,83
Shalen,F,87,72,11,83
Shironda,F,100,83,0,83
Shogo,M,100,0,83,83
Storme,F,59,49,34,83
Takaya,F,94,78,5,83
Tamel,M,100,0,83,83
Tattianna,F,100,83,0,83
Terriyah,F,100,83,0,83
Timmey,M,100,0,83,83
Torien,M,100,0,83,83
Valary,F,100,83,0,83
Veleria,F,100,83,0,83
Velita,F,100,83,0,83
Veria,F,100,83,0,83
Vernel,M,81,16,67,83
Vineeth,M,100,0,83,83
Wynee,F,100,83,0,83
Yaniyah,F,100,83,0,83
Yuya,M,100,0,83,83
Zayley,F,100,83,0,83
Zelene,F,100,83,0,83
Zykeriah,F,100,83,0,83
Abad,M,100,0,82,82
Abbegale,F,100,82,0,82
Abdulhadi,M,100,0,82,82
Adaliah,F,100,82,0,82
Adelaido,M,100,0,82,82
Adith,M,100,0,82,82
Adlyn,F,100,82,0,82
Ahsha,F,100,82,0,82
Ailine,F,100,82,0,82
Akif,M,100,0,82,82
Aking,M,100,0,82,82
Alanta,F,100,82,0,82
Alechia,F,100,82,0,82
Alonia,F,100,82,0,82
Alyla,F,100,82,0,82
Amahd,M,100,0,82,82
Amarien,M,100,0,82,82
Anaiza,F,100,82,0,82
Andros,M,100,0,82,82
Anicka,F,100,82,0,82
Anida,F,100,82,0,82
Aniko,F,100,82,0,82
Aniyia,F,100,82,0,82
Anjenette,F,100,82,0,82
Annamay,F,100,82,0,82
Antinio,M,100,0,82,82
Aracelys,F,100,82,0,82
Arafat,M,100,0,82,82
Ariba,F,100,82,0,82
Asianae,F,100,82,0,82
Aviannah,F,100,82,0,82
Ayerim,F,100,82,0,82
Azai,M,100,0,82,82
Azalie,F,100,82,0,82
Berline,F,100,82,0,82
Betul,F,100,82,0,82
Bharath,M,100,0,82,82
Breklyn,F,100,82,0,82
Britteney,F,100,82,0,82
Cambrey,F,100,82,0,82
Camyah,F,100,82,0,82
Camyra,F,100,82,0,82
Carmellia,F,100,82,0,82
Carollee,F,100,82,0,82
Caterra,F,100,82,0,82
Charlei,F,100,82,0,82
Charleton,M,100,0,82,82
Chaunta,F,100,82,0,82
Chemeka,F,100,82,0,82
Christionna,F,100,82,0,82
Colbin,M,100,0,82,82
Courtany,F,100,82,0,82
Cutberto,M,100,0,82,82
Dakwan,M,100,0,82,82
Dalissa,F,100,82,0,82
Dallys,F,100,82,0,82
Dameer,M,100,0,82,82
Danese,F,100,82,0,82
Danisa,F,100,82,0,82
Darean,M,68,26,56,82
Darlisha,F,100,82,0,82
Deardra,F,100,82,0,82
Deiona,F,100,82,0,82
Delainie,F,100,82,0,82
Deniss,F,94,77,5,82
Dequavius,M,100,0,82,82
Deriona,F,100,82,0,82
Desarea,F,100,82,0,82
Dontrey,M,100,0,82,82
Eann,M,100,0,82,82
Elizjah,M,100,0,82,82
Emberleigh,F,100,82,0,82
Emilianna,F,100,82,0,82
Falisa,F,100,82,0,82
Fidela,F,100,82,0,82
Fotios,M,100,0,82,82
Gokul,M,100,0,82,82
Guerry,M,100,0,82,82
Guss,M,100,0,82,82
Hadasah,F,100,82,0,82
Itzamara,F,100,82,0,82
Jadasia,F,100,82,0,82
Jameriah,F,100,82,0,82
Jaqualin,M,100,0,82,82
Jasmain,F,100,82,0,82
Jayle,F,100,82,0,82
Jehieli,F,100,82,0,82
Jeriko,M,100,0,82,82
Jesten,M,100,0,82,82
Jonella,F,100,82,0,82
Joyceline,F,100,82,0,82
Judianne,F,100,82,0,82
Kadeen,M,100,0,82,82
Kadra,F,100,82,0,82
Kaicee,F,100,82,0,82
Karlita,F,100,82,0,82
Keashia,F,100,82,0,82
Kellar,M,100,0,82,82
Kevork,M,100,0,82,82
Keyvin,M,100,0,82,82
Khamora,F,100,82,0,82
Kindrick,M,100,0,82,82
Kindsey,F,100,82,0,82
Kinser,M,100,0,82,82
Kortny,F,100,82,0,82
Laiana,F,100,82,0,82
Lajuanda,F,100,82,0,82
Laneice,F,100,82,0,82
Laurens,M,100,0,82,82
Legna,F,100,82,0,82
Leven,M,94,5,77,82
Levorn,M,89,9,73,82
Lilo,F,100,82,0,82
Lindbergh,M,100,0,82,82
Lucielle,F,100,82,0,82
Lynnet,F,100,82,0,82
Mackenze,F,100,82,0,82
Mansfield,M,100,0,82,82
Marithza,F,100,82,0,82
Maritssa,F,100,82,0,82
Maston,M,100,0,82,82
Mayanna,F,100,82,0,82
Maydelin,F,100,82,0,82
Mclane,M,94,5,77,82
Meli,F,100,82,0,82
Mialynn,F,100,82,0,82
Mikahla,F,100,82,0,82
Minas,M,100,0,82,82
Miraj,M,88,10,72,82
Mykhia,F,100,82,0,82
Nahdia,F,100,82,0,82
Nakeitha,F,100,82,0,82
Nataliee,F,100,82,0,82
Negin,F,100,82,0,82
Nevaen,F,100,82,0,82
Odarius,M,100,0,82,82
Olesya,F,100,82,0,82
Oliviagrace,F,100,82,0,82
Ormond,M,100,0,82,82
Peityn,F,100,82,0,82
Qusai,M,100,0,82,82
Raad,M,100,0,82,82
Rachit,M,100,0,82,82
Radwan,M,100,0,82,82
Rayme,F,68,56,26,82
Rekita,F,100,82,0,82
Reznor,M,100,0,82,82
Roseana,F,100,82,0,82
Saathvik,M,100,0,82,82
Sabriah,F,100,82,0,82
Saifan,M,100,0,82,82
Salisha,F,100,82,0,82
Samyak,M,100,0,82,82
Sandip,M,100,0,82,82
Shakeda,F,100,82,0,82
Shalayah,F,100,82,0,82
Sharnese,F,100,82,0,82
Shayona,F,100,82,0,82
Shekela,F,100,82,0,82
Shreyansh,M,100,0,82,82
Sims,M,100,0,82,82
Sokha,F,67,55,27,82
Sreshta,F,100,82,0,82
Staisha,F,100,82,0,82
Stark,M,100,0,82,82
Swayzie,F,100,82,0,82
Syd,M,100,0,82,82
Symphonie,F,100,82,0,82
Tamaiya,F,100,82,0,82
Tammela,F,100,82,0,82
Tawonda,F,100,82,0,82
Tawonna,F,100,82,0,82
Tenya,F,100,82,0,82
Teresina,F,100,82,0,82
Tiondra,F,100,82,0,82
Toula,F,100,82,0,82
Turrell,M,100,0,82,82
Tyde,M,100,0,82,82
Tymira,F,100,82,0,82
Tyreshia,F,100,82,0,82
Vale,M,71,24,58,82
Vertie,F,100,82,0,82
Virgia,F,100,82,0,82
Willona,F,100,82,0,82
Wilmary,F,100,82,0,82
Yamen,M,100,0,82,82
Yaris,F,100,82,0,82
Yetzali,F,100,82,0,82
Yuniel,M,100,0,82,82
Zadin,M,100,0,82,82
Zaidin,M,100,0,82,82
Zaleigh,F,100,82,0,82
Zamere,M,100,0,82,82
Zinedine,M,100,0,82,82
Aanvi,F,100,81,0,81
Adhvik,M,100,0,81,81
Ahyana,F,100,81,0,81
Aileene,F,100,81,0,81
Akyia,F,100,81,0,81
Alajiah,F,100,81,0,81
Alisan,F,100,81,0,81
Alven,M,100,0,81,81
Amadu,M,100,0,81,81
Amandalynn,F,100,81,0,81
Amanti,M,64,29,52,81
Amaura,F,100,81,0,81
Andrus,M,100,0,81,81
Annalycia,F,100,81,0,81
Anyi,F,100,81,0,81
Aundraya,F,100,81,0,81
Aydia,F,100,81,0,81
Bartlomiej,M,100,0,81,81
Basilia,F,100,81,0,81
Breta,F,100,81,0,81
Bulah,F,100,81,0,81
Caeson,M,100,0,81,81
Caili,F,100,81,0,81
Cayleen,F,100,81,0,81
Chanteria,F,100,81,0,81
Charels,M,100,0,81,81
Cheetara,F,100,81,0,81
Chenika,F,100,81,0,81
Chrishawna,F,100,81,0,81
Chudney,F,94,76,5,81
Ciarrah,F,100,81,0,81
Courtne,F,100,81,0,81
Dakiyah,F,100,81,0,81
Davelyn,F,100,81,0,81
Dayvian,M,100,0,81,81
Debany,F,100,81,0,81
Delvecchio,M,100,0,81,81
Deniel,M,100,0,81,81
Dessirae,F,100,81,0,81
Dionisios,M,100,0,81,81
Doaa,F,100,81,0,81
Donevin,M,100,0,81,81
Doristine,F,100,81,0,81
Draydon,M,100,0,81,81
Dreydon,M,100,0,81,81
Elizabethanne,F,100,81,0,81
Ellarae,F,100,81,0,81
Emary,F,100,81,0,81
Emett,M,100,0,81,81
Essense,F,100,81,0,81
Eurika,F,100,81,0,81
Fabyan,M,100,0,81,81
Faolan,M,100,0,81,81
Fiora,F,100,81,0,81
Garrell,M,100,0,81,81
Haileyann,F,100,81,0,81
Hidaya,F,100,81,0,81
Ibtisam,F,100,81,0,81
Indyah,F,100,81,0,81
Istvan,M,100,0,81,81
Jaamal,M,100,0,81,81
Jahyra,F,100,81,0,81
Jalien,M,94,5,76,81
Jamirra,F,100,81,0,81
Janille,F,100,81,0,81
Jaramiah,M,100,0,81,81
Jasmane,F,100,81,0,81
Jenascia,F,100,81,0,81
Jennaya,F,100,81,0,81
Jerimey,M,100,0,81,81
Jeyda,F,100,81,0,81
Jolonda,F,100,81,0,81
Josimar,M,100,0,81,81
Kairos,M,100,0,81,81
Kajah,F,100,81,0,81
Kalifa,F,100,81,0,81
Kanoe,F,100,81,0,81
Kashlynn,F,100,81,0,81
Keaden,M,100,0,81,81
Keiaira,F,100,81,0,81
Keishawna,F,100,81,0,81
Khamoni,M,68,26,55,81
Koleson,M,100,0,81,81
Krisy,F,100,81,0,81
Krystianna,F,100,81,0,81
Kue,M,100,0,81,81
Kyl,M,100,0,81,81
Labradford,M,100,0,81,81
Lalania,F,100,81,0,81
Leili,F,100,81,0,81
Lekha,F,100,81,0,81
Lenix,M,72,23,58,81
Leocadio,M,100,0,81,81
Lind,F,88,71,10,81
Logon,M,100,0,81,81
Lovett,M,100,0,81,81
Malgorzata,F,100,81,0,81
Malyna,F,100,81,0,81
Marishka,F,100,81,0,81
Marria,F,100,81,0,81
Marrietta,F,100,81,0,81
Matisyn,F,100,81,0,81
Maycol,M,100,0,81,81
Mckinnon,M,94,5,76,81
Monseratt,F,100,81,0,81
Mussa,M,100,0,81,81
Mykeisha,F,100,81,0,81
Nautia,F,100,81,0,81
Neshia,F,100,81,0,81
Nesiah,F,94,76,5,81
Nohea,F,70,57,24,81
Onie,F,80,65,16,81
Panfilo,M,100,0,81,81
Pollyann,F,100,81,0,81
Pricella,F,100,81,0,81
Princes,F,100,81,0,81
Quaran,M,100,0,81,81
Quinnten,M,100,0,81,81
Rabiah,F,100,81,0,81
Rafiel,M,100,0,81,81
Ramaj,M,100,0,81,81
Retal,F,100,81,0,81
Reyce,M,85,12,69,81
Rockney,M,100,0,81,81
Romin,M,100,0,81,81
Rydan,M,100,0,81,81
Salaya,F,100,81,0,81
Seydou,M,100,0,81,81
Shown,M,93,6,75,81
Sneijder,M,100,0,81,81
Solomia,F,100,81,0,81
Sosie,F,100,81,0,81
Suhailah,F,100,81,0,81
Tanetta,F,100,81,0,81
Taylia,F,100,81,0,81
Teyton,M,100,0,81,81
Thorsten,M,100,0,81,81
Tico,M,100,0,81,81
Tiran,M,100,0,81,81
Torance,M,52,39,42,81
Travanti,M,100,0,81,81
Trevious,M,100,0,81,81
Trinka,F,100,81,0,81
Tykee,M,100,0,81,81
Vandell,M,100,0,81,81
Venida,F,100,81,0,81
Vonnetta,F,100,81,0,81
Yaslene,F,100,81,0,81
Yeraldine,F,100,81,0,81
Yojan,M,100,0,81,81
Yoshika,F,100,81,0,81
Zale,M,100,0,81,81
Zamariyah,F,100,81,0,81
Zhanna,F,100,81,0,81
Zyia,F,100,81,0,81
Abdulraheem,M,100,0,80,80
Abisola,F,100,80,0,80
Adelei,F,100,80,0,80
Adynn,M,79,17,63,80
Aerika,F,100,80,0,80
Aithan,M,100,0,80,80
Aleeha,F,100,80,0,80
Amaal,F,100,80,0,80
Aminat,F,100,80,0,80
Anae,F,100,80,0,80
Arul,M,100,0,80,80
Aspin,F,100,80,0,80
Aviyon,M,92,6,74,80
Azzure,F,94,75,5,80
Bianco,F,89,71,9,80
Bosten,M,100,0,80,80
Briele,F,100,80,0,80
Brycelyn,F,100,80,0,80
Burhanuddin,M,100,0,80,80
Cadience,F,100,80,0,80
Caetano,M,100,0,80,80
Cecely,F,100,80,0,80
Chanetta,F,100,80,0,80
Chardonay,F,100,80,0,80
Chrisangel,M,100,0,80,80
Chrisanna,F,100,80,0,80
Clarivel,F,100,80,0,80
Clydie,F,100,80,0,80
Coden,M,100,0,80,80
Colum,M,100,0,80,80
Cordarrell,M,100,0,80,80
Corneshia,F,100,80,0,80
Corvette,F,100,80,0,80
Dashanna,F,100,80,0,80
Deagen,M,100,0,80,80
Dearion,M,92,6,74,80
Deissy,F,100,80,0,80
Demareon,M,100,0,80,80
Derelle,M,100,0,80,80
Destony,F,100,80,0,80
Deyani,F,100,80,0,80
Dhiren,M,100,0,80,80
Dionel,M,100,0,80,80
Dominiqua,F,100,80,0,80
Domino,F,94,75,5,80
Donnika,F,100,80,0,80
Dreamer,F,94,75,5,80
Edona,F,100,80,0,80
Elorah,F,100,80,0,80
Emilliano,M,100,0,80,80
Epifania,F,100,80,0,80
Ercia,F,100,80,0,80
Ettie,F,100,80,0,80
Faryal,F,100,80,0,80
Fermina,F,100,80,0,80
Garielle,F,100,80,0,80
Geniene,F,100,80,0,80
Gicela,F,100,80,0,80
Givanni,M,100,0,80,80
Gopal,M,100,0,80,80
Gresham,M,100,0,80,80
Hadli,F,100,80,0,80
Hafiz,M,100,0,80,80
Hairo,M,100,0,80,80
Harshal,M,100,0,80,80
Ioan,M,100,0,80,80
Irisha,F,100,80,0,80
Jadelin,F,100,80,0,80
Jaeceon,M,100,0,80,80
Jaizon,M,100,0,80,80
Jakarius,M,100,0,80,80
Jakyle,M,100,0,80,80
Jalyric,F,94,75,5,80
Jamaurion,M,100,0,80,80
Janann,F,100,80,0,80
Jatavis,M,100,0,80,80
Jaymari,M,100,0,80,80
Johnryan,M,100,0,80,80
Joshiah,M,100,0,80,80
Jossette,F,100,80,0,80
Josslin,F,100,80,0,80
Joydan,F,100,80,0,80
Julliette,F,100,80,0,80
Kaiyana,F,100,80,0,80
Kallum,M,100,0,80,80
Kamariyah,F,100,80,0,80
Karalyne,F,100,80,0,80
Kariya,F,100,80,0,80
Karnisha,F,100,80,0,80
Kately,F,100,80,0,80
Kaytelyn,F,100,80,0,80
Kerrilynn,F,100,80,0,80
Khamauri,M,94,5,75,80
Krissia,F,100,80,0,80
Kyleena,F,100,80,0,80
Kynisha,F,100,80,0,80
Lamekia,F,100,80,0,80
Lasheba,F,100,80,0,80
Lasundra,F,100,80,0,80
Latanza,F,100,80,0,80
Leliana,F,100,80,0,80
Lesleyanne,F,100,80,0,80
Lindora,F,100,80,0,80
Lynel,F,81,65,15,80
Lynford,M,100,0,80,80
Mady,F,100,80,0,80
Mahli,F,100,80,0,80
Mahsa,F,100,80,0,80
Makella,F,100,80,0,80
Malacai,M,100,0,80,80
Marabella,F,100,80,0,80
Marcques,M,100,0,80,80
Mariusz,M,100,0,80,80
Markeesha,F,100,80,0,80
Marrah,F,100,80,0,80
Melysa,F,100,80,0,80
Merrianne,F,100,80,0,80
Miaisabella,F,100,80,0,80
Monick,F,100,80,0,80
Mori,F,71,57,23,80
Naresh,M,100,0,80,80
Neyra,F,100,80,0,80
Niclas,M,100,0,80,80
Nykerria,F,100,80,0,80
Nyrie,F,100,80,0,80
Odella,F,100,80,0,80
Ohana,F,100,80,0,80
Orhan,M,100,0,80,80
Orlandis,M,100,0,80,80
Patirica,F,100,80,0,80
Pecolia,F,100,80,0,80
Persais,F,100,80,0,80
Primus,M,100,0,80,80
Rakeb,F,100,80,0,80
Ranata,F,100,80,0,80
Ratasha,F,100,80,0,80
Reniah,F,100,80,0,80
Rilea,F,100,80,0,80
Roshun,M,81,15,65,80
Rylah,F,100,80,0,80
Sanaai,F,100,80,0,80
Seddrick,M,100,0,80,80
Shafiq,M,100,0,80,80
Shahzad,M,100,0,80,80
Sham,F,61,49,31,80
Shaneta,F,100,80,0,80
Shanne,F,54,43,37,80
Sharlett,F,100,80,0,80
Sharnelle,F,100,80,0,80
Shelvy,F,80,64,16,80
Shykeria,F,100,80,0,80
Siboney,F,100,80,0,80
Skylynne,F,100,80,0,80
Sophiagrace,F,100,80,0,80
Sowmya,F,100,80,0,80
Srihari,M,100,0,80,80
Stephinie,F,100,80,0,80
Sye,M,100,0,80,80
Sylvestre,M,100,0,80,80
Tahlor,F,100,80,0,80
Tamorah,F,100,80,0,80
Tanaia,F,100,80,0,80
Tanayia,F,100,80,0,80
Taylr,F,100,80,0,80
Theoren,M,100,0,80,80
Tiaunna,F,100,80,0,80
Timarion,M,100,0,80,80
Timtohy,M,100,0,80,80
Ukiah,M,92,6,74,80
Vayla,F,100,80,0,80
Voshon,M,100,0,80,80
Wileen,F,100,80,0,80
Xzandria,F,100,80,0,80
Zuley,F,100,80,0,80
Abiha,F,100,79,0,79
Adar,M,65,28,51,79
Adoni,M,100,0,79,79
Ajeenah,F,100,79,0,79
Akeel,M,100,0,79,79
Akiel,M,100,0,79,79
Alben,M,100,0,79,79
Alyda,F,100,79,0,79
Annaliesa,F,100,79,0,79
Annalucia,F,100,79,0,79
Anthonymichael,M,100,0,79,79
Anwyn,F,100,79,0,79
Apphia,F,100,79,0,79
Ariannie,F,100,79,0,79
Ariyannah,F,100,79,0,79
Arvie,M,100,0,79,79
Arwin,M,100,0,79,79
Asah,M,100,0,79,79
Bassheva,F,100,79,0,79
Beila,F,100,79,0,79
Bethenny,F,100,79,0,79
Bilaal,M,100,0,79,79
Billyjack,M,100,0,79,79
Bleu,F,57,45,34,79
Brave,M,100,0,79,79
Breshawn,M,56,35,44,79
Brytani,F,100,79,0,79
Carlei,F,100,79,0,79
Cecylia,F,100,79,0,79
Charrisse,F,100,79,0,79
Chasyn,M,100,0,79,79
Chemere,F,100,79,0,79
Cherylanne,F,100,79,0,79
Chiante,F,94,74,5,79
Clearnce,M,100,0,79,79
Corderius,M,100,0,79,79
Coreon,M,100,0,79,79
Dammon,M,100,0,79,79
Daneya,F,100,79,0,79
Daquavion,M,100,0,79,79
Deania,F,100,79,0,79
Demaurion,M,100,0,79,79
Demontrez,M,100,0,79,79
Desani,F,78,62,17,79
Dezaria,F,100,79,0,79
Diannie,F,100,79,0,79
Dustee,F,100,79,0,79
Edwen,M,100,0,79,79
Eknoor,F,86,68,11,79
Elleah,F,100,79,0,79
Elyna,F,100,79,0,79
Emeril,M,80,16,63,79
Enisa,F,100,79,0,79
Ericberto,M,100,0,79,79
Evaleigh,F,100,79,0,79
Gedalia,M,100,0,79,79
Ginia,F,100,79,0,79
Glenroy,M,100,0,79,79
Greogory,M,100,0,79,79
Ichelle,F,100,79,0,79
Illene,F,100,79,0,79
Ismahan,F,100,79,0,79
Izyan,M,100,0,79,79
Jacaria,F,100,79,0,79
Jahvier,M,100,0,79,79
Jamae,F,94,74,5,79
Jarquis,M,100,0,79,79
Jas,M,84,13,66,79
Jazlen,F,100,79,0,79
Jeannifer,F,100,79,0,79
Jhace,M,100,0,79,79
Jiali,F,100,79,0,79
Jimmylee,M,100,0,79,79
Johntay,M,100,0,79,79
Jovonta,M,100,0,79,79
Kalasia,F,100,79,0,79
Kanoelani,F,100,79,0,79
Kashauna,F,100,79,0,79
Kasidi,F,100,79,0,79
Kein,M,100,0,79,79
Keltin,M,100,0,79,79
Kelyse,F,100,79,0,79
Keric,M,100,0,79,79
Kiam,M,100,0,79,79
Kiaraliz,F,100,79,0,79
Kieon,M,100,0,79,79
Kilea,F,100,79,0,79
Kinze,F,100,79,0,79
Kista,F,100,79,0,79
Kj,M,100,0,79,79
Krysteena,F,100,79,0,79
Kveon,M,100,0,79,79
Kynlei,F,100,79,0,79
Kysean,M,100,0,79,79
Labella,F,100,79,0,79
Ladashia,F,100,79,0,79
Lakara,F,100,79,0,79
Lalanya,F,100,79,0,79
Lastacia,F,100,79,0,79
Latana,F,100,79,0,79
Lauris,F,52,41,38,79
Leisl,F,100,79,0,79
Leny,M,72,22,57,79
Levetta,F,100,79,0,79
Levia,F,100,79,0,79
Levis,M,100,0,79,79
Lillieanna,F,100,79,0,79
Lowana,F,100,79,0,79
Luchiano,M,100,0,79,79
Lukisha,F,100,79,0,79
Lylla,F,100,79,0,79
Lynzy,F,100,79,0,79
Macky,M,100,0,79,79
Markea,F,100,79,0,79
Marquett,M,100,0,79,79
Mataio,M,100,0,79,79
Mayia,F,100,79,0,79
Meriem,F,100,79,0,79
Meryle,F,100,79,0,79
Micaylah,F,100,79,0,79
Milen,M,75,20,59,79
Mirenda,F,100,79,0,79
Montzerrat,F,100,79,0,79
Murdock,M,100,0,79,79
Nagi,M,100,0,79,79
Nakoma,F,54,43,36,79
Natasa,F,100,79,0,79
Nianna,F,100,79,0,79
Nichollas,M,100,0,79,79
Niquan,M,100,0,79,79
Nirel,F,92,73,6,79
Norell,F,81,64,15,79
Nyshaun,M,100,0,79,79
Oneita,F,100,79,0,79
Orbie,M,100,0,79,79
Oreste,M,100,0,79,79
Othella,F,100,79,0,79
Otila,F,100,79,0,79
Oziah,M,100,0,79,79
Paizleigh,F,100,79,0,79
Prestina,F,100,79,0,79
Racer,M,100,0,79,79
Rambo,M,100,0,79,79
Rashiya,F,100,79,0,79
Remberto,M,100,0,79,79
Revel,M,94,5,74,79
Rickardo,M,100,0,79,79
Rie,F,100,79,0,79
Riyaan,M,86,11,68,79
Romesha,F,100,79,0,79
Ryelynn,F,100,79,0,79
Ryonna,F,100,79,0,79
Sahirah,F,100,79,0,79
Sanel,M,100,0,79,79
Seung,M,100,0,79,79
Shalece,F,100,79,0,79
Shamanda,F,100,79,0,79
Shamariah,F,100,79,0,79
Shanena,F,100,79,0,79
Shantoya,F,100,79,0,79
Sharren,F,100,79,0,79
Sydelle,F,100,79,0,79
Sylva,F,100,79,0,79
Taleeya,F,100,79,0,79
Tanise,F,100,79,0,79
Tarea,F,100,79,0,79
Tayloranne,F,100,79,0,79
Tenasia,F,100,79,0,79
Therin,M,100,0,79,79
Thienan,M,63,29,50,79
Tityana,F,100,79,0,79
Tongela,F,100,79,0,79
Trayvond,M,100,0,79,79
Trinika,F,100,79,0,79
Tritia,F,100,79,0,79
Tykwon,M,100,0,79,79
Tyresa,F,100,79,0,79
Veanna,F,100,79,0,79
Visente,M,100,0,79,79
Vitalia,F,100,79,0,79
Wilkie,M,100,0,79,79
Windle,M,100,0,79,79
Wlliam,M,100,0,79,79
Xariah,F,100,79,0,79
Yahsir,M,100,0,79,79
Yamili,F,100,79,0,79
Yamilka,F,100,79,0,79
Yekaterina,F,100,79,0,79
Zadia,F,100,79,0,79
Aanyah,F,100,78,0,78
Addalie,F,100,78,0,78
Adryen,M,100,0,78,78
Aland,M,100,0,78,78
Aleathea,F,100,78,0,78
Alekxander,M,100,0,78,78
Alverna,F,100,78,0,78
Amanii,F,100,78,0,78
Amariyana,F,100,78,0,78
Amaro,M,100,0,78,78
Annalysse,F,100,78,0,78
Anner,F,85,66,12,78
Ardath,F,100,78,0,78
Asmara,F,100,78,0,78
Atilla,M,100,0,78,78
Azreal,M,100,0,78,78
Barbarita,F,100,78,0,78
Billyjo,F,56,44,34,78
Bowdy,M,100,0,78,78
Brace,M,100,0,78,78
Buff,F,60,47,31,78
Caffie,F,100,78,0,78
Casin,M,100,0,78,78
Casten,M,100,0,78,78
Ceri,F,100,78,0,78
Cinzia,F,100,78,0,78
Clovia,F,100,78,0,78
Daaiyah,F,100,78,0,78
Dametra,F,100,78,0,78
Darlette,F,100,78,0,78
Darrnell,M,100,0,78,78
Daysen,M,100,0,78,78
Delanda,F,100,78,0,78
Delynda,F,100,78,0,78
Diasha,F,100,78,0,78
Doniqua,F,100,78,0,78
Duard,M,100,0,78,78
Dulcy,F,100,78,0,78
Dysen,M,100,0,78,78
Elowyn,F,100,78,0,78
Emmamae,F,100,78,0,78
Eriko,F,100,78,0,78
Esaw,M,100,0,78,78
Eulonda,F,100,78,0,78
Evelette,F,100,78,0,78
Eyonna,F,100,78,0,78
Fallou,M,100,0,78,78
Fany,F,100,78,0,78
Galileah,F,100,78,0,78
Genesia,F,100,78,0,78
Georgian,F,100,78,0,78
Gerarda,F,100,78,0,78
Glora,F,100,78,0,78
Graesyn,M,72,22,56,78
Gregoire,M,100,0,78,78
Gregori,M,100,0,78,78
Hansford,M,100,0,78,78
Harshith,M,100,0,78,78
Hazelyn,F,100,78,0,78
Henryk,M,100,0,78,78
Holmes,M,100,0,78,78
Irem,F,100,78,0,78
Izaah,M,100,0,78,78
Jaimon,M,100,0,78,78
Jemuel,M,100,0,78,78
Jennea,F,100,78,0,78
Jhada,F,100,78,0,78
Jhaden,M,100,0,78,78
Johnathyn,M,100,0,78,78
Jonet,F,100,78,0,78
Jossilyn,F,100,78,0,78
Justinian,M,100,0,78,78
Kamarius,M,100,0,78,78
Kanav,M,100,0,78,78
Kawehi,F,100,78,0,78
Kaylem,M,100,0,78,78
Keshanna,F,100,78,0,78
Keyuana,F,100,78,0,78
Khadeem,M,100,0,78,78
Kialee,F,100,78,0,78
Kimbrely,F,100,78,0,78
Kitai,M,100,0,78,78
Kjuan,M,100,0,78,78
Kourtland,M,100,0,78,78
Kvion,M,100,0,78,78
Kylian,M,91,7,71,78
Laloni,F,100,78,0,78
Lashaunta,F,100,78,0,78
Lashawne,F,100,78,0,78
Lateya,F,100,78,0,78
Latise,F,100,78,0,78
Layza,F,100,78,0,78
Leibish,M,100,0,78,78
Lenya,F,100,78,0,78
Lesieli,F,100,78,0,78
Leyli,F,100,78,0,78
Lillianah,F,100,78,0,78
Lilygrace,F,100,78,0,78
Lossie,F,100,78,0,78
Luay,M,100,0,78,78
Lucely,F,100,78,0,78
Makayleigh,F,100,78,0,78
Mako,M,59,32,46,78
Mallerie,F,100,78,0,78
Marlean,F,100,78,0,78
Mayzee,F,100,78,0,78
Menaal,F,100,78,0,78
Merwyn,M,100,0,78,78
Namari,M,67,26,52,78
Navarre,M,100,0,78,78
Naveena,F,100,78,0,78
Naven,M,100,0,78,78
Nazanin,F,100,78,0,78
Olivette,F,100,78,0,78
Phiona,F,100,78,0,78
Pradyun,M,100,0,78,78
Quantavia,F,100,78,0,78
Raesean,M,100,0,78,78
Raesha,F,100,78,0,78
Rayhana,F,100,78,0,78
Reagann,F,100,78,0,78
Renel,M,79,16,62,78
Reshanda,F,100,78,0,78
Rhyland,M,92,6,72,78
Riti,F,100,78,0,78
Rondrick,M,100,0,78,78
Ryleah,F,100,78,0,78
Saia,F,100,78,0,78
Salil,M,100,0,78,78
Samaa,F,100,78,0,78
Sanskriti,F,100,78,0,78
Scottlynn,F,100,78,0,78
Senetra,F,100,78,0,78
Shaquasha,F,100,78,0,78
Shashwat,M,100,0,78,78
Shataria,F,100,78,0,78
Shaunie,F,100,78,0,78
Shedric,M,100,0,78,78
Sheleen,F,100,78,0,78
Sheneika,F,100,78,0,78
Shirline,F,100,78,0,78
Skylene,F,100,78,0,78
Soundra,F,100,78,0,78
Stanisha,F,100,78,0,78
Suhaas,M,100,0,78,78
Swayzee,F,100,78,0,78
Syrianna,F,100,78,0,78
Tahjanae,F,100,78,0,78
Takeru,M,100,0,78,78
Tashari,F,100,78,0,78
Tasharra,F,100,78,0,78
Tavionna,F,100,78,0,78
Tawona,F,100,78,0,78
Tejasvi,F,100,78,0,78
Tierria,F,100,78,0,78
Tishawna,F,100,78,0,78
Tkeya,F,100,78,0,78
Tnya,F,100,78,0,78
Torianne,F,100,78,0,78
Tranise,F,100,78,0,78
Travonna,F,100,78,0,78
Treacy,F,100,78,0,78
Trev,M,100,0,78,78
Valdis,M,100,0,78,78
Vara,F,100,78,0,78
Veleda,F,100,78,0,78
Venisa,F,100,78,0,78
Vian,M,72,22,56,78
Zahki,M,100,0,78,78
Zanylah,F,100,78,0,78
Zayonna,F,100,78,0,78
Zoriana,F,100,78,0,78
Amandamarie,F,100,77,0,77
Amay,M,100,0,77,77
Amed,M,100,0,77,77
Analei,F,100,77,0,77
Anitta,F,100,77,0,77
Antaniya,F,100,77,0,77
Arihant,M,100,0,77,77
Arnecia,F,100,77,0,77
Arnella,F,100,77,0,77
Avyon,M,100,0,77,77
Avyukth,M,100,0,77,77
Ayomikun,M,66,26,51,77
Baneza,F,100,77,0,77
Barnie,M,100,0,77,77
Beretta,F,100,77,0,77
Blandon,M,100,0,77,77
Brysten,M,100,0,77,77
Carlinda,F,100,77,0,77
Carmisha,F,100,77,0,77
Chaska,M,87,10,67,77
Chayil,F,100,77,0,77
Chosen,M,74,20,57,77
Chrystel,F,100,77,0,77
Ciclaly,F,100,77,0,77
Cormick,M,100,0,77,77
Coutney,F,100,77,0,77
Crystelle,F,100,77,0,77
Curstin,F,100,77,0,77
Cylinda,F,100,77,0,77
Daisee,F,100,77,0,77
Dareth,F,100,77,0,77
Dasja,F,100,77,0,77
Davidjames,M,100,0,77,77
Derionna,F,100,77,0,77
Donivin,M,100,0,77,77
Dovber,M,100,0,77,77
Edger,M,100,0,77,77
Edita,F,100,77,0,77
Elayjah,F,100,77,0,77
Eldonna,F,100,77,0,77
Eleasha,F,100,77,0,77
Elizet,F,100,77,0,77
Emberli,F,100,77,0,77
Erico,M,100,0,77,77
Etosha,F,100,77,0,77
Francyne,F,100,77,0,77
Garv,M,100,0,77,77
Gaudencio,M,100,0,77,77
Geran,M,100,0,77,77
Giannamarie,F,100,77,0,77
Gracieann,F,100,77,0,77
Gracielynn,F,100,77,0,77
Hanae,F,100,77,0,77
Hendry,M,100,0,77,77
Indea,F,100,77,0,77
Isay,M,100,0,77,77
Issaic,M,100,0,77,77
Jamorian,M,100,0,77,77
Jance,M,94,5,72,77
Jaryah,F,100,77,0,77
Javaeh,F,100,77,0,77
Jaycelynn,F,100,77,0,77
Jaykwon,M,100,0,77,77
Jazmina,F,100,77,0,77
Jazzlene,F,100,77,0,77
Jesselee,M,100,0,77,77
Jeven,M,100,0,77,77
Jimesha,F,100,77,0,77
Joda,F,100,77,0,77
Joffrey,M,100,0,77,77
Josceline,F,100,77,0,77
Joselinne,F,100,77,0,77
Jovoni,M,94,5,72,77
Kaimani,M,94,5,72,77
Kaiyden,M,94,5,72,77
Kandas,F,100,77,0,77
Kashius,M,100,0,77,77
Katharin,F,100,77,0,77
Kayleann,F,100,77,0,77
Kayn,M,100,0,77,77
Keavon,M,100,0,77,77
Kebra,F,100,77,0,77
Kendricks,M,100,0,77,77
Khyli,F,100,77,0,77
Kimimila,F,100,77,0,77
Kimmberly,F,100,77,0,77
Kirrah,F,100,77,0,77
Kniyah,F,100,77,0,77
Kresha,F,100,77,0,77
Kyrielle,F,100,77,0,77
Ladarrious,M,100,0,77,77
Laelia,F,100,77,0,77
Lamira,F,100,77,0,77
Laquilla,F,100,77,0,77
Lasaro,M,100,0,77,77
Lauralei,F,100,77,0,77
Leelyn,M,100,0,77,77
Leimomi,F,100,77,0,77
Leonce,M,100,0,77,77
Linsi,F,100,77,0,77
Lyberti,F,100,77,0,77
Lyvonne,F,100,77,0,77
Makih,M,100,0,77,77
Mani,M,94,5,72,77
Maripaz,F,100,77,0,77
Meral,F,100,77,0,77
Militza,F,100,77,0,77
Mirayah,F,100,77,0,77
Murice,M,100,0,77,77
Mustaf,M,100,0,77,77
Naethan,M,100,0,77,77
Naftula,M,100,0,77,77
Natasja,F,100,77,0,77
Neilani,F,100,77,0,77
Nekayla,F,100,77,0,77
Nekeya,F,100,77,0,77
Ngina,F,100,77,0,77
Nidya,F,100,77,0,77
Norely,F,100,77,0,77
Nyheim,M,100,0,77,77
Odaly,F,100,77,0,77
Olivianna,F,100,77,0,77
Olusegun,M,100,0,77,77
Omare,M,100,0,77,77
Omarius,M,100,0,77,77
Oryon,M,100,0,77,77
Rayssa,F,100,77,0,77
Revin,M,100,0,77,77
Riannah,F,100,77,0,77
Rocsi,F,100,77,0,77
Rodina,F,100,77,0,77
Romeka,F,100,77,0,77
Runa,F,100,77,0,77
Ryeleigh,F,100,77,0,77
Rykin,M,100,0,77,77
Saafir,M,100,0,77,77
Samit,M,100,0,77,77
Samon,F,86,66,11,77
Sandia,F,100,77,0,77
Sanela,F,100,77,0,77
Severa,F,100,77,0,77
Sevilla,F,100,77,0,77
Shadon,F,57,44,33,77
Shale,M,73,21,56,77
Shanaia,F,100,77,0,77
Shandricka,F,100,77,0,77
Shaneca,F,100,77,0,77
Shantez,M,62,29,48,77
Shekera,F,100,77,0,77
Shonique,F,100,77,0,77
Shye,F,94,72,5,77
Siobahn,F,100,77,0,77
Stephie,F,100,77,0,77
Sunya,F,100,77,0,77
Tashala,F,100,77,0,77
Timari,F,65,50,27,77
Tinslee,F,100,77,0,77
Tirth,M,100,0,77,77
Travarus,M,100,0,77,77
Treina,F,100,77,0,77
Tremont,M,100,0,77,77
Trudee,F,100,77,0,77
Twylia,F,100,77,0,77
Varvara,F,100,77,0,77
Velecia,F,100,77,0,77
Vrishank,M,100,0,77,77
Winta,F,100,77,0,77
Xzaiver,M,100,0,77,77
Yesennia,F,100,77,0,77
Zacherie,M,100,0,77,77
Zebulin,M,100,0,77,77
Zykera,F,100,77,0,77
Aayliah,F,100,76,0,76
Adaijah,F,100,76,0,76
Aldora,F,100,76,0,76
Alpa,F,100,76,0,76
Ambermarie,F,100,76,0,76
Amiere,M,91,7,69,76
Anaika,F,100,76,0,76
Anastaisa,F,100,76,0,76
Angelize,F,100,76,0,76
Annalaura,F,100,76,0,76
Anushri,F,100,76,0,76
Arabel,F,100,76,0,76
Ardean,F,72,55,21,76
Arkin,M,100,0,76,76
Armya,F,100,76,0,76
Arnetia,F,100,76,0,76
Arohi,F,100,76,0,76
Arzu,F,100,76,0,76
Aseem,M,100,0,76,76
Avangelina,F,100,76,0,76
Axxel,M,100,0,76,76
Aztlan,M,100,0,76,76
Benno,M,100,0,76,76
Breezie,F,100,76,0,76
Brelee,F,100,76,0,76
Britzy,F,100,76,0,76
Cambridge,F,53,40,36,76
Camika,F,100,76,0,76
Cashae,F,100,76,0,76
Casidee,F,100,76,0,76
Chakara,F,100,76,0,76
Challen,M,93,5,71,76
Chalsey,F,100,76,0,76
Chamara,F,100,76,0,76
Chief,M,100,0,76,76
Chrissi,F,100,76,0,76
Coran,M,100,0,76,76
Cottrell,M,100,0,76,76
Curtez,M,100,0,76,76
Daaiel,M,100,0,76,76
Daimion,M,100,0,76,76
Damiean,M,100,0,76,76
Dayzha,F,100,76,0,76
Deliana,F,100,76,0,76
Delio,M,100,0,76,76
Derril,M,100,0,76,76
Deveion,M,100,0,76,76
Dinita,F,100,76,0,76
Donnalyn,F,100,76,0,76
Dub,M,100,0,76,76
Eathon,M,100,0,76,76
Elenie,F,100,76,0,76
Elfego,M,100,0,76,76
Ellenore,F,100,76,0,76
Giovonnie,M,100,0,76,76
Hanaan,F,100,76,0,76
Harlym,F,79,60,16,76
Hawley,F,80,61,15,76
Holle,F,100,76,0,76
Ioane,M,100,0,76,76
Jakylan,M,100,0,76,76
Jalaysha,F,100,76,0,76
Jamaurie,M,100,0,76,76
Jamesrobert,M,100,0,76,76
Jarick,M,100,0,76,76
Jaterrius,M,100,0,76,76
Jazzalynn,F,100,76,0,76
Jeronda,F,100,76,0,76
Jerrine,F,100,76,0,76
Jodilyn,F,100,76,0,76
Jonanthan,M,100,0,76,76
Jonise,F,100,76,0,76
Josanna,F,100,76,0,76
Josel,M,100,0,76,76
Kadajah,F,100,76,0,76
Kaena,F,76,58,18,76
Kaiyu,M,100,0,76,76
Kamilya,F,100,76,0,76
Kanton,M,100,0,76,76
Keaun,M,100,0,76,76
Keishana,F,100,76,0,76
Khaniyah,F,100,76,0,76
Kijuana,F,100,76,0,76
Kilani,F,100,76,0,76
Korion,M,100,0,76,76
Ladajah,F,100,76,0,76
Laden,M,100,0,76,76
Larance,M,100,0,76,76
Laurenashley,F,100,76,0,76
Layliana,F,100,76,0,76
Leonidus,M,100,0,76,76
Lewanna,F,100,76,0,76
Lilymae,F,100,76,0,76
Lynasia,F,100,76,0,76
Madsen,M,93,5,71,76
Mahati,F,100,76,0,76
Maliea,F,100,76,0,76
Marchia,F,100,76,0,76
Marieanne,F,100,76,0,76
Mima,F,100,76,0,76
Miosotis,F,100,76,0,76
Monterrius,M,100,0,76,76
Montrae,M,100,0,76,76
Moody,M,100,0,76,76
Mukhtar,M,100,0,76,76
Myking,M,100,0,76,76
Myquan,M,100,0,76,76
Myran,M,93,5,71,76
Najiyah,F,100,76,0,76
Nakeyia,F,100,76,0,76
Nashalie,F,100,76,0,76
Nashonda,F,100,76,0,76
Nasirah,F,100,76,0,76
Naylee,F,100,76,0,76
Nayquan,M,100,0,76,76
Nijay,M,54,35,41,76
Nilam,F,100,76,0,76
Nyeemah,F,100,76,0,76
Oceane,F,100,76,0,76
Ollin,M,100,0,76,76
Olukemi,F,100,76,0,76
Orlondo,M,100,0,76,76
Osaze,M,100,0,76,76
Ovie,M,100,0,76,76
Patrich,M,100,0,76,76
Perley,M,100,0,76,76
Prescious,F,100,76,0,76
Pride,M,100,0,76,76
Quantel,M,100,0,76,76
Quasean,M,100,0,76,76
Quentez,M,100,0,76,76
Rainen,M,100,0,76,76
Rajendra,M,100,0,76,76
Reesha,F,100,76,0,76
Rhapsody,F,100,76,0,76
Ritchard,M,100,0,76,76
Robertlee,M,100,0,76,76
Roverto,M,100,0,76,76
Rowe,M,100,0,76,76
Samaia,F,100,76,0,76
Santhiago,M,100,0,76,76
Sathvika,F,100,76,0,76
Savir,M,100,0,76,76
Selicia,F,100,76,0,76
Selso,M,100,0,76,76
Shanterica,F,100,76,0,76
Shaunn,M,100,0,76,76
Sheika,F,100,76,0,76
Sheilyn,F,100,76,0,76
Shellyann,F,100,76,0,76
Shelvia,F,100,76,0,76
Sheniece,F,100,76,0,76
Shirla,F,100,76,0,76
Shunna,F,100,76,0,76
Sophiea,F,100,76,0,76
Stashia,F,100,76,0,76
Tahjay,M,100,0,76,76
Tameyah,F,100,76,0,76
Tanisa,F,100,76,0,76
Tarran,F,51,39,37,76
Tary,M,61,30,46,76
Tauren,M,89,8,68,76
Theoplis,M,100,0,76,76
Timouthy,M,100,0,76,76
Tomeshia,F,100,76,0,76
Tranice,F,100,76,0,76
Travez,M,100,0,76,76
Tyreisha,F,100,76,0,76
Valleri,F,100,76,0,76
Vinaya,F,100,76,0,76
Wyn,M,78,17,59,76
Yanilen,F,100,76,0,76
Zauria,F,100,76,0,76
Zineb,F,100,76,0,76
Zymiere,M,100,0,76,76
Abdulah,M,100,0,75,75
Abdulai,M,100,0,75,75
Aerik,M,100,0,75,75
Ahlivia,F,100,75,0,75
Aidah,F,100,75,0,75
Akshitha,F,100,75,0,75
Alayssa,F,100,75,0,75
Alecxis,M,100,0,75,75
Alexismarie,F,100,75,0,75
Alithia,F,100,75,0,75
Alyssha,F,100,75,0,75
Analiya,F,100,75,0,75
Andrika,F,100,75,0,75
Angalena,F,100,75,0,75
Anwitha,F,100,75,0,75
Arisbel,F,100,75,0,75
Azha,F,100,75,0,75
Bernadean,F,100,75,0,75
Brenly,F,100,75,0,75
Brookley,F,100,75,0,75
Byan,M,100,0,75,75
Cacie,F,100,75,0,75
Calvyn,M,100,0,75,75
Camylle,F,100,75,0,75
Caro,F,100,75,0,75
Caster,M,100,0,75,75
Caydn,M,100,0,75,75
Cedra,F,100,75,0,75
Chaelyn,F,100,75,0,75
Chanette,F,100,75,0,75
Chene,F,85,64,11,75
Christinna,F,100,75,0,75
Corayma,F,100,75,0,75
Cortasia,F,100,75,0,75
Culley,M,100,0,75,75
Dajiah,F,100,75,0,75
Darnette,F,100,75,0,75
Davielle,F,100,75,0,75
Dechelle,F,100,75,0,75
Dejai,F,100,75,0,75
Demica,F,100,75,0,75
Demico,M,100,0,75,75
Deztinee,F,100,75,0,75
Diaz,M,100,0,75,75
Dioselina,F,100,75,0,75
Draylen,M,100,0,75,75
Dyanara,F,100,75,0,75
Dyneshia,F,100,75,0,75
Eivin,M,100,0,75,75
Elohim,M,100,0,75,75
Eulas,M,100,0,75,75
Fatime,F,100,75,0,75
Fayrene,F,100,75,0,75
Federick,M,100,0,75,75
Forrester,M,100,0,75,75
Garris,M,100,0,75,75
Giang,M,84,12,63,75
Ginnifer,F,100,75,0,75
Govani,M,100,0,75,75
Haelie,F,100,75,0,75
Hargun,F,75,56,19,75
Hartlyn,F,100,75,0,75
Heathe,F,68,51,24,75
Hiroko,F,100,75,0,75
Hitesh,M,100,0,75,75
Hodari,M,100,0,75,75
Honest,F,61,46,29,75
Iasiah,M,91,7,68,75
Iyauna,F,100,75,0,75
Jacody,M,100,0,75,75
Janete,F,100,75,0,75
Jantz,M,100,0,75,75
Jaydynn,F,71,53,22,75
Jearldine,F,100,75,0,75
Jenisse,F,100,75,0,75
Jomayra,F,100,75,0,75
Jonhatan,M,100,0,75,75
Jora,F,100,75,0,75
Joyclyn,F,100,75,0,75
Juley,F,100,75,0,75
Justinn,M,100,0,75,75
Jyrah,F,100,75,0,75
Kariss,F,100,75,0,75
Katlen,F,100,75,0,75
Katori,F,100,75,0,75
Kauri,F,87,65,10,75
Kayland,F,76,57,18,75
Keatin,M,100,0,75,75
Kenshawn,M,100,0,75,75
Kiano,M,100,0,75,75
Kimori,F,100,75,0,75
Krysia,F,100,75,0,75
Kseniya,F,100,75,0,75
Kylle,M,93,5,70,75
Labrisha,F,100,75,0,75
Ladene,F,100,75,0,75
Lailynn,F,100,75,0,75
Lanisa,F,100,75,0,75
Lashawnna,F,100,75,0,75
Leialoha,F,100,75,0,75
Lenoria,F,100,75,0,75
Licet,F,100,75,0,75
Lindyn,F,100,75,0,75
Luverne,F,51,38,37,75
Lysle,M,100,0,75,75
Maday,F,100,75,0,75
Magie,F,100,75,0,75
Makayela,F,100,75,0,75
Makyi,M,100,0,75,75
Malayja,F,100,75,0,75
Mareesa,F,100,75,0,75
Marquesa,F,100,75,0,75
Marquinn,M,100,0,75,75
Massa,F,100,75,0,75
Maureena,F,100,75,0,75
Maximum,M,100,0,75,75
Mckaylin,F,100,75,0,75
Mersedes,F,100,75,0,75
Mihcael,M,100,0,75,75
Mikaelyn,F,100,75,0,75
Mirely,F,100,75,0,75
Momodou,M,100,0,75,75
Montique,F,55,41,34,75
Nadalyn,F,100,75,0,75
Naela,F,100,75,0,75
Nakema,F,100,75,0,75
Nashanti,F,100,75,0,75
Nasire,M,100,0,75,75
Navpreet,F,100,75,0,75
Neamiah,M,100,0,75,75
Nicha,F,100,75,0,75
Nyelli,F,100,75,0,75
Paton,M,100,0,75,75
Pegah,F,100,75,0,75
Prathik,M,100,0,75,75
Raydin,M,100,0,75,75
Reia,F,100,75,0,75
Rocklyn,F,68,51,24,75
Rodneshia,F,100,75,0,75
Ruweyda,F,100,75,0,75
Ryelan,M,93,5,70,75
Ryoma,M,100,0,75,75
Ryot,M,100,0,75,75
Sajad,M,100,0,75,75
Salihah,F,100,75,0,75
Shanicqua,F,100,75,0,75
Sharrieff,M,100,0,75,75
Shatiqua,F,100,75,0,75
Sherby,F,100,75,0,75
Shiheem,M,100,0,75,75
Shreena,F,100,75,0,75
Shunsuke,M,100,0,75,75
Somaly,F,100,75,0,75
Starleen,F,100,75,0,75
Sukanya,F,100,75,0,75
Summerlynn,F,100,75,0,75
Tajha,F,100,75,0,75
Takirah,F,100,75,0,75
Tannie,F,92,69,6,75
Tayo,M,100,0,75,75
Teeghan,F,100,75,0,75
Tiea,F,100,75,0,75
Tiena,F,100,75,0,75
Tomeeka,F,100,75,0,75
Torence,M,93,5,70,75
Tranika,F,100,75,0,75
Treysean,M,100,0,75,75
Trice,M,100,0,75,75
Tyreonna,F,100,75,0,75
Vaniyah,F,100,75,0,75
Volney,M,100,0,75,75
Wayden,M,100,0,75,75
Wilkes,M,100,0,75,75
Yao,M,100,0,75,75
Yarethzi,F,100,75,0,75
Yarisbel,F,100,75,0,75
Yasmene,F,100,75,0,75
Yaxiel,M,100,0,75,75
Younique,F,100,75,0,75
Yumalay,F,100,75,0,75
Zakkiyya,F,100,75,0,75
Aariyana,F,100,74,0,74
Aaronmichael,M,100,0,74,74
Adriahna,F,100,74,0,74
Aibhlinn,F,100,74,0,74
Alixis,F,100,74,0,74
Almin,M,100,0,74,74
Amberia,F,100,74,0,74
Ammara,F,100,74,0,74
Anadia,F,100,74,0,74
Andren,M,100,0,74,74
Anelisse,F,100,74,0,74
Ariez,M,93,5,69,74
Arli,F,100,74,0,74
Armonee,F,92,68,6,74
Artemisa,F,100,74,0,74
Aryahna,F,100,74,0,74
Asyia,F,100,74,0,74
Aubrina,F,100,74,0,74
Auset,F,100,74,0,74
Avryl,F,100,74,0,74
Aymara,F,100,74,0,74
Azaya,F,100,74,0,74
Azazel,M,100,0,74,74
Azjah,F,100,74,0,74
Balen,M,100,0,74,74
Bellagrace,F,100,74,0,74
Bladyn,M,100,0,74,74
Braxdon,M,100,0,74,74
Brees,M,77,17,57,74
Breionna,F,100,74,0,74
Brookelin,F,100,74,0,74
Brynnly,F,100,74,0,74
Carlester,M,100,0,74,74
Cathalina,F,100,74,0,74
Cathline,F,100,74,0,74
Catrinia,F,100,74,0,74
Chanique,F,100,74,0,74
Chasya,F,100,74,0,74
Chrstopher,M,100,0,74,74
Cicley,F,100,74,0,74
Crystallee,F,100,74,0,74
Dafna,F,100,74,0,74
Daschel,M,100,0,74,74
Datra,F,100,74,0,74
Davinci,M,100,0,74,74
Deaisa,F,100,74,0,74
Decari,M,100,0,74,74
Deneene,F,100,74,0,74
Derak,M,100,0,74,74
Deriana,F,100,74,0,74
Deronte,M,100,0,74,74
Dontreal,M,100,0,74,74
Drury,M,100,0,74,74
Duvan,M,100,0,74,74
Eeva,F,100,74,0,74
Elaura,F,100,74,0,74
Elih,M,100,0,74,74
Ellese,F,100,74,0,74
Elyshia,F,100,74,0,74
Emalina,F,100,74,0,74
Esaiah,M,100,0,74,74
Fahmida,F,100,74,0,74
Farran,F,100,74,0,74
Fateh,M,100,0,74,74
Flower,F,100,74,0,74
Francessca,F,100,74,0,74
Gardy,M,100,0,74,74
Gawain,M,100,0,74,74
Gedeon,M,100,0,74,74
Geraldy,F,100,74,0,74
Gilberta,F,100,74,0,74
Graiden,M,100,0,74,74
Harumi,F,100,74,0,74
Hassel,M,100,0,74,74
Haunani,F,100,74,0,74
Hyland,M,86,10,64,74
Ilanna,F,100,74,0,74
Imberly,F,100,74,0,74
Issacc,M,100,0,74,74
Itzelle,F,100,74,0,74
Jahmiya,F,100,74,0,74
Jahrel,M,100,0,74,74
Jalayne,F,100,74,0,74
Jameica,F,100,74,0,74
Janal,F,93,69,5,74
Jartavious,M,100,0,74,74
Javyon,M,100,0,74,74
Jayveion,M,100,0,74,74
Jazyiah,F,100,74,0,74
Jelisha,F,100,74,0,74
Jendaya,F,100,74,0,74
Jerl,M,100,0,74,74
Jerrelle,M,100,0,74,74
Jeslie,F,100,74,0,74
Jette,F,92,68,6,74
Joakim,M,100,0,74,74
Jonaya,F,100,74,0,74
Jontavia,F,100,74,0,74
Joron,M,100,0,74,74
Joson,M,100,0,74,74
Jovane,M,100,0,74,74
Kaari,F,100,74,0,74
Kalup,M,100,0,74,74
Kamarrion,M,100,0,74,74
Kambra,F,100,74,0,74
Karo,M,100,0,74,74
Kaylum,M,100,0,74,74
Kayren,F,100,74,0,74
Keionte,M,100,0,74,74
Kelissa,F,100,74,0,74
Kemond,M,100,0,74,74
Keslyn,F,100,74,0,74
Ketara,F,100,74,0,74
Ketrick,M,100,0,74,74
Keylah,F,100,74,0,74
Khalise,F,100,74,0,74
Kiev,M,100,0,74,74
Kiriana,F,100,74,0,74
Kischa,F,100,74,0,74
Kmarion,M,100,0,74,74
Kryslyn,F,100,74,0,74
Krystalle,F,100,74,0,74
Lalaine,F,100,74,0,74
Lamondre,M,100,0,74,74
Laporchia,F,100,74,0,74
Lashena,F,100,74,0,74
Latorie,F,100,74,0,74
Lautaro,M,100,0,74,74
Libertie,F,100,74,0,74
Liliahna,F,100,74,0,74
Lyrical,F,100,74,0,74
Macaiah,F,86,64,10,74
Magin,F,93,69,5,74
Mahalie,F,100,74,0,74
Mairely,F,100,74,0,74
Malessa,F,100,74,0,74
Marjon,F,80,59,15,74
Markavious,M,100,0,74,74
Matylda,F,100,74,0,74
Maurianna,F,100,74,0,74
Mccrae,M,100,0,74,74
Mckenze,F,100,74,0,74
Meline,F,100,74,0,74
Micca,F,100,74,0,74
Nagee,M,100,0,74,74
Naiah,F,100,74,0,74
Naydeline,F,100,74,0,74
Nechemia,M,100,0,74,74
Nevea,F,100,74,0,74
Neylan,F,58,43,31,74
Nichoals,M,100,0,74,74
Nyari,F,100,74,0,74
Orey,M,100,0,74,74
Paulena,F,100,74,0,74
Prabhav,M,100,0,74,74
Preslei,F,100,74,0,74
Rache,F,100,74,0,74
Raeqwon,M,100,0,74,74
Ramesha,F,100,74,0,74
Randalyn,F,100,74,0,74
Rashawd,M,100,0,74,74
Rayman,M,100,0,74,74
Reiana,F,100,74,0,74
Renai,F,100,74,0,74
Reneshia,F,100,74,0,74
Reshunda,F,100,74,0,74
Reve,F,74,55,19,74
Reyah,F,100,74,0,74
Reynol,M,100,0,74,74
Rily,F,78,58,16,74
Ronneisha,F,100,74,0,74
Rosha,F,100,74,0,74
Rowin,M,91,7,67,74
Ryshawn,M,100,0,74,74
Sahily,F,100,74,0,74
Samyukta,F,100,74,0,74
Sandralee,F,100,74,0,74
Saraia,F,100,74,0,74
Saretta,F,100,74,0,74
Shacarra,F,100,74,0,74
Shahil,M,100,0,74,74
Shaunessy,F,93,69,5,74
Sheehan,M,93,5,69,74
Shemicka,F,100,74,0,74
Sheretha,F,100,74,0,74
Shjon,M,100,0,74,74
Shriley,F,100,74,0,74
Sidonia,F,100,74,0,74
Solyana,F,100,74,0,74
Starkeisha,F,100,74,0,74
Sylvain,M,100,0,74,74
Taaj,M,93,5,69,74
Taelon,M,100,0,74,74
Tajay,M,86,10,64,74
Tallin,M,100,0,74,74
Tangia,F,100,74,0,74
Tareka,F,100,74,0,74
Tateanna,F,100,74,0,74
Tauheed,M,100,0,74,74
Taymar,M,57,32,42,74
Tayshun,M,100,0,74,74
Telsa,F,100,74,0,74
Tenessa,F,100,74,0,74
Tienna,F,100,74,0,74
Timarie,F,100,74,0,74
Toia,F,100,74,0,74
Treson,M,100,0,74,74
Trygg,M,100,0,74,74
Tyshauna,F,100,74,0,74
Valton,M,100,0,74,74
Vamsi,M,100,0,74,74
Verdia,F,100,74,0,74
Vernestine,F,100,74,0,74
Wanette,F,100,74,0,74
Wanisha,F,100,74,0,74
Welby,M,100,0,74,74
Willadean,F,100,74,0,74
Xsavier,M,100,0,74,74
Yarethzy,F,100,74,0,74
Zaia,F,100,74,0,74
Zhania,F,100,74,0,74
Ziza,F,100,74,0,74
Zynasia,F,100,74,0,74
Aaira,F,100,73,0,73
Abbegayle,F,100,73,0,73
Abia,F,100,73,0,73
Adisynn,F,100,73,0,73
Aemilia,F,100,73,0,73
Aerie,F,100,73,0,73
Akima,F,100,73,0,73
Aleksis,F,93,68,5,73
Alyha,F,100,73,0,73
Alysabeth,F,100,73,0,73
Amarise,F,100,73,0,73
Ambriana,F,100,73,0,73
Amorita,F,100,73,0,73
Anieya,F,100,73,0,73
Anjeli,F,100,73,0,73
Anush,M,100,0,73,73
Appolonia,F,100,73,0,73
Artia,F,100,73,0,73
Ashlon,F,93,68,5,73
Asjia,F,100,73,0,73
Attikus,M,100,0,73,73
Azlin,F,100,73,0,73
Azriella,F,100,73,0,73
Batul,F,100,73,0,73
Bayyinah,F,100,73,0,73
Beni,M,71,21,52,73
Bertis,M,100,0,73,73
Bowe,M,100,0,73,73
Brendaly,F,100,73,0,73
Brennden,M,100,0,73,73
Bryam,M,100,0,73,73
Calel,M,100,0,73,73
Cassidey,F,100,73,0,73
Catalena,F,100,73,0,73
Catricia,F,100,73,0,73
Celese,F,100,73,0,73
Cerrone,M,100,0,73,73
Chalese,F,100,73,0,73
Chaos,M,100,0,73,73
Chayah,F,100,73,0,73
Chemika,F,100,73,0,73
Chetara,F,100,73,0,73
Chinonso,M,100,0,73,73
Chrishauna,F,100,73,0,73
Cleofas,M,100,0,73,73
Cressida,F,100,73,0,73
Crixus,M,100,0,73,73
Davinia,F,100,73,0,73
Debbera,F,100,73,0,73
Deira,F,100,73,0,73
Denijah,F,100,73,0,73
Derrie,M,70,22,51,73
Desarai,F,100,73,0,73
Deshanae,F,100,73,0,73
Destinae,F,100,73,0,73
Dianelly,F,100,73,0,73
Diyana,F,100,73,0,73
Donnavin,M,100,0,73,73
Dymin,F,100,73,0,73
Edrei,M,100,0,73,73
Emilygrace,F,100,73,0,73
Emmalena,F,100,73,0,73
Emmory,F,100,73,0,73
Emnet,F,100,73,0,73
Esbeydi,F,100,73,0,73
Fe,F,100,73,0,73
Franshesca,F,100,73,0,73
Gotti,M,100,0,73,73
Hakiem,M,100,0,73,73
Haston,M,100,0,73,73
Hawke,M,100,0,73,73
Hevin,F,100,73,0,73
Iliyana,F,100,73,0,73
Illyria,F,100,73,0,73
Jaivian,M,100,0,73,73
Janaisa,F,100,73,0,73
Janzen,M,100,0,73,73
Jarquavious,M,100,0,73,73
Jaymason,M,100,0,73,73
Jelan,M,100,0,73,73
Jemeka,F,100,73,0,73
Jimin,F,58,42,31,73
Jissell,F,100,73,0,73
Jp,M,100,0,73,73
Juanjesus,M,100,0,73,73
Julias,M,100,0,73,73
Kaamil,M,100,0,73,73
Kalanie,F,100,73,0,73
Kambrey,F,100,73,0,73
Katiejo,F,100,73,0,73
Kattleya,F,100,73,0,73
Keimari,M,67,24,49,73
Kelseigh,F,100,73,0,73
Kemesha,F,100,73,0,73
Khamarion,M,100,0,73,73
Khamryn,F,52,38,35,73
Khye,M,100,0,73,73
Kierria,F,100,73,0,73
Kinaya,F,100,73,0,73
Kiryn,F,77,56,17,73
Klayten,M,100,0,73,73
Korayma,F,100,73,0,73
Koven,M,100,0,73,73
Kriya,F,100,73,0,73
Kumiko,F,100,73,0,73
Kylil,M,100,0,73,73
Kyshon,M,100,0,73,73
Lannis,M,92,6,67,73
Layson,M,100,0,73,73
Lazlo,M,100,0,73,73
Leiam,M,100,0,73,73
Lillyauna,F,100,73,0,73
Liridona,F,100,73,0,73
Lorieann,F,100,73,0,73
Lucresha,F,100,73,0,73
Macarius,M,100,0,73,73
Magaline,F,100,73,0,73
Marchel,F,100,73,0,73
Mariacristina,F,100,73,0,73
Matthewjames,M,100,0,73,73
Mialani,F,100,73,0,73
Miche,F,100,73,0,73
Mikinzie,F,100,73,0,73
Mosi,M,85,11,62,73
Myrtha,F,100,73,0,73
Nakaila,F,100,73,0,73
Nakeita,F,100,73,0,73
Nasteho,F,100,73,0,73
Nguyet,F,100,73,0,73
Nykiah,F,100,73,0,73
Odessia,F,100,73,0,73
Odus,M,100,0,73,73
Pacer,M,100,0,73,73
Padme,F,100,73,0,73
Parthiv,M,100,0,73,73
Perian,F,100,73,0,73
Prajna,F,100,73,0,73
Prerna,F,100,73,0,73
Raquon,M,100,0,73,73
Reakwon,M,100,0,73,73
Rebekha,F,100,73,0,73
Renesmae,F,100,73,0,73
Reyanne,F,100,73,0,73
Riel,M,75,18,55,73
Rosealee,F,100,73,0,73
Roselyne,F,100,73,0,73
Royetta,F,100,73,0,73
Rudene,F,100,73,0,73
Rumeal,M,100,0,73,73
Sabirin,F,100,73,0,73
Sahvannah,F,100,73,0,73
Salik,M,100,0,73,73
Saunders,M,100,0,73,73
Seniah,F,100,73,0,73
Shanele,F,100,73,0,73
Sheranda,F,100,73,0,73
Sissi,F,100,73,0,73
Skya,F,100,73,0,73
Sparkles,F,100,73,0,73
Staton,M,100,0,73,73
Suman,F,86,63,10,73
Sumi,F,100,73,0,73
Symphanie,F,100,73,0,73
Talajah,F,100,73,0,73
Taler,F,93,68,5,73
Teneil,F,100,73,0,73
Tersea,F,100,73,0,73
Tewana,F,100,73,0,73
Thailyn,F,86,63,10,73
Tmya,F,100,73,0,73
Tremane,M,100,0,73,73
Tupac,M,100,0,73,73
Tyreck,M,100,0,73,73
Valbona,F,100,73,0,73
Viera,F,100,73,0,73
Vitali,M,100,0,73,73
Vonceil,F,100,73,0,73
Yaman,M,100,0,73,73
Yeraldy,F,100,73,0,73
Yoniel,M,100,0,73,73
Yuvaan,M,100,0,73,73
Zamariya,F,100,73,0,73
Zhaniya,F,100,73,0,73
Zyeir,M,100,0,73,73
Aaban,M,100,0,72,72
Aahna,F,100,72,0,72
Aariya,F,100,72,0,72
Adajah,F,100,72,0,72
Adelfa,F,100,72,0,72
Ahijah,M,100,0,72,72
Ahlayah,F,100,72,0,72
Airrion,M,100,0,72,72
Ajahni,M,100,0,72,72
Alawna,F,100,72,0,72
Alishah,F,92,66,6,72
Aliviyah,F,100,72,0,72
Altheia,F,100,72,0,72
Alysiah,F,100,72,0,72
Ameisha,F,100,72,0,72
Amonda,F,100,72,0,72
Analeese,F,100,72,0,72
Anjannette,F,100,72,0,72
Annesha,F,100,72,0,72
Annsleigh,F,100,72,0,72
Antonela,F,100,72,0,72
Antonis,M,100,0,72,72
Aricela,F,100,72,0,72
Ariea,F,100,72,0,72
Artavis,M,100,0,72,72
Ashritha,F,100,72,0,72
Avabella,F,100,72,0,72
Baretta,M,72,20,52,72
Brittnae,F,100,72,0,72
Bufford,M,100,0,72,72
Burtis,M,100,0,72,72
Camay,F,100,72,0,72
Cassandria,F,100,72,0,72
Chaysen,M,100,0,72,72
Chelan,F,100,72,0,72
Codylee,M,100,0,72,72
Cyndra,F,100,72,0,72
Daneesha,F,100,72,0,72
Deanda,F,100,72,0,72
Deeandra,F,100,72,0,72
Dehaven,M,100,0,72,72
Delva,F,100,72,0,72
Denissa,F,100,72,0,72
Deo,M,100,0,72,72
Dequann,M,100,0,72,72
Destane,F,100,72,0,72
Detravion,M,100,0,72,72
Deval,M,100,0,72,72
Dianara,F,100,72,0,72
Dontrelle,M,100,0,72,72
Drystan,M,100,0,72,72
Duru,F,100,72,0,72
Dushaun,M,100,0,72,72
Dwayn,M,100,0,72,72
Edwena,F,100,72,0,72
Elaiza,F,100,72,0,72
Eloina,F,100,72,0,72
Elowen,F,100,72,0,72
Embrie,F,100,72,0,72
Esparanza,F,100,72,0,72
Evalette,F,100,72,0,72
Gali,F,100,72,0,72
Garima,F,100,72,0,72
Gemayel,M,100,0,72,72
Gentri,F,100,72,0,72
Gianlucca,M,100,0,72,72
Glenora,F,100,72,0,72
Grenda,F,100,72,0,72
Haevyn,F,100,72,0,72
Haruna,F,100,72,0,72
Hiran,M,100,0,72,72
Hyder,M,100,0,72,72
Idara,F,100,72,0,72
Ivoree,F,100,72,0,72
Jaikob,M,100,0,72,72
Jaqulyn,F,100,72,0,72
Jareb,M,100,0,72,72
Jaryan,M,100,0,72,72
Jashad,M,100,0,72,72
Jaslen,F,100,72,0,72
Jatasia,F,100,72,0,72
Javiana,F,100,72,0,72
Jaymian,M,100,0,72,72
Jeffren,M,100,0,72,72
Jhalen,M,100,0,72,72
Jhania,F,100,72,0,72
Jiaire,M,100,0,72,72
Joandy,M,100,0,72,72
Joeline,F,100,72,0,72
Joeziah,M,100,0,72,72
Johnnell,M,100,0,72,72
Josy,F,100,72,0,72
Jozey,F,100,72,0,72
Jozlin,F,100,72,0,72
Jozy,F,93,67,5,72
Jream,F,86,62,10,72
Judaea,F,100,72,0,72
Jya,F,100,72,0,72
Jyla,F,100,72,0,72
Kaelem,M,100,0,72,72
Kaelene,F,100,72,0,72
Kalecia,F,100,72,0,72
Karlis,M,100,0,72,72
Kasiya,F,100,72,0,72
Kasson,M,100,0,72,72
Kaylyne,F,100,72,0,72
Keayra,F,100,72,0,72
Kenlea,F,100,72,0,72
Kenston,M,100,0,72,72
Kentarius,M,100,0,72,72
Keyontay,M,100,0,72,72
Khalaya,F,100,72,0,72
Kinnedy,F,100,72,0,72
Kore,M,100,0,72,72
Korianna,F,100,72,0,72
Krishawna,F,100,72,0,72
Krrish,M,100,0,72,72
Kyi,M,61,28,44,72
Lakhia,F,100,72,0,72
Lamonda,F,100,72,0,72
Laydon,M,100,0,72,72
Lemoyne,M,100,0,72,72
Lianni,F,100,72,0,72
Lilliahna,F,100,72,0,72
Lillyian,F,100,72,0,72
Linlee,F,100,72,0,72
Loanne,F,100,72,0,72
Lundynn,F,100,72,0,72
Lysha,F,100,72,0,72
Maecie,F,100,72,0,72
Mahrukh,F,100,72,0,72
Makay,F,51,37,35,72
Malaney,F,100,72,0,72
Malesha,F,100,72,0,72
Manvi,F,100,72,0,72
Marites,F,100,72,0,72
Mats,M,100,0,72,72
Maxey,M,100,0,72,72
Mcgregor,M,100,0,72,72
Meleane,F,100,72,0,72
Merelin,F,100,72,0,72
Mickal,M,100,0,72,72
Mikhia,F,100,72,0,72
Milcah,F,100,72,0,72
Missey,F,100,72,0,72
Mistey,F,100,72,0,72
Morse,M,100,0,72,72
Munachimso,F,64,46,26,72
Myha,F,100,72,0,72
Mylen,M,100,0,72,72
Nailani,F,100,72,0,72
Naydeen,F,100,72,0,72
Nedda,F,100,72,0,72
Neveyah,F,100,72,0,72
Nic,M,100,0,72,72
Nimrat,F,100,72,0,72
Nivaan,M,100,0,72,72
Olyver,M,100,0,72,72
Ondine,F,100,72,0,72
Pacen,M,100,0,72,72
Pattricia,F,100,72,0,72
Phyllistine,F,100,72,0,72
Raeli,F,100,72,0,72
Rafan,M,100,0,72,72
Ramari,M,100,0,72,72
Rayder,M,100,0,72,72
Regie,M,100,0,72,72
Reichen,M,100,0,72,72
Remiel,M,100,0,72,72
Ricca,F,100,72,0,72
Robena,F,100,72,0,72
Saanya,F,100,72,0,72
Sadae,F,100,72,0,72
Sahian,F,100,72,0,72
Saliah,F,100,72,0,72
Sary,F,93,67,5,72
Satine,F,100,72,0,72
Scorpio,M,100,0,72,72
Shahira,F,100,72,0,72
Shaquoia,F,100,72,0,72
Sherylann,F,100,72,0,72
Shonica,F,100,72,0,72
Sosaia,M,100,0,72,72
Starlee,F,100,72,0,72
Syniyah,F,100,72,0,72
Tagg,M,100,0,72,72
Talene,F,100,72,0,72
Talyia,F,100,72,0,72
Taniaya,F,100,72,0,72
Taydon,M,100,0,72,72
Tequlia,F,100,72,0,72
Thoren,M,100,0,72,72
Tonnya,F,100,72,0,72
Trenese,F,100,72,0,72
Tyge,M,100,0,72,72
Verlan,M,100,0,72,72
Vietta,F,100,72,0,72
Waqas,M,100,0,72,72
Winferd,M,100,0,72,72
Xzaviar,M,100,0,72,72
Yailine,F,100,72,0,72
Yenni,F,100,72,0,72
Yvaine,F,100,72,0,72
Zakara,F,100,72,0,72
Zamoria,F,100,72,0,72
Zohal,F,100,72,0,72
Zuha,F,100,72,0,72
Zykee,M,100,0,72,72
Aaryav,M,100,0,71,71
Ahni,F,100,71,0,71
Ainhoa,F,100,71,0,71
Akaila,F,100,71,0,71
Akirra,F,100,71,0,71
Akon,M,86,10,61,71
Albana,F,100,71,0,71
Alessander,M,100,0,71,71
Aliani,F,100,71,0,71
Alizza,F,100,71,0,71
Ambri,F,100,71,0,71
Amoree,F,100,71,0,71
Anahid,F,100,71,0,71
Anandi,F,100,71,0,71
Andalyn,F,100,71,0,71
Andriel,M,56,31,40,71
Aneyah,F,100,71,0,71
Anhelica,F,100,71,0,71
Antonea,F,100,71,0,71
Apryll,F,100,71,0,71
Ardeth,F,100,71,0,71
Ashantia,F,100,71,0,71
Autrey,M,93,5,66,71
Ayslin,F,100,71,0,71
Bailen,M,100,0,71,71
Bailley,F,100,71,0,71
Barba,F,100,71,0,71
Boby,M,100,0,71,71
Braylinn,F,100,71,0,71
Bristyn,F,100,71,0,71
Brix,M,100,0,71,71
Caliber,M,100,0,71,71
Calinda,F,100,71,0,71
Canary,F,100,71,0,71
Cande,F,100,71,0,71
Cesareo,M,100,0,71,71
Chalyn,F,100,71,0,71
Chananya,M,100,0,71,71
Chantrice,F,100,71,0,71
Chinara,F,100,71,0,71
Chiquetta,F,100,71,0,71
Dacy,F,100,71,0,71
Damondre,M,100,0,71,71
Damyra,F,100,71,0,71
Danalee,F,100,71,0,71
Dardan,M,100,0,71,71
Daveda,F,100,71,0,71
Davius,M,100,0,71,71
Delijah,F,59,42,29,71
Dellanira,F,100,71,0,71
Demere,M,100,0,71,71
Demorio,M,100,0,71,71
Denesia,F,100,71,0,71
Dequandre,M,100,0,71,71
Destan,M,100,0,71,71
Dhamar,F,100,71,0,71
Diannah,F,100,71,0,71
Dimitriy,M,100,0,71,71
Dmiya,F,100,71,0,71
Donjuan,M,100,0,71,71
Earlena,F,100,71,0,71
Elexius,F,100,71,0,71
Elvert,M,100,0,71,71
Enrika,F,100,71,0,71
Fable,F,93,66,5,71
Faustine,F,100,71,0,71
Fawne,F,100,71,0,71
Gabriellia,F,100,71,0,71
Geordie,M,100,0,71,71
Gissella,F,100,71,0,71
Haset,F,100,71,0,71
Hazim,M,100,0,71,71
Hiyab,F,85,60,11,71
Hosam,M,100,0,71,71
Ibrahem,M,100,0,71,71
Iceis,F,100,71,0,71
Ingra,F,100,71,0,71
Innocence,F,100,71,0,71
Irys,F,100,71,0,71
Jacqualynn,F,100,71,0,71
Jader,M,100,0,71,71
Jakeel,M,100,0,71,71
Jakhiya,F,100,71,0,71
Jalaiyah,F,100,71,0,71
Janautica,F,100,71,0,71
Jaquasha,F,100,71,0,71
Jarl,M,100,0,71,71
Jelesa,F,100,71,0,71
Jesstin,M,100,0,71,71
Johm,M,100,0,71,71
Johneric,M,100,0,71,71
Jolana,F,100,71,0,71
Jordyan,F,92,65,6,71
Joslyne,F,100,71,0,71
Jsoeph,M,100,0,71,71
Kadarious,M,100,0,71,71
Kadynn,F,82,58,13,71
Kaeleen,F,100,71,0,71
Kaianna,F,100,71,0,71
Karion,M,93,5,66,71
Kaydenn,M,100,0,71,71
Kenneshia,F,100,71,0,71
Kersey,F,73,52,19,71
Khamila,F,100,71,0,71
Kihanna,F,100,71,0,71
Kindel,F,93,66,5,71
Kloi,F,100,71,0,71
Koya,F,100,71,0,71
Krishon,M,100,0,71,71
Kushi,F,100,71,0,71
Kyal,M,100,0,71,71
Ladonne,F,100,71,0,71
Lakeena,F,100,71,0,71
Latisia,F,100,71,0,71
Launi,F,100,71,0,71
Leray,M,100,0,71,71
Levante,M,100,0,71,71
Levent,M,100,0,71,71
Liandro,M,100,0,71,71
Limmie,M,100,0,71,71
Lucifer,M,100,0,71,71
Lui,M,100,0,71,71
Lycia,F,100,71,0,71
Lynore,F,100,71,0,71
Macguire,M,100,0,71,71
Mahitha,F,100,71,0,71
Marranda,F,100,71,0,71
Marshe,F,100,71,0,71
Miela,F,100,71,0,71
Mihran,M,100,0,71,71
Mirca,F,100,71,0,71
Miryah,F,100,71,0,71
Myleka,F,100,71,0,71
Nalee,F,100,71,0,71
Neyah,F,100,71,0,71
Niranjan,M,100,0,71,71
Odai,M,100,0,71,71
Okema,F,100,71,0,71
Oluwadara,F,93,66,5,71
Pietra,F,100,71,0,71
Quantay,M,100,0,71,71
Quintavia,F,100,71,0,71
Raciel,M,100,0,71,71
Renton,M,100,0,71,71
Renu,F,100,71,0,71
Rhealynn,F,100,71,0,71
Robey,M,100,0,71,71
Robinn,F,100,71,0,71
Rondia,F,100,71,0,71
Rontae,M,100,0,71,71
Sabel,F,100,71,0,71
Safire,F,100,71,0,71
Saivion,M,100,0,71,71
Saragrace,F,100,71,0,71
Sarajean,F,100,71,0,71
Sevannah,F,100,71,0,71
Shacola,F,100,71,0,71
Shadell,F,93,66,5,71
Shahiem,M,100,0,71,71
Shaman,M,100,0,71,71
Shareta,F,100,71,0,71
Sharlisa,F,100,71,0,71
Shatasia,F,100,71,0,71
Shaunae,F,100,71,0,71
Sheelah,F,100,71,0,71
Sheniah,F,100,71,0,71
Shonteria,F,100,71,0,71
Sreenidhi,F,100,71,0,71
Sricharan,M,100,0,71,71
Sufian,M,100,0,71,71
Syona,F,100,71,0,71
Tacoya,F,100,71,0,71
Tashai,F,100,71,0,71
Tawfiq,M,100,0,71,71
Tiane,F,100,71,0,71
Tochi,F,77,55,16,71
Tonilynn,F,100,71,0,71
Trajon,M,100,0,71,71
Trase,M,100,0,71,71
Treniya,F,100,71,0,71
Treyana,F,100,71,0,71
Twilia,F,100,71,0,71
Tymeshia,F,100,71,0,71
Tyniya,F,100,71,0,71
Tyrihanna,F,100,71,0,71
Tyse,M,100,0,71,71
Wilkin,M,100,0,71,71
Xiao,F,92,65,6,71
Yahmir,M,100,0,71,71
Yannely,F,100,71,0,71
Yazlynn,F,100,71,0,71
Yazmen,F,100,71,0,71
Zackerie,M,100,0,71,71
Zafar,M,100,0,71,71
Zaharah,F,100,71,0,71
Zahniya,F,100,71,0,71
Zailen,M,100,0,71,71
Zakhari,M,93,5,66,71
Zanobia,F,100,71,0,71
Zarayah,F,100,71,0,71
Abbygael,F,100,70,0,70
Abeeha,F,100,70,0,70
Acsa,F,100,70,0,70
Adonus,M,100,0,70,70
Adorian,M,100,0,70,70
Aleera,F,100,70,0,70
Ameet,M,100,0,70,70
Angelissa,F,100,70,0,70
Anira,F,100,70,0,70
Annaleigha,F,100,70,0,70
Antaeus,M,100,0,70,70
Antinette,F,100,70,0,70
Antwian,M,100,0,70,70
Aprel,F,100,70,0,70
Asyria,F,100,70,0,70
Athanasius,M,100,0,70,70
Aviela,F,100,70,0,70
Azell,M,100,0,70,70
Azzie,F,100,70,0,70
Berdie,F,100,70,0,70
Biruk,M,100,0,70,70
Branigan,F,56,39,31,70
Brei,F,100,70,0,70
Brezlyn,F,100,70,0,70
Brinsley,F,100,70,0,70
Brolin,M,100,0,70,70
Brondon,M,100,0,70,70
Brysyn,M,100,0,70,70
Caralina,F,100,70,0,70
Carianna,F,100,70,0,70
Carlyne,F,100,70,0,70
Chalet,F,100,70,0,70
Chaunice,F,100,70,0,70
Chellsie,F,100,70,0,70
Cia,F,100,70,0,70
Corleen,F,100,70,0,70
Cylan,M,100,0,70,70
Daegon,M,100,0,70,70
Dalasia,F,100,70,0,70
Dalbert,M,100,0,70,70
Damico,M,100,0,70,70
Danija,F,100,70,0,70
Darald,M,100,0,70,70
Dashell,F,67,47,23,70
Dejae,F,100,70,0,70
Dekisha,F,100,70,0,70
Delron,M,100,0,70,70
Desirai,F,100,70,0,70
Dilana,F,100,70,0,70
Dilpreet,M,54,32,38,70
Dmetrius,M,100,0,70,70
Dnya,F,100,70,0,70
Dontavian,M,100,0,70,70
Drayce,M,100,0,70,70
Dwayna,F,100,70,0,70
Dyneisha,F,100,70,0,70
Eain,M,100,0,70,70
Edynn,F,100,70,0,70
Emileo,M,100,0,70,70
Emmalou,F,100,70,0,70
Enyah,F,100,70,0,70
Errik,M,100,0,70,70
Ezequias,M,100,0,70,70
Fadia,F,100,70,0,70
Fawnda,F,100,70,0,70
Finnbar,M,100,0,70,70
Finneus,M,100,0,70,70
Gahel,M,100,0,70,70
Gamble,M,93,5,65,70
Georjean,F,100,70,0,70
Giovoni,M,100,0,70,70
Glendi,F,100,70,0,70
Graylen,M,100,0,70,70
Grisela,F,100,70,0,70
Haim,M,100,0,70,70
Haleemah,F,100,70,0,70
Harutyun,M,100,0,70,70
Havah,F,100,70,0,70
Icholas,M,100,0,70,70
Iolani,F,100,70,0,70
Iylah,F,100,70,0,70
Jahzier,M,100,0,70,70
Jailani,F,100,70,0,70
Jaimarie,F,100,70,0,70
Jaimere,M,100,0,70,70
Jaleil,M,100,0,70,70
Jaquia,F,100,70,0,70
Jarman,M,100,0,70,70
Jaselynn,F,100,70,0,70
Jaxan,M,100,0,70,70
Jaysiah,M,100,0,70,70
Jayten,M,100,0,70,70
Jeannelle,F,100,70,0,70
Jermall,M,100,0,70,70
Jimma,F,100,70,0,70
Jimmye,F,90,63,7,70
Jimya,F,100,70,0,70
Jonmarc,M,100,0,70,70
Joseeduardo,M,100,0,70,70
Jozalynn,F,100,70,0,70
Judiann,F,100,70,0,70
Kahlin,M,84,11,59,70
Kahliya,F,100,70,0,70
Kailany,F,100,70,0,70
Kalden,M,100,0,70,70
Kaleea,F,100,70,0,70
Kaleeah,F,100,70,0,70
Kamica,F,100,70,0,70
Kassadee,F,100,70,0,70
Kasumi,F,100,70,0,70
Kavina,F,100,70,0,70
Keldan,M,100,0,70,70
Kenlei,F,100,70,0,70
Kennedey,F,100,70,0,70
Kensly,F,93,65,5,70
Keora,F,100,70,0,70
Kimberlye,F,100,70,0,70
Kinzlie,F,100,70,0,70
Kizzi,F,100,70,0,70
Lada,F,100,70,0,70
Ladamien,M,100,0,70,70
Lakshya,M,57,30,40,70
Laquashia,F,100,70,0,70
Laterrian,M,93,5,65,70
Laurabeth,F,100,70,0,70
Lauranne,F,100,70,0,70
Ledon,M,100,0,70,70
Lety,F,100,70,0,70
Leydy,F,100,70,0,70
Liley,F,100,70,0,70
Lindsea,F,100,70,0,70
Lizvette,F,100,70,0,70
Lonnel,M,100,0,70,70
Lucilia,F,100,70,0,70
Makailee,F,100,70,0,70
Makailey,F,100,70,0,70
Manessa,F,100,70,0,70
Manly,M,100,0,70,70
Marirose,F,100,70,0,70
Marlicia,F,100,70,0,70
Marvena,F,100,70,0,70
Mattthew,M,100,0,70,70
Mayara,F,100,70,0,70
Melayah,F,100,70,0,70
Michaelina,F,100,70,0,70
Milanni,F,100,70,0,70
Miroslav,M,100,0,70,70
Mj,M,100,0,70,70
Muzamil,M,100,0,70,70
Nahiem,M,100,0,70,70
Naithen,M,100,0,70,70
Nalla,F,100,70,0,70
Nancylee,F,100,70,0,70
Nanda,F,93,65,5,70
Neithan,M,100,0,70,70
Numa,F,79,55,15,70
Nyan,M,100,0,70,70
Nyazia,F,100,70,0,70
Oliveah,F,100,70,0,70
Othel,M,100,0,70,70
Oveta,F,100,70,0,70
Patricie,F,100,70,0,70
Pesach,M,100,0,70,70
Quenesha,F,100,70,0,70
Raenette,F,100,70,0,70
Rayquon,M,100,0,70,70
Remmie,F,100,70,0,70
Rhaya,F,100,70,0,70
Rhayne,F,100,70,0,70
Rishith,M,100,0,70,70
Rodrecus,M,100,0,70,70
Rogenia,F,100,70,0,70
Rosalene,F,100,70,0,70
Rozelle,F,69,48,22,70
Ruxin,M,100,0,70,70
Saphyra,F,100,70,0,70
Saquoia,F,100,70,0,70
Savahanna,F,100,70,0,70
Shabreka,F,100,70,0,70
Shamarcus,M,100,0,70,70
Shariece,F,100,70,0,70
Shauniece,F,100,70,0,70
Shawntrice,F,100,70,0,70
Shu,M,74,18,52,70
Shyleigh,F,100,70,0,70
Skyleen,F,100,70,0,70
Sontee,F,100,70,0,70
Staceyann,F,100,70,0,70
Sundance,M,93,5,65,70
Swade,M,100,0,70,70
Tache,F,100,70,0,70
Taeden,M,100,0,70,70
Tanyika,F,100,70,0,70
Tanylah,F,100,70,0,70
Tenzing,M,77,16,54,70
Teriah,F,100,70,0,70
Toddy,M,100,0,70,70
Trevione,M,100,0,70,70
Trypp,M,100,0,70,70
Tyshell,F,100,70,0,70
Vipul,M,100,0,70,70
Wang,M,100,0,70,70
Yarrow,F,77,54,16,70
Zai,M,79,15,55,70
Zakariyah,M,73,19,51,70
Zameria,F,100,70,0,70
Zannie,M,86,10,60,70
Zarielle,F,100,70,0,70
Zaydrian,M,100,0,70,70
Zell,M,76,17,53,70
Zo,F,86,60,10,70
Zonya,F,100,70,0,70
Accalia,F,100,69,0,69
Acea,M,93,5,64,69
Adahlia,F,100,69,0,69
Adeliz,F,100,69,0,69
Adysson,F,100,69,0,69
Akaiya,F,100,69,0,69
Alaney,F,100,69,0,69
Aldean,F,54,37,32,69
Amandajo,F,100,69,0,69
Amiree,F,100,69,0,69
Analys,F,100,69,0,69
Anatole,M,100,0,69,69
Annibelle,F,100,69,0,69
Antanasia,F,100,69,0,69
Antanette,F,100,69,0,69
Araf,M,100,0,69,69
Armelia,F,100,69,0,69
Ashea,F,100,69,0,69
Ashelynn,F,100,69,0,69
Astou,F,100,69,0,69
Aybree,F,100,69,0,69
Azarius,M,100,0,69,69
Azyriah,F,100,69,0,69
Bellamia,F,100,69,0,69
Branae,F,100,69,0,69
Braylea,F,100,69,0,69
Briannia,F,100,69,0,69
Brittay,F,100,69,0,69
Brittinie,F,100,69,0,69
Broedy,M,100,0,69,69
Brooksie,F,100,69,0,69
Buren,M,100,0,69,69
Burleigh,M,100,0,69,69
Burlin,M,100,0,69,69
Caedin,M,100,0,69,69
Caprina,F,100,69,0,69
Carisha,F,100,69,0,69
Castin,M,100,0,69,69
Cedrica,F,100,69,0,69
Chamille,F,100,69,0,69
Chanese,F,100,69,0,69
Charika,F,100,69,0,69
Cheryllynn,F,100,69,0,69
Chevez,M,100,0,69,69
Clarissia,F,100,69,0,69
Clide,M,100,0,69,69
Cobain,M,100,0,69,69
Courney,F,100,69,0,69
Curlie,F,57,39,30,69
Curtina,F,100,69,0,69
Dajanee,F,100,69,0,69
Dakodah,M,59,28,41,69
Daliya,F,100,69,0,69
Dam,M,100,0,69,69
Danyael,M,100,0,69,69
Darril,M,100,0,69,69
Datrell,M,100,0,69,69
Daylah,F,100,69,0,69
Dayn,M,100,0,69,69
Dayyan,M,100,0,69,69
Dayzee,F,100,69,0,69
Demontrae,M,100,0,69,69
Denyla,F,100,69,0,69
Deserai,F,100,69,0,69
Devaeh,F,100,69,0,69
Devetta,F,100,69,0,69
Devun,M,100,0,69,69
Deyci,F,100,69,0,69
Deyvi,M,100,0,69,69
Dezyrae,F,100,69,0,69
Dlisa,F,100,69,0,69
Donnalynn,F,100,69,0,69
Doyne,M,100,0,69,69
Eljay,M,100,0,69,69
Elliona,F,100,69,0,69
Endiya,F,100,69,0,69
Eriyonna,F,100,69,0,69
Essam,M,100,0,69,69
Estelita,F,100,69,0,69
Exavior,M,100,0,69,69
Fareedah,F,100,69,0,69
Fatin,F,86,59,10,69
Foday,M,100,0,69,69
Gardiner,M,100,0,69,69
Gracilyn,F,100,69,0,69
Hridhaan,M,100,0,69,69
Ibis,F,83,57,12,69
Ikeisha,F,100,69,0,69
Ileigh,F,100,69,0,69
Inette,F,100,69,0,69
Iori,M,100,0,69,69
Iridessa,F,100,69,0,69
Jaben,M,100,0,69,69
Jackqulyn,F,100,69,0,69
Jaeline,F,100,69,0,69
Jalacia,F,100,69,0,69
Jalayiah,F,100,69,0,69
Jamaia,F,100,69,0,69
Jamayia,F,100,69,0,69
Janijah,F,100,69,0,69
Jarielys,F,100,69,0,69
Jaydalee,F,100,69,0,69
Jenille,F,100,69,0,69
Jong,M,100,0,69,69
Jonnell,F,84,58,11,69
Jovontae,M,100,0,69,69
Jurrell,M,100,0,69,69
Kabeer,M,100,0,69,69
Katelind,F,100,69,0,69
Katheline,F,100,69,0,69
Katrianna,F,100,69,0,69
Kavontae,M,100,0,69,69
Keeanna,F,100,69,0,69
Kerstie,F,100,69,0,69
Keymarion,M,100,0,69,69
Khambrel,M,100,0,69,69
Kimbria,F,100,69,0,69
Kirti,F,100,69,0,69
Kortne,F,100,69,0,69
Kweku,M,100,0,69,69
Kyleigha,F,100,69,0,69
Kyrianna,F,100,69,0,69
Laekyn,F,100,69,0,69
Lajuanna,F,100,69,0,69
Laquenta,F,100,69,0,69
Lataria,F,100,69,0,69
Layn,M,100,0,69,69
Leahann,F,100,69,0,69
Leelynd,M,100,0,69,69
Lelon,M,100,0,69,69
Lexx,M,100,0,69,69
Lexys,F,100,69,0,69
Lillyn,F,100,69,0,69
Linet,F,100,69,0,69
Lonald,M,100,0,69,69
Loukisha,F,100,69,0,69
Loveah,F,100,69,0,69
Lujuana,F,100,69,0,69
Lygia,F,100,69,0,69
Lyllie,F,100,69,0,69
Macalister,M,100,0,69,69
Mackinzee,F,100,69,0,69
Maguadalupe,F,100,69,0,69
Mahoganie,F,100,69,0,69
Maicey,F,100,69,0,69
Malavika,F,100,69,0,69
Malvika,F,100,69,0,69
Manali,F,100,69,0,69
Marcellas,M,100,0,69,69
Matther,M,100,0,69,69
Mechille,F,100,69,0,69
Mehtab,M,100,0,69,69
Mourad,M,100,0,69,69
Nalina,F,100,69,0,69
Nateisha,F,100,69,0,69
Neshawn,M,86,10,59,69
Nisaiah,M,100,0,69,69
Norberta,F,100,69,0,69
Patryck,M,100,0,69,69
Paycen,F,61,42,27,69
Phillipa,F,100,69,0,69
Psalms,F,78,54,15,69
Quientin,M,100,0,69,69
Quindarrius,M,100,0,69,69
Rahmah,F,100,69,0,69
Ramonte,M,100,0,69,69
Ravina,F,100,69,0,69
Requan,M,100,0,69,69
Rigley,M,83,12,57,69
Rilynne,F,100,69,0,69
Rodnisha,F,100,69,0,69
Ronne,M,55,31,38,69
Roshini,F,100,69,0,69
Royann,F,100,69,0,69
Safiyya,F,100,69,0,69
Sandrina,F,100,69,0,69
Sapir,F,100,69,0,69
Shakaria,F,100,69,0,69
Shantanu,M,100,0,69,69
Sharnika,F,100,69,0,69
Sherrine,F,100,69,0,69
Sherryll,F,100,69,0,69
Simren,F,100,69,0,69
Skila,F,100,69,0,69
Skyley,F,100,69,0,69
Skylinn,F,100,69,0,69
Soniyah,F,100,69,0,69
Stefannie,F,100,69,0,69
Stevana,F,100,69,0,69
Sukhraj,M,100,0,69,69
Tadarrius,M,100,0,69,69
Taleeyah,F,100,69,0,69
Tamanika,F,100,69,0,69
Tasmine,F,100,69,0,69
Tehillah,F,100,69,0,69
Teiana,F,100,69,0,69
Teliah,F,100,69,0,69
Terianne,F,100,69,0,69
Tessi,F,100,69,0,69
Theone,F,93,64,5,69
Ti,M,83,12,57,69
Tijana,F,100,69,0,69
Treyvonne,M,100,0,69,69
Tyme,F,71,49,20,69
Tynleigh,F,100,69,0,69
Valla,F,100,69,0,69
Vasilia,F,100,69,0,69
Wataru,M,100,0,69,69
Xiamara,F,100,69,0,69
Yailen,F,100,69,0,69
Yisell,F,100,69,0,69
Zaakirah,F,100,69,0,69
Zalea,F,100,69,0,69
Zeidy,F,100,69,0,69
Znya,F,100,69,0,69
Zyen,M,100,0,69,69
Aarini,F,100,68,0,68
Aava,F,100,68,0,68
Abass,M,100,0,68,68
Aisea,M,100,0,68,68
Aison,M,100,0,68,68
Aivan,M,93,5,63,68
Alayzha,F,100,68,0,68
Aleshka,F,100,68,0,68
Alexanderjames,M,100,0,68,68
Ameliyah,F,100,68,0,68
Anabelen,F,100,68,0,68
Arlissa,F,100,68,0,68
Arminta,F,100,68,0,68
Armiyah,F,100,68,0,68
Arriyah,F,100,68,0,68
Arryn,F,93,63,5,68
Artha,F,78,53,15,68
Ashiah,F,100,68,0,68
Autumnrose,F,100,68,0,68
Azeez,M,100,0,68,68
Bhavika,F,100,68,0,68
Blanka,F,100,68,0,68
Bonnetta,F,100,68,0,68
Bradshaw,M,100,0,68,68
Brailon,M,100,0,68,68
Brelan,M,100,0,68,68
Caterine,F,100,68,0,68
Chantille,F,100,68,0,68
Chestina,F,100,68,0,68
Chidiebere,M,100,0,68,68
Chistine,F,100,68,0,68
Christyann,F,100,68,0,68
Claudean,F,100,68,0,68
Clayburn,M,100,0,68,68
Coleston,M,100,0,68,68
Crewe,M,100,0,68,68
Dayanis,F,100,68,0,68
Deanza,F,100,68,0,68
Dearra,F,100,68,0,68
Delyn,F,84,57,11,68
Demeisha,F,100,68,0,68
Deshundra,F,100,68,0,68
Dezirea,F,100,68,0,68
Diella,F,100,68,0,68
Dimonique,F,100,68,0,68
Dmani,M,72,19,49,68
Dominyck,M,100,0,68,68
Dyshaun,M,100,0,68,68
Elanah,F,100,68,0,68
Emelee,F,100,68,0,68
Eswin,M,100,0,68,68
Euel,M,100,0,68,68
Eugen,M,100,0,68,68
Feleica,F,100,68,0,68
Fiana,F,100,68,0,68
Gabbi,F,100,68,0,68
Geza,M,100,0,68,68
Habeeb,M,100,0,68,68
Hakeen,M,100,0,68,68
Hanz,M,100,0,68,68
Harvy,M,100,0,68,68
Hassie,F,100,68,0,68
Havier,M,100,0,68,68
Hawraa,F,100,68,0,68
Hesper,F,100,68,0,68
Heylee,F,100,68,0,68
Hye,F,100,68,0,68
Ilze,F,100,68,0,68
Jacquelinne,F,100,68,0,68
Jaeven,M,100,0,68,68
Jamiaya,F,100,68,0,68
Jamiyla,F,100,68,0,68
Janmarie,F,100,68,0,68
Jarriel,M,100,0,68,68
Javanni,M,100,0,68,68
Jaysie,F,100,68,0,68
Jenness,F,100,68,0,68
Jericca,F,100,68,0,68
Jermario,M,100,0,68,68
Jerol,M,100,0,68,68
Jerrian,M,100,0,68,68
Jevaeh,F,100,68,0,68
Jevaun,M,100,0,68,68
Jewelene,F,100,68,0,68
Jihaad,M,100,0,68,68
Jomel,M,100,0,68,68
Joniece,F,100,68,0,68
Juni,F,75,51,17,68
Kailoni,F,100,68,0,68
Kamill,F,100,68,0,68
Kamla,F,100,68,0,68
Kaydense,F,100,68,0,68
Kayleanna,F,100,68,0,68
Kealoha,F,53,36,32,68
Kearie,F,100,68,0,68
Keeshia,F,100,68,0,68
Kekai,M,100,0,68,68
Kelynn,F,69,47,21,68
Kenecia,F,100,68,0,68
Kenitha,F,100,68,0,68
Kerston,F,100,68,0,68
Keyen,M,100,0,68,68
Keyia,F,100,68,0,68
Kharee,M,100,0,68,68
Kirstein,F,100,68,0,68
Kissa,F,100,68,0,68
Konya,F,91,62,6,68
Kristapher,M,100,0,68,68
Kristyanna,F,100,68,0,68
Kymorah,F,100,68,0,68
Lanaysia,F,100,68,0,68
Laquitha,F,100,68,0,68
Latamara,F,100,68,0,68
Laurielle,F,100,68,0,68
Layli,F,100,68,0,68
Ledonna,F,100,68,0,68
Leinaala,F,100,68,0,68
Lerae,F,100,68,0,68
Lillyen,F,100,68,0,68
Lindberg,M,100,0,68,68
Lohgan,F,53,36,32,68
Lydiana,F,100,68,0,68
Mabelle,F,100,68,0,68
Mahamud,M,100,0,68,68
Marieelena,F,100,68,0,68
Marton,M,100,0,68,68
Maryem,F,100,68,0,68
Matthe,M,100,0,68,68
Melanni,F,100,68,0,68
Millee,F,100,68,0,68
Mory,M,100,0,68,68
Mry,F,100,68,0,68
Nabilah,F,100,68,0,68
Naiomy,F,100,68,0,68
Nasrin,F,100,68,0,68
Naturi,F,100,68,0,68
Naviyah,F,100,68,0,68
Nikaela,F,100,68,0,68
Obdulio,M,100,0,68,68
Octivia,F,100,68,0,68
Olander,M,100,0,68,68
Olene,F,100,68,0,68
Onyekachi,M,84,11,57,68
Orazio,M,100,0,68,68
Orlander,M,100,0,68,68
Philo,M,100,0,68,68
Philopateer,M,100,0,68,68
Pookela,M,100,0,68,68
Previn,M,100,0,68,68
Pricsilla,F,100,68,0,68
Quamesha,F,100,68,0,68
Quina,F,100,68,0,68
Raekwan,M,100,0,68,68
Rajanee,F,100,68,0,68
Ramisa,F,100,68,0,68
Rasheida,F,100,68,0,68
Ratha,M,74,18,50,68
Rayhaan,M,100,0,68,68
Raymel,M,100,0,68,68
Redina,F,100,68,0,68
Regana,F,100,68,0,68
Roda,F,100,68,0,68
Roquel,F,100,68,0,68
Ruffus,M,100,0,68,68
Ruvi,F,100,68,0,68
Sallyanne,F,100,68,0,68
Samanthamarie,F,100,68,0,68
Santez,M,100,0,68,68
Satia,F,100,68,0,68
Sayana,F,100,68,0,68
Scharlene,F,100,68,0,68
Seleen,F,100,68,0,68
Shaylinn,F,100,68,0,68
Sherisa,F,100,68,0,68
Shikara,F,100,68,0,68
Shirlette,F,100,68,0,68
Shirrell,F,100,68,0,68
Suede,M,100,0,68,68
Sukaina,F,100,68,0,68
Suly,F,100,68,0,68
Sya,F,100,68,0,68
Taneah,F,100,68,0,68
Tanisia,F,100,68,0,68
Tanzie,F,100,68,0,68
Tatijana,F,100,68,0,68
Tejuan,M,100,0,68,68
Tequia,F,100,68,0,68
Terique,M,100,0,68,68
Thatiana,F,100,68,0,68
Tiarrah,F,100,68,0,68
Tishina,F,100,68,0,68
Tocara,F,100,68,0,68
Tomoya,M,100,0,68,68
Tonye,F,100,68,0,68
Travante,M,100,0,68,68
Trigo,M,100,0,68,68
Tura,F,100,68,0,68
Verenis,F,100,68,0,68
Xandrea,F,100,68,0,68
Xinyi,F,100,68,0,68
Yameli,F,100,68,0,68
Yamna,F,100,68,0,68
Yanice,F,100,68,0,68
Yanissa,F,100,68,0,68
Yedidya,M,100,0,68,68
Yeilyn,F,100,68,0,68
Zabella,F,100,68,0,68
Zalyn,M,91,6,62,68
Zhamir,M,100,0,68,68
Zoii,F,100,68,0,68
Aanchal,F,100,67,0,67
Adilynne,F,100,67,0,67
Ahmarion,M,100,0,67,67
Ahmira,F,100,67,0,67
Ajiah,F,100,67,0,67
Alajia,F,100,67,0,67
Alaysiah,F,100,67,0,67
Aleza,F,100,67,0,67
Almarie,F,100,67,0,67
Aloria,F,100,67,0,67
Alveta,F,100,67,0,67
Alyannah,F,100,67,0,67
Anastazja,F,100,67,0,67
Aneeka,F,100,67,0,67
Anie,F,100,67,0,67
Aniken,M,100,0,67,67
Aquita,F,100,67,0,67
Arad,M,100,0,67,67
Areliz,F,100,67,0,67
Aritha,F,100,67,0,67
Arnesia,F,100,67,0,67
Arraya,F,100,67,0,67
Arshi,F,100,67,0,67
Ashleyanne,F,100,67,0,67
Ashni,F,100,67,0,67
Asti,F,100,67,0,67
Atiyana,F,100,67,0,67
Augusten,M,100,0,67,67
Aurther,M,100,0,67,67
Ayauna,F,100,67,0,67
Ayaz,M,100,0,67,67
Barbee,F,100,67,0,67
Bindu,F,100,67,0,67
Bonniejean,F,100,67,0,67
Brandley,M,100,0,67,67
Brayah,F,100,67,0,67
Breshae,F,100,67,0,67
Briggett,F,100,67,0,67
Briteny,F,100,67,0,67
Carsin,M,100,0,67,67
Cartel,M,100,0,67,67
Cela,F,100,67,0,67
Cesiah,F,100,67,0,67
Chanoch,M,100,0,67,67
Charlot,F,100,67,0,67
Chelcea,F,100,67,0,67
Chevella,F,100,67,0,67
Chevie,F,75,50,17,67
Chisum,M,100,0,67,67
Cleave,M,100,0,67,67
Corabelle,F,100,67,0,67
Curly,M,100,0,67,67
Dainelle,F,100,67,0,67
Dajane,F,100,67,0,67
Danaija,F,100,67,0,67
Danaly,F,100,67,0,67
Danaye,F,100,67,0,67
Darika,F,100,67,0,67
Darivs,M,100,0,67,67
Davonda,F,100,67,0,67
Deannie,F,100,67,0,67
Demaree,M,84,11,56,67
Denaisha,F,100,67,0,67
Denaly,F,100,67,0,67
Dequane,M,100,0,67,67
Derran,M,100,0,67,67
Disaya,F,100,67,0,67
Doua,M,58,28,39,67
Duvall,M,100,0,67,67
Edu,M,100,0,67,67
Eean,M,100,0,67,67
Eline,F,100,67,0,67
Elishua,M,100,0,67,67
Elizardo,M,100,0,67,67
Emaley,F,100,67,0,67
Emilene,F,100,67,0,67
Eryc,M,100,0,67,67
Eurydice,F,100,67,0,67
Everlene,F,100,67,0,67
Fabiano,M,100,0,67,67
Finnean,M,100,0,67,67
Gabreille,F,100,67,0,67
Graeden,M,100,0,67,67
Granite,M,100,0,67,67
Haidan,M,91,6,61,67
Hanny,F,100,67,0,67
Horst,M,100,0,67,67
Ilma,F,100,67,0,67
Inigo,M,100,0,67,67
Izaha,M,100,0,67,67
Jagar,M,100,0,67,67
Jahleah,F,100,67,0,67
Jaimya,F,100,67,0,67
Jamaiyah,F,100,67,0,67
Jamespaul,M,100,0,67,67
Jaquaya,F,100,67,0,67
Jasnoor,F,93,62,5,67
Javana,F,100,67,0,67
Jayesh,M,100,0,67,67
Jaymarion,M,100,0,67,67
Jazen,M,100,0,67,67
Jazia,F,100,67,0,67
Jerae,F,91,61,6,67
Jereld,M,100,0,67,67
Jlon,M,100,0,67,67
Jocilynn,F,100,67,0,67
Josephanthony,M,100,0,67,67
Junah,M,91,6,61,67
Jymir,M,100,0,67,67
Kainat,F,100,67,0,67
Kaisei,M,100,0,67,67
Kalep,M,100,0,67,67
Kamylle,F,100,67,0,67
Karandeep,M,100,0,67,67
Katira,F,100,67,0,67
Katniss,F,100,67,0,67
Kattia,F,100,67,0,67
Keaja,F,100,67,0,67
Keaunna,F,100,67,0,67
Keondrick,M,100,0,67,67
Kessie,F,100,67,0,67
Keyetta,F,100,67,0,67
Khalidah,F,100,67,0,67
Khalis,F,78,52,15,67
Koehn,M,100,0,67,67
Kosei,M,100,0,67,67
Kynesha,F,100,67,0,67
Lafrance,F,67,45,22,67
Lakely,F,100,67,0,67
Lash,M,100,0,67,67
Likisha,F,100,67,0,67
Lincon,M,100,0,67,67
Liona,F,100,67,0,67
Lorae,F,100,67,0,67
Loreley,F,100,67,0,67
Lynniah,F,100,67,0,67
Maddoxx,M,100,0,67,67
Malva,F,100,67,0,67
Marceil,F,100,67,0,67
Margrette,F,100,67,0,67
Marionette,F,100,67,0,67
Marjo,F,100,67,0,67
Marticia,F,100,67,0,67
Matheau,M,100,0,67,67
Maysin,M,93,5,62,67
Micajah,M,100,0,67,67
Miken,M,100,0,67,67
Mikias,M,100,0,67,67
Milam,M,100,0,67,67
Miu,F,100,67,0,67
Mixtli,F,100,67,0,67
Naif,M,100,0,67,67
Nakenya,F,100,67,0,67
Neasia,F,100,67,0,67
Nikiesha,F,100,67,0,67
Nikitas,M,100,0,67,67
Nimesh,M,100,0,67,67
Nolah,F,100,67,0,67
Nyair,M,100,0,67,67
Ohanna,F,100,67,0,67
Orvis,M,100,0,67,67
Oseph,M,100,0,67,67
Oyindamola,F,93,62,5,67
Patt,F,85,57,10,67
Pranit,M,100,0,67,67
Puanani,F,100,67,0,67
Quadry,M,100,0,67,67
Rabecka,F,100,67,0,67
Raechell,F,100,67,0,67
Raequon,M,100,0,67,67
Ranessa,F,100,67,0,67
Reason,M,85,10,57,67
Rjay,M,100,0,67,67
Rollen,M,100,0,67,67
Roniqua,F,100,67,0,67
Rosamary,F,100,67,0,67
Roselani,F,100,67,0,67
Ryna,F,70,47,20,67
Saurabh,M,100,0,67,67
Saveah,F,100,67,0,67
Savera,F,100,67,0,67
Seiya,M,100,0,67,67
Shaida,F,100,67,0,67
Shammond,M,100,0,67,67
Shaolin,F,93,62,5,67
Shaylynne,F,100,67,0,67
Shereda,F,100,67,0,67
Sherlon,F,100,67,0,67
Shihab,M,100,0,67,67
Shiryl,F,100,67,0,67
Siddh,M,100,0,67,67
Siris,M,100,0,67,67
Slevin,M,100,0,67,67
Steadman,M,100,0,67,67
Strummer,M,100,0,67,67
Surafel,M,100,0,67,67
Taiana,F,100,67,0,67
Talayeh,F,100,67,0,67
Talaysha,F,100,67,0,67
Tamecca,F,100,67,0,67
Tekelia,F,100,67,0,67
Tenelle,F,100,67,0,67
Tiann,F,100,67,0,67
Tiffnay,F,100,67,0,67
Tihanna,F,100,67,0,67
Timmya,F,100,67,0,67
Toniette,F,100,67,0,67
Torii,F,75,50,17,67
Tramane,M,100,0,67,67
Tramond,M,100,0,67,67
Trasean,M,100,0,67,67
Tyshana,F,100,67,0,67
Vasiliy,M,100,0,67,67
Vence,M,100,0,67,67
Vickee,F,100,67,0,67
Villa,F,100,67,0,67
Vivyan,F,100,67,0,67
Yaresly,F,100,67,0,67
Yarianna,F,100,67,0,67
Yariela,F,100,67,0,67
Yarisa,F,100,67,0,67
Yeila,F,100,67,0,67
Yerania,F,100,67,0,67
Zaidy,F,100,67,0,67
Zaxton,M,100,0,67,67
Zayvien,M,100,0,67,67
Zyree,M,76,16,51,67
Abbeygail,F,100,66,0,66
Abdirizak,M,100,0,66,66
Adalai,F,100,66,0,66
Adriaan,M,100,0,66,66
Adrinne,F,100,66,0,66
Adyen,M,100,0,66,66
Aliahna,F,100,66,0,66
Anaily,F,100,66,0,66
Anjelita,F,100,66,0,66
Anvith,M,100,0,66,66
Araminta,F,100,66,0,66
Ashima,F,100,66,0,66
Asmi,F,100,66,0,66
Audreena,F,100,66,0,66
Azariel,M,100,0,66,66
Beauden,M,100,0,66,66
Bellatrix,F,100,66,0,66
Bralee,F,100,66,0,66
Britiny,F,100,66,0,66
Cadden,M,100,0,66,66
Caera,F,100,66,0,66
Calyx,M,55,30,36,66
Cameka,F,100,66,0,66
Charnel,F,100,66,0,66
Chelesea,F,100,66,0,66
Cochise,M,100,0,66,66
Crystallynn,F,100,66,0,66
Daizee,F,100,66,0,66
Daray,M,100,0,66,66
Dartanyan,M,100,0,66,66
Deaun,F,100,66,0,66
Delcia,F,100,66,0,66
Delesa,F,100,66,0,66
Deuce,M,100,0,66,66
Deziya,F,100,66,0,66
Dijuan,M,100,0,66,66
Dlynn,F,100,66,0,66
Dontario,M,100,0,66,66
Dorea,F,100,66,0,66
Dossie,M,85,10,56,66
Dynastie,F,100,66,0,66
Elandra,F,100,66,0,66
Eleesha,F,100,66,0,66
Eliese,F,100,66,0,66
Ellakate,F,100,66,0,66
Emera,F,100,66,0,66
Estiben,M,100,0,66,66
Ether,F,91,60,6,66
Faraaz,M,100,0,66,66
Ferrah,F,100,66,0,66
Gaege,M,100,0,66,66
Geneieve,F,100,66,0,66
Gianlucas,M,100,0,66,66
Gift,F,100,66,0,66
Haila,F,100,66,0,66
Harith,M,100,0,66,66
Haylo,F,100,66,0,66
Heidee,F,100,66,0,66
Heleena,F,100,66,0,66
Hyden,M,100,0,66,66
Ilaisaane,F,100,66,0,66
Imya,F,100,66,0,66
Inas,F,100,66,0,66
Isobelle,F,100,66,0,66
Israella,F,100,66,0,66
Iviona,F,100,66,0,66
Jadavion,M,100,0,66,66
Jahree,M,100,0,66,66
Jaideep,M,100,0,66,66
Jamarkis,M,100,0,66,66
Janelie,F,100,66,0,66
Jarelyn,F,100,66,0,66
Jayelyn,F,100,66,0,66
Jeraldin,F,100,66,0,66
Jerric,M,100,0,66,66
Jeyren,M,100,0,66,66
Jillien,F,100,66,0,66
Jonnatan,M,100,0,66,66
Jossalin,F,100,66,0,66
Juwann,M,100,0,66,66
Kahlel,M,100,0,66,66
Kaidynn,F,61,40,26,66
Kajol,F,100,66,0,66
Karcyn,F,100,66,0,66
Karstyn,F,100,66,0,66
Karyss,F,100,66,0,66
Kaymon,M,100,0,66,66
Keaisha,F,100,66,0,66
Keeven,M,100,0,66,66
Keigo,M,100,0,66,66
Kermitt,M,100,0,66,66
Keryl,F,100,66,0,66
Kevron,M,100,0,66,66
Kieli,F,100,66,0,66
Kimaria,F,100,66,0,66
Kouper,M,100,0,66,66
Laguana,F,100,66,0,66
Lashe,F,100,66,0,66
Lelania,F,100,66,0,66
Lexany,F,100,66,0,66
Lithzy,F,100,66,0,66
Lulia,F,100,66,0,66
Lyrah,F,100,66,0,66
Madalaine,F,100,66,0,66
Makael,M,100,0,66,66
Malu,F,100,66,0,66
Malvern,M,100,0,66,66
Marcianne,F,100,66,0,66
Marelly,F,100,66,0,66
Mariachristina,F,100,66,0,66
Marieclaire,F,100,66,0,66
Markasia,F,100,66,0,66
Maxamilian,M,100,0,66,66
Mckynlie,F,100,66,0,66
Mellina,F,100,66,0,66
Mikaiah,F,85,56,10,66
Mirriam,F,100,66,0,66
Monicka,F,100,66,0,66
Monnica,F,100,66,0,66
Muranda,F,100,66,0,66
Mysty,F,100,66,0,66
Nachmen,M,100,0,66,66
Nahal,F,100,66,0,66
Nahjae,F,100,66,0,66
Nahome,M,100,0,66,66
Naileah,F,100,66,0,66
Nakiea,F,100,66,0,66
Nalu,M,100,0,66,66
Nandika,F,100,66,0,66
Natayah,F,100,66,0,66
Ngai,M,100,0,66,66
Niamya,F,100,66,0,66
Nikash,M,100,0,66,66
Nilza,F,100,66,0,66
Omani,M,55,30,36,66
Omesha,F,100,66,0,66
Orris,M,100,0,66,66
Parisha,F,100,66,0,66
Pearley,F,100,66,0,66
Platon,M,100,0,66,66
Prajwal,M,100,0,66,66
Quatavious,M,100,0,66,66
Randyl,M,83,11,55,66
Rekisha,F,100,66,0,66
Reynoldo,M,100,0,66,66
Ritta,F,100,66,0,66
Robertt,M,100,0,66,66
Rojean,F,100,66,0,66
Romond,M,100,0,66,66
Rydge,M,100,0,66,66
Saaya,F,100,66,0,66
Sacramento,M,100,0,66,66
Samariyah,F,100,66,0,66
Samayra,F,100,66,0,66
Saraiyah,F,100,66,0,66
Sarath,M,70,20,46,66
Savaya,F,100,66,0,66
Say,F,71,47,19,66
Schawn,M,100,0,66,66
Sentoria,F,100,66,0,66
Seraya,F,100,66,0,66
Serin,F,100,66,0,66
Shalik,M,100,0,66,66
Shandora,F,100,66,0,66
Shelisha,F,100,66,0,66
Shemuel,M,100,0,66,66
Shishir,M,100,0,66,66
Shyteria,F,100,66,0,66
Sindee,F,100,66,0,66
Sly,M,100,0,66,66
Steph,F,100,66,0,66
Stephfon,M,100,0,66,66
Sussan,F,100,66,0,66
Taleigh,F,100,66,0,66
Tanice,F,100,66,0,66
Tannisha,F,100,66,0,66
Tarquin,M,100,0,66,66
Tarvares,M,100,0,66,66
Tavone,M,100,0,66,66
Tayjon,M,100,0,66,66
Taysom,M,100,0,66,66
Teige,M,100,0,66,66
Teondre,M,100,0,66,66
Terease,F,100,66,0,66
Tesneem,F,100,66,0,66
Tiandre,M,100,0,66,66
Toshika,F,100,66,0,66
Trell,M,100,0,66,66
Tyhir,M,100,0,66,66
Tyreesha,F,100,66,0,66
Vedh,M,100,0,66,66
Walaa,F,100,66,0,66
Walida,F,100,66,0,66
Wyley,M,100,0,66,66
Yaiden,M,100,0,66,66
Yamaira,F,100,66,0,66
Yanelie,F,100,66,0,66
Yanil,F,100,66,0,66
Yarima,F,100,66,0,66
Yesena,F,100,66,0,66
Yolani,F,100,66,0,66
Zacory,M,100,0,66,66
Zaray,F,100,66,0,66
Zoeie,F,100,66,0,66
Zubayr,M,100,0,66,66
Zyheir,M,100,0,66,66
Acire,F,100,65,0,65
Akashdeep,M,100,0,65,65
Alann,M,100,0,65,65
Alka,F,100,65,0,65
Allaya,F,100,65,0,65
Alohilani,F,100,65,0,65
Alyssamae,F,100,65,0,65
Amarrah,F,100,65,0,65
Ameah,F,100,65,0,65
Amoy,F,100,65,0,65
Amzie,F,100,65,0,65
Andron,M,100,0,65,65
Angles,F,100,65,0,65
Aniyiah,F,100,65,0,65
Anona,F,100,65,0,65
Anubis,M,100,0,65,65
Anzal,F,100,65,0,65
Armanni,M,83,11,54,65
Arriah,F,100,65,0,65
Ashrita,F,100,65,0,65
Braeton,M,100,0,65,65
Brandel,M,80,13,52,65
Brione,F,83,54,11,65
Brodan,M,100,0,65,65
Broox,M,100,0,65,65
Calhoun,M,100,0,65,65
Calieb,M,100,0,65,65
Calvary,F,68,44,21,65
Camen,M,85,10,55,65
Cashawn,M,100,0,65,65
Catheline,F,100,65,0,65
Charlann,F,100,65,0,65
Cheryel,F,100,65,0,65
Claudett,F,100,65,0,65
Clista,F,100,65,0,65
Conya,F,100,65,0,65
Crecencio,M,100,0,65,65
Crystalee,F,100,65,0,65
Daesia,F,100,65,0,65
Dalayah,F,100,65,0,65
Danielly,F,100,65,0,65
Dantre,M,100,0,65,65
Danylah,F,100,65,0,65
Daquisha,F,100,65,0,65
Darriell,F,83,54,11,65
Darrio,M,100,0,65,65
Deaysia,F,100,65,0,65
Debhora,F,100,65,0,65
Debroh,F,100,65,0,65
Demarus,M,100,0,65,65
Demeco,M,100,0,65,65
Derel,M,100,0,65,65
Deyonce,F,89,58,7,65
Deyra,F,100,65,0,65
Diahn,F,100,65,0,65
Dinh,M,100,0,65,65
Dnyla,F,100,65,0,65
Dylanie,F,100,65,0,65
Eaton,M,100,0,65,65
Edgerrin,M,100,0,65,65
Eliette,F,100,65,0,65
Elijahjames,M,100,0,65,65
Elizar,M,100,0,65,65
Ellionna,F,100,65,0,65
Elmin,M,100,0,65,65
Emanuell,M,100,0,65,65
Endrit,M,100,0,65,65
Eydan,M,100,0,65,65
Faelyn,F,100,65,0,65
Fedra,F,100,65,0,65
Geniece,F,100,65,0,65
Gerlad,M,100,0,65,65
Haji,M,100,0,65,65
Harleyquinn,F,100,65,0,65
Hasheem,M,100,0,65,65
Hersey,M,100,0,65,65
Holy,F,100,65,0,65
Ishi,F,89,58,7,65
Islay,F,100,65,0,65
Iyonnah,F,100,65,0,65
Jaana,F,100,65,0,65
Jadene,F,100,65,0,65
Jahlisa,F,100,65,0,65
Jahmeek,M,100,0,65,65
Jaquaveon,M,100,0,65,65
Javione,M,100,0,65,65
Jayleon,M,100,0,65,65
Jayquon,M,100,0,65,65
Jesusmanuel,M,100,0,65,65
Jmichael,M,100,0,65,65
Jodel,F,100,65,0,65
Joseandres,M,100,0,65,65
Josiane,F,100,65,0,65
Joua,F,100,65,0,65
Jowel,M,100,0,65,65
Juleon,M,100,0,65,65
Kaevion,M,100,0,65,65
Kaiel,M,100,0,65,65
Kaliope,F,100,65,0,65
Kano,M,100,0,65,65
Kashe,F,62,40,25,65
Katena,F,100,65,0,65
Kaysa,F,100,65,0,65
Kazzandra,F,100,65,0,65
Keali,F,100,65,0,65
Kennice,F,100,65,0,65
Kevontay,M,100,0,65,65
Khrystyna,F,100,65,0,65
Kienna,F,100,65,0,65
Kingslee,M,55,29,36,65
Kinnie,M,100,0,65,65
Kiyani,F,100,65,0,65
Kobyn,M,100,0,65,65
Kortlynn,F,100,65,0,65
Ksean,M,100,0,65,65
Kunaal,M,100,0,65,65
Kyrollos,M,100,0,65,65
Ladesha,F,100,65,0,65
Laelle,F,100,65,0,65
Lailie,F,100,65,0,65
Lakela,F,100,65,0,65
Lalitha,F,100,65,0,65
Lashonne,F,100,65,0,65
Latarshia,F,100,65,0,65
Lelynd,M,100,0,65,65
Letti,F,100,65,0,65
Liadan,F,100,65,0,65
Lindaann,F,100,65,0,65
Loi,M,82,12,53,65
Lonya,F,100,65,0,65
Loray,F,100,65,0,65
Magdala,F,100,65,0,65
Mahdiya,F,100,65,0,65
Mak,M,100,0,65,65
Makaria,F,100,65,0,65
Makarios,M,100,0,65,65
Makinzey,F,100,65,0,65
Manhattan,F,100,65,0,65
Marckus,M,100,0,65,65
Mariselda,F,100,65,0,65
Marriana,F,100,65,0,65
Meliya,F,100,65,0,65
Mella,F,100,65,0,65
Miel,F,100,65,0,65
Mikaiya,F,100,65,0,65
Mikena,F,100,65,0,65
Milanie,F,100,65,0,65
Mithra,F,100,65,0,65
Monaye,F,100,65,0,65
Navada,F,91,59,6,65
Nayab,F,100,65,0,65
Nazire,M,100,0,65,65
Nazly,F,100,65,0,65
Ndidi,F,100,65,0,65
Neytiri,F,100,65,0,65
Niemah,F,100,65,0,65
Nikodem,M,100,0,65,65
Nissan,M,92,5,60,65
Nycere,M,100,0,65,65
Nysia,F,100,65,0,65
Odean,M,75,16,49,65
Onnika,F,100,65,0,65
Othon,M,100,0,65,65
Pedram,M,100,0,65,65
Poseidon,M,100,0,65,65
Quame,M,100,0,65,65
Raelie,F,100,65,0,65
Rage,M,100,0,65,65
Rakeya,F,100,65,0,65
Ramelo,M,100,0,65,65
Redding,M,100,0,65,65
Regla,F,100,65,0,65
Rendon,M,100,0,65,65
Rosalynd,F,100,65,0,65
Rosan,F,100,65,0,65
Ryllie,F,100,65,0,65
Saban,M,100,0,65,65
Sae,F,92,60,5,65
Safiatou,F,100,65,0,65
Sahmya,F,100,65,0,65
Sakib,M,100,0,65,65
Salaam,M,100,0,65,65
Salayah,F,100,65,0,65
Samarrah,F,100,65,0,65
Sarabella,F,100,65,0,65
Seymone,F,100,65,0,65
Shristi,F,100,65,0,65
Simora,F,100,65,0,65
Skyra,F,100,65,0,65
Solaris,F,100,65,0,65
Sulay,F,100,65,0,65
Summers,F,100,65,0,65
Sweet,F,100,65,0,65
Tachina,F,100,65,0,65
Tanuj,M,100,0,65,65
Tayvien,M,100,0,65,65
Teea,F,100,65,0,65
Temperence,F,100,65,0,65
Tonea,F,100,65,0,65
Torra,F,100,65,0,65
Traveion,M,100,0,65,65
Tremar,M,100,0,65,65
Tumeka,F,100,65,0,65
Tyqwan,M,100,0,65,65
Tyyonna,F,100,65,0,65
Vanny,F,75,49,16,65
Vantasia,F,100,65,0,65
Vee,F,92,60,5,65
Vernadette,F,100,65,0,65
Xzaria,F,100,65,0,65
Yavier,M,100,0,65,65
Yianna,F,100,65,0,65
Yuleidy,F,100,65,0,65
Zala,F,100,65,0,65
Zamarian,M,100,0,65,65
Zamauri,M,91,6,59,65
Zamyiah,F,100,65,0,65
Zayven,M,100,0,65,65
Ziquan,M,100,0,65,65
Zoye,F,100,65,0,65
Aala,F,100,64,0,64
Aarit,M,100,0,64,64
Adriella,F,100,64,0,64
Adylin,F,100,64,0,64
Ahliya,F,100,64,0,64
Alantra,F,100,64,0,64
Algenis,M,100,0,64,64
Aliece,F,100,64,0,64
Alonnie,F,100,64,0,64
Anaih,F,100,64,0,64
Anddy,M,100,0,64,64
Anelly,F,100,64,0,64
Annalei,F,100,64,0,64
Ansar,M,100,0,64,64
Antoneo,M,100,0,64,64
Antwyne,M,100,0,64,64
Aradhana,F,100,64,0,64
Arkel,M,100,0,64,64
Arriyana,F,100,64,0,64
Ayris,F,100,64,0,64
Azarel,M,100,0,64,64
Azzan,M,100,0,64,64
Baer,M,100,0,64,64
Belisa,F,100,64,0,64
Bishoy,M,100,0,64,64
Blayklee,F,100,64,0,64
Blayn,M,100,0,64,64
Bracen,M,100,0,64,64
Calyb,M,100,0,64,64
Carlethia,F,100,64,0,64
Chaneka,F,100,64,0,64
Chantha,F,53,34,30,64
Charene,F,100,64,0,64
Chenoah,F,100,64,0,64
Cicilia,F,100,64,0,64
Crisol,F,100,64,0,64
Cristalle,F,100,64,0,64
Damel,M,100,0,64,64
Danecia,F,100,64,0,64
Dannisha,F,100,64,0,64
Dare,M,66,22,42,64
Darica,F,100,64,0,64
Darielys,F,100,64,0,64
Delrick,M,100,0,64,64
Demarrius,M,100,0,64,64
Denzal,M,100,0,64,64
Deosha,F,100,64,0,64
Derrich,M,100,0,64,64
Derrisha,F,100,64,0,64
Devarious,M,100,0,64,64
Devontaye,M,100,0,64,64
Devvon,M,92,5,59,64
Di,F,80,51,13,64
Divon,M,100,0,64,64
Diyari,M,100,0,64,64
Donahue,M,100,0,64,64
Dorissa,F,100,64,0,64
Dyamon,F,100,64,0,64
Dynell,M,91,6,58,64
Eagle,M,100,0,64,64
Ernesha,F,100,64,0,64
Esmirna,F,100,64,0,64
Fallen,F,100,64,0,64
Fani,F,100,64,0,64
Fantasha,F,100,64,0,64
Farhaan,M,100,0,64,64
Fatih,M,100,0,64,64
Francely,F,100,64,0,64
Gaelyn,F,100,64,0,64
Gaytha,F,100,64,0,64
Giann,M,100,0,64,64
Gilverto,M,100,0,64,64
Gwendolin,F,100,64,0,64
Hartford,M,100,0,64,64
Hassani,M,100,0,64,64
Horton,M,100,0,64,64
Hutchinson,M,100,0,64,64
Ianmichael,M,100,0,64,64
Icy,F,100,64,0,64
Inocente,M,100,0,64,64
Iren,M,100,0,64,64
Ireoluwa,F,61,39,25,64
Iriel,F,100,64,0,64
Iyah,F,100,64,0,64
Iyanni,F,100,64,0,64
Izumi,F,100,64,0,64
Jaber,M,100,0,64,64
Jadiah,M,59,26,38,64
Jaidalyn,F,100,64,0,64
Jaidence,F,91,58,6,64
Jamyson,M,100,0,64,64
Janara,F,100,64,0,64
Janit,F,100,64,0,64
Jaxsun,M,100,0,64,64
Jaykub,M,100,0,64,64
Jazari,F,66,42,22,64
Jeremian,M,100,0,64,64
Jernie,F,100,64,0,64
Jiayi,F,84,54,10,64
Jilene,F,100,64,0,64
Jisella,F,100,64,0,64
Joany,F,92,59,5,64
Jodye,F,100,64,0,64
Johnmatthew,M,100,0,64,64
Jordani,M,100,0,64,64
Jorgina,F,100,64,0,64
Juron,M,100,0,64,64
Jyles,M,100,0,64,64
Kalyiah,F,100,64,0,64
Kapena,M,100,0,64,64
Karesa,F,100,64,0,64
Katessa,F,100,64,0,64
Katyana,F,100,64,0,64
Kaytlynne,F,100,64,0,64
Keeara,F,100,64,0,64
Keerat,F,92,59,5,64
Keigen,M,100,0,64,64
Keiva,F,100,64,0,64
Kejon,M,100,0,64,64
Kelilah,F,100,64,0,64
Kemo,M,100,0,64,64
Keyundra,F,100,64,0,64
Khaleem,M,100,0,64,64
Khamia,F,100,64,0,64
Kiaja,F,100,64,0,64
Kielyn,F,92,59,5,64
Kinlie,F,100,64,0,64
Kizer,M,100,0,64,64
Kline,M,100,0,64,64
Kolina,F,100,64,0,64
Koralyn,F,100,64,0,64
Kourtlynn,F,100,64,0,64
Kryssa,F,100,64,0,64
Kynzleigh,F,100,64,0,64
Lachae,F,100,64,0,64
Latria,F,100,64,0,64
Laurelin,F,100,64,0,64
Leronda,F,100,64,0,64
Letishia,F,100,64,0,64
Lianah,F,100,64,0,64
Lilybelle,F,100,64,0,64
Lorree,F,100,64,0,64
Lurena,F,100,64,0,64
Maclovio,M,100,0,64,64
Maeryn,F,100,64,0,64
Maikayla,F,100,64,0,64
Malakie,M,100,0,64,64
Mallorey,F,100,64,0,64
Maraki,F,100,64,0,64
Mariabella,F,100,64,0,64
Marissia,F,100,64,0,64
Masiya,F,92,59,5,64
Mauria,F,100,64,0,64
Megahn,F,100,64,0,64
Melesio,M,100,0,64,64
Micco,M,100,0,64,64
Michelyn,F,100,64,0,64
Miyako,F,100,64,0,64
Modupe,F,100,64,0,64
Mohogany,F,100,64,0,64
Montey,M,100,0,64,64
Morayo,F,100,64,0,64
Mykai,M,100,0,64,64
Nadea,F,100,64,0,64
Naksh,M,100,0,64,64
Naraya,F,100,64,0,64
Nashid,M,100,0,64,64
Nashton,M,100,0,64,64
Natalin,F,100,64,0,64
Natayla,F,100,64,0,64
Nathanie,M,100,0,64,64
Necola,F,100,64,0,64
Nicoya,F,100,64,0,64
Nikitta,F,100,64,0,64
Niti,F,100,64,0,64
Nolawi,M,100,0,64,64
Obi,M,100,0,64,64
Oyinkansola,F,100,64,0,64
Payeton,F,100,64,0,64
Payslie,F,100,64,0,64
Phillp,M,100,0,64,64
Prosperity,F,100,64,0,64
Purva,F,100,64,0,64
Raijon,M,100,0,64,64
Rajae,M,66,22,42,64
Ranard,M,100,0,64,64
Rathana,M,80,13,51,64
Raunel,M,100,0,64,64
Renso,M,100,0,64,64
Riata,F,100,64,0,64
Rithy,M,100,0,64,64
Ritik,M,100,0,64,64
Rylend,M,100,0,64,64
Salathiel,M,100,0,64,64
Samil,M,100,0,64,64
Santresa,F,100,64,0,64
Sasuke,M,100,0,64,64
Shahmeer,M,100,0,64,64
Shahram,M,100,0,64,64
Shahrukh,M,100,0,64,64
Shail,M,100,0,64,64
Shalayne,F,100,64,0,64
Shaniqwa,F,100,64,0,64
Sharaine,F,100,64,0,64
Sharlyne,F,100,64,0,64
Shawnay,F,100,64,0,64
Shephanie,F,100,64,0,64
Shequilla,F,100,64,0,64
Shereta,F,100,64,0,64
Sheriden,F,100,64,0,64
Sherrise,F,100,64,0,64
Shuntell,F,100,64,0,64
Sohana,F,100,64,0,64
Solash,F,100,64,0,64
Soliyana,F,100,64,0,64
Srinivas,M,100,0,64,64
Sriyan,M,100,0,64,64
Taijuan,M,100,0,64,64
Tange,F,100,64,0,64
Tatelyn,F,100,64,0,64
Tayt,M,100,0,64,64
Tc,M,100,0,64,64
Tennelle,F,100,64,0,64
Topher,M,100,0,64,64
Traycen,M,100,0,64,64
Trayonna,F,100,64,0,64
Trevionne,M,100,0,64,64
Treyvone,M,100,0,64,64
Trimaine,M,100,0,64,64
Tristy,F,100,64,0,64
Trooper,M,100,0,64,64
Trulee,F,100,64,0,64
Tymara,F,100,64,0,64
Tyrica,F,100,64,0,64
Vendela,F,100,64,0,64
Vennela,F,100,64,0,64
Viona,F,100,64,0,64
Whittley,F,100,64,0,64
Wilberth,M,100,0,64,64
Xayvier,M,100,0,64,64
Yasseen,M,100,0,64,64
Yexalen,F,100,64,0,64
Zailah,F,100,64,0,64
Zandyr,M,100,0,64,64
Zareth,F,81,52,12,64
Zehava,F,100,64,0,64
Abou,M,100,0,63,63
Adelfo,M,100,0,63,63
Ahamed,M,100,0,63,63
Akaisha,F,100,63,0,63
Akelia,F,100,63,0,63
Aksh,M,100,0,63,63
Aleathia,F,100,63,0,63
Alexica,F,100,63,0,63
Alexyia,F,100,63,0,63
Allsion,F,100,63,0,63
Amalea,F,100,63,0,63
Amauris,M,100,0,63,63
Ambriella,F,100,63,0,63
Amond,M,100,0,63,63
Amorina,F,100,63,0,63
Anab,F,100,63,0,63
Anacleto,M,100,0,63,63
Anikin,M,100,0,63,63
Antoney,M,100,0,63,63
Anzlee,F,100,63,0,63
Arfa,F,100,63,0,63
Aristidis,M,100,0,63,63
Armone,M,84,10,53,63
Arnetra,F,100,63,0,63
Astria,F,100,63,0,63
Avedis,M,100,0,63,63
Avier,M,100,0,63,63
Ayansh,M,100,0,63,63
Belissa,F,100,63,0,63
Brahim,M,100,0,63,63
Brittannie,F,100,63,0,63
Bryahna,F,100,63,0,63
Bryndan,M,100,0,63,63
Brytnee,F,100,63,0,63
Cabrini,F,100,63,0,63
Caidynce,F,100,63,0,63
Camary,F,100,63,0,63
Canna,F,100,63,0,63
Ceonna,F,100,63,0,63
Chabely,F,100,63,0,63
Chamaine,F,100,63,0,63
Charmika,F,100,63,0,63
Chicquita,F,100,63,0,63
Cici,F,100,63,0,63
Cieanna,F,100,63,0,63
Clayvon,M,100,0,63,63
Colisha,F,100,63,0,63
Conlee,M,67,21,42,63
Consuello,F,100,63,0,63
Courteny,F,100,63,0,63
Dajahnae,F,100,63,0,63
Dakin,M,100,0,63,63
Dalesha,F,100,63,0,63
Dalonda,F,100,63,0,63
Damica,F,100,63,0,63
Daney,F,90,57,6,63
Danijela,F,100,63,0,63
Darshana,F,100,63,0,63
Desera,F,100,63,0,63
Devarion,M,100,0,63,63
Deya,F,100,63,0,63
Deyja,F,100,63,0,63
Dimitrious,M,100,0,63,63
Dinia,F,100,63,0,63
Doll,F,100,63,0,63
Doranne,F,100,63,0,63
Dorleen,F,100,63,0,63
Dosha,F,100,63,0,63
Druanne,F,100,63,0,63
Duanna,F,100,63,0,63
Ebubechukwu,M,100,0,63,63
Edilia,F,100,63,0,63
Elbia,F,100,63,0,63
Eragon,M,100,0,63,63
Erisa,F,100,63,0,63
Evalie,F,100,63,0,63
Everard,M,100,0,63,63
Evonte,M,100,0,63,63
Fahed,M,100,0,63,63
Faruq,M,100,0,63,63
Felise,F,100,63,0,63
Gen,M,90,6,57,63
Guhan,M,100,0,63,63
Hajira,F,100,63,0,63
Heywood,M,100,0,63,63
Hiilei,F,100,63,0,63
Hovanes,M,100,0,63,63
Hrithik,M,100,0,63,63
Hydie,F,100,63,0,63
Icyss,F,100,63,0,63
Ijah,F,90,57,6,63
Ilai,M,100,0,63,63
Jacaden,M,100,0,63,63
Jaella,F,100,63,0,63
Jansel,M,100,0,63,63
Jarika,F,100,63,0,63
Jaxxen,M,100,0,63,63
Jazae,F,100,63,0,63
Jazziel,M,100,0,63,63
Jeannia,F,100,63,0,63
Jenniah,F,100,63,0,63
Jessly,F,100,63,0,63
Joelys,F,100,63,0,63
Johnella,F,100,63,0,63
Johnnisha,F,100,63,0,63
Johnross,M,100,0,63,63
Jorita,F,100,63,0,63
Juanya,M,100,0,63,63
Kairav,M,100,0,63,63
Kamin,M,100,0,63,63
Kariel,F,73,46,17,63
Kathlen,F,100,63,0,63
Katrece,F,100,63,0,63
Kazoua,F,100,63,0,63
Kenneisha,F,100,63,0,63
Kenzly,F,100,63,0,63
Keshayla,F,100,63,0,63
Kess,F,100,63,0,63
Ketina,F,100,63,0,63
Keviana,F,100,63,0,63
Khloei,F,100,63,0,63
Kisean,M,100,0,63,63
Koua,M,100,0,63,63
Krayton,M,100,0,63,63
Kwali,M,100,0,63,63
Ladarrell,M,100,0,63,63
Lakenzie,F,100,63,0,63
Lamaj,M,100,0,63,63
Lameeka,F,100,63,0,63
Lamica,F,100,63,0,63
Laquonda,F,100,63,0,63
Laurian,F,100,63,0,63
Laurieanne,F,100,63,0,63
Lella,F,100,63,0,63
Leonell,M,100,0,63,63
Lisaanne,F,100,63,0,63
Loetta,F,100,63,0,63
Lorriann,F,100,63,0,63
Louretta,F,100,63,0,63
Lovelee,F,100,63,0,63
Luisfelipe,M,100,0,63,63
Luismario,M,100,0,63,63
Luticia,F,100,63,0,63
Lyall,M,100,0,63,63
Lyzbeth,F,100,63,0,63
Malcomb,M,100,0,63,63
Mamoudou,M,100,0,63,63
Marasia,F,100,63,0,63
Marcianna,F,100,63,0,63
Maritta,F,100,63,0,63
Mati,F,73,46,17,63
Mayreli,F,100,63,0,63
Maytte,F,100,63,0,63
Mialee,F,100,63,0,63
Milany,F,100,63,0,63
Milind,M,100,0,63,63
Monzerat,F,100,63,0,63
Najmah,F,100,63,0,63
Nakyiah,F,100,63,0,63
Naly,F,100,63,0,63
Natha,F,57,36,27,63
Nijee,M,100,0,63,63
Nyjai,F,100,63,0,63
Odeth,F,100,63,0,63
Oliviarose,F,100,63,0,63
Oluwadamilare,M,100,0,63,63
Oshen,M,92,5,58,63
Porshea,F,100,63,0,63
Prerana,F,100,63,0,63
Rahmon,M,100,0,63,63
Rajean,F,100,63,0,63
Ran,M,92,5,58,63
Ranyia,F,100,63,0,63
Raynald,M,100,0,63,63
Rayvion,M,100,0,63,63
Regene,F,100,63,0,63
Renalda,F,100,63,0,63
Rodrickus,M,100,0,63,63
Rosaelena,F,100,63,0,63
Roylee,M,100,0,63,63
Ruqaya,F,100,63,0,63
Samary,F,100,63,0,63
Satomi,F,100,63,0,63
Selenne,F,100,63,0,63
Sephira,F,100,63,0,63
Shaeley,F,100,63,0,63
Shailen,M,92,5,58,63
Shanitha,F,100,63,0,63
Shany,F,100,63,0,63
Sharlon,F,100,63,0,63
Shebra,F,100,63,0,63
Sherrina,F,100,63,0,63
Shresta,F,100,63,0,63
Signa,F,100,63,0,63
Siyah,F,100,63,0,63
Skii,F,100,63,0,63
Smitty,M,100,0,63,63
Sohrab,M,100,0,63,63
Suezette,F,100,63,0,63
Syesha,F,100,63,0,63
Tacha,F,100,63,0,63
Taelin,M,60,25,38,63
Tajuanna,F,100,63,0,63
Takeila,F,100,63,0,63
Tamarick,M,100,0,63,63
Tametria,F,100,63,0,63
Taquanna,F,100,63,0,63
Tearah,F,100,63,0,63
Thaine,M,100,0,63,63
Thelia,F,100,63,0,63
Thena,F,100,63,0,63
Theora,F,100,63,0,63
Timberlee,F,100,63,0,63
Timira,F,100,63,0,63
Tishanna,F,100,63,0,63
Torell,M,100,0,63,63
Treesa,F,100,63,0,63
Trinidi,F,100,63,0,63
Tulani,F,100,63,0,63
Tulip,F,100,63,0,63
Twania,F,100,63,0,63
Tyarra,F,100,63,0,63
Tykiera,F,100,63,0,63
Tymar,M,100,0,63,63
Tyreona,F,100,63,0,63
Valincia,F,100,63,0,63
Valoria,F,100,63,0,63
Varetta,F,100,63,0,63
Viral,M,100,0,63,63
Walterine,F,100,63,0,63
Williamson,M,100,0,63,63
Xareni,F,100,63,0,63
Xyon,M,89,7,56,63
Yichen,M,67,21,42,63
Zackarey,M,100,0,63,63
Zeynab,F,100,63,0,63
Zianne,F,100,63,0,63
Zlatan,M,100,0,63,63
Zykeem,M,100,0,63,63
Achaia,F,100,62,0,62
Ahmyah,F,100,62,0,62
Aidenjames,M,100,0,62,62
Ailton,M,100,0,62,62
Akiem,M,100,0,62,62
Alesi,F,100,62,0,62
Alexzavier,M,100,0,62,62
Allani,F,100,62,0,62
Alleya,F,100,62,0,62
Almina,F,100,62,0,62
Alysiana,F,100,62,0,62
Amillya,F,100,62,0,62
Analyah,F,100,62,0,62
Anan,M,92,5,57,62
Anastasio,M,100,0,62,62
Ariv,M,100,0,62,62
Ariyel,F,100,62,0,62
Ariz,M,100,0,62,62
Arriyanna,F,100,62,0,62
Artice,M,84,10,52,62
Aryaa,F,100,62,0,62
Ashir,M,100,0,62,62
Autumne,F,100,62,0,62
Avyonna,F,100,62,0,62
Azarya,F,84,52,10,62
Bayly,F,82,51,11,62
Berania,F,100,62,0,62
Bohden,M,100,0,62,62
Brynnlie,F,100,62,0,62
Bryttney,F,100,62,0,62
Byren,M,100,0,62,62
Calven,M,100,0,62,62
Candid,F,100,62,0,62
Ceriah,F,100,62,0,62
Charl,F,79,49,13,62
Charnika,F,100,62,0,62
Chasin,M,100,0,62,62
Chennel,F,100,62,0,62
Cherre,F,100,62,0,62
Chestine,F,100,62,0,62
Chontel,F,100,62,0,62
Chrysten,F,100,62,0,62
Colleena,F,100,62,0,62
Constant,M,58,26,36,62
Cordarrel,M,100,0,62,62
Courvoisier,M,100,0,62,62
Cristol,F,100,62,0,62
Crystalmarie,F,100,62,0,62
Dak,M,100,0,62,62
Damek,M,100,0,62,62
Dannya,F,100,62,0,62
Deazia,F,100,62,0,62
Dereonna,F,100,62,0,62
Desjuan,M,100,0,62,62
Dezra,F,100,62,0,62
Dhruti,F,100,62,0,62
Donnamaria,F,100,62,0,62
Dorethia,F,100,62,0,62
Dorna,F,100,62,0,62
Duilio,M,100,0,62,62
Eddye,F,90,56,6,62
Edrie,F,100,62,0,62
Elasha,F,100,62,0,62
Elica,F,100,62,0,62
Epic,M,81,12,50,62
Ernisha,F,100,62,0,62
Estanislado,M,100,0,62,62
Eudelia,F,100,62,0,62
Eulis,M,100,0,62,62
Faaris,M,100,0,62,62
Faatima,F,100,62,0,62
Faithanne,F,100,62,0,62
Fardowsa,F,100,62,0,62
Farooq,M,100,0,62,62
Fatisha,F,100,62,0,62
Fedrick,M,100,0,62,62
Festus,M,100,0,62,62
Filomeno,M,100,0,62,62
Finnick,M,100,0,62,62
Fleeta,F,100,62,0,62
Francesa,F,100,62,0,62
Garlon,M,100,0,62,62
Gjon,M,100,0,62,62
Glanda,F,100,62,0,62
Guerin,M,100,0,62,62
Helem,F,100,62,0,62
Heyli,F,100,62,0,62
Jameon,M,100,0,62,62
Jashley,F,100,62,0,62
Jatorian,M,100,0,62,62
Jerelene,F,100,62,0,62
Jerriyah,F,100,62,0,62
Jeson,M,100,0,62,62
Jeyli,F,100,62,0,62
Jlee,F,100,62,0,62
Jobanny,M,100,0,62,62
Joffre,M,100,0,62,62
Johnedward,M,100,0,62,62
Johniece,F,100,62,0,62
Joliana,F,100,62,0,62
Jolicia,F,100,62,0,62
Journe,F,100,62,0,62
Jrake,M,100,0,62,62
Julizza,F,100,62,0,62
Kabe,M,100,0,62,62
Kadelyn,F,100,62,0,62
Kaiea,M,92,5,57,62
Kaiven,M,100,0,62,62
Kaiyon,M,100,0,62,62
Karema,F,100,62,0,62
Katalyn,F,100,62,0,62
Kateena,F,100,62,0,62
Kateryna,F,100,62,0,62
Katyra,F,100,62,0,62
Kayzlee,F,100,62,0,62
Keidan,M,100,0,62,62
Kenae,F,100,62,0,62
Kerington,F,100,62,0,62
Kersti,F,100,62,0,62
Keyaria,F,100,62,0,62
Kimarion,M,100,0,62,62
Kimberl,F,100,62,0,62
Kivon,M,100,0,62,62
Kiylah,F,100,62,0,62
Kollyns,F,100,62,0,62
Koury,M,100,0,62,62
Kupono,M,100,0,62,62
Kyrstan,F,100,62,0,62
Labib,M,100,0,62,62
Lacara,F,100,62,0,62
Ladarryl,M,100,0,62,62
Laithan,M,100,0,62,62
Laquia,F,100,62,0,62
Latwan,M,100,0,62,62
Laurencia,F,100,62,0,62
Law,M,100,0,62,62
Lecretia,F,100,62,0,62
Lemya,F,100,62,0,62
Leory,M,100,0,62,62
Libia,F,100,62,0,62
Lizvet,F,100,62,0,62
Luvia,F,100,62,0,62
Maliaka,F,100,62,0,62
Mance,M,100,0,62,62
Mariaceleste,F,100,62,0,62
Markiah,F,100,62,0,62
Mckinze,F,100,62,0,62
Melven,M,100,0,62,62
Mette,F,100,62,0,62
Miloh,M,100,0,62,62
Monyae,F,92,57,5,62
Najmo,F,100,62,0,62
Nargis,F,100,62,0,62
Narya,F,100,62,0,62
Nazair,M,100,0,62,62
Neera,F,100,62,0,62
Nikeia,F,100,62,0,62
Nyimah,F,100,62,0,62
Omarrion,M,100,0,62,62
Pink,M,92,5,57,62
Pradeep,M,100,0,62,62
Quanell,M,100,0,62,62
Rashema,F,100,62,0,62
Rashena,F,100,62,0,62
Raylinn,F,100,62,0,62
Rekia,F,100,62,0,62
Resean,M,100,0,62,62
Rim,F,100,62,0,62
Roberth,M,100,0,62,62
Rochanda,F,100,62,0,62
Rolande,F,100,62,0,62
Rosmary,F,100,62,0,62
Rubert,M,100,0,62,62
Ruther,F,100,62,0,62
Sache,F,100,62,0,62
Saidi,F,100,62,0,62
Sakoya,F,100,62,0,62
Samentha,F,100,62,0,62
Saylah,F,100,62,0,62
Sender,M,100,0,62,62
Shakai,M,92,5,57,62
Shaneal,F,100,62,0,62
Shankar,M,100,0,62,62
Shenoa,F,100,62,0,62
Shernell,F,100,62,0,62
Shevette,F,100,62,0,62
Shiesha,F,100,62,0,62
Shyia,F,100,62,0,62
Siennah,F,100,62,0,62
Skyelyn,F,100,62,0,62
Somnang,M,100,0,62,62
Sourish,M,100,0,62,62
Staria,F,100,62,0,62
Steed,M,100,0,62,62
Syair,M,100,0,62,62
Tahliyah,F,100,62,0,62
Taigen,F,58,36,26,62
Talton,M,100,0,62,62
Tamyrah,F,100,62,0,62
Teighan,F,92,57,5,62
Telford,M,100,0,62,62
Thales,M,100,0,62,62
Tikita,F,100,62,0,62
Tomaz,M,100,0,62,62
Trafton,M,100,0,62,62
Trejuan,M,100,0,62,62
Treyshon,M,100,0,62,62
Trinadee,F,100,62,0,62
Tyishia,F,100,62,0,62
Tymeer,M,100,0,62,62
Vallory,F,100,62,0,62
Vannah,F,100,62,0,62
Verlisa,F,100,62,0,62
Vonette,F,100,62,0,62
Voula,F,100,62,0,62
Walther,M,100,0,62,62
Waynesha,F,100,62,0,62
Wilmon,M,100,0,62,62
Yamilee,F,100,62,0,62
Yanisa,F,100,62,0,62
Yavuz,M,100,0,62,62
Yenesis,F,100,62,0,62
Yudit,F,100,62,0,62
Yuleni,F,100,62,0,62
Yzabelle,F,100,62,0,62
Zanasia,F,100,62,0,62
Zareah,F,100,62,0,62
Zareya,F,100,62,0,62
Zaryia,F,100,62,0,62
Zelphia,F,100,62,0,62
Zimere,M,100,0,62,62
Aashika,F,100,61,0,61
Adaysha,F,100,61,0,61
Adekunle,M,100,0,61,61
Aftin,F,100,61,0,61
Ahnesty,F,100,61,0,61
Airyonna,F,100,61,0,61
Alfonsa,M,100,0,61,61
Alizzon,F,100,61,0,61
Amandine,F,100,61,0,61
Amiir,M,100,0,61,61
Amry,F,100,61,0,61
Anahla,F,100,61,0,61
Anetria,F,100,61,0,61
Aniruddh,M,100,0,61,61
Anorah,F,100,61,0,61
Antero,M,100,0,61,61
Arieh,M,100,0,61,61
Ark,M,100,0,61,61
Arth,M,100,0,61,61
Ashutosh,M,100,0,61,61
Avagail,F,100,61,0,61
Avalin,F,100,61,0,61
Avanni,F,100,61,0,61
Avarae,F,100,61,0,61
Bandon,M,100,0,61,61
Beanca,F,100,61,0,61
Benen,M,100,0,61,61
Beniah,M,100,0,61,61
Bernardina,F,100,61,0,61
Beyounce,F,100,61,0,61
Bilan,F,100,61,0,61
Braeson,M,100,0,61,61
Braydee,F,92,56,5,61
Bristyl,F,100,61,0,61
Britlee,F,100,61,0,61
Byrd,M,100,0,61,61
Caragh,F,100,61,0,61
Careli,F,100,61,0,61
Carlisia,F,100,61,0,61
Carmi,F,84,51,10,61
Casady,F,100,61,0,61
Chanay,F,100,61,0,61
Charlisha,F,100,61,0,61
Chauntay,F,100,61,0,61
Chenay,F,100,61,0,61
Chloeanne,F,100,61,0,61
Christl,F,100,61,0,61
Christpoher,M,100,0,61,61
Claris,F,100,61,0,61
Conna,F,100,61,0,61
Crosley,M,69,19,42,61
Daci,F,100,61,0,61
Daegen,M,100,0,61,61
Daire,M,90,6,55,61
Damyiah,F,100,61,0,61
Danaiya,F,100,61,0,61
Dandrae,M,100,0,61,61
Dashonna,F,100,61,0,61
Daxson,M,100,0,61,61
Demetries,M,100,0,61,61
Deoni,F,100,61,0,61
Derita,F,100,61,0,61
Deriyah,F,100,61,0,61
Deshanta,F,100,61,0,61
Desten,M,100,0,61,61
Dhillon,M,100,0,61,61
Doss,M,100,0,61,61
Ece,F,100,61,0,61
Eliav,M,100,0,61,61
Elyon,M,100,0,61,61
Emannuel,M,100,0,61,61
Emilian,M,100,0,61,61
Emmerich,M,100,0,61,61
Eriverto,M,100,0,61,61
Erminio,M,100,0,61,61
Esti,F,100,61,0,61
Frederika,F,100,61,0,61
Geetika,F,100,61,0,61
Genni,F,100,61,0,61
Giliana,F,100,61,0,61
Graycin,F,54,33,28,61
Gwendy,F,100,61,0,61
Halil,M,100,0,61,61
Harla,F,100,61,0,61
Hephzibah,F,100,61,0,61
Humna,F,100,61,0,61
Iliany,F,100,61,0,61
Imri,M,77,14,47,61
Ioana,F,100,61,0,61
Iokepa,M,100,0,61,61
Iracema,F,100,61,0,61
Jacai,M,100,0,61,61
Jadier,M,100,0,61,61
Jairy,F,100,61,0,61
Jakyren,M,100,0,61,61
Jalei,F,100,61,0,61
Jaleiyah,F,100,61,0,61
Jamariyah,F,100,61,0,61
Jamieon,M,100,0,61,61
Janazia,F,100,61,0,61
Jashira,F,100,61,0,61
Jasyah,M,70,18,43,61
Jayleena,F,100,61,0,61
Jaymien,M,100,0,61,61
Jeiry,F,100,61,0,61
Johnwesley,M,100,0,61,61
Jordell,M,100,0,61,61
Judithann,F,100,61,0,61
Kabrea,F,100,61,0,61
Kailena,F,100,61,0,61
Kaleiyah,F,100,61,0,61
Kamareon,M,100,0,61,61
Karanvir,M,100,0,61,61
Kashari,F,100,61,0,61
Keierra,F,100,61,0,61
Kerly,F,100,61,0,61
Keyston,M,100,0,61,61
Khailee,F,100,61,0,61
Kiandria,F,100,61,0,61
Kimbal,M,92,5,56,61
Kimeka,F,100,61,0,61
Krosby,M,92,5,56,61
Kyandre,M,100,0,61,61
Kyheem,M,100,0,61,61
Ladaija,F,100,61,0,61
Laderius,M,100,0,61,61
Lakima,F,100,61,0,61
Lataunya,F,100,61,0,61
Lativia,F,100,61,0,61
Latreshia,F,100,61,0,61
Laverta,F,100,61,0,61
Lavin,M,100,0,61,61
Lonisha,F,100,61,0,61
Lonnetta,F,100,61,0,61
Lonza,M,100,0,61,61
Lorijean,F,100,61,0,61
Luara,F,100,61,0,61
Lynnleigh,F,100,61,0,61
Macayle,F,92,56,5,61
Madeeha,F,100,61,0,61
Makaveli,M,100,0,61,61
Malayzia,F,100,61,0,61
Marcellius,M,100,0,61,61
Marsa,F,100,61,0,61
Marsden,M,100,0,61,61
Mataeo,M,100,0,61,61
Maysoon,F,100,61,0,61
Mckenleigh,F,100,61,0,61
Mckinsley,F,100,61,0,61
Mckyle,M,100,0,61,61
Mende,F,100,61,0,61
Mercedees,F,100,61,0,61
Mian,M,92,5,56,61
Micheil,M,100,0,61,61
Miliyah,F,100,61,0,61
Milon,M,100,0,61,61
Milyn,F,100,61,0,61
Mireyah,F,100,61,0,61
Moyinoluwa,F,100,61,0,61
Myrella,F,100,61,0,61
Nanako,F,100,61,0,61
Naoko,F,100,61,0,61
Nareh,F,100,61,0,61
Narjis,F,100,61,0,61
Nashua,M,100,0,61,61
Nathifa,F,100,61,0,61
Nickita,F,66,40,21,61
Nilaya,F,100,61,0,61
Nohelani,F,100,61,0,61
Noralyn,F,100,61,0,61
Nthony,M,100,0,61,61
Oluwasemilore,M,57,26,35,61
Onesti,F,100,61,0,61
Penda,F,100,61,0,61
Persis,F,100,61,0,61
Pistol,M,77,14,47,61
Raelan,F,92,56,5,61
Ravenne,F,100,61,0,61
Reeanna,F,100,61,0,61
Rejina,F,100,61,0,61
Revanth,M,100,0,61,61
Ronnett,F,100,61,0,61
Roshawna,F,100,61,0,61
Ruhani,F,100,61,0,61
Rutilio,M,100,0,61,61
Ryleeann,F,100,61,0,61
Saadiya,F,100,61,0,61
Sacora,F,100,61,0,61
Santita,F,100,61,0,61
Saphia,F,100,61,0,61
Seanne,F,100,61,0,61
Severn,M,100,0,61,61
Shabre,F,100,61,0,61
Shadara,F,100,61,0,61
Shalaunda,F,100,61,0,61
Shantanique,F,100,61,0,61
Shaymus,M,100,0,61,61
Shuntavia,F,100,61,0,61
Shuntia,F,100,61,0,61
Shynice,F,100,61,0,61
Sobia,F,100,61,0,61
Symphoni,F,100,61,0,61
Synda,F,100,61,0,61
Taavi,M,100,0,61,61
Tabb,M,100,0,61,61
Taigan,F,92,56,5,61
Takerra,F,100,61,0,61
Tamberlyn,F,100,61,0,61
Tamiki,F,100,61,0,61
Tanganika,F,100,61,0,61
Tanor,M,100,0,61,61
Tatisha,F,100,61,0,61
Tauri,F,100,61,0,61
Temara,F,100,61,0,61
Tennis,M,100,0,61,61
Thaer,M,100,0,61,61
Thersia,F,100,61,0,61
Theta,F,100,61,0,61
Tiant,M,100,0,61,61
Tnia,F,100,61,0,61
Tomma,F,100,61,0,61
Toron,M,100,0,61,61
Traeson,M,100,0,61,61
Tramar,M,100,0,61,61
Trong,M,100,0,61,61
Tyrees,M,100,0,61,61
Vetta,F,100,61,0,61
Victorina,F,100,61,0,61
Vung,F,100,61,0,61
Xylah,F,100,61,0,61
Zenaya,F,100,61,0,61
Zriyah,F,100,61,0,61
Abas,M,100,0,60,60
Achillies,M,100,0,60,60
Adryel,M,100,0,60,60
Aeralyn,F,100,60,0,60
Agape,F,83,50,10,60
Aidaly,F,100,60,0,60
Aitan,M,100,0,60,60
Akeiba,F,100,60,0,60
Akire,F,100,60,0,60
Alaria,F,100,60,0,60
Alieah,F,100,60,0,60
Alira,F,100,60,0,60
Alroy,M,100,0,60,60
Amonti,M,92,5,55,60
Analaya,F,100,60,0,60
Aneita,F,100,60,0,60
Angellynn,F,100,60,0,60
Annajulia,F,100,60,0,60
Annitta,F,100,60,0,60
Anokhi,F,100,60,0,60
Antoninette,F,100,60,0,60
Anyra,F,100,60,0,60
Baruc,M,100,0,60,60
Blimi,F,100,60,0,60
Bradely,M,100,0,60,60
Braeley,F,100,60,0,60
Brandilee,F,100,60,0,60
Branston,M,100,0,60,60
Brycelynn,F,100,60,0,60
Caleel,M,100,0,60,60
Calene,F,100,60,0,60
Candela,F,100,60,0,60
Careena,F,100,60,0,60
Carneshia,F,100,60,0,60
Catalyna,F,100,60,0,60
Cayd,M,100,0,60,60
Ceylin,F,100,60,0,60
Chaia,F,100,60,0,60
Chanan,M,100,0,60,60
Charletha,F,100,60,0,60
Charrie,F,100,60,0,60
Chou,M,100,0,60,60
Christne,F,100,60,0,60
Cimberly,F,100,60,0,60
Cleto,M,100,0,60,60
Constancia,F,100,60,0,60
Cordelro,M,100,0,60,60
Corrisa,F,100,60,0,60
Coti,F,82,49,11,60
Curtistine,F,100,60,0,60
Cyani,F,100,60,0,60
Cynthie,F,100,60,0,60
Cynthis,F,100,60,0,60
Dacen,M,100,0,60,60
Dazja,F,100,60,0,60
Dekoda,M,82,11,49,60
Demtrius,M,100,0,60,60
Deshawnda,F,100,60,0,60
Develle,M,100,0,60,60
Dheeraj,M,100,0,60,60
Diany,F,100,60,0,60
Dinnis,M,100,0,60,60
Dmarius,M,100,0,60,60
Dodger,M,100,0,60,60
Donnivan,M,100,0,60,60
Drishti,F,100,60,0,60
Ebunoluwa,F,100,60,0,60
Edrees,M,100,0,60,60
Emersynn,F,100,60,0,60
Emmauel,M,100,0,60,60
Emone,F,92,55,5,60
Evanee,F,100,60,0,60
Everhett,M,100,0,60,60
Evoleht,F,100,60,0,60
Fatiha,F,100,60,0,60
Galya,F,100,60,0,60
Gevorg,M,100,0,60,60
Gianne,F,100,60,0,60
Giezi,M,100,0,60,60
Gor,M,100,0,60,60
Grasyn,M,65,21,39,60
Graviela,F,100,60,0,60
Gurkirat,M,90,6,54,60
Havanah,F,100,60,0,60
Henritta,F,100,60,0,60
Henya,F,100,60,0,60
Hezakiah,M,100,0,60,60
Hobson,M,100,0,60,60
Hollianne,F,100,60,0,60
Ibraham,M,100,0,60,60
Ilyaas,M,100,0,60,60
Inaara,F,100,60,0,60
Iniyah,F,100,60,0,60
Isiaah,M,100,0,60,60
Jackston,M,100,0,60,60
Jahmez,M,100,0,60,60
Jakyron,M,100,0,60,60
Jalissia,F,100,60,0,60
Jaquitta,F,100,60,0,60
Jarvon,M,100,0,60,60
Jasara,F,100,60,0,60
Jaycey,F,100,60,0,60
Jayin,M,100,0,60,60
Jazyah,F,100,60,0,60
Jenavive,F,100,60,0,60
Jenique,F,100,60,0,60
Jerisha,F,100,60,0,60
Jerusalen,F,100,60,0,60
Jessicaanne,F,100,60,0,60
Jezebelle,F,100,60,0,60
Johniqua,F,100,60,0,60
Josely,F,100,60,0,60
Jostyn,M,80,12,48,60
Julianny,F,100,60,0,60
Kahdijah,F,100,60,0,60
Kalix,M,100,0,60,60
Katanna,F,100,60,0,60
Kattaleya,F,100,60,0,60
Keicha,F,100,60,0,60
Kerion,M,100,0,60,60
Kimyada,F,100,60,0,60
Kineta,F,100,60,0,60
Kitina,F,100,60,0,60
Korinn,F,100,60,0,60
Kycen,M,100,0,60,60
Kyrstie,F,100,60,0,60
Kyston,M,100,0,60,60
Ladislao,M,100,0,60,60
Lalana,F,100,60,0,60
Laqunda,F,100,60,0,60
Larya,F,100,60,0,60
Lashya,F,100,60,0,60
Laurna,F,100,60,0,60
Lemario,M,100,0,60,60
Leniah,F,100,60,0,60
Lenorris,M,100,0,60,60
Lessley,F,90,54,6,60
Ligaya,F,100,60,0,60
Lillyth,F,100,60,0,60
Lisl,F,100,60,0,60
Lynnita,F,100,60,0,60
Madalee,F,100,60,0,60
Makyna,F,100,60,0,60
Malli,F,100,60,0,60
Marialis,F,100,60,0,60
Marialuiza,F,100,60,0,60
Marilyne,F,100,60,0,60
Marliss,F,100,60,0,60
Marylon,F,100,60,0,60
Maybel,F,100,60,0,60
Mekiyah,F,100,60,0,60
Mendie,F,100,60,0,60
Mikayle,F,92,55,5,60
Mionna,F,100,60,0,60
Mishaal,F,100,60,0,60
Mizani,F,100,60,0,60
Momen,M,100,0,60,60
Monike,F,100,60,0,60
Monish,M,100,0,60,60
Monque,F,100,60,0,60
Mylynn,F,100,60,0,60
Nadyah,F,100,60,0,60
Nasheed,M,100,0,60,60
Nashika,F,100,60,0,60
Neidra,F,100,60,0,60
Nevaan,M,100,0,60,60
Orpheus,M,100,0,60,60
Paelyn,F,100,60,0,60
Pauleen,F,100,60,0,60
Phyillis,F,100,60,0,60
Piera,F,100,60,0,60
Pranati,F,100,60,0,60
Preeya,F,100,60,0,60
Quadree,M,100,0,60,60
Quintarious,M,100,0,60,60
Raelea,F,100,60,0,60
Raionna,F,100,60,0,60
Raliyah,F,100,60,0,60
Ramere,M,100,0,60,60
Rebeccalynn,F,100,60,0,60
Reisa,F,100,60,0,60
Ridha,F,73,44,16,60
Rodny,M,100,0,60,60
Rodrico,M,100,0,60,60
Rossanna,F,100,60,0,60
Ryzen,M,100,0,60,60
Sahand,M,100,0,60,60
Sameena,F,100,60,0,60
Santhosh,M,100,0,60,60
Santiana,F,100,60,0,60
Savvas,M,100,0,60,60
Shaleka,F,100,60,0,60
Shaletta,F,100,60,0,60
Shaneya,F,100,60,0,60
Shenekia,F,100,60,0,60
Sherlie,F,100,60,0,60
Shilee,F,100,60,0,60
Shivaun,F,100,60,0,60
Shylyn,F,100,60,0,60
Siclali,F,100,60,0,60
Smera,F,100,60,0,60
Solenne,F,100,60,0,60
Sonakshi,F,100,60,0,60
Sophira,F,100,60,0,60
Sriman,M,100,0,60,60
Stellah,F,100,60,0,60
Suetta,F,100,60,0,60
Tadashi,M,100,0,60,60
Takala,F,100,60,0,60
Tamekka,F,100,60,0,60
Tanesa,F,100,60,0,60
Tanette,F,100,60,0,60
Taryll,M,100,0,60,60
Taylre,F,100,60,0,60
Tiffin,F,100,60,0,60
Tilia,F,100,60,0,60
Tilley,F,100,60,0,60
Tinea,F,100,60,0,60
Tisheena,F,100,60,0,60
Toccarra,F,100,60,0,60
Torya,F,100,60,0,60
Trese,F,100,60,0,60
Trevonta,M,100,0,60,60
Trintin,M,100,0,60,60
Tronda,F,100,60,0,60
Twanya,F,100,60,0,60
Tydrick,M,100,0,60,60
Tyrielle,F,100,60,0,60
Ulrica,F,100,60,0,60
Vaani,F,100,60,0,60
Vedder,M,100,0,60,60
Vincy,F,100,60,0,60
Yahdira,F,100,60,0,60
Yaisa,F,100,60,0,60
Yama,M,100,0,60,60
Yariza,F,100,60,0,60
Yasira,F,100,60,0,60
Yina,F,100,60,0,60
Yvana,F,100,60,0,60
Zakaya,F,100,60,0,60
Zakye,M,100,0,60,60
Zayneb,F,100,60,0,60
Zeph,M,100,0,60,60
Zhyon,M,80,12,48,60
Zoiey,F,100,60,0,60
Zyien,M,80,12,48,60
Adelee,F,100,59,0,59
Adrine,F,92,54,5,59
Ahnesti,F,100,59,0,59
Airik,M,100,0,59,59
Alanny,F,100,59,0,59
Aldina,F,100,59,0,59
Aleijah,F,100,59,0,59
Aliveah,F,100,59,0,59
Amadis,F,100,59,0,59
Amsi,F,100,59,0,59
Andersyn,F,100,59,0,59
Anjalina,F,100,59,0,59
Ankitha,F,100,59,0,59
Antonin,M,100,0,59,59
Archita,F,100,59,0,59
Arvetta,F,100,59,0,59
Ashyr,M,100,0,59,59
Asly,F,100,59,0,59
Athens,M,88,7,52,59
Avalene,F,100,59,0,59
Avanish,M,100,0,59,59
Ayiden,M,100,0,59,59
Ayza,F,100,59,0,59
Azalyn,F,100,59,0,59
Azharia,F,100,59,0,59
Bartek,M,100,0,59,59
Batu,M,100,0,59,59
Benecio,M,100,0,59,59
Brayanna,F,100,59,0,59
Brazen,M,100,0,59,59
Brownie,M,58,25,34,59
Burkley,M,54,27,32,59
Caelee,F,100,59,0,59
Cail,M,100,0,59,59
Camaren,M,92,5,54,59
Carolos,M,100,0,59,59
Caryle,F,100,59,0,59
Cashlynn,F,100,59,0,59
Chairty,F,100,59,0,59
Chaniah,F,100,59,0,59
Chaquana,F,100,59,0,59
Charlestine,F,100,59,0,59
Chaselynn,F,100,59,0,59
Chenee,F,100,59,0,59
Cheniqua,F,100,59,0,59
Cherye,F,100,59,0,59
Chinedum,M,100,0,59,59
Chukwuka,M,100,0,59,59
Claxton,M,100,0,59,59
Cloris,F,100,59,0,59
Coburn,M,100,0,59,59
Colorado,M,100,0,59,59
Corney,M,100,0,59,59
Cortlandt,M,100,0,59,59
Courtlin,M,78,13,46,59
Cristle,F,100,59,0,59
Crystalina,F,100,59,0,59
Cuinn,M,100,0,59,59
Daimeon,M,100,0,59,59
Dalontae,M,100,0,59,59
Danaijah,F,100,59,0,59
Danaria,F,100,59,0,59
Danyeal,F,100,59,0,59
Datwan,M,100,0,59,59
Delmonte,M,100,0,59,59
Demeatrice,F,69,41,18,59
Dennies,M,100,0,59,59
Dequawn,M,100,0,59,59
Dimon,F,83,49,10,59
Dionysios,M,100,0,59,59
Doneen,F,100,59,0,59
Durene,F,100,59,0,59
Dystiny,F,100,59,0,59
Edrik,M,100,0,59,59
Emilce,F,100,59,0,59
Emit,M,100,0,59,59
Emmilia,F,100,59,0,59
Esraa,F,100,59,0,59
Ezmae,F,100,59,0,59
Gad,M,100,0,59,59
Galan,M,100,0,59,59
Graceland,F,100,59,0,59
Hasmik,F,100,59,0,59
Hatem,M,100,0,59,59
Izea,M,100,0,59,59
Jacarie,M,100,0,59,59
Jacobee,M,100,0,59,59
Jais,M,100,0,59,59
Jallen,M,100,0,59,59
Janaeya,F,100,59,0,59
Jaqlyn,F,100,59,0,59
Jaquila,F,100,59,0,59
Jarrah,F,92,54,5,59
Jarryn,M,100,0,59,59
Jaser,M,100,0,59,59
Javiar,M,100,0,59,59
Jaxxson,M,100,0,59,59
Jaylise,F,100,59,0,59
Jecaryous,M,100,0,59,59
Jela,F,100,59,0,59
Jeremee,M,100,0,59,59
Jeydan,M,100,0,59,59
Jocey,F,100,59,0,59
Joevanni,M,100,0,59,59
Johnanna,F,100,59,0,59
Joshva,M,100,0,59,59
Juelle,F,73,43,16,59
Juliona,F,100,59,0,59
Kaien,M,100,0,59,59
Kalysa,F,100,59,0,59
Kamarra,F,100,59,0,59
Kamra,F,100,59,0,59
Kayal,F,100,59,0,59
Kennison,F,76,45,14,59
Kerney,M,100,0,59,59
Ketzaly,F,100,59,0,59
Kimiah,F,100,59,0,59
Kingjames,M,100,0,59,59
Kreston,M,100,0,59,59
Krisan,F,100,59,0,59
Krissandra,F,100,59,0,59
Kristilyn,F,100,59,0,59
Kura,F,100,59,0,59
Kymere,M,100,0,59,59
Kytzia,F,100,59,0,59
Lamere,M,100,0,59,59
Lanija,F,100,59,0,59
Leilanny,F,100,59,0,59
Liesha,F,100,59,0,59
Lilana,F,100,59,0,59
Loui,M,100,0,59,59
Louri,F,100,59,0,59
Luciann,F,100,59,0,59
Lurae,F,100,59,0,59
Lylliana,F,100,59,0,59
Lyndzi,F,100,59,0,59
Macari,M,81,11,48,59
Makhari,M,80,12,47,59
Maleiya,F,100,59,0,59
Malikiah,M,100,0,59,59
Mang,M,73,16,43,59
Marlaya,F,100,59,0,59
Marlia,F,100,59,0,59
Mattson,M,100,0,59,59
Maxten,M,100,0,59,59
Meerab,F,100,59,0,59
Merridith,F,100,59,0,59
Michaelanne,F,100,59,0,59
Midajah,F,100,59,0,59
Mikeshia,F,100,59,0,59
Mohamadou,M,100,0,59,59
Moni,F,100,59,0,59
Monisa,F,100,59,0,59
Mykail,M,100,0,59,59
Mylz,M,100,0,59,59
Nawaal,F,100,59,0,59
Naydelyn,F,100,59,0,59
Neriya,F,100,59,0,59
Nishawn,M,100,0,59,59
Nitisha,F,100,59,0,59
Noris,F,73,43,16,59
Norrin,M,100,0,59,59
Nurah,F,100,59,0,59
Nyelah,F,100,59,0,59
Nyx,F,90,53,6,59
Oyuky,F,100,59,0,59
Pavle,M,100,0,59,59
Phantasia,F,100,59,0,59
Preshus,F,100,59,0,59
Quavis,M,100,0,59,59
Quendarius,M,100,0,59,59
Quinzell,M,100,0,59,59
Rakiah,F,100,59,0,59
Ranea,F,100,59,0,59
Ranon,M,100,0,59,59
Raqual,F,100,59,0,59
Rashann,M,100,0,59,59
Rason,M,100,0,59,59
Ravion,M,80,12,47,59
Ravynn,F,100,59,0,59
Rennard,M,100,0,59,59
Rhondi,F,100,59,0,59
Riven,M,58,25,34,59
Roblyn,F,100,59,0,59
Roey,M,100,0,59,59
Rogen,M,100,0,59,59
Royanne,F,100,59,0,59
Saory,F,100,59,0,59
Sargon,M,100,0,59,59
Seandra,F,100,59,0,59
Semiah,F,100,59,0,59
Sephiroth,M,100,0,59,59
Shaaron,F,100,59,0,59
Shakemia,F,100,59,0,59
Shamikia,F,100,59,0,59
Shanedra,F,100,59,0,59
Shanielle,F,100,59,0,59
Shanigua,F,100,59,0,59
Shankia,F,100,59,0,59
Shantese,F,100,59,0,59
Sharunda,F,100,59,0,59
Shawntrell,F,86,51,8,59
Shelvin,M,100,0,59,59
Shemeeka,F,100,59,0,59
Shiara,F,100,59,0,59
Soliel,F,100,59,0,59
Soumil,M,100,0,59,59
Soyini,F,100,59,0,59
Stephaniemarie,F,100,59,0,59
Sydnye,F,100,59,0,59
Tajanee,F,100,59,0,59
Tajanique,F,100,59,0,59
Tameah,F,100,59,0,59
Tameki,F,100,59,0,59
Tanaija,F,100,59,0,59
Tanikia,F,100,59,0,59
Tateyana,F,100,59,0,59
Taylir,F,100,59,0,59
Tayva,F,100,59,0,59
Tekayla,F,100,59,0,59
Teriq,M,100,0,59,59
Thamas,M,100,0,59,59
Tiairra,F,100,59,0,59
Timiah,F,100,59,0,59
Toronda,F,100,59,0,59
Toscha,F,100,59,0,59
Trenesha,F,100,59,0,59
Trennon,M,100,0,59,59
Trynitee,F,100,59,0,59
Tywann,M,100,0,59,59
Ulyana,F,100,59,0,59
Veronnica,F,100,59,0,59
Via,F,100,59,0,59
Virat,M,100,0,59,59
Whitleigh,F,100,59,0,59
Woods,M,100,0,59,59
Yanellie,F,100,59,0,59
Yuepheng,M,100,0,59,59
Zahriah,F,100,59,0,59
Zaivion,M,100,0,59,59
Zakaiya,F,100,59,0,59
Zakyria,F,100,59,0,59
Abbiegale,F,100,58,0,58
Achille,M,100,0,58,58
Adarryl,M,100,0,58,58
Adelyna,F,100,58,0,58
Adianez,F,100,58,0,58
Ahria,F,100,58,0,58
Aiyona,F,100,58,0,58
Alarik,M,100,0,58,58
Alfa,F,91,53,5,58
Allyne,F,100,58,0,58
Amariyon,M,100,0,58,58
Ammarie,F,100,58,0,58
Andia,F,100,58,0,58
Andin,M,91,5,53,58
Angeleigh,F,100,58,0,58
Antiwan,M,100,0,58,58
Arael,M,100,0,58,58
Armend,M,100,0,58,58
Ashkon,M,100,0,58,58
Asir,M,100,0,58,58
Aviyanna,F,100,58,0,58
Babetta,F,100,58,0,58
Baldo,M,100,0,58,58
Brunella,F,100,58,0,58
Cace,M,100,0,58,58
Camani,F,74,43,15,58
Catilin,F,100,58,0,58
Caydyn,M,100,0,58,58
Caylob,M,100,0,58,58
Cedrie,M,100,0,58,58
Ceth,M,100,0,58,58
Chakayla,F,100,58,0,58
Chanea,F,100,58,0,58
Chasitee,F,100,58,0,58
Chelce,F,100,58,0,58
Chidozie,M,100,0,58,58
Chonte,F,100,58,0,58
Choyce,F,57,33,25,58
Chundra,F,100,58,0,58
Cortne,F,100,58,0,58
Daiza,F,100,58,0,58
Dallanara,F,100,58,0,58
Dameshia,F,100,58,0,58
Danen,M,100,0,58,58
Darias,M,100,0,58,58
Davidanthony,M,100,0,58,58
Daynah,F,100,58,0,58
Delshon,M,100,0,58,58
Demarcos,M,100,0,58,58
Demarqus,M,100,0,58,58
Demontra,M,100,0,58,58
Denah,F,100,58,0,58
Deniah,F,100,58,0,58
Dominisha,F,100,58,0,58
Dowell,M,100,0,58,58
Edelin,F,100,58,0,58
Edge,M,100,0,58,58
Efrata,F,100,58,0,58
Ekansh,M,100,0,58,58
Elexys,F,100,58,0,58
Ellanie,F,100,58,0,58
Elliannah,F,100,58,0,58
Emeral,F,91,53,5,58
Eulah,F,100,58,0,58
Farhiya,F,100,58,0,58
Fedora,F,100,58,0,58
Francee,F,100,58,0,58
Gabriellah,F,100,58,0,58
Gaylia,F,100,58,0,58
Gearold,M,100,0,58,58
Gegory,M,100,0,58,58
Giona,F,100,58,0,58
Gredmarie,F,100,58,0,58
Hade,F,100,58,0,58
Hanya,F,100,58,0,58
Heru,M,100,0,58,58
Hondo,M,100,0,58,58
Icelynn,F,100,58,0,58
Irini,F,100,58,0,58
Izzah,F,100,58,0,58
Jacobs,M,100,0,58,58
Jadey,F,100,58,0,58
Jakobee,M,100,0,58,58
Jamse,M,100,0,58,58
Jannete,F,100,58,0,58
Jarone,M,100,0,58,58
Jatarius,M,100,0,58,58
Javionna,F,100,58,0,58
Jaworski,M,100,0,58,58
Jazzell,F,100,58,0,58
Jeniel,M,100,0,58,58
Jeraldo,M,100,0,58,58
Jibriel,M,100,0,58,58
Joannamarie,F,100,58,0,58
Jochebed,F,100,58,0,58
Jole,F,91,53,5,58
Jorma,M,100,0,58,58
Josanne,F,100,58,0,58
Josilin,F,100,58,0,58
Josphine,F,100,58,0,58
Jovonda,F,100,58,0,58
Julysa,F,100,58,0,58
Kaelib,M,100,0,58,58
Kaimi,M,55,26,32,58
Kaire,M,90,6,52,58
Kaitrin,F,100,58,0,58
Kameah,F,100,58,0,58
Kamiryn,F,100,58,0,58
Kamorie,F,83,48,10,58
Kasem,M,100,0,58,58
Kaysean,M,100,0,58,58
Kdyn,M,100,0,58,58
Kebron,M,81,11,47,58
Keighly,F,100,58,0,58
Keshay,F,100,58,0,58
Keyjuan,M,100,0,58,58
Khalida,F,100,58,0,58
Kharissa,F,100,58,0,58
Khelsea,F,100,58,0,58
Kode,M,100,0,58,58
Koralynn,F,100,58,0,58
Krys,F,81,47,11,58
Lamarian,M,100,0,58,58
Lanaja,F,100,58,0,58
Laquinn,M,91,5,53,58
Latima,F,100,58,0,58
Latiqua,F,100,58,0,58
Leauna,F,100,58,0,58
Levii,M,100,0,58,58
Lihanna,F,100,58,0,58
Liliauna,F,100,58,0,58
Lillybeth,F,100,58,0,58
Lilyannah,F,100,58,0,58
Lisania,F,100,58,0,58
Lissy,F,100,58,0,58
Louren,F,100,58,0,58
Lyndzee,F,100,58,0,58
Macin,M,100,0,58,58
Madhuri,F,100,58,0,58
Maeby,F,100,58,0,58
Maleiyah,F,100,58,0,58
Mandolyn,F,100,58,0,58
Mariell,F,100,58,0,58
Marinell,F,100,58,0,58
Maritess,F,100,58,0,58
Markeysha,F,100,58,0,58
Marteka,F,100,58,0,58
Marvie,F,86,50,8,58
Matricia,F,100,58,0,58
Mckelle,F,100,58,0,58
Melburn,M,100,0,58,58
Mikiel,M,100,0,58,58
Milina,F,100,58,0,58
Miyani,F,100,58,0,58
Myda,F,100,58,0,58
Nahia,F,100,58,0,58
Nahja,F,100,58,0,58
Nailyn,F,100,58,0,58
Nameer,M,100,0,58,58
Naomee,F,100,58,0,58
Nataline,F,100,58,0,58
Natily,F,100,58,0,58
Naw,F,100,58,0,58
Naz,F,100,58,0,58
Nemesio,M,100,0,58,58
Nicosha,F,100,58,0,58
Nielle,F,100,58,0,58
Numan,M,100,0,58,58
Nyel,M,72,16,42,58
Olanrewaju,M,100,0,58,58
Omie,F,100,58,0,58
Oslo,M,100,0,58,58
Ozil,M,100,0,58,58
Persephonie,F,100,58,0,58
Prakash,M,100,0,58,58
Promiss,F,100,58,0,58
Qualin,M,100,0,58,58
Quanna,F,100,58,0,58
Quanteria,F,100,58,0,58
Quisha,F,100,58,0,58
Qunicy,M,100,0,58,58
Raejon,M,100,0,58,58
Raliegh,M,100,0,58,58
Rayansh,M,100,0,58,58
Raydan,M,100,0,58,58
Regnald,M,100,0,58,58
Reymon,M,100,0,58,58
Richanda,F,100,58,0,58
Riddik,M,100,0,58,58
Ritaj,F,100,58,0,58
Rivan,M,100,0,58,58
Rmoni,F,100,58,0,58
Rovena,F,100,58,0,58
Rozalia,F,100,58,0,58
Sahaana,F,100,58,0,58
Saintclair,M,100,0,58,58
Samoria,F,100,58,0,58
Sante,M,100,0,58,58
Sayf,M,100,0,58,58
Shaana,F,100,58,0,58
Shaiden,M,100,0,58,58
Shaiel,F,100,58,0,58
Shakaya,F,100,58,0,58
Shalev,M,100,0,58,58
Shamaiya,F,100,58,0,58
Shanton,M,74,15,43,58
Sharmarke,M,100,0,58,58
Sharmeen,F,100,58,0,58
Shaynee,F,100,58,0,58
Shereena,F,100,58,0,58
Sherwanda,F,100,58,0,58
Shilyn,F,100,58,0,58
Shondria,F,100,58,0,58
Simiyah,F,100,58,0,58
Sniyah,F,100,58,0,58
Starnisha,F,100,58,0,58
Stepehn,M,100,0,58,58
Sudeep,M,100,0,58,58
Suvi,F,100,58,0,58
Symira,F,100,58,0,58
Takasha,F,100,58,0,58
Tamaris,F,55,32,26,58
Tanelle,F,100,58,0,58
Tashunda,F,100,58,0,58
Tecumseh,M,100,0,58,58
Thaddus,M,100,0,58,58
Tiawan,M,100,0,58,58
Timeshia,F,100,58,0,58
Tolanda,F,100,58,0,58
Tregan,M,100,0,58,58
Tremya,F,100,58,0,58
Troya,F,100,58,0,58
Tukker,M,100,0,58,58
Tyrec,M,100,0,58,58
Tytiona,F,100,58,0,58
Uganda,F,79,46,12,58
Valerian,M,100,0,58,58
Vinisha,F,100,58,0,58
Vonne,F,100,58,0,58
Wetzel,M,100,0,58,58
Willean,F,100,58,0,58
Xabi,M,100,0,58,58
Yaasir,M,100,0,58,58
Yakir,M,100,0,58,58
Yeiden,M,100,0,58,58
Zerlina,F,100,58,0,58
Zhoey,F,100,58,0,58
Zilah,F,100,58,0,58
Zira,F,100,58,0,58
Zylee,F,100,58,0,58
Aaris,M,51,28,29,57
Ac,M,100,0,57,57
Aimen,F,54,31,26,57
Akida,M,74,15,42,57
Alexaundria,F,100,57,0,57
Alieyah,F,100,57,0,57
Alila,F,100,57,0,57
Alithea,F,100,57,0,57
Amandalyn,F,100,57,0,57
Amiley,F,100,57,0,57
Anarie,F,100,57,0,57
Angelinne,F,100,57,0,57
Anji,F,100,57,0,57
Annay,F,100,57,0,57
Anuraag,M,100,0,57,57
Anyea,F,100,57,0,57
Aragon,M,100,0,57,57
Ashlay,F,100,57,0,57
Ashtian,M,100,0,57,57
Avamae,F,100,57,0,57
Bardia,M,100,0,57,57
Barnell,M,100,0,57,57
Berea,F,100,57,0,57
Bern,M,100,0,57,57
Blessings,F,100,57,0,57
Braxxton,M,100,0,57,57
Breosha,F,100,57,0,57
Britanni,F,100,57,0,57
Bryttni,F,100,57,0,57
Calon,M,100,0,57,57
Carleah,F,100,57,0,57
Cartavious,M,100,0,57,57
Casson,M,100,0,57,57
Caziah,M,68,18,39,57
Charod,M,100,0,57,57
Chazmin,F,100,57,0,57
Christino,M,100,0,57,57
Coury,M,100,0,57,57
Daleena,F,100,57,0,57
Darinel,M,100,0,57,57
Dauntae,M,100,0,57,57
Daveah,F,100,57,0,57
Daymen,M,100,0,57,57
Deaire,M,100,0,57,57
Deangleo,M,100,0,57,57
Deionta,M,100,0,57,57
Dhyana,F,100,57,0,57
Din,M,100,0,57,57
Dnae,F,100,57,0,57
Doddie,F,100,57,0,57
Drisana,F,100,57,0,57
Effrey,M,100,0,57,57
Ercilia,F,100,57,0,57
Ermias,M,100,0,57,57
Eryx,M,100,0,57,57
Estes,M,100,0,57,57
Euell,M,100,0,57,57
Eustolia,F,100,57,0,57
Everlean,F,100,57,0,57
Evva,F,100,57,0,57
Ezrael,M,100,0,57,57
Fleurette,F,100,57,0,57
Franke,M,100,0,57,57
Gayane,F,100,57,0,57
Genova,F,100,57,0,57
Geramy,M,100,0,57,57
Gerriann,F,100,57,0,57
Gwenlyn,F,100,57,0,57
Halimo,F,100,57,0,57
Hasset,F,100,57,0,57
Heran,F,100,57,0,57
Hidi,F,100,57,0,57
Holdan,M,100,0,57,57
Ikeria,F,100,57,0,57
Inmer,M,100,0,57,57
Itzael,M,100,0,57,57
Izsabella,F,100,57,0,57
Jacqueleen,F,100,57,0,57
Jadd,M,100,0,57,57
Jahmiyah,F,100,57,0,57
Jahzel,F,91,52,5,57
Jamain,M,100,0,57,57
Janye,F,100,57,0,57
Jarrard,M,100,0,57,57
Jasalynn,F,100,57,0,57
Jashia,F,100,57,0,57
Javiera,F,100,57,0,57
Jazzma,F,100,57,0,57
Jeleesa,F,100,57,0,57
Jelene,F,100,57,0,57
Jenry,M,100,0,57,57
Jillienne,F,100,57,0,57
Joaly,F,100,57,0,57
Johnatha,M,100,0,57,57
Johntrell,M,100,0,57,57
Jolanta,F,100,57,0,57
Joliyah,F,100,57,0,57
Jonluc,M,100,0,57,57
Joshuadavid,M,100,0,57,57
Jossalynn,F,100,57,0,57
Juanye,M,100,0,57,57
Kaizlee,F,100,57,0,57
Karlon,M,100,0,57,57
Kaua,M,100,0,57,57
Kayshla,F,100,57,0,57
Kedrin,M,100,0,57,57
Keema,F,100,57,0,57
Keja,F,100,57,0,57
Keltie,F,100,57,0,57
Keshan,M,100,0,57,57
Keslee,F,100,57,0,57
Khadar,M,100,0,57,57
Khilyn,M,51,28,29,57
Kieler,M,100,0,57,57
Kilan,M,100,0,57,57
Kimbree,F,100,57,0,57
Kimyra,F,100,57,0,57
Kohan,M,100,0,57,57
Kyannah,F,100,57,0,57
Lakrista,F,100,57,0,57
Lametra,F,100,57,0,57
Lapatrick,M,100,0,57,57
Larken,F,100,57,0,57
Lataurus,M,91,5,52,57
Laymond,M,100,0,57,57
Leeum,M,100,0,57,57
Leotha,M,61,22,35,57
Lesie,F,100,57,0,57
Lindamarie,F,100,57,0,57
Lorrane,F,100,57,0,57
Lucetta,F,100,57,0,57
Lurleen,F,100,57,0,57
Macintyre,M,100,0,57,57
Mahri,F,100,57,0,57
Mairen,F,100,57,0,57
Makayden,F,68,39,18,57
Makaylla,F,100,57,0,57
Malyia,F,100,57,0,57
Marchetta,F,100,57,0,57
Markail,M,100,0,57,57
Markevia,F,100,57,0,57
Marsena,F,100,57,0,57
Mccormick,M,100,0,57,57
Mellissia,F,100,57,0,57
Melvine,F,79,45,12,57
Mikaylin,F,100,57,0,57
Mikkayla,F,100,57,0,57
Minaal,F,100,57,0,57
Moneshia,F,100,57,0,57
Mychele,F,100,57,0,57
Mykeia,F,100,57,0,57
Naema,F,100,57,0,57
Naiyana,F,100,57,0,57
Nakina,F,100,57,0,57
Namine,F,100,57,0,57
Narcisa,F,100,57,0,57
Nasif,M,100,0,57,57
Nataleah,F,100,57,0,57
Nazaiah,M,100,0,57,57
Nehamiah,M,100,0,57,57
Nethan,M,100,0,57,57
Neythan,M,100,0,57,57
Nii,M,100,0,57,57
Nimco,F,100,57,0,57
Norvella,F,100,57,0,57
Nyeesha,F,100,57,0,57
Nyrah,F,100,57,0,57
Omarri,M,100,0,57,57
Omir,M,100,0,57,57
Omran,M,100,0,57,57
Oniya,F,100,57,0,57
Pallas,F,100,57,0,57
Pashion,F,100,57,0,57
Paymon,M,100,0,57,57
Pravin,M,100,0,57,57
Preslyn,F,100,57,0,57
Pritesh,M,100,0,57,57
Qualyn,M,100,0,57,57
Quinnley,F,100,57,0,57
Ragena,F,100,57,0,57
Ragine,F,100,57,0,57
Ramont,M,100,0,57,57
Razia,F,100,57,0,57
Reinette,F,100,57,0,57
Rilei,F,100,57,0,57
Romani,M,81,11,46,57
Roselina,F,100,57,0,57
Roston,M,100,0,57,57
Saajan,M,100,0,57,57
Sahalie,F,100,57,0,57
Salote,F,100,57,0,57
Samala,F,100,57,0,57
Santee,M,100,0,57,57
Savva,M,100,0,57,57
Sebastyan,M,100,0,57,57
Semajay,M,100,0,57,57
Senan,M,100,0,57,57
Serrita,F,100,57,0,57
Shaliya,F,100,57,0,57
Shallen,F,100,57,0,57
Shanvi,F,100,57,0,57
Shaquesha,F,100,57,0,57
Shaquna,F,100,57,0,57
Sharvi,F,100,57,0,57
Shavana,F,100,57,0,57
Shellbie,F,100,57,0,57
Sherricka,F,100,57,0,57
Sibley,F,100,57,0,57
Sidny,F,100,57,0,57
Simisola,F,100,57,0,57
Skanda,M,100,0,57,57
Soyna,F,100,57,0,57
Starlina,F,100,57,0,57
Suheily,F,100,57,0,57
Suyash,M,100,0,57,57
Svara,F,100,57,0,57
Syndee,F,100,57,0,57
Tahjir,M,100,0,57,57
Taisia,F,100,57,0,57
Takaiya,F,100,57,0,57
Takeem,M,100,0,57,57
Tashawnda,F,100,57,0,57
Tashun,M,100,0,57,57
Tavari,M,100,0,57,57
Taziah,F,100,57,0,57
Tekila,F,100,57,0,57
Tekira,F,100,57,0,57
Tischa,F,100,57,0,57
Torino,M,79,12,45,57
Toshiko,F,100,57,0,57
Truxton,M,100,0,57,57
Tryna,F,100,57,0,57
Tymeir,M,100,0,57,57
Tynae,F,100,57,0,57
Vanesia,F,100,57,0,57
Vasu,M,100,0,57,57
Vyron,M,100,0,57,57
Warden,M,100,0,57,57
Worthy,M,100,0,57,57
Yordin,M,100,0,57,57
Yulieth,F,100,57,0,57
Yuren,M,100,0,57,57
Yurianna,F,100,57,0,57
Zaydn,M,100,0,57,57
Zylon,M,100,0,57,57
Abdirahim,M,100,0,56,56
Addaline,F,100,56,0,56
Adelis,F,100,56,0,56
Ahnyah,F,100,56,0,56
Ahnyla,F,100,56,0,56
Aima,F,100,56,0,56
Akhia,F,100,56,0,56
Aleeta,F,100,56,0,56
Alexxandra,F,100,56,0,56
Aliene,F,100,56,0,56
Alisi,F,100,56,0,56
Almedia,F,100,56,0,56
Altina,F,100,56,0,56
Amair,M,100,0,56,56
Anavi,F,100,56,0,56
Anber,F,100,56,0,56
Anivea,F,100,56,0,56
Annaclara,F,100,56,0,56
Anvay,M,100,0,56,56
Anyelo,M,100,0,56,56
Anzleigh,F,100,56,0,56
Arpi,F,100,56,0,56
Arseniy,M,100,0,56,56
Ato,M,100,0,56,56
Avalie,F,100,56,0,56
Aycen,M,100,0,56,56
Azahel,M,100,0,56,56
Belmin,M,100,0,56,56
Bereniz,F,100,56,0,56
Boen,M,100,0,56,56
Braxen,M,100,0,56,56
Brend,F,100,56,0,56
Brenndan,M,100,0,56,56
Brittinee,F,100,56,0,56
Cabela,F,100,56,0,56
Camery,F,100,56,0,56
Cardelia,F,100,56,0,56
Celsie,F,100,56,0,56
Chanci,F,100,56,0,56
Chanequa,F,100,56,0,56
Chasitty,F,100,56,0,56
Cherylin,F,100,56,0,56
Chiane,F,100,56,0,56
Chrishun,M,100,0,56,56
Cidnee,F,100,56,0,56
Cinsere,M,91,5,51,56
Cleone,F,100,56,0,56
Cniyah,F,100,56,0,56
Corla,F,100,56,0,56
Crystalle,F,100,56,0,56
Dakisha,F,100,56,0,56
Damarquis,M,100,0,56,56
Darianny,F,100,56,0,56
Dawnyel,F,100,56,0,56
Daytin,M,100,0,56,56
Dazani,F,100,56,0,56
Deavian,F,100,56,0,56
Deivi,M,100,0,56,56
Delonna,F,100,56,0,56
Deloy,M,100,0,56,56
Delsa,F,100,56,0,56
Demyan,M,100,0,56,56
Depaul,M,100,0,56,56
Derien,M,100,0,56,56
Desra,F,100,56,0,56
Dilraj,M,100,0,56,56
Dimaggio,M,100,0,56,56
Dinamarie,F,100,56,0,56
Donicia,F,100,56,0,56
Elisama,F,100,56,0,56
Eshe,F,100,56,0,56
Espiridion,M,100,0,56,56
Evelisse,F,100,56,0,56
Fher,M,100,0,56,56
Firman,M,100,0,56,56
Gabreilla,F,100,56,0,56
Ge,M,91,5,51,56
Giara,F,100,56,0,56
Gilliam,M,82,10,46,56
Giulliana,F,100,56,0,56
Gurneet,F,100,56,0,56
Hadlea,F,100,56,0,56
Handsome,M,100,0,56,56
Harless,M,100,0,56,56
Hayleen,F,100,56,0,56
Heaton,M,100,0,56,56
Honestie,F,100,56,0,56
Ilyn,F,100,56,0,56
Ivannia,F,100,56,0,56
Jahnee,F,100,56,0,56
Jamariyon,M,100,0,56,56
Jamita,F,100,56,0,56
Jamyriah,F,100,56,0,56
Janalynn,F,100,56,0,56
Janera,F,100,56,0,56
Jarvaris,M,100,0,56,56
Jauron,M,100,0,56,56
Javad,M,100,0,56,56
Javarri,M,100,0,56,56
Jaxie,F,100,56,0,56
Jazmere,F,100,56,0,56
Jenavi,F,100,56,0,56
Jennesis,F,100,56,0,56
Jennia,F,100,56,0,56
Jennifermarie,F,100,56,0,56
Jervonte,M,100,0,56,56
Jhamal,M,100,0,56,56
Jillanne,F,100,56,0,56
Jishnu,M,100,0,56,56
Joeanne,F,100,56,0,56
Jola,F,100,56,0,56
Jomaira,F,100,56,0,56
Josclyn,F,100,56,0,56
Joshaun,M,100,0,56,56
Joshelyn,F,100,56,0,56
Julisha,F,100,56,0,56
Juliun,M,100,0,56,56
Jyrell,M,100,0,56,56
Kaleeya,F,100,56,0,56
Kambre,F,100,56,0,56
Kashis,M,100,0,56,56
Kashtyn,M,91,5,51,56
Kassiah,F,100,56,0,56
Keairah,F,100,56,0,56
Kewaun,M,100,0,56,56
Keylani,F,100,56,0,56
Keymiah,F,100,56,0,56
Khyrin,M,100,0,56,56
Kimanh,F,100,56,0,56
Kimoria,F,100,56,0,56
Kirklyn,F,57,32,24,56
Kniya,F,100,56,0,56
Kyrus,M,100,0,56,56
Lacedric,M,100,0,56,56
Lakyah,F,100,56,0,56
Lamart,M,100,0,56,56
Lanasha,F,100,56,0,56
Lashala,F,100,56,0,56
Lashanae,F,100,56,0,56
Lashina,F,100,56,0,56
Lathyn,M,100,0,56,56
Leeandre,M,100,0,56,56
Leilynn,F,100,56,0,56
Lekecia,F,100,56,0,56
Lemarion,M,100,0,56,56
Lezette,F,100,56,0,56
Liyla,F,100,56,0,56
Lucynda,F,100,56,0,56
Luisdaniel,M,100,0,56,56
Madex,M,100,0,56,56
Makini,F,100,56,0,56
Malahki,M,100,0,56,56
Marabelle,F,100,56,0,56
Marajade,F,100,56,0,56
Margrit,F,100,56,0,56
Marielouise,F,100,56,0,56
Marijayne,F,100,56,0,56
Maritere,F,100,56,0,56
Massai,M,100,0,56,56
Measia,F,100,56,0,56
Mieisha,F,100,56,0,56
Mirandah,F,100,56,0,56
Mita,F,100,56,0,56
Moncerat,F,100,56,0,56
Monchel,F,100,56,0,56
Myishia,F,100,56,0,56
Nadelyn,F,100,56,0,56
Naryiah,F,100,56,0,56
Nashaya,F,100,56,0,56
Nazira,F,100,56,0,56
Neeharika,F,100,56,0,56
Nial,M,100,0,56,56
Nichell,F,100,56,0,56
Nickolos,M,100,0,56,56
Nicoll,F,100,56,0,56
Nimrit,F,100,56,0,56
Norva,F,100,56,0,56
Nzingha,F,100,56,0,56
Oliviya,F,100,56,0,56
Omya,F,100,56,0,56
Oneda,F,100,56,0,56
Orissa,F,100,56,0,56
Osmani,M,100,0,56,56
Philena,F,100,56,0,56
Pierra,F,100,56,0,56
Rahsan,M,100,0,56,56
Randyn,M,100,0,56,56
Ravensymone,F,100,56,0,56
Rawleigh,M,100,0,56,56
Regnia,F,100,56,0,56
Reighlyn,F,100,56,0,56
Rifat,M,100,0,56,56
Riquelme,M,100,0,56,56
Rishad,M,100,0,56,56
Ritisha,F,100,56,0,56
Roee,M,100,0,56,56
Roxene,F,100,56,0,56
Ryliee,F,100,56,0,56
Safir,M,100,0,56,56
Saifullah,M,100,0,56,56
Sarinah,F,100,56,0,56
Sarye,F,100,56,0,56
Sasan,M,100,0,56,56
Savayah,F,100,56,0,56
Shaeli,F,100,56,0,56
Shamik,M,91,5,51,56
Shammara,F,100,56,0,56
Shanayah,F,100,56,0,56
Shaquiel,M,91,5,51,56
Sharada,F,100,56,0,56
Sharneice,F,100,56,0,56
Sheilagh,F,100,56,0,56
Shenicka,F,100,56,0,56
Sherrey,F,100,56,0,56
Shloima,M,100,0,56,56
Shykira,F,100,56,0,56
Silvie,F,100,56,0,56
Sincerity,F,100,56,0,56
Sofhia,F,100,56,0,56
Sorrel,F,100,56,0,56
Sostenes,M,100,0,56,56
Stepen,M,100,0,56,56
Suesan,F,100,56,0,56
Talayla,F,100,56,0,56
Taqwa,F,100,56,0,56
Tarla,F,100,56,0,56
Teshara,F,100,56,0,56
Tezra,F,100,56,0,56
Thaison,M,100,0,56,56
Thaniel,M,100,0,56,56
Tiari,F,100,56,0,56
Ticara,F,100,56,0,56
Tinzley,F,100,56,0,56
Trevarius,M,100,0,56,56
Tyniqua,F,100,56,0,56
Va,M,100,0,56,56
Vasily,M,100,0,56,56
Velena,F,100,56,0,56
Wafaa,F,100,56,0,56
Wake,M,100,0,56,56
Xaniyah,F,100,56,0,56
Xayla,F,100,56,0,56
Yatzary,F,100,56,0,56
Ysmael,M,100,0,56,56
Yzabel,F,100,56,0,56
Zebulen,M,100,0,56,56
Zienna,F,100,56,0,56
Adelheid,F,100,55,0,55
Adlynn,F,100,55,0,55
Afomia,F,100,55,0,55
Airanna,F,100,55,0,55
Aislee,F,100,55,0,55
Akansha,F,100,55,0,55
Aletia,F,100,55,0,55
Alixzander,M,100,0,55,55
Alysea,F,100,55,0,55
Amron,M,100,0,55,55
Anayansi,F,100,55,0,55
Anielle,F,100,55,0,55
Annastazia,F,100,55,0,55
Annlee,F,100,55,0,55
Antoan,M,100,0,55,55
Antoniodejesus,M,100,0,55,55
Antrice,F,100,55,0,55
Appollonia,F,100,55,0,55
Arlenis,F,100,55,0,55
Arpil,F,100,55,0,55
Ashla,F,100,55,0,55
Asijah,F,100,55,0,55
Astaria,F,100,55,0,55
Astryd,F,100,55,0,55
Attallah,F,100,55,0,55
Aubra,F,58,32,23,55
Aubriauna,F,100,55,0,55
Audiel,M,100,0,55,55
Audrieanna,F,100,55,0,55
Avaiah,F,100,55,0,55
Avita,F,100,55,0,55
Azzam,M,100,0,55,55
Balie,F,100,55,0,55
Bastion,M,100,0,55,55
Baylyn,F,100,55,0,55
Bionka,F,100,55,0,55
Bowyn,M,89,6,49,55
Brainard,M,100,0,55,55
Breeauna,F,100,55,0,55
Brenita,F,100,55,0,55
Briannie,F,100,55,0,55
Bronco,M,100,0,55,55
Cadedra,F,100,55,0,55
Carnita,F,100,55,0,55
Caroleena,F,100,55,0,55
Cassanda,F,100,55,0,55
Catheleen,F,100,55,0,55
Celin,F,100,55,0,55
Celsa,F,100,55,0,55
Charlyse,F,100,55,0,55
Chazity,F,100,55,0,55
Cherlin,F,100,55,0,55
Chevi,F,100,55,0,55
Cleona,F,100,55,0,55
Clyda,F,100,55,0,55
Cordon,M,100,0,55,55
Cytlaly,F,100,55,0,55
Dacorian,M,100,0,55,55
Damontez,M,100,0,55,55
Danali,F,100,55,0,55
Danalyn,F,100,55,0,55
Danetra,F,100,55,0,55
Danian,M,100,0,55,55
Dannyelle,F,100,55,0,55
Darryal,M,100,0,55,55
Darsey,F,100,55,0,55
Dearrius,M,100,0,55,55
Debriana,F,100,55,0,55
Decorion,M,100,0,55,55
Dejonte,M,100,0,55,55
Derone,M,100,0,55,55
Derrike,M,100,0,55,55
Deveny,F,100,55,0,55
Devette,F,100,55,0,55
Deylan,M,100,0,55,55
Dhairya,M,100,0,55,55
Dhwani,F,100,55,0,55
Dinara,F,100,55,0,55
Dokota,M,100,0,55,55
Dorey,F,87,48,7,55
Dozier,M,100,0,55,55
Durrel,M,100,0,55,55
Dzyre,F,100,55,0,55
Edem,M,100,0,55,55
Ehrin,F,60,33,22,55
Elaynah,F,100,55,0,55
Elbridge,M,100,0,55,55
Emyli,F,100,55,0,55
Evgenia,F,100,55,0,55
Exander,M,100,0,55,55
Fiore,M,80,11,44,55
Geniah,F,100,55,0,55
Georgenia,F,100,55,0,55
Govanny,M,100,0,55,55
Guerline,F,100,55,0,55
Hatice,F,100,55,0,55
Hendel,F,100,55,0,55
Iaan,M,100,0,55,55
Ildiko,F,100,55,0,55
Indyia,F,100,55,0,55
Jadlyn,F,100,55,0,55
Jahfari,M,100,0,55,55
Jaidee,F,100,55,0,55
Jaired,M,100,0,55,55
Jairius,M,100,0,55,55
Jakaleb,M,100,0,55,55
Jakalyn,F,100,55,0,55
Jameire,M,100,0,55,55
Jamesanthony,M,100,0,55,55
Janace,F,100,55,0,55
Jante,M,75,14,41,55
Japleen,F,100,55,0,55
Jasher,M,100,0,55,55
Jathniel,M,100,0,55,55
Jaydaliz,F,100,55,0,55
Jaydie,F,100,55,0,55
Jaylaa,F,100,55,0,55
Jaystin,M,100,0,55,55
Jearlean,F,100,55,0,55
Jeffray,M,100,0,55,55
Jermaya,F,100,55,0,55
Jerrianne,F,100,55,0,55
Jesiel,M,100,0,55,55
Jesmine,F,100,55,0,55
Jewelie,F,100,55,0,55
Jhoel,M,100,0,55,55
Jizzelle,F,100,55,0,55
Jocalyn,F,100,55,0,55
Jocellyn,F,100,55,0,55
Johneshia,F,100,55,0,55
Joliene,F,100,55,0,55
Jonathandavid,M,100,0,55,55
Jorga,F,100,55,0,55
Joseramon,M,100,0,55,55
Josselynn,F,100,55,0,55
Jovanka,F,100,55,0,55
Jovona,F,100,55,0,55
Juell,M,100,0,55,55
Jullissa,F,100,55,0,55
Kahri,M,64,20,35,55
Kainoah,M,100,0,55,55
Kamarria,F,100,55,0,55
Karil,F,100,55,0,55
Kass,M,100,0,55,55
Kasy,F,100,55,0,55
Kayelani,F,100,55,0,55
Kayeleigh,F,100,55,0,55
Kayen,M,91,5,50,55
Kazaria,F,100,55,0,55
Kealee,F,100,55,0,55
Keiontae,M,100,0,55,55
Kenry,M,100,0,55,55
Kente,M,100,0,55,55
Kerisa,F,100,55,0,55
Keyun,M,100,0,55,55
Khizar,M,100,0,55,55
Klark,M,89,6,49,55
Kristlyn,F,100,55,0,55
Kwinton,M,100,0,55,55
Kyian,M,100,0,55,55
Kymara,F,100,55,0,55
Laiylah,F,100,55,0,55
Laker,M,100,0,55,55
Lanyla,F,100,55,0,55
Laprincia,F,100,55,0,55
Lavale,M,100,0,55,55
Lavarr,M,100,0,55,55
Ledia,F,100,55,0,55
Leevon,M,100,0,55,55
Leinani,F,100,55,0,55
Leondro,M,100,0,55,55
Lesette,F,100,55,0,55
Lismary,F,100,55,0,55
Lizza,F,100,55,0,55
Lorrina,F,100,55,0,55
Lumi,F,100,55,0,55
Lynnox,F,82,45,10,55
Lyris,F,100,55,0,55
Lyssette,F,100,55,0,55
Maat,F,100,55,0,55
Maebel,F,100,55,0,55
Malcome,M,100,0,55,55
Marabeth,F,100,55,0,55
Marketia,F,100,55,0,55
Martae,M,100,0,55,55
Matayah,F,100,55,0,55
Maylia,F,100,55,0,55
Meeah,F,100,55,0,55
Meshulem,M,100,0,55,55
Mete,M,100,0,55,55
Miricle,F,100,55,0,55
Moo,M,56,24,31,55
Morio,M,100,0,55,55
Mykea,F,100,55,0,55
Nahara,F,100,55,0,55
Naki,M,91,5,50,55
Namira,F,100,55,0,55
Namish,M,100,0,55,55
Naron,M,100,0,55,55
Natahlia,F,100,55,0,55
Nataja,F,100,55,0,55
Naydine,F,100,55,0,55
Nelta,F,100,55,0,55
Nickeya,F,100,55,0,55
Nickisha,F,100,55,0,55
Nusaiba,F,100,55,0,55
Nyrell,M,100,0,55,55
Oved,M,100,0,55,55
Punam,F,100,55,0,55
Quatasia,F,100,55,0,55
Quindarious,M,100,0,55,55
Raenah,F,100,55,0,55
Rafid,M,100,0,55,55
Rahm,M,100,0,55,55
Ralphy,M,100,0,55,55
Ramina,F,100,55,0,55
Raqueal,F,100,55,0,55
Rayshonda,F,100,55,0,55
Rebbie,F,100,55,0,55
Retia,F,100,55,0,55
Rheann,F,100,55,0,55
Riham,F,100,55,0,55
Rilya,F,100,55,0,55
Roxsana,F,100,55,0,55
Ryn,F,64,35,20,55
Sa,F,76,42,13,55
Saaketh,M,100,0,55,55
Saamir,M,100,0,55,55
Saga,F,100,55,0,55
Salita,F,100,55,0,55
Sametria,F,100,55,0,55
Sanat,M,100,0,55,55
Sandara,F,100,55,0,55
Sarang,M,56,24,31,55
Sarely,F,100,55,0,55
Saunya,F,100,55,0,55
Savonnah,F,100,55,0,55
Scherri,F,100,55,0,55
Seletha,F,100,55,0,55
Shafin,M,100,0,55,55
Shakeil,M,100,0,55,55
Shalva,F,100,55,0,55
Shamora,F,100,55,0,55
Shantique,F,100,55,0,55
Shaquay,F,100,55,0,55
Sharyah,F,100,55,0,55
Shavawn,F,100,55,0,55
Shekelia,F,100,55,0,55
Sheyanna,F,100,55,0,55
Shontez,M,100,0,55,55
Shuayb,M,100,0,55,55
Shyree,F,100,55,0,55
Shyron,M,100,0,55,55
Silvanna,F,100,55,0,55
Sinay,F,100,55,0,55
Snehal,M,89,6,49,55
Sondos,F,100,55,0,55
Songa,F,100,55,0,55
Stu,M,100,0,55,55
Suchir,M,100,0,55,55
Suria,F,100,55,0,55
Taelar,F,100,55,0,55
Taki,M,91,5,50,55
Talani,F,100,55,0,55
Talyiah,F,100,55,0,55
Tamesia,F,100,55,0,55
Tangula,F,100,55,0,55
Tanzy,F,100,55,0,55
Tashell,F,100,55,0,55
Taurian,M,100,0,55,55
Temari,F,91,50,5,55
Terald,M,100,0,55,55
Tewanna,F,100,55,0,55
Thaden,M,100,0,55,55
Tiffinee,F,100,55,0,55
Tirell,M,100,0,55,55
Tomikia,F,100,55,0,55
Trajen,M,100,0,55,55
Tuana,F,100,55,0,55
Tyquasha,F,100,55,0,55
Tyreana,F,100,55,0,55
Tyshika,F,100,55,0,55
Tysir,M,100,0,55,55
Vedanshi,F,100,55,0,55
Viha,F,100,55,0,55
Willodean,F,100,55,0,55
Wyllow,F,100,55,0,55
Yaviel,M,100,0,55,55
Yerlin,F,100,55,0,55
Youcef,M,100,0,55,55
Yuktha,F,100,55,0,55
Yuriah,F,51,28,27,55
Zabria,F,100,55,0,55
Zeev,M,100,0,55,55
Zymeria,F,100,55,0,55
Abrionna,F,100,54,0,54
Adda,F,100,54,0,54
Adilen,F,100,54,0,54
Adyline,F,100,54,0,54
Ailyne,F,100,54,0,54
Aizza,F,100,54,0,54
Alandis,M,100,0,54,54
Alanee,F,100,54,0,54
Alexondra,F,100,54,0,54
Altheria,F,100,54,0,54
Alyzea,F,100,54,0,54
Amear,M,100,0,54,54
Andilyn,F,100,54,0,54
Anijha,F,100,54,0,54
Annyssa,F,100,54,0,54
Anteria,F,100,54,0,54
Arnasia,F,100,54,0,54
Arrica,F,100,54,0,54
Ashiana,F,100,54,0,54
Aubriegh,F,100,54,0,54
Aunisty,F,100,54,0,54
Aveena,F,100,54,0,54
Azaira,F,100,54,0,54
Azayah,F,67,36,18,54
Azeria,F,100,54,0,54
Biancha,F,100,54,0,54
Birdena,F,100,54,0,54
Branford,M,100,0,54,54
Branko,M,100,0,54,54
Braylei,F,100,54,0,54
Breasha,F,100,54,0,54
Briara,F,100,54,0,54
Bricyn,M,100,0,54,54
Brindley,F,100,54,0,54
Buelah,F,100,54,0,54
Cailley,F,100,54,0,54
Calden,M,100,0,54,54
Calliegh,F,100,54,0,54
Cambron,M,100,0,54,54
Canada,F,100,54,0,54
Caragan,F,100,54,0,54
Carlyann,F,100,54,0,54
Cazandra,F,100,54,0,54
Chakyra,F,100,54,0,54
Chalanda,F,100,54,0,54
Chamiya,F,100,54,0,54
Chanaya,F,100,54,0,54
Chandan,M,100,0,54,54
Chantra,F,65,35,19,54
Christof,M,100,0,54,54
Clever,M,100,0,54,54
Coray,M,100,0,54,54
Curby,M,100,0,54,54
Dafny,F,100,54,0,54
Daiquon,M,100,0,54,54
Dameron,M,72,15,39,54
Darvon,M,100,0,54,54
Deia,F,100,54,0,54
Deretha,F,100,54,0,54
Develyn,F,100,54,0,54
Dezeree,F,100,54,0,54
Diovanni,M,100,0,54,54
Dmarkus,M,100,0,54,54
Dmiyah,F,100,54,0,54
Doan,M,69,17,37,54
Dohn,M,100,0,54,54
Eliakim,M,100,0,54,54
Elizeo,M,100,0,54,54
Ellexis,F,100,54,0,54
Emika,F,100,54,0,54
Emmaus,M,91,5,49,54
Envi,F,100,54,0,54
Evelise,F,100,54,0,54
Ezel,M,100,0,54,54
Farnaz,F,100,54,0,54
Fedor,M,100,0,54,54
Ferguson,M,100,0,54,54
Florette,F,100,54,0,54
Gaynor,F,81,44,10,54
Gerber,M,100,0,54,54
Gianncarlo,M,100,0,54,54
Goeffrey,M,100,0,54,54
Grantley,M,100,0,54,54
Heatherann,F,100,54,0,54
Hend,F,100,54,0,54
Hermenegildo,M,100,0,54,54
Honore,F,91,49,5,54
Hopelynn,F,100,54,0,54
Iniko,M,100,0,54,54
Itzayanna,F,100,54,0,54
Ivi,F,100,54,0,54
Jaece,M,100,0,54,54
Jaekob,M,100,0,54,54
Jahri,M,100,0,54,54
Jahshawn,M,100,0,54,54
Jakela,F,100,54,0,54
Jakhya,F,100,54,0,54
Jaksen,M,100,0,54,54
Jalliyah,F,100,54,0,54
Jamarlon,M,100,0,54,54
Jamieka,F,100,54,0,54
Jarik,M,100,0,54,54
Javette,F,100,54,0,54
Jaylissa,F,100,54,0,54
Jazzel,F,100,54,0,54
Jda,F,100,54,0,54
Jermeria,F,100,54,0,54
Jiwoo,F,70,38,16,54
Johara,F,100,54,0,54
Jolisha,F,100,54,0,54
Josaline,F,100,54,0,54
Joshuamichael,M,100,0,54,54
Kampbell,F,100,54,0,54
Kaneka,F,100,54,0,54
Kantrell,M,100,0,54,54
Katerria,F,100,54,0,54
Kayceon,M,100,0,54,54
Keedan,M,100,0,54,54
Keelynn,F,91,49,5,54
Kengo,M,100,0,54,54
Keysa,F,100,54,0,54
Khalisha,F,100,54,0,54
Khory,M,100,0,54,54
Kilo,M,100,0,54,54
Ko,M,81,10,44,54
Konica,F,100,54,0,54
Kristyann,F,100,54,0,54
Kyiana,F,100,54,0,54
Kylii,F,100,54,0,54
Kyu,M,100,0,54,54
Ladetra,F,100,54,0,54
Lakeysa,F,100,54,0,54
Lalaina,F,100,54,0,54
Lamija,F,100,54,0,54
Landers,M,100,0,54,54
Lanese,F,100,54,0,54
Latawnya,F,100,54,0,54
Lavonn,F,70,38,16,54
Layani,F,100,54,0,54
Leanah,F,100,54,0,54
Leha,F,100,54,0,54
Lendora,F,100,54,0,54
Lillyahna,F,100,54,0,54
Lynkin,M,100,0,54,54
Maebelle,F,100,54,0,54
Mahalah,F,100,54,0,54
Mairani,F,100,54,0,54
Margaretha,F,100,54,0,54
Markecia,F,100,54,0,54
Marnetta,F,100,54,0,54
Maryonna,F,100,54,0,54
Matha,F,100,54,0,54
Meleia,F,100,54,0,54
Michealla,F,100,54,0,54
Mikeia,F,100,54,0,54
Milene,F,100,54,0,54
Millennia,F,100,54,0,54
Minela,F,100,54,0,54
Mishele,F,100,54,0,54
Muath,M,100,0,54,54
Nataisha,F,100,54,0,54
Navina,F,100,54,0,54
Neria,F,100,54,0,54
Nicia,F,100,54,0,54
Nicolly,F,100,54,0,54
Nykeisha,F,100,54,0,54
Oktober,F,100,54,0,54
Oleh,M,100,0,54,54
Paytience,F,100,54,0,54
Peggysue,F,100,54,0,54
Pelin,F,100,54,0,54
Plummer,M,100,0,54,54
Ragene,F,83,45,9,54
Rasaun,M,100,0,54,54
Ravis,M,100,0,54,54
Renice,F,100,54,0,54
Revecca,F,100,54,0,54
Rikka,F,100,54,0,54
Rini,F,100,54,0,54
Rohnda,F,100,54,0,54
Romunda,F,100,54,0,54
Ruqayya,F,100,54,0,54
Ryanjames,M,100,0,54,54
Samarria,F,100,54,0,54
Sammatha,F,100,54,0,54
Sanaiah,F,100,54,0,54
Sariana,F,100,54,0,54
Sarianna,F,100,54,0,54
Sarrinah,F,100,54,0,54
Sawsan,F,100,54,0,54
Saylee,F,100,54,0,54
Seba,F,100,54,0,54
Senaca,M,100,0,54,54
Shaguana,F,100,54,0,54
Shallan,F,100,54,0,54
Shanine,F,100,54,0,54
Sharane,F,100,54,0,54
Sharitta,F,100,54,0,54
Shaunika,F,100,54,0,54
Shelbea,F,100,54,0,54
Shenetha,F,100,54,0,54
Shevonda,F,100,54,0,54
Shonnon,F,57,31,23,54
Shryl,F,100,54,0,54
Somone,F,100,54,0,54
Syana,F,100,54,0,54
Taahira,F,100,54,0,54
Taeshon,M,100,0,54,54
Taishi,M,100,0,54,54
Tanishi,F,100,54,0,54
Taraann,F,100,54,0,54
Tasya,F,100,54,0,54
Taveion,M,100,0,54,54
Tawanya,F,100,54,0,54
Teagun,M,100,0,54,54
Teionna,F,100,54,0,54
Teleshia,F,100,54,0,54
Temeika,F,100,54,0,54
Teric,M,100,0,54,54
Terreance,M,100,0,54,54
Teshawna,F,100,54,0,54
Thaiz,F,100,54,0,54
Thomasjames,M,100,0,54,54
Tierah,F,100,54,0,54
Tiffanye,F,100,54,0,54
Toa,M,100,0,54,54
Tood,M,100,0,54,54
Trane,F,100,54,0,54
Treniyah,F,100,54,0,54
Tresure,F,100,54,0,54
Treveion,M,100,0,54,54
Twanisha,F,100,54,0,54
Tywain,M,100,0,54,54
Unita,F,100,54,0,54
Unk,M,69,17,37,54
Vaniah,F,100,54,0,54
Vaun,M,100,0,54,54
Veldon,M,100,0,54,54
Walberto,M,100,0,54,54
Wander,F,100,54,0,54
Wojciech,M,100,0,54,54
Yamily,F,100,54,0,54
Yanai,F,100,54,0,54
Yanky,M,100,0,54,54
Yelina,F,100,54,0,54
Yuvette,F,100,54,0,54
Zareena,F,100,54,0,54
Zaveion,M,100,0,54,54
Zekia,F,100,54,0,54
Zitlally,F,100,54,0,54
Aakarsh,M,100,0,53,53
Abednego,M,100,0,53,53
Abhiraj,M,100,0,53,53
Adriaunna,F,100,53,0,53
Aeryk,M,100,0,53,53
Ahley,F,100,53,0,53
Ahyanna,F,100,53,0,53
Aianna,F,100,53,0,53
Aishi,F,100,53,0,53
Ajada,F,100,53,0,53
Ajmal,M,100,0,53,53
Alannie,F,100,53,0,53
Albie,M,100,0,53,53
Aleila,F,100,53,0,53
Aleynah,F,100,53,0,53
Allin,M,100,0,53,53
Allivia,F,100,53,0,53
Alycen,F,100,53,0,53
Amariss,F,100,53,0,53
Anareli,F,100,53,0,53
Anaston,F,100,53,0,53
Andersson,M,100,0,53,53
Angula,F,100,53,0,53
Anjulie,F,100,53,0,53
Annaliah,F,100,53,0,53
Antonine,M,100,0,53,53
Anyela,F,100,53,0,53
Arali,F,100,53,0,53
Arayla,F,100,53,0,53
Ariabella,F,100,53,0,53
Arieyana,F,100,53,0,53
Arisbet,F,100,53,0,53
Aritzel,F,100,53,0,53
Arlecia,F,100,53,0,53
Arn,M,100,0,53,53
Arnice,F,100,53,0,53
Aroura,F,100,53,0,53
Atika,F,100,53,0,53
Audianna,F,100,53,0,53
Ayleah,F,100,53,0,53
Azelyn,F,100,53,0,53
Bascom,M,100,0,53,53
Bergan,F,100,53,0,53
Binnie,F,91,48,5,53
Breeya,F,100,53,0,53
Bricelyn,F,100,53,0,53
Bridge,M,91,5,48,53
Brnadon,M,100,0,53,53
Bryndle,F,100,53,0,53
Brynlynn,F,100,53,0,53
Bryseida,F,100,53,0,53
Caasi,F,100,53,0,53
Calvon,M,100,0,53,53
Carnella,F,100,53,0,53
Caronda,F,100,53,0,53
Carrey,F,89,47,6,53
Carrine,F,100,53,0,53
Cas,M,100,0,53,53
Cetera,F,100,53,0,53
Chares,M,100,0,53,53
Chinmayi,F,100,53,0,53
Ciclali,F,100,53,0,53
Colben,M,100,0,53,53
Cydnei,F,100,53,0,53
Cynthina,F,100,53,0,53
Daevin,M,100,0,53,53
Damariah,F,100,53,0,53
Danishia,F,100,53,0,53
Danye,M,77,12,41,53
Darieon,M,100,0,53,53
Dartavious,M,100,0,53,53
Dedrea,F,100,53,0,53
Demonie,M,89,6,47,53
Deshunda,F,100,53,0,53
Devane,M,100,0,53,53
Drexler,M,100,0,53,53
Ebelia,F,100,53,0,53
Elbin,M,100,0,53,53
Elizabeht,F,100,53,0,53
Ellorie,F,100,53,0,53
Elsey,F,100,53,0,53
Emia,F,100,53,0,53
Emila,F,100,53,0,53
Eryanna,F,100,53,0,53
Esiquio,M,100,0,53,53
Esveidy,F,100,53,0,53
Gibril,M,100,0,53,53
Gicelle,F,100,53,0,53
Grayci,F,100,53,0,53
Heater,F,100,53,0,53
Hebe,F,100,53,0,53
Helia,F,100,53,0,53
Herber,M,100,0,53,53
Hervin,M,100,0,53,53
Hilal,F,62,33,20,53
Huntter,M,100,0,53,53
Iago,M,100,0,53,53
Ieva,F,100,53,0,53
Inika,F,100,53,0,53
Ireana,F,100,53,0,53
Iresha,F,100,53,0,53
Isaha,M,100,0,53,53
Ishaaq,M,100,0,53,53
Issabela,F,100,53,0,53
Jahla,F,100,53,0,53
Jakar,M,100,0,53,53
Jalaila,F,100,53,0,53
Jalinda,F,100,53,0,53
Jalyse,F,100,53,0,53
Janeesa,F,100,53,0,53
Jarilyn,F,100,53,0,53
Javayah,F,100,53,0,53
Jeila,F,100,53,0,53
Jeilin,F,100,53,0,53
Jeliyah,F,100,53,0,53
Jemini,F,81,43,10,53
Jesie,F,60,32,21,53
Jherica,F,100,53,0,53
Jimaya,F,100,53,0,53
Jlah,F,100,53,0,53
Joriel,M,100,0,53,53
Jsutin,M,100,0,53,53
Juanika,F,100,53,0,53
Juleigh,F,100,53,0,53
Juliete,F,100,53,0,53
Jyana,F,100,53,0,53
Kaian,M,100,0,53,53
Kalianne,F,100,53,0,53
Kallysta,F,100,53,0,53
Karonda,F,100,53,0,53
Kashanna,F,100,53,0,53
Kata,F,100,53,0,53
Keuna,F,100,53,0,53
Keyairah,F,100,53,0,53
Keyoka,F,100,53,0,53
Keyonah,F,100,53,0,53
Keyth,M,100,0,53,53
Khaylee,F,100,53,0,53
Kionne,M,72,15,38,53
Kordai,M,100,0,53,53
Kyela,F,100,53,0,53
Lajessica,F,100,53,0,53
Lakeda,F,100,53,0,53
Lalonnie,F,100,53,0,53
Lamoni,F,66,35,18,53
Larica,F,100,53,0,53
Latresia,F,100,53,0,53
Leeona,F,100,53,0,53
Lekendra,F,100,53,0,53
Linaya,F,100,53,0,53
Lochlin,M,100,0,53,53
Maahir,M,100,0,53,53
Makalee,F,100,53,0,53
Makenleigh,F,100,53,0,53
Makenli,F,100,53,0,53
Malosi,M,100,0,53,53
Markevis,M,100,0,53,53
Marquil,M,100,0,53,53
Mayes,M,91,5,48,53
Mayraalejandra,F,100,53,0,53
Mckenah,F,100,53,0,53
Mckendra,F,100,53,0,53
Meliana,F,100,53,0,53
Merriam,F,100,53,0,53
Meyli,F,100,53,0,53
Milanya,F,100,53,0,53
Milley,F,100,53,0,53
Minyon,F,100,53,0,53
Moani,F,100,53,0,53
Montavia,F,100,53,0,53
Naidely,F,100,53,0,53
Nanita,F,100,53,0,53
Nanyamka,F,100,53,0,53
Nare,F,100,53,0,53
Navae,F,100,53,0,53
Negar,F,100,53,0,53
Nekeia,F,100,53,0,53
Ngela,F,100,53,0,53
Nilan,M,100,0,53,53
Nimah,F,100,53,0,53
Nimai,M,100,0,53,53
Nylasia,F,100,53,0,53
Nyshia,F,100,53,0,53
Oralee,F,100,53,0,53
Orbin,M,100,0,53,53
Paeyton,F,100,53,0,53
Pardeep,M,100,0,53,53
Pearlena,F,100,53,0,53
Quatina,F,100,53,0,53
Quayvon,M,100,0,53,53
Queshawn,M,100,0,53,53
Quineshia,F,100,53,0,53
Quintasha,F,100,53,0,53
Raahil,M,100,0,53,53
Rafik,M,100,0,53,53
Raife,M,100,0,53,53
Raihana,F,100,53,0,53
Rakeshia,F,100,53,0,53
Randahl,M,100,0,53,53
Ranna,F,100,53,0,53
Raphiel,M,100,0,53,53
Rayel,F,89,47,6,53
Requel,F,100,53,0,53
Rhylynn,F,100,53,0,53
Rihan,F,60,32,21,53
Rikkia,F,100,53,0,53
Riniyah,F,100,53,0,53
Ritter,M,100,0,53,53
Rodricka,F,100,53,0,53
Samnatha,F,100,53,0,53
Saveion,M,100,0,53,53
Semra,F,100,53,0,53
Seward,M,100,0,53,53
Shaki,M,100,0,53,53
Shakyah,F,100,53,0,53
Shakyrah,F,100,53,0,53
Shamyiah,F,100,53,0,53
Shaphan,M,100,0,53,53
Sharain,F,100,53,0,53
Sharya,F,100,53,0,53
Shauntrice,F,100,53,0,53
Shavondra,F,100,53,0,53
Shayquan,M,100,0,53,53
Sheriah,F,100,53,0,53
Shymir,M,100,0,53,53
Shyvonne,F,100,53,0,53
Siriah,F,100,53,0,53
Slayter,M,100,0,53,53
Soteria,F,100,53,0,53
Stefone,M,100,0,53,53
Suma,F,100,53,0,53
Sumar,F,100,53,0,53
Sumiya,F,100,53,0,53
Sundai,F,100,53,0,53
Taevyn,M,100,0,53,53
Tahina,F,100,53,0,53
Tahya,F,100,53,0,53
Tajma,F,100,53,0,53
Takuto,M,100,0,53,53
Talanda,F,100,53,0,53
Tamah,F,100,53,0,53
Taquesha,F,100,53,0,53
Tehreem,F,100,53,0,53
Terrena,F,100,53,0,53
Theus,M,100,0,53,53
Tiffeney,F,100,53,0,53
Timyra,F,100,53,0,53
Torriana,F,100,53,0,53
Trishana,F,100,53,0,53
Tyanah,F,100,53,0,53
Tykese,M,100,0,53,53
Tyneesha,F,100,53,0,53
Vaneshia,F,100,53,0,53
Vennesa,F,100,53,0,53
Wendoly,F,100,53,0,53
Yaniya,F,100,53,0,53
Yonic,M,100,0,53,53
Yvonnia,F,100,53,0,53
Zahriyah,F,100,53,0,53
Zaion,M,100,0,53,53
Zierre,M,100,0,53,53
Zinia,F,100,53,0,53
Aasin,M,100,0,52,52
Addilynne,F,100,52,0,52
Adileni,F,100,52,0,52
Adwita,F,100,52,0,52
Afi,F,100,52,0,52
Ajna,F,100,52,0,52
Alanson,M,100,0,52,52
Alberth,M,100,0,52,52
Aldous,M,100,0,52,52
Aleighna,F,100,52,0,52
Aleyia,F,100,52,0,52
Alisya,F,100,52,0,52
Alvira,F,100,52,0,52
Amymarie,F,100,52,0,52
Anacecilia,F,100,52,0,52
Andreyah,F,100,52,0,52
Anelisa,F,100,52,0,52
Angelinna,F,100,52,0,52
Antonesha,F,100,52,0,52
Antoniya,F,100,52,0,52
Apirl,F,100,52,0,52
Aritzy,F,100,52,0,52
Asami,F,100,52,0,52
Ashaad,M,100,0,52,52
Ashantie,F,100,52,0,52
Ayania,F,100,52,0,52
Bandi,F,100,52,0,52
Bassil,M,100,0,52,52
Bengy,M,100,0,52,52
Berdine,F,100,52,0,52
Bobetta,F,100,52,0,52
Bracy,M,90,5,47,52
Cacy,F,100,52,0,52
Caesare,M,81,10,42,52
Camp,M,100,0,52,52
Ceren,F,100,52,0,52
Cerinity,F,100,52,0,52
Chanden,M,100,0,52,52
Chaquetta,F,100,52,0,52
Charlen,F,100,52,0,52
Chellsey,F,100,52,0,52
Cheral,F,100,52,0,52
Cheylynn,F,100,52,0,52
Chilton,M,100,0,52,52
Choice,M,100,0,52,52
Chrissandra,F,100,52,0,52
Christophermich,M,100,0,52,52
Cieria,F,100,52,0,52
Cutina,F,100,52,0,52
Daequon,M,100,0,52,52
Daffne,F,100,52,0,52
Daicy,F,100,52,0,52
Damoney,M,100,0,52,52
Danzig,M,100,0,52,52
Dareus,M,100,0,52,52
Darisha,F,100,52,0,52
Darr,M,100,0,52,52
Daryen,M,73,14,38,52
Davae,F,90,47,5,52
Davinity,F,100,52,0,52
Dayanni,F,100,52,0,52
Dazire,F,100,52,0,52
Deboria,F,100,52,0,52
Delmira,F,100,52,0,52
Denham,M,100,0,52,52
Derisha,F,100,52,0,52
Deyaneira,F,100,52,0,52
Deyjah,F,100,52,0,52
Diaja,F,100,52,0,52
Dio,M,100,0,52,52
Efrat,F,100,52,0,52
Eilley,F,100,52,0,52
Eldwin,M,100,0,52,52
Eliajah,M,100,0,52,52
Elizette,F,100,52,0,52
Elody,F,100,52,0,52
Emelynn,F,100,52,0,52
Enyla,F,100,52,0,52
Erza,F,69,36,16,52
Euriah,M,90,5,47,52
Feliciti,F,100,52,0,52
Fifi,F,100,52,0,52
Finnan,M,100,0,52,52
Gailene,F,100,52,0,52
Garla,F,100,52,0,52
Gaya,F,100,52,0,52
Geniva,F,100,52,0,52
Geramiah,M,100,0,52,52
Glenette,F,100,52,0,52
Graelyn,F,100,52,0,52
Grizel,F,100,52,0,52
Haizley,F,100,52,0,52
Harshaan,M,100,0,52,52
Havoc,M,100,0,52,52
Hy,M,100,0,52,52
Iniki,F,87,45,7,52
Izyk,M,100,0,52,52
Jadarien,M,100,0,52,52
Jadesola,F,100,52,0,52
Jaeon,M,100,0,52,52
Jakevia,F,100,52,0,52
Jaliana,F,100,52,0,52
Janaa,F,100,52,0,52
Javeyon,M,100,0,52,52
Jaysten,M,100,0,52,52
Jefery,M,100,0,52,52
Jermecia,F,100,52,0,52
Jermyn,M,100,0,52,52
Jerniya,F,100,52,0,52
Jerniyah,F,100,52,0,52
Jesean,M,100,0,52,52
Jheremy,M,100,0,52,52
Jimari,M,100,0,52,52
Joliet,F,100,52,0,52
Joneshia,F,100,52,0,52
Jonnathon,M,100,0,52,52
Jorman,M,100,0,52,52
Kadaja,F,100,52,0,52
Kaicen,M,100,0,52,52
Kamrey,F,100,52,0,52
Kasaun,M,100,0,52,52
Katona,F,100,52,0,52
Kemarrion,M,100,0,52,52
Kendia,F,100,52,0,52
Keyonce,F,100,52,0,52
Keywan,M,100,0,52,52
Khamaria,F,100,52,0,52
Kippi,F,100,52,0,52
Kongpheng,M,100,0,52,52
Kratos,M,100,0,52,52
Krishav,M,100,0,52,52
Krisie,F,100,52,0,52
Kristanna,F,100,52,0,52
Krister,M,69,16,36,52
Kunga,M,75,13,39,52
Kutina,F,100,52,0,52
Kynia,F,100,52,0,52
Kyong,F,100,52,0,52
Laderrius,M,100,0,52,52
Lashonya,F,100,52,0,52
Laverda,F,100,52,0,52
Layman,M,100,0,52,52
Lear,M,56,23,29,52
Lenis,M,73,14,38,52
Leslei,F,100,52,0,52
Lexiss,F,100,52,0,52
Lillymae,F,100,52,0,52
Lukes,M,100,0,52,52
Lyndora,F,100,52,0,52
Maan,M,100,0,52,52
Madilee,F,100,52,0,52
Malechi,M,100,0,52,52
Margee,F,100,52,0,52
Mariangely,F,100,52,0,52
Marqueshia,F,100,52,0,52
Marquite,F,100,52,0,52
Maryjose,F,100,52,0,52
Matalynn,F,100,52,0,52
Maximillan,M,100,0,52,52
Maymuna,F,100,52,0,52
Mccain,M,100,0,52,52
Michellee,F,100,52,0,52
Mihai,M,100,0,52,52
Mikalya,F,100,52,0,52
Moeshia,F,100,52,0,52
Naelani,F,100,52,0,52
Nainika,F,100,52,0,52
Najay,F,50,26,26,52
Najely,F,100,52,0,52
Nakendra,F,100,52,0,52
Nakeria,F,100,52,0,52
Naleigh,F,100,52,0,52
Nancyjo,F,100,52,0,52
Natahsa,F,100,52,0,52
Nathally,F,100,52,0,52
Nayonna,F,100,52,0,52
Neilah,F,100,52,0,52
Nesly,F,90,47,5,52
Nhyla,F,100,52,0,52
Nichalous,M,100,0,52,52
Nikera,F,100,52,0,52
Nikhila,F,100,52,0,52
Nikoloz,M,100,0,52,52
Norissa,F,100,52,0,52
Nyila,F,100,52,0,52
Ogechukwu,F,88,46,6,52
Oley,M,100,0,52,52
Olubunmi,F,100,52,0,52
Oluwateniola,F,88,46,6,52
Omaya,F,100,52,0,52
Oneshia,F,100,52,0,52
Ong,F,100,52,0,52
Orlene,F,100,52,0,52
Paytn,F,100,52,0,52
Phalon,F,71,37,15,52
Philopater,M,100,0,52,52
Pranjal,F,56,29,23,52
Quion,M,100,0,52,52
Raaga,F,100,52,0,52
Raime,F,100,52,0,52
Rajdeep,M,79,11,41,52
Ramah,F,100,52,0,52
Rawson,M,100,0,52,52
Raylynne,F,100,52,0,52
Rayvn,F,100,52,0,52
Reggy,M,100,0,52,52
Rheda,F,100,52,0,52
Ridhaan,M,100,0,52,52
Rucker,M,100,0,52,52
Ryant,M,100,0,52,52
Sachit,M,100,0,52,52
Salif,M,100,0,52,52
Sarh,F,100,52,0,52
Saroya,F,100,52,0,52
Sarp,M,100,0,52,52
Sequioa,F,100,52,0,52
Shadea,F,100,52,0,52
Shaen,M,100,0,52,52
Shagun,F,100,52,0,52
Shaia,F,100,52,0,52
Shakenna,F,100,52,0,52
Shakilya,F,100,52,0,52
Shalyse,F,100,52,0,52
Shamani,F,100,52,0,52
Shamil,M,71,15,37,52
Sharl,F,100,52,0,52
Shaterika,F,100,52,0,52
Shawnea,F,100,52,0,52
Shellena,F,100,52,0,52
Shenan,F,52,27,25,52
Shylia,F,100,52,0,52
Shylie,F,100,52,0,52
Siam,M,100,0,52,52
Siann,F,100,52,0,52
Silka,F,100,52,0,52
Skylarr,F,100,52,0,52
Smauel,M,100,0,52,52
Sofian,M,100,0,52,52
Stanlee,M,100,0,52,52
Taea,F,100,52,0,52
Takema,F,100,52,0,52
Tamarie,F,100,52,0,52
Taneja,F,100,52,0,52
Tanell,F,100,52,0,52
Tarasha,F,100,52,0,52
Tasi,F,69,36,16,52
Tasmin,F,100,52,0,52
Tateum,M,52,25,27,52
Tavianna,F,100,52,0,52
Taycee,F,100,52,0,52
Tho,M,88,6,46,52
Tkia,F,100,52,0,52
Tristynn,F,100,52,0,52
Troylynn,F,100,52,0,52
Tyanthony,M,100,0,52,52
Tyberious,M,100,0,52,52
Tyvin,M,100,0,52,52
Vertina,F,100,52,0,52
Veyonce,F,100,52,0,52
Vyncent,M,100,0,52,52
Waheed,M,100,0,52,52
Wanona,F,100,52,0,52
Whittni,F,100,52,0,52
Woodford,M,100,0,52,52
Xitllali,F,100,52,0,52
Zareyah,F,100,52,0,52
Zeah,F,100,52,0,52
Zee,M,71,15,37,52
Zethan,M,100,0,52,52
Aamyah,F,100,51,0,51
Adaia,F,100,51,0,51
Addiel,M,100,0,51,51
Adeli,F,100,51,0,51
Admire,F,100,51,0,51
Adrein,M,100,0,51,51
Adrijana,F,100,51,0,51
Afifa,F,100,51,0,51
Afshin,M,100,0,51,51
Ahri,F,100,51,0,51
Aileah,F,100,51,0,51
Alailah,F,100,51,0,51
Alescia,F,100,51,0,51
Alilah,F,100,51,0,51
Aliyiah,F,100,51,0,51
Almer,M,90,5,46,51
Alonni,F,100,51,0,51
Alucard,M,100,0,51,51
Amaurion,M,100,0,51,51
Ambreia,F,100,51,0,51
Anaaya,F,100,51,0,51
Ancelmo,M,100,0,51,51
Andrielle,F,100,51,0,51
Andrw,M,100,0,51,51
Anjail,F,100,51,0,51
Annayah,F,100,51,0,51
Anngela,F,100,51,0,51
Annisten,F,100,51,0,51
Ardi,M,100,0,51,51
Arlesha,F,100,51,0,51
Aryanne,F,100,51,0,51
Asean,M,100,0,51,51
Ashaureah,F,100,51,0,51
Ashmi,F,100,51,0,51
Aysen,M,100,0,51,51
Azalya,F,100,51,0,51
Bemnet,F,53,27,24,51
Benet,M,61,20,31,51
Bennette,F,78,40,11,51
Bernadene,F,100,51,0,51
Birda,F,100,51,0,51
Birttany,F,100,51,0,51
Blaklee,F,100,51,0,51
Breella,F,100,51,0,51
Brenlyn,F,100,51,0,51
Buena,F,100,51,0,51
Callysta,F,100,51,0,51
Camerron,M,100,0,51,51
Cantrice,F,100,51,0,51
Casonya,F,100,51,0,51
Celyna,F,100,51,0,51
Charra,F,100,51,0,51
Chayenne,F,100,51,0,51
Chinaza,F,100,51,0,51
Ciniya,F,100,51,0,51
Clorisa,F,100,51,0,51
Colee,F,100,51,0,51
Cordasia,F,100,51,0,51
Costello,M,100,0,51,51
Cristhofer,M,100,0,51,51
Crysti,F,100,51,0,51
Dahna,F,100,51,0,51
Dakira,F,100,51,0,51
Daksha,F,100,51,0,51
Dandrew,M,100,0,51,51
Danniele,F,100,51,0,51
Daquita,F,100,51,0,51
Darrilyn,F,100,51,0,51
Dawnesha,F,100,51,0,51
Daxtin,M,100,0,51,51
Deadre,F,100,51,0,51
Deasya,F,100,51,0,51
Delson,M,100,0,51,51
Demetriana,F,100,51,0,51
Demitre,M,100,0,51,51
Denaysia,F,100,51,0,51
Derri,F,100,51,0,51
Deyvon,M,100,0,51,51
Dieon,M,100,0,51,51
Dmia,F,100,51,0,51
Donsha,F,51,26,25,51
Ehlana,F,100,51,0,51
Elianis,F,100,51,0,51
Elisabella,F,100,51,0,51
Elisavet,F,100,51,0,51
Ellianne,F,100,51,0,51
Emilina,F,100,51,0,51
Emjay,F,55,28,23,51
Endre,M,100,0,51,51
Esam,M,100,0,51,51
Esmay,F,100,51,0,51
Etheleen,F,100,51,0,51
Gaonou,F,100,51,0,51
Genella,F,100,51,0,51
Giamarie,F,100,51,0,51
Gopi,F,100,51,0,51
Gudelia,F,100,51,0,51
Gyzelle,F,100,51,0,51
Haizel,F,100,51,0,51
Harrie,M,86,7,44,51
Hassell,M,100,0,51,51
Hektor,M,100,0,51,51
Henning,M,100,0,51,51
Hillman,M,100,0,51,51
Huntyr,F,73,37,14,51
Ikeia,F,100,51,0,51
Intisar,F,100,51,0,51
Jadarrion,M,100,0,51,51
Jaguar,M,100,0,51,51
Jahida,F,100,51,0,51
Jahnyla,F,100,51,0,51
Jaiyanna,F,100,51,0,51
Jaleesha,F,100,51,0,51
Jameyah,F,100,51,0,51
Janetzy,F,100,51,0,51
Jarnell,M,100,0,51,51
Jarol,M,100,0,51,51
Jeanina,F,100,51,0,51
Jenard,M,100,0,51,51
Jennay,F,100,51,0,51
Jeraldy,F,100,51,0,51
Jeray,M,100,0,51,51
Jeromiah,M,100,0,51,51
Jkai,M,100,0,51,51
Jkobe,M,100,0,51,51
Johnique,F,100,51,0,51
Jontel,M,61,20,31,51
Jordano,M,100,0,51,51
Jymere,M,100,0,51,51
Kaikoa,M,100,0,51,51
Kalyah,F,100,51,0,51
Kamirra,F,100,51,0,51
Karrine,F,100,51,0,51
Karthika,F,100,51,0,51
Karynna,F,100,51,0,51
Kashanti,F,100,51,0,51
Keeta,F,100,51,0,51
Keimarion,M,100,0,51,51
Kemaury,M,100,0,51,51
Kenika,F,100,51,0,51
Kevaun,M,100,0,51,51
Keynon,M,100,0,51,51
Khadijatou,F,100,51,0,51
Khamar,M,100,0,51,51
Khasir,M,100,0,51,51
Klyde,M,100,0,51,51
Kourtny,F,100,51,0,51
Krishay,M,100,0,51,51
Kylena,F,100,51,0,51
Lakecha,F,100,51,0,51
Laleh,F,100,51,0,51
Larrion,M,100,0,51,51
Lavayah,F,100,51,0,51
Lavoy,M,100,0,51,51
Laylana,F,100,51,0,51
Leanor,F,100,51,0,51
Leeman,M,100,0,51,51
Libertad,F,100,51,0,51
Lidiana,F,100,51,0,51
Liyanna,F,100,51,0,51
Lizelle,F,100,51,0,51
Loxley,F,80,41,10,51
Lucee,F,100,51,0,51
Lycan,M,100,0,51,51
Lylie,F,100,51,0,51
Lysbeth,F,100,51,0,51
Maddysen,F,100,51,0,51
Madelinn,F,100,51,0,51
Madellyn,F,100,51,0,51
Mahak,F,100,51,0,51
Makenlie,F,100,51,0,51
Makensy,F,100,51,0,51
Makynlie,F,100,51,0,51
Malacki,M,100,0,51,51
Malaky,M,100,0,51,51
Marigny,F,100,51,0,51
Markhi,M,100,0,51,51
Markian,M,100,0,51,51
Marsel,M,100,0,51,51
Marua,F,100,51,0,51
Marybella,F,100,51,0,51
Maximas,M,100,0,51,51
Mayrim,F,100,51,0,51
Melachi,M,100,0,51,51
Michaline,F,100,51,0,51
Michealle,F,100,51,0,51
Mickenna,F,100,51,0,51
Mihailo,M,100,0,51,51
Milaina,F,100,51,0,51
Moataz,M,100,0,51,51
Montee,M,100,0,51,51
Monyette,F,100,51,0,51
Muneerah,F,100,51,0,51
Myalee,F,100,51,0,51
Mykesha,F,100,51,0,51
Mykhi,M,100,0,51,51
Mythias,M,100,0,51,51
Nasiir,M,100,0,51,51
Nedal,M,100,0,51,51
Neelesh,M,100,0,51,51
Neika,F,100,51,0,51
Nicholad,M,100,0,51,51
Nihaal,M,100,0,51,51
Nikkisha,F,100,51,0,51
Nikoleta,F,100,51,0,51
Nilaja,F,100,51,0,51
Notorious,M,100,0,51,51
Nox,M,100,0,51,51
Numair,M,100,0,51,51
Nykesha,F,100,51,0,51
Ofir,M,90,5,46,51
Okoye,M,100,0,51,51
Olisa,F,100,51,0,51
Oluwatomiwa,M,100,0,51,51
Omario,M,100,0,51,51
Pretty,F,100,51,0,51
Prudy,F,100,51,0,51
Qadira,F,100,51,0,51
Quasia,F,100,51,0,51
Quaylon,M,100,0,51,51
Quetcy,F,100,51,0,51
Qwanell,M,100,0,51,51
Rafa,F,67,34,17,51
Rahat,M,90,5,46,51
Ramsie,F,100,51,0,51
Raschel,F,100,51,0,51
Reeta,F,100,51,0,51
Rhoderick,M,100,0,51,51
Ridgely,M,90,5,46,51
Rommell,M,100,0,51,51
Rontavius,M,100,0,51,51
Rosalynda,F,100,51,0,51
Roseland,F,100,51,0,51
Saahas,M,100,0,51,51
Seini,F,100,51,0,51
Seleny,F,100,51,0,51
Serine,F,100,51,0,51
Shannae,F,100,51,0,51
Shannetta,F,100,51,0,51
Shardee,F,100,51,0,51
Sherle,F,100,51,0,51
Sherol,F,100,51,0,51
Shikera,F,100,51,0,51
Shontrell,F,100,51,0,51
Smitha,F,100,51,0,51
Soraiya,F,100,51,0,51
Srihith,M,100,0,51,51
Stylianos,M,100,0,51,51
Sunee,F,100,51,0,51
Surah,F,100,51,0,51
Suriel,M,100,0,51,51
Suzett,F,100,51,0,51
Sydna,F,100,51,0,51
Takeema,F,100,51,0,51
Tatyanah,F,100,51,0,51
Teera,F,100,51,0,51
Teriyah,F,100,51,0,51
Tevaughn,M,100,0,51,51
Tizoc,M,100,0,51,51
Trisia,F,100,51,0,51
Turki,M,100,0,51,51
Tyelor,M,100,0,51,51
Tyjuana,F,100,51,0,51
Tymisha,F,100,51,0,51
Tytiyana,F,100,51,0,51
Videl,F,63,32,19,51
Willey,M,100,0,51,51
Willoughby,M,65,18,33,51
Xiadani,F,100,51,0,51
Yalda,F,100,51,0,51
Yanneli,F,100,51,0,51
Yaribel,F,100,51,0,51
Yentl,F,100,51,0,51
Yireh,F,100,51,0,51
Yousof,M,100,0,51,51
Zakaree,M,100,0,51,51
Zannah,F,100,51,0,51
Zarrah,F,100,51,0,51
Zekhi,M,100,0,51,51
Zenita,F,100,51,0,51
Zitlalic,F,100,51,0,51
Zmya,F,100,51,0,51
Zoann,F,100,51,0,51
Zyrus,M,100,0,51,51
Aara,F,100,50,0,50
Abishek,M,100,0,50,50
Adahir,M,100,0,50,50
Adilson,M,100,0,50,50
Adisynne,F,100,50,0,50
Akeim,M,100,0,50,50
Alenda,F,100,50,0,50
Alizandra,F,100,50,0,50
Alveena,F,100,50,0,50
Amaad,M,100,0,50,50
Amazin,F,100,50,0,50
Anat,F,100,50,0,50
Anatoliy,M,100,0,50,50
Anayelli,F,100,50,0,50
Anetha,F,100,50,0,50
Aniessa,F,100,50,0,50
Annison,F,100,50,0,50
Antelmo,M,100,0,50,50
Apollos,M,100,0,50,50
Araeya,F,100,50,0,50
Ardene,F,100,50,0,50
Areg,M,100,0,50,50
Ariyahna,F,100,50,0,50
Arkisha,F,100,50,0,50
Arles,M,100,0,50,50
Artan,M,100,0,50,50
Arthea,F,100,50,0,50
Aryann,F,100,50,0,50
Ashay,F,54,27,23,50
Asna,F,100,50,0,50
Assia,F,100,50,0,50
Astasia,F,100,50,0,50
Azaliyah,F,100,50,0,50
Azalynn,F,100,50,0,50
Azumi,F,100,50,0,50
Azuriah,M,100,0,50,50
Bach,M,100,0,50,50
Baeli,F,100,50,0,50
Balraj,M,100,0,50,50
Bly,M,100,0,50,50
Boedy,M,100,0,50,50
Briniyah,F,100,50,0,50
Briuna,F,100,50,0,50
Brynlei,F,100,50,0,50
Carlosmanuel,M,100,0,50,50
Carmindy,F,100,50,0,50
Carreen,F,100,50,0,50
Cathrina,F,100,50,0,50
Cathyjo,F,100,50,0,50
Cathyrn,F,100,50,0,50
Cesley,F,100,50,0,50
Chaske,M,100,0,50,50
Chaye,F,100,50,0,50
Cherlene,F,100,50,0,50
Chrysti,F,100,50,0,50
Cnythia,F,100,50,0,50
Couture,F,100,50,0,50
Cuba,M,54,23,27,50
Dack,M,100,0,50,50
Damire,M,100,0,50,50
Dejanai,F,100,50,0,50
Delman,M,100,0,50,50
Denashia,F,100,50,0,50
Dencil,M,100,0,50,50
Dennine,F,100,50,0,50
Denzelle,M,100,0,50,50
Deri,F,100,50,0,50
Devvin,M,100,0,50,50
Diksha,F,100,50,0,50
Doralyn,F,100,50,0,50
Dyemond,F,100,50,0,50
Dymere,M,100,0,50,50
Egor,M,100,0,50,50
Emonii,F,100,50,0,50
Erubey,M,100,0,50,50
Evalyse,F,100,50,0,50
Evanjelina,F,100,50,0,50
Evvie,F,100,50,0,50
Falina,F,100,50,0,50
Faven,F,100,50,0,50
Ganiyah,F,100,50,0,50
Gemari,M,100,0,50,50
Giankarlo,M,100,0,50,50
Gitzel,F,100,50,0,50
Governor,M,100,0,50,50
Gradon,M,100,0,50,50
Guneet,F,100,50,0,50
Hallelujah,F,100,50,0,50
Hamida,F,100,50,0,50
Hazelynn,F,100,50,0,50
Hazyl,F,100,50,0,50
Heddy,F,100,50,0,50
Herma,F,100,50,0,50
Hosey,M,100,0,50,50
Hriday,M,100,0,50,50
Hughey,M,100,0,50,50
Hussan,M,100,0,50,50
Ichiro,M,100,0,50,50
Ieshea,F,100,50,0,50
Imagin,F,100,50,0,50
Indria,F,100,50,0,50
Inetha,F,100,50,0,50
Izsak,M,100,0,50,50
Jacquely,F,100,50,0,50
Jaeleah,F,100,50,0,50
Jaeley,F,100,50,0,50
Jaielle,F,100,50,0,50
Jaileigh,F,100,50,0,50
Jakima,F,100,50,0,50
Janemarie,F,100,50,0,50
Jarreth,M,100,0,50,50
Jary,M,100,0,50,50
Jaskiran,F,100,50,0,50
Jaydrien,M,100,0,50,50
Jayelynn,F,100,50,0,50
Jazayah,F,100,50,0,50
Jeaneane,F,100,50,0,50
Jeida,F,100,50,0,50
Jeptha,M,100,0,50,50
Jeramih,M,100,0,50,50
Jeremiha,M,100,0,50,50
Jerina,F,100,50,0,50
Jhonen,M,100,0,50,50
Johnee,F,100,50,0,50
Jonnetta,F,100,50,0,50
Jsiah,M,100,0,50,50
Jully,F,100,50,0,50
Kahlilah,F,100,50,0,50
Kahmani,M,78,11,39,50
Kaliyan,F,100,50,0,50
Kamili,F,100,50,0,50
Kanecia,F,100,50,0,50
Karliah,F,100,50,0,50
Keivan,M,100,0,50,50
Kelena,F,100,50,0,50
Kenja,F,100,50,0,50
Keris,F,100,50,0,50
Ketia,F,100,50,0,50
Keyleen,F,100,50,0,50
Keyvan,M,100,0,50,50
Khadijha,F,100,50,0,50
Kieona,F,100,50,0,50
Kiyanah,F,100,50,0,50
Kristoph,M,100,0,50,50
Kylina,F,100,50,0,50
Kynsli,F,100,50,0,50
Lachon,F,90,45,5,50
Lacia,F,100,50,0,50
Lailana,F,100,50,0,50
Laraina,F,100,50,0,50
Latavian,M,100,0,50,50
Lesile,F,90,45,5,50
Leyani,F,100,50,0,50
Liad,M,100,0,50,50
Life,M,66,17,33,50
Lilymarie,F,100,50,0,50
Lissie,F,100,50,0,50
Llana,F,100,50,0,50
Lucresia,F,100,50,0,50
Lydea,F,100,50,0,50
Lytzy,F,100,50,0,50
Madelen,F,100,50,0,50
Makaliah,F,100,50,0,50
Makda,F,100,50,0,50
Malakia,M,84,8,42,50
Malikia,F,90,45,5,50
Manrique,M,100,0,50,50
Marai,F,100,50,0,50
Maricar,F,100,50,0,50
Marilisa,F,100,50,0,50
Marizela,F,100,50,0,50
Martiana,F,100,50,0,50
Masahiro,M,100,0,50,50
Matalin,F,100,50,0,50
Mekiya,F,100,50,0,50
Melbin,M,100,0,50,50
Meldrick,M,100,0,50,50
Merredith,F,100,50,0,50
Michaeldavid,M,100,0,50,50
Mikera,F,100,50,0,50
Mikol,M,100,0,50,50
Milledge,M,100,0,50,50
Miray,F,100,50,0,50
Modou,M,100,0,50,50
Montego,M,100,0,50,50
Mozes,M,100,0,50,50
Nakaylah,F,100,50,0,50
Nalany,F,100,50,0,50
Necha,F,100,50,0,50
Nemanja,M,100,0,50,50
Niela,F,100,50,0,50
Nikolaj,M,100,0,50,50
Nirvi,F,100,50,0,50
Nitesh,M,100,0,50,50
Nollan,M,100,0,50,50
Norhan,F,100,50,0,50
Nyella,F,100,50,0,50
Olie,M,80,10,40,50
Omnia,F,100,50,0,50
Oneill,M,100,0,50,50
Othell,M,100,0,50,50
Patia,F,100,50,0,50
Persayus,F,100,50,0,50
Pranshu,M,100,0,50,50
Quaniesha,F,100,50,0,50
Quentasia,F,100,50,0,50
Rabekah,F,100,50,0,50
Rachid,M,100,0,50,50
Raffael,M,100,0,50,50
Rahniya,F,100,50,0,50
Raimi,F,100,50,0,50
Rally,M,100,0,50,50
Ranald,M,100,0,50,50
Randeep,M,100,0,50,50
Raniesha,F,100,50,0,50
Recco,M,100,0,50,50
Renaud,M,100,0,50,50
Renecia,F,100,50,0,50
Reshell,F,100,50,0,50
Rhyana,F,100,50,0,50
Rhylei,F,100,50,0,50
Ricko,M,100,0,50,50
Roczen,M,100,0,50,50
Rodrigus,M,100,0,50,50
Romyn,M,100,0,50,50
Royd,M,100,0,50,50
Rusell,M,100,0,50,50
Rykker,M,100,0,50,50
Saanvika,F,100,50,0,50
Sabastain,M,100,0,50,50
Salsabeel,F,100,50,0,50
Salvatrice,F,100,50,0,50
Sandrika,F,100,50,0,50
Sashenka,F,100,50,0,50
Shadeja,F,100,50,0,50
Shahzeb,M,100,0,50,50
Shaneiqua,F,100,50,0,50
Shareeta,F,100,50,0,50
Shatiya,F,100,50,0,50
Shaula,F,100,50,0,50
Shaunti,F,100,50,0,50
Shavy,F,100,50,0,50
Shawniqua,F,100,50,0,50
Shenouda,M,100,0,50,50
Sherone,F,80,40,10,50
Shonell,F,100,50,0,50
Shvonne,F,100,50,0,50
Shyonna,F,100,50,0,50
Skyi,F,100,50,0,50
Sritha,F,100,50,0,50
Suelynn,F,100,50,0,50
Syeed,M,100,0,50,50
Tachelle,F,100,50,0,50
Taivion,M,100,0,50,50
Talika,F,100,50,0,50
Tammika,F,100,50,0,50
Taneyah,F,100,50,0,50
Tarianna,F,100,50,0,50
Tasheana,F,100,50,0,50
Tayley,F,100,50,0,50
Teneille,F,100,50,0,50
Terick,M,100,0,50,50
Teshon,M,100,0,50,50
Thessaly,F,100,50,0,50
Tiniya,F,100,50,0,50
Tomecia,F,100,50,0,50
Tomomi,F,100,50,0,50
Torrean,M,100,0,50,50
Trayvone,M,100,0,50,50
Treton,M,100,0,50,50
Treymon,M,100,0,50,50
Trischa,F,100,50,0,50
Tywuan,M,100,0,50,50
Tziah,M,76,12,38,50
Valma,F,100,50,0,50
Valynn,F,100,50,0,50
Vannak,M,100,0,50,50
Vernida,F,100,50,0,50
Vyolet,F,100,50,0,50
Wayneisha,F,100,50,0,50
Wydell,M,100,0,50,50
Wyvonne,F,100,50,0,50
Xiclali,F,100,50,0,50
Yaden,M,100,0,50,50
Yamika,F,100,50,0,50
Yamini,F,100,50,0,50
Yanell,F,100,50,0,50
Yehya,M,100,0,50,50
Yhair,M,100,0,50,50
Yolotzin,F,100,50,0,50
Zae,M,100,0,50,50
Zakar,M,100,0,50,50
Zanib,F,100,50,0,50
Zaryn,F,56,28,22,50
Zoanne,F,100,50,0,50
Abdulrehman,M,100,0,49,49
Adaleah,F,100,49,0,49
Adelicia,F,100,49,0,49
Aerick,M,100,0,49,49
Ahjah,F,100,49,0,49
Akelah,F,100,49,0,49
Alaster,M,100,0,49,49
Aleighya,F,100,49,0,49
Alexandrew,M,100,0,49,49
Alexjandro,M,100,0,49,49
Aleydis,F,100,49,0,49
Alijha,M,78,11,38,49
Alistar,M,100,0,49,49
Aliviana,F,100,49,0,49
Almetta,F,100,49,0,49
Amarachukwu,F,100,49,0,49
Amarelis,F,100,49,0,49
Amirr,M,100,0,49,49
Amme,F,100,49,0,49
Amorion,M,100,0,49,49
Analeya,F,100,49,0,49
Analuz,F,100,49,0,49
Annitra,F,100,49,0,49
Arianie,F,100,49,0,49
Ashaley,F,100,49,0,49
Audia,F,100,49,0,49
Austun,M,100,0,49,49
Avish,M,100,0,49,49
Ayren,M,90,5,44,49
Baltasar,M,100,0,49,49
Bellamie,F,100,49,0,49
Berkay,M,100,0,49,49
Bernadina,F,100,49,0,49
Berneda,F,100,49,0,49
Betrice,F,100,49,0,49
Bg,F,100,49,0,49
Bracey,M,59,20,29,49
Breannia,F,100,49,0,49
Brihany,F,100,49,0,49
Briniya,F,100,49,0,49
Brint,M,100,0,49,49
Browning,M,100,0,49,49
Camrey,F,100,49,0,49
Cayse,M,59,20,29,49
Ceiara,F,100,49,0,49
Celecia,F,100,49,0,49
Chandice,F,100,49,0,49
Chelsay,F,100,49,0,49
Chesni,F,100,49,0,49
Christoff,M,100,0,49,49
Cinamon,F,100,49,0,49
Clayden,M,100,0,49,49
Cleaster,F,90,44,5,49
Clendon,M,100,0,49,49
Clowie,F,100,49,0,49
Corye,M,100,0,49,49
Courntey,F,100,49,0,49
Dag,M,100,0,49,49
Dakai,M,100,0,49,49
Daqwon,M,100,0,49,49
Dashton,M,100,0,49,49
Dayatra,F,100,49,0,49
Declin,M,100,0,49,49
Deericka,F,100,49,0,49
Deianeira,F,100,49,0,49
Delasia,F,100,49,0,49
Deontai,M,100,0,49,49
Desmarie,F,100,49,0,49
Devlynn,F,100,49,0,49
Dkayla,F,100,49,0,49
Dmichael,M,100,0,49,49
Dontia,F,73,36,13,49
Doralene,F,100,49,0,49
Dorisa,F,100,49,0,49
Dorota,F,100,49,0,49
Dristen,M,90,5,44,49
Duell,M,100,0,49,49
Eiliana,F,100,49,0,49
Ellysia,F,100,49,0,49
Eloni,F,100,49,0,49
Eraclio,M,100,0,49,49
Eshwar,M,100,0,49,49
Estle,M,100,0,49,49
Eugune,M,100,0,49,49
Evalisse,F,100,49,0,49
Fabain,M,100,0,49,49
Field,M,100,0,49,49
Florestine,F,100,49,0,49
Gearline,F,100,49,0,49
Genard,M,100,0,49,49
Gerlene,F,100,49,0,49
Gleason,M,100,0,49,49
Glendaly,F,100,49,0,49
Gralin,M,100,0,49,49
Gunnison,M,100,0,49,49
Gurvir,M,100,0,49,49
Haadiya,F,100,49,0,49
Hance,M,100,0,49,49
Herrick,M,100,0,49,49
Hulen,M,100,0,49,49
Ikeshia,F,100,49,0,49
Ilise,F,100,49,0,49
Iliza,F,100,49,0,49
Illias,M,100,0,49,49
Inman,M,100,0,49,49
Inocencia,F,100,49,0,49
Ishara,F,100,49,0,49
Ismenia,F,100,49,0,49
Issack,M,100,0,49,49
Ivry,F,90,44,5,49
Jacqlynn,F,100,49,0,49
Jadeon,M,100,0,49,49
Jahnyah,F,100,49,0,49
Jaiyon,M,100,0,49,49
Jamele,M,100,0,49,49
Jaric,M,100,0,49,49
Jaspal,M,100,0,49,49
Jayleana,F,100,49,0,49
Jayvonte,M,100,0,49,49
Jeffy,M,100,0,49,49
Jovina,F,100,49,0,49
Joziyah,M,100,0,49,49
Juwanna,F,100,49,0,49
Jyzelle,F,100,49,0,49
Kaamilya,F,100,49,0,49
Kadeesha,F,100,49,0,49
Kailyne,F,100,49,0,49
Kaleal,M,100,0,49,49
Kalii,F,100,49,0,49
Kamerion,M,100,0,49,49
Katielyn,F,100,49,0,49
Kedan,M,100,0,49,49
Keeland,M,100,0,49,49
Kenderrick,M,100,0,49,49
Kenlynn,F,100,49,0,49
Kenzell,M,100,0,49,49
Kevisha,F,100,49,0,49
Kevonne,M,88,6,43,49
Keyonni,F,100,49,0,49
Kierin,M,65,17,32,49
Knya,F,100,49,0,49
Kweisi,M,100,0,49,49
Kymm,F,100,49,0,49
Kynadie,F,100,49,0,49
Kyzen,M,100,0,49,49
Ladeidra,F,100,49,0,49
Lamarquis,M,100,0,49,49
Lamor,M,100,0,49,49
Lanautica,F,100,49,0,49
Laquintin,M,100,0,49,49
Laquishia,F,100,49,0,49
Larayah,F,100,49,0,49
Latreese,F,100,49,0,49
Laylamarie,F,100,49,0,49
Lerry,M,100,0,49,49
Letoria,F,100,49,0,49
Linah,F,100,49,0,49
Lumumba,M,100,0,49,49
Maanas,M,100,0,49,49
Macheal,M,67,16,33,49
Madalina,F,100,49,0,49
Madeleyn,F,100,49,0,49
Mandra,F,100,49,0,49
Marliyah,F,100,49,0,49
Marshai,F,100,49,0,49
Mckenly,F,90,44,5,49
Mekenzi,F,100,49,0,49
Meris,F,100,49,0,49
Mikiala,F,100,49,0,49
Minori,F,100,49,0,49
Modestine,F,100,49,0,49
Momo,F,100,49,0,49
Montero,M,100,0,49,49
Morgun,M,100,0,49,49
Mulki,F,100,49,0,49
Munachiso,F,80,39,10,49
Mutasim,M,100,0,49,49
Nakeema,F,100,49,0,49
Naleigha,F,100,49,0,49
Naoto,M,100,0,49,49
Nathaiel,M,100,0,49,49
Natthew,M,100,0,49,49
Naveh,F,100,49,0,49
Nayson,M,100,0,49,49
Nessiah,F,80,39,10,49
Nickelle,F,100,49,0,49
Nohlan,M,100,0,49,49
Nonna,F,100,49,0,49
Noriel,M,100,0,49,49
Nuriel,M,100,0,49,49
Nyhla,F,100,49,0,49
Oceania,F,100,49,0,49
Oniyah,F,100,49,0,49
Opeyemi,F,61,30,19,49
Paisli,F,100,49,0,49
Pavithra,F,100,49,0,49
Permelia,F,100,49,0,49
Phabian,M,100,0,49,49
Pleasant,M,78,11,38,49
Prabhleen,F,100,49,0,49
Raahim,M,100,0,49,49
Radhames,M,100,0,49,49
Rakell,F,100,49,0,49
Ramirez,M,100,0,49,49
Randarius,M,100,0,49,49
Rasmus,M,100,0,49,49
Rayelynn,F,100,49,0,49
Recia,F,100,49,0,49
Rikiya,F,100,49,0,49
Rodregus,M,100,0,49,49
Rosangel,F,100,49,0,49
Rushabh,M,100,0,49,49
Saabir,M,100,0,49,49
Sacred,F,100,49,0,49
Sadiqa,F,100,49,0,49
Sanjaya,M,73,13,36,49
Sanyi,F,100,49,0,49
Satcha,F,100,49,0,49
Seona,F,100,49,0,49
Sequana,F,100,49,0,49
Shalei,F,100,49,0,49
Shandalyn,F,100,49,0,49
Shardea,F,100,49,0,49
Sharlin,F,100,49,0,49
Sharn,M,53,23,26,49
Shrina,F,100,49,0,49
Slader,M,100,0,49,49
Stefana,F,100,49,0,49
Stpehen,M,100,0,49,49
Sunjay,M,100,0,49,49
Symonne,F,100,49,0,49
Tabius,M,100,0,49,49
Tahia,F,100,49,0,49
Taiveon,M,100,0,49,49
Takayuki,M,100,0,49,49
Tamyiah,F,100,49,0,49
Tanyanika,F,100,49,0,49
Tarrel,M,100,0,49,49
Teniesha,F,100,49,0,49
Tharun,M,100,0,49,49
Theodoric,M,100,0,49,49
Tilisha,F,100,49,0,49
Tommey,M,100,0,49,49
Toronto,M,100,0,49,49
Traeger,M,100,0,49,49
Treighton,M,100,0,49,49
Treneice,F,100,49,0,49
Tyionna,F,100,49,0,49
Tykwan,M,100,0,49,49
Tyonne,M,67,16,33,49
Tyriece,M,100,0,49,49
Tysheen,M,100,0,49,49
Vandora,F,100,49,0,49
Vernae,F,100,49,0,49
Vernis,M,88,6,43,49
Vlada,F,100,49,0,49
Vontae,M,100,0,49,49
Watt,M,100,0,49,49
Weiland,M,100,0,49,49
Wendle,M,100,0,49,49
Xaver,M,100,0,49,49
Xavy,M,100,0,49,49
Xiclaly,F,100,49,0,49
Yakub,M,100,0,49,49
Yazmina,F,100,49,0,49
Zacharian,M,100,0,49,49
Zahi,M,100,0,49,49
Zeandre,M,100,0,49,49
Zeid,M,100,0,49,49
Zevon,M,100,0,49,49
Zonda,F,100,49,0,49
Abdulahad,M,100,0,48,48
Abem,M,100,0,48,48
Abinaya,F,100,48,0,48
Abshir,M,100,0,48,48
Aeja,F,100,48,0,48
Aerilynn,F,100,48,0,48
Aireon,M,90,5,43,48
Aishat,F,100,48,0,48
Akeshia,F,100,48,0,48
Akir,M,100,0,48,48
Akito,M,100,0,48,48
Alaysa,F,100,48,0,48
Alazne,F,100,48,0,48
Alinne,F,100,48,0,48
Allisandra,F,100,48,0,48
Alper,M,100,0,48,48
Alyxandrea,F,100,48,0,48
Amarr,M,100,0,48,48
Amree,F,100,48,0,48
Anavey,F,100,48,0,48
Aowyn,F,100,48,0,48
Areyon,F,69,33,15,48
Aricin,M,100,0,48,48
Aryahi,F,100,48,0,48
Atzi,F,100,48,0,48
Auryn,M,77,11,37,48
Autiana,F,100,48,0,48
Azarriah,F,100,48,0,48
Azaylea,F,100,48,0,48
Baelynn,F,100,48,0,48
Baze,M,100,0,48,48
Berwyn,M,100,0,48,48
Betha,F,100,48,0,48
Beto,M,100,0,48,48
Birdia,F,100,48,0,48
Brayana,F,100,48,0,48
Brynlyn,F,100,48,0,48
Calyse,F,100,48,0,48
Camilya,F,100,48,0,48
Cataleyah,F,100,48,0,48
Ceslie,F,100,48,0,48
Chadney,M,90,5,43,48
Chamia,F,100,48,0,48
Channy,F,69,33,15,48
Charlinda,F,100,48,0,48
Cherree,F,100,48,0,48
Cheyana,F,100,48,0,48
Chritina,F,100,48,0,48
Ciandra,F,100,48,0,48
Cilia,F,100,48,0,48
Cimarron,M,88,6,42,48
Ciniyah,F,100,48,0,48
Colwyn,M,100,0,48,48
Conar,M,100,0,48,48
Cong,M,100,0,48,48
Corneilius,M,100,0,48,48
Crissi,F,100,48,0,48
Daiva,F,100,48,0,48
Dakyla,F,100,48,0,48
Daliza,F,100,48,0,48
Daphny,F,100,48,0,48
Darnae,F,100,48,0,48
Darrill,M,100,0,48,48
Davondre,M,100,0,48,48
Dayli,F,100,48,0,48
Dayzia,F,100,48,0,48
Debron,M,100,0,48,48
Deiontre,M,100,0,48,48
Deqwan,M,100,0,48,48
Deshaunda,F,100,48,0,48
Deylin,F,73,35,13,48
Dnaiel,M,100,0,48,48
Dorsie,F,60,29,19,48
Dvonta,M,100,0,48,48
Dwaun,M,100,0,48,48
Elfrieda,F,100,48,0,48
Elion,M,100,0,48,48
Emara,F,100,48,0,48
Eural,M,100,0,48,48
Evannie,F,100,48,0,48
Eyon,M,100,0,48,48
Fabiha,F,100,48,0,48
Falin,F,100,48,0,48
Ferd,M,100,0,48,48
Ferrel,M,100,0,48,48
Franciszek,M,100,0,48,48
Fremont,M,100,0,48,48
Giah,F,100,48,0,48
Gwennyth,F,100,48,0,48
Haidynn,F,100,48,0,48
Hastin,M,100,0,48,48
Holger,M,100,0,48,48
Hristina,F,100,48,0,48
Inesh,M,100,0,48,48
Iosefa,M,100,0,48,48
Irissa,F,100,48,0,48
Isair,M,100,0,48,48
Isavel,F,100,48,0,48
Issamar,F,100,48,0,48
Izach,M,100,0,48,48
Izen,M,100,0,48,48
Jaafar,M,100,0,48,48
Jackleen,F,100,48,0,48
Jacqualin,F,100,48,0,48
Jadyne,F,54,26,22,48
Jaeanna,F,100,48,0,48
Jahmiere,M,100,0,48,48
Jakisha,F,100,48,0,48
Jalitza,F,100,48,0,48
Jamahri,M,100,0,48,48
Jasaan,M,100,0,48,48
Jawun,M,100,0,48,48
Jedidah,F,100,48,0,48
Jenessy,F,100,48,0,48
Jermelle,M,100,0,48,48
Jermica,F,100,48,0,48
Jerryd,M,100,0,48,48
Jesa,F,100,48,0,48
Jettson,M,100,0,48,48
Jobi,F,88,42,6,48
Johngabriel,M,100,0,48,48
Johnine,F,100,48,0,48
Jonne,F,100,48,0,48
Jonnelle,F,100,48,0,48
Jujhar,M,100,0,48,48
Jusin,M,100,0,48,48
Kadeeja,F,100,48,0,48
Kaislee,F,100,48,0,48
Kaler,M,100,0,48,48
Kallon,M,100,0,48,48
Kamarr,M,100,0,48,48
Kamir,M,100,0,48,48
Kashiya,F,100,48,0,48
Katen,F,100,48,0,48
Kawanza,F,100,48,0,48
Kazuya,M,100,0,48,48
Keats,M,100,0,48,48
Kecha,F,100,48,0,48
Keiren,M,90,5,43,48
Keiyanna,F,100,48,0,48
Kellieann,F,100,48,0,48
Kendryck,M,100,0,48,48
Kerman,M,100,0,48,48
Khaaliq,M,100,0,48,48
Khamil,F,100,48,0,48
Khushboo,F,100,48,0,48
Kingdom,M,100,0,48,48
Kinneth,M,100,0,48,48
Kirana,F,100,48,0,48
Krikor,M,100,0,48,48
Lacourtney,F,100,48,0,48
Ladonia,F,100,48,0,48
Lamareon,M,100,0,48,48
Lareesa,F,100,48,0,48
Lauralye,F,100,48,0,48
Laveyah,F,100,48,0,48
Leeanthony,M,100,0,48,48
Lenesha,F,100,48,0,48
Lewin,M,100,0,48,48
Leyan,F,100,48,0,48
Lilijana,F,100,48,0,48
Lillis,F,100,48,0,48
Lively,F,100,48,0,48
Livianna,F,100,48,0,48
Lizete,F,100,48,0,48
Loriah,F,100,48,0,48
Luccia,F,100,48,0,48
Lucillie,F,100,48,0,48
Lyasia,F,100,48,0,48
Makahi,M,100,0,48,48
Makhala,F,100,48,0,48
Malaja,F,100,48,0,48
Marene,F,100,48,0,48
Margues,M,100,0,48,48
Mariany,F,100,48,0,48
Marylene,F,100,48,0,48
Mattis,M,100,0,48,48
Merianne,F,100,48,0,48
Merrideth,F,100,48,0,48
Mhia,F,100,48,0,48
Miaa,F,100,48,0,48
Michaya,F,100,48,0,48
Moeisha,F,100,48,0,48
Nakeda,F,100,48,0,48
Nalaysia,F,100,48,0,48
Narine,F,100,48,0,48
Natishia,F,100,48,0,48
Neeti,F,100,48,0,48
Netha,F,100,48,0,48
Nevon,M,100,0,48,48
Neyva,F,100,48,0,48
Nitosha,F,100,48,0,48
Nolee,F,100,48,0,48
Norlene,F,100,48,0,48
Nyera,F,100,48,0,48
Nykeem,M,100,0,48,48
Oneyda,F,100,48,0,48
Pamel,F,100,48,0,48
Patrycia,F,100,48,0,48
Qwentin,M,100,0,48,48
Raea,F,100,48,0,48
Raeshon,M,100,0,48,48
Raimee,F,100,48,0,48
Rakhi,F,100,48,0,48
Rakyah,F,100,48,0,48
Ranaya,F,100,48,0,48
Randloph,M,100,0,48,48
Raylei,F,100,48,0,48
Rechy,F,100,48,0,48
Rhilyn,F,100,48,0,48
Rhyley,F,62,30,18,48
Rickisha,F,100,48,0,48
Rikiyah,F,100,48,0,48
Riyadh,M,100,0,48,48
Rondle,M,100,0,48,48
Roopa,F,100,48,0,48
Rosmarie,F,100,48,0,48
Rotonda,F,100,48,0,48
Ruhama,F,100,48,0,48
Ryka,F,100,48,0,48
Sabirah,F,100,48,0,48
Samiel,M,100,0,48,48
Sammual,M,100,0,48,48
Samuela,M,54,22,26,48
Savas,M,100,0,48,48
Seila,F,100,48,0,48
Seton,M,79,10,38,48
Shakeim,M,100,0,48,48
Shameaka,F,100,48,0,48
Shannice,F,100,48,0,48
Sharlean,F,100,48,0,48
Shauntea,F,100,48,0,48
Shauri,F,100,48,0,48
Shenaya,F,100,48,0,48
Shenese,F,100,48,0,48
Shernika,F,100,48,0,48
Shirlynn,F,100,48,0,48
Shondel,F,50,24,24,48
Sihaam,F,100,48,0,48
Sincer,M,100,0,48,48
Skyye,F,100,48,0,48
Solia,F,100,48,0,48
Sriharsha,M,100,0,48,48
Sunset,F,100,48,0,48
Sussie,F,100,48,0,48
Synetta,F,100,48,0,48
Tahmina,F,100,48,0,48
Tahnya,F,100,48,0,48
Taisley,F,100,48,0,48
Tamiera,F,100,48,0,48
Tanyell,F,100,48,0,48
Tasanee,F,100,48,0,48
Tavier,M,100,0,48,48
Tiffancy,F,100,48,0,48
Tihesha,F,100,48,0,48
Tomieka,F,100,48,0,48
Traden,M,100,0,48,48
Trinae,F,100,48,0,48
Tudor,M,100,0,48,48
Tyle,M,100,0,48,48
Tylena,F,100,48,0,48
Ubah,F,100,48,0,48
Verleen,F,100,48,0,48
Wa,M,100,0,48,48
Xiomar,M,100,0,48,48
Yasmyne,F,100,48,0,48
Yazaira,F,100,48,0,48
Yecica,F,100,48,0,48
Yendi,F,100,48,0,48
Yesinia,F,100,48,0,48
Zeeva,F,100,48,0,48
Zerah,F,100,48,0,48
Zylie,F,100,48,0,48
Aaliayh,F,100,47,0,47
Aalivia,F,100,47,0,47
Aanshi,F,100,47,0,47
Abbygaile,F,100,47,0,47
Addysan,F,100,47,0,47
Adinah,F,100,47,0,47
Adriah,F,100,47,0,47
Aella,F,100,47,0,47
Aicia,F,100,47,0,47
Alandrea,F,100,47,0,47
Alexiea,F,100,47,0,47
Ameirah,F,100,47,0,47
Amiyrah,F,100,47,0,47
Ammiel,M,100,0,47,47
Amryn,F,87,41,6,47
Anberlyn,F,100,47,0,47
Anees,M,100,0,47,47
Anell,F,100,47,0,47
Anyely,F,100,47,0,47
Aseret,F,100,47,0,47
Autym,F,100,47,0,47
Axsel,M,100,0,47,47
Ayrika,F,100,47,0,47
Bali,F,100,47,0,47
Baye,F,100,47,0,47
Bennita,F,100,47,0,47
Berle,M,100,0,47,47
Bethney,F,100,47,0,47
Bilinda,F,100,47,0,47
Branisha,F,100,47,0,47
Breno,M,100,0,47,47
Breonica,F,100,47,0,47
Briyona,F,100,47,0,47
Brysun,M,100,0,47,47
Caledonia,F,100,47,0,47
Caneisha,F,100,47,0,47
Carabella,F,100,47,0,47
Caretta,F,100,47,0,47
Carlan,F,53,25,22,47
Catrece,F,100,47,0,47
Caye,F,100,47,0,47
Ceddrick,M,100,0,47,47
Chandara,M,87,6,41,47
Chantey,F,100,47,0,47
Cherrita,F,100,47,0,47
Chitara,F,100,47,0,47
Cogan,M,100,0,47,47
Conisha,F,100,47,0,47
Daarina,F,100,47,0,47
Daejuan,M,100,0,47,47
Dakkota,M,87,6,41,47
Dakyra,F,100,47,0,47
Dalayza,F,100,47,0,47
Dameria,F,100,47,0,47
Dameyon,M,100,0,47,47
Danieal,F,62,29,18,47
Dannielynn,F,100,47,0,47
Daquain,M,100,0,47,47
Darinka,F,100,47,0,47
Dashley,F,100,47,0,47
Dawuan,M,100,0,47,47
Debbye,F,100,47,0,47
Deede,F,100,47,0,47
Delara,F,100,47,0,47
Dellene,F,100,47,0,47
Demarien,M,100,0,47,47
Demira,F,100,47,0,47
Demitry,M,100,0,47,47
Deonica,F,100,47,0,47
Deryan,M,100,0,47,47
Desmone,M,87,6,41,47
Devontea,M,100,0,47,47
Dezmariah,F,100,47,0,47
Dorain,M,85,7,40,47
Dougals,M,100,0,47,47
Draedyn,M,100,0,47,47
Efosa,M,100,0,47,47
Efstathios,M,100,0,47,47
Eland,M,100,0,47,47
Eldra,M,100,0,47,47
Elibeth,F,100,47,0,47
Elmyra,F,100,47,0,47
Elyanah,F,100,47,0,47
Emah,F,100,47,0,47
Emilymarie,F,100,47,0,47
Epimenio,M,100,0,47,47
Eppie,F,51,24,23,47
Eshika,F,100,47,0,47
Evangelyne,F,100,47,0,47
Ezrie,F,100,47,0,47
Fawzi,M,100,0,47,47
Faylynn,F,100,47,0,47
Flonnie,F,100,47,0,47
Frantasia,F,100,47,0,47
Gardell,M,100,0,47,47
Gelina,F,100,47,0,47
Geordi,M,100,0,47,47
Gianno,M,100,0,47,47
Girolamo,M,100,0,47,47
Gizella,F,100,47,0,47
Graysin,M,100,0,47,47
Gretchyn,F,100,47,0,47
Haani,F,100,47,0,47
Haidon,M,100,0,47,47
Halaya,F,100,47,0,47
Hananiah,F,62,29,18,47
Harmone,F,100,47,0,47
Harve,M,100,0,47,47
Hasten,M,100,0,47,47
Holston,M,100,0,47,47
Imanee,F,100,47,0,47
Inanna,F,100,47,0,47
Irmalinda,F,100,47,0,47
Isaya,M,100,0,47,47
Ishrat,F,100,47,0,47
Issachar,M,100,0,47,47
Jacier,M,100,0,47,47
Jacquenette,F,100,47,0,47
Jaems,M,100,0,47,47
Jaewon,M,100,0,47,47
Jahzarra,F,100,47,0,47
Jakarra,F,100,47,0,47
Jamespatrick,M,100,0,47,47
Jamonie,M,87,6,41,47
Jaquavia,F,100,47,0,47
Jawaad,M,100,0,47,47
Jaze,M,100,0,47,47
Jazmynne,F,100,47,0,47
Jazzlyne,F,100,47,0,47
Jeannean,F,100,47,0,47
Jeneice,F,100,47,0,47
Jenielle,F,100,47,0,47
Jenniger,F,100,47,0,47
Jerrik,M,100,0,47,47
Jeshurun,M,100,0,47,47
Jetli,M,100,0,47,47
Jetty,F,100,47,0,47
Jezabella,F,100,47,0,47
Jillean,F,100,47,0,47
Jini,F,100,47,0,47
Jodilynn,F,100,47,0,47
Johaan,M,100,0,47,47
Jolen,M,79,10,37,47
Jomana,F,100,47,0,47
Juwaan,M,100,0,47,47
Kaishawn,M,100,0,47,47
Kalliyah,F,100,47,0,47
Karlotta,F,100,47,0,47
Katalea,F,100,47,0,47
Katheine,F,100,47,0,47
Kayelin,F,100,47,0,47
Kemorah,F,100,47,0,47
Kemyia,F,100,47,0,47
Keoka,F,100,47,0,47
Kerbi,F,100,47,0,47
Kesiah,F,100,47,0,47
Kevian,M,100,0,47,47
Khalyl,M,100,0,47,47
Khandi,F,100,47,0,47
Khiyan,M,100,0,47,47
Khyran,M,100,0,47,47
Kieya,F,100,47,0,47
Kinly,F,100,47,0,47
Kirsha,F,100,47,0,47
Kiwane,M,100,0,47,47
Kobin,M,100,0,47,47
Kolben,M,100,0,47,47
Krishaun,M,87,6,41,47
Kryslynn,F,100,47,0,47
Kylla,F,100,47,0,47
Laaibah,F,100,47,0,47
Ladamian,M,100,0,47,47
Laikin,F,100,47,0,47
Lambros,M,100,0,47,47
Laquarius,M,89,5,42,47
Laquina,F,100,47,0,47
Laquisa,F,100,47,0,47
Laraven,F,100,47,0,47
Larice,F,100,47,0,47
Lasonda,F,100,47,0,47
Latusha,F,100,47,0,47
Lavi,M,100,0,47,47
Lavisha,F,100,47,0,47
Llasmin,F,100,47,0,47
Lujayn,F,100,47,0,47
Lunabella,F,100,47,0,47
Macaylah,F,100,47,0,47
Machala,F,100,47,0,47
Madiline,F,100,47,0,47
Maeola,F,100,47,0,47
Mahdy,M,100,0,47,47
Malorey,F,100,47,0,47
Mann,M,100,0,47,47
Mansa,M,100,0,47,47
Mariyanna,F,100,47,0,47
Maryangel,F,100,47,0,47
Massey,F,68,32,15,47
Matrix,M,100,0,47,47
Mays,M,77,11,36,47
Maze,M,100,0,47,47
Meladie,F,100,47,0,47
Merribeth,F,100,47,0,47
Mistelle,F,100,47,0,47
Morticia,F,100,47,0,47
Muhannad,M,100,0,47,47
Naamah,F,100,47,0,47
Nathalye,F,100,47,0,47
Natron,M,100,0,47,47
Neisa,F,100,47,0,47
Nerida,F,100,47,0,47
Nevena,F,100,47,0,47
Niley,F,100,47,0,47
Niomie,F,100,47,0,47
Nuriya,F,100,47,0,47
Nyaisa,F,100,47,0,47
Olesia,F,100,47,0,47
Onathan,M,100,0,47,47
Patick,M,100,0,47,47
Phedra,F,100,47,0,47
Pheona,F,100,47,0,47
Polet,F,100,47,0,47
Pritika,F,100,47,0,47
Quennel,M,100,0,47,47
Quinnesha,F,100,47,0,47
Rabon,M,100,0,47,47
Rafeef,F,100,47,0,47
Rc,M,100,0,47,47
Red,M,100,0,47,47
Redford,M,100,0,47,47
Remijio,M,100,0,47,47
Rendall,M,100,0,47,47
Renley,F,68,32,15,47
Rhyli,F,100,47,0,47
Rontez,M,100,0,47,47
Rorik,M,100,0,47,47
Rotem,F,89,42,5,47
Roxxanne,F,100,47,0,47
Rury,M,100,0,47,47
Rusbel,M,100,0,47,47
Ryce,M,79,10,37,47
Sadiel,M,100,0,47,47
Saicharan,M,100,0,47,47
Sakena,F,100,47,0,47
Samauria,F,100,47,0,47
Sametra,F,100,47,0,47
Sarahrose,F,100,47,0,47
Savonte,M,100,0,47,47
Semia,F,100,47,0,47
Senay,M,100,0,47,47
Shaelie,F,100,47,0,47
Shafi,M,100,0,47,47
Shakeva,F,100,47,0,47
Shaniquah,F,100,47,0,47
Shaquona,F,100,47,0,47
Shaqwana,F,100,47,0,47
Sharekia,F,100,47,0,47
Shaundell,M,89,5,42,47
Shelinda,F,100,47,0,47
Sheriece,F,100,47,0,47
Sherrard,M,100,0,47,47
Shontina,F,100,47,0,47
Shrita,F,100,47,0,47
Shritha,F,100,47,0,47
Sivi,F,100,47,0,47
So,F,100,47,0,47
Sonata,F,100,47,0,47
Suhan,M,100,0,47,47
Sukhdeep,M,79,10,37,47
Syla,F,100,47,0,47
Symara,F,100,47,0,47
Takarra,F,100,47,0,47
Takeela,F,100,47,0,47
Tang,F,100,47,0,47
Tantania,F,100,47,0,47
Taryah,F,100,47,0,47
Tashua,F,100,47,0,47
Tasmia,F,100,47,0,47
Tatyiana,F,100,47,0,47
Teaya,F,100,47,0,47
Tierza,F,100,47,0,47
Tijon,M,100,0,47,47
Tommas,M,100,0,47,47
Touger,M,100,0,47,47
Travonn,M,100,0,47,47
Treona,F,100,47,0,47
Twalla,F,100,47,0,47
Vaishnav,M,100,0,47,47
Velisha,F,100,47,0,47
Verdis,M,87,6,41,47
Viraat,M,100,0,47,47
Vontavious,M,100,0,47,47
Vytautas,M,100,0,47,47
Xaviel,M,100,0,47,47
Xolani,F,100,47,0,47
Yasleen,F,100,47,0,47
Yazleen,F,100,47,0,47
Yediel,M,100,0,47,47
Yonina,F,100,47,0,47
Zahaira,F,100,47,0,47
Zahyra,F,100,47,0,47
Zaiyah,F,100,47,0,47
Zamire,M,100,0,47,47
Zanay,F,100,47,0,47
Zelinda,F,100,47,0,47
Zenja,F,100,47,0,47
Ziere,M,100,0,47,47
Zymari,M,100,0,47,47
Aashni,F,100,46,0,46
Aaylah,F,100,46,0,46
Abdulhamid,M,100,0,46,46
Adellyn,F,100,46,0,46
Aeriona,F,100,46,0,46
Alanii,F,100,46,0,46
Albaraa,M,100,0,46,46
Alette,F,100,46,0,46
Alexender,M,100,0,46,46
Alfreddie,M,100,0,46,46
Aliyaah,F,100,46,0,46
Allicyn,F,100,46,0,46
Alonie,F,100,46,0,46
Ambera,F,100,46,0,46
Anapatricia,F,100,46,0,46
Anea,F,100,46,0,46
Angalee,F,100,46,0,46
Angeleque,F,100,46,0,46
Annarae,F,100,46,0,46
Annicka,F,100,46,0,46
Antisha,F,100,46,0,46
Areial,F,100,46,0,46
Armeen,M,89,5,41,46
Artavion,M,100,0,46,46
Astacia,F,100,46,0,46
Aul,M,100,0,46,46
Aurion,F,65,30,16,46
Autherine,F,100,46,0,46
Avannah,F,100,46,0,46
Aveyon,M,100,0,46,46
Avilyn,F,100,46,0,46
Avrian,M,100,0,46,46
Ayliah,F,100,46,0,46
Ayoka,F,100,46,0,46
Bertran,M,100,0,46,46
Besan,F,100,46,0,46
Bethene,F,100,46,0,46
Billyray,M,100,0,46,46
Caide,M,100,0,46,46
Cardae,M,100,0,46,46
Cardon,M,100,0,46,46
Carlosalberto,M,100,0,46,46
Carzell,M,100,0,46,46
Casarah,F,100,46,0,46
Caymon,M,100,0,46,46
Cecilya,F,100,46,0,46
Cereniti,F,100,46,0,46
Cheemeng,M,100,0,46,46
Chelese,F,100,46,0,46
Cheramie,F,100,46,0,46
Chimaobi,M,100,0,46,46
Cianne,F,100,46,0,46
Cliford,M,100,0,46,46
Cortrell,M,100,0,46,46
Cossette,F,100,46,0,46
Cotrina,F,100,46,0,46
Creedon,M,100,0,46,46
Cresha,F,100,46,0,46
Creta,F,100,46,0,46
Cye,M,100,0,46,46
Cyrilla,F,100,46,0,46
Daffany,F,100,46,0,46
Dajoun,M,100,0,46,46
Damini,F,100,46,0,46
Danele,F,100,46,0,46
Daresha,F,100,46,0,46
Darissa,F,100,46,0,46
Darricka,F,100,46,0,46
Darshell,F,100,46,0,46
Daryna,F,100,46,0,46
Dashone,M,100,0,46,46
Davontre,M,100,0,46,46
Daycee,F,100,46,0,46
Delayza,F,100,46,0,46
Delcina,F,100,46,0,46
Delorian,M,78,10,36,46
Delshaun,M,100,0,46,46
Demie,F,100,46,0,46
Denon,M,100,0,46,46
Deresa,F,100,46,0,46
Dermaine,M,100,0,46,46
Deroy,M,100,0,46,46
Derrianna,F,100,46,0,46
Deshona,F,100,46,0,46
Desteney,F,100,46,0,46
Devohn,M,100,0,46,46
Deyshawn,M,100,0,46,46
Dixi,F,100,46,0,46
Dmauri,M,100,0,46,46
Dontra,M,100,0,46,46
Dorsa,F,100,46,0,46
Drayvin,M,100,0,46,46
Elchanan,M,100,0,46,46
Elideth,F,100,46,0,46
Eliut,M,100,0,46,46
Elonna,F,100,46,0,46
Eriyah,F,100,46,0,46
Esmeraldo,F,100,46,0,46
Esteffany,F,100,46,0,46
Feiga,F,100,46,0,46
Femi,M,59,19,27,46
Forbes,M,100,0,46,46
Frak,M,100,0,46,46
Frimy,F,100,46,0,46
Gabrael,M,100,0,46,46
Ghali,M,100,0,46,46
Glenetta,F,100,46,0,46
Gwendolynne,F,100,46,0,46
Gwennette,F,100,46,0,46
Gwin,F,63,29,17,46
Haben,M,78,10,36,46
Hadriel,M,100,0,46,46
Haidi,F,100,46,0,46
Haleigha,F,100,46,0,46
Hamadi,M,100,0,46,46
Hamda,F,100,46,0,46
Harison,M,100,0,46,46
Hedaya,F,100,46,0,46
Hinckley,M,100,0,46,46
Honi,F,100,46,0,46
Icie,F,100,46,0,46
Insha,F,100,46,0,46
Iolana,F,100,46,0,46
Isabelly,F,100,46,0,46
Ivaan,M,100,0,46,46
Ivona,F,100,46,0,46
Jacyn,F,50,23,23,46
Jaesha,F,100,46,0,46
Jago,M,100,0,46,46
Jahaun,M,100,0,46,46
Jahnea,F,100,46,0,46
Jaislyn,F,100,46,0,46
Jaivan,M,100,0,46,46
Jakyi,M,100,0,46,46
Jamanda,F,100,46,0,46
Jamayla,F,100,46,0,46
Jameis,M,100,0,46,46
Jamora,F,100,46,0,46
Janiyia,F,100,46,0,46
Jaryiah,F,100,46,0,46
Jasminn,F,100,46,0,46
Jesley,F,100,46,0,46
Jesusantonio,M,100,0,46,46
Jmarcus,M,100,0,46,46
Jonis,M,100,0,46,46
Jovannah,F,100,46,0,46
Juris,M,100,0,46,46
Jurnei,F,100,46,0,46
Justinmichael,M,100,0,46,46
Kadeejah,F,100,46,0,46
Kaeya,F,100,46,0,46
Kahler,M,87,6,40,46
Kairie,F,100,46,0,46
Kaleema,F,100,46,0,46
Kamonie,F,100,46,0,46
Kamyron,M,89,5,41,46
Kanako,F,100,46,0,46
Kanari,F,50,23,23,46
Karch,M,100,0,46,46
Kaveri,F,100,46,0,46
Kaylanni,F,100,46,0,46
Kelvina,F,100,46,0,46
Kenniah,F,100,46,0,46
Kentavion,M,100,0,46,46
Keyahna,F,100,46,0,46
Keymya,F,100,46,0,46
Kiajah,F,100,46,0,46
Kiane,F,100,46,0,46
Kimberlyanne,F,100,46,0,46
Kinzly,F,100,46,0,46
Kirie,F,100,46,0,46
Kirke,M,100,0,46,46
Kirtus,M,100,0,46,46
Kornelius,M,100,0,46,46
Kosuke,M,100,0,46,46
Kyllian,M,100,0,46,46
Kynzley,F,100,46,0,46
Kyuss,M,100,0,46,46
Laderricka,F,100,46,0,46
Lamontay,M,100,0,46,46
Lanaisha,F,100,46,0,46
Laraib,F,100,46,0,46
Lareyna,F,100,46,0,46
Lashira,F,100,46,0,46
Latrinda,F,100,46,0,46
Lavana,F,100,46,0,46
Lavanna,F,100,46,0,46
Leeon,M,100,0,46,46
Leonetta,F,100,46,0,46
Letcher,M,100,0,46,46
Libny,F,100,46,0,46
Lilija,F,100,46,0,46
Liliyana,F,100,46,0,46
Linard,M,100,0,46,46
Lindzi,F,100,46,0,46
Lucelia,F,100,46,0,46
Lynese,F,100,46,0,46
Maelys,F,100,46,0,46
Makaylan,F,100,46,0,46
Makensi,F,100,46,0,46
Malakii,M,100,0,46,46
Maliky,M,100,0,46,46
Markeyta,F,100,46,0,46
Marlesha,F,100,46,0,46
Maro,M,100,0,46,46
Matlyn,F,100,46,0,46
Mcdaniel,M,100,0,46,46
Mckynzee,F,100,46,0,46
Mckynzi,F,100,46,0,46
Medgar,M,100,0,46,46
Meeyah,F,100,46,0,46
Mehwish,F,100,46,0,46
Meriyah,F,100,46,0,46
Michalia,F,100,46,0,46
Mihira,F,100,46,0,46
Mit,M,100,0,46,46
Mohammedali,M,100,0,46,46
Monzerath,F,100,46,0,46
Mouna,F,100,46,0,46
Murel,M,100,0,46,46
Nahriah,F,100,46,0,46
Nanine,F,100,46,0,46
Naol,M,100,0,46,46
Naturelle,F,100,46,0,46
Nayelee,F,100,46,0,46
Neilan,M,100,0,46,46
Neily,F,100,46,0,46
Neima,F,89,41,5,46
Nekole,F,100,46,0,46
Nermeen,F,100,46,0,46
Nhat,M,100,0,46,46
Nicklus,M,100,0,46,46
Nikima,F,100,46,0,46
Nisaa,F,100,46,0,46
Noman,M,100,0,46,46
Nyanza,F,100,46,0,46
Nyilah,F,100,46,0,46
Nyko,M,100,0,46,46
Oddie,M,100,0,46,46
Oluwatimileyin,M,100,0,46,46
Ozair,M,100,0,46,46
Pake,M,100,0,46,46
Paulisha,F,100,46,0,46
Pericles,M,100,0,46,46
Phillina,F,100,46,0,46
Poppi,F,100,46,0,46
Que,M,100,0,46,46
Quent,M,100,0,46,46
Quida,F,100,46,0,46
Quinterra,F,100,46,0,46
Qusay,M,100,0,46,46
Raely,F,100,46,0,46
Raichel,F,100,46,0,46
Ramesses,M,100,0,46,46
Rayniah,F,100,46,0,46
Regionald,M,100,0,46,46
Relinda,F,100,46,0,46
Rhyne,M,100,0,46,46
Roderrick,M,100,0,46,46
Ryeland,M,100,0,46,46
Sachet,F,100,46,0,46
Saheli,F,100,46,0,46
Sanijah,F,100,46,0,46
Sarenna,F,100,46,0,46
Sarine,F,100,46,0,46
Schuylar,F,61,28,18,46
Senon,M,100,0,46,46
Serenia,F,100,46,0,46
Shantaye,F,100,46,0,46
Sharbel,M,100,0,46,46
Shaza,F,100,46,0,46
Shiran,F,100,46,0,46
Shyon,M,100,0,46,46
Sincear,M,100,0,46,46
Skyli,F,100,46,0,46
Sohini,F,100,46,0,46
Stasi,F,100,46,0,46
Stassi,F,100,46,0,46
Sumiyah,F,100,46,0,46
Suzeth,F,100,46,0,46
Syvannah,F,100,46,0,46
Tairra,F,100,46,0,46
Taka,F,100,46,0,46
Tanille,F,100,46,0,46
Tarji,F,100,46,0,46
Tarone,M,100,0,46,46
Tazhane,F,100,46,0,46
Tehra,F,100,46,0,46
Tellas,M,100,0,46,46
Tenesa,F,100,46,0,46
Teyo,M,100,0,46,46
Theryn,M,65,16,30,46
Thurlow,M,100,0,46,46
Timothyjames,M,100,0,46,46
Tishaun,M,100,0,46,46
Tommylee,M,100,0,46,46
Tonicia,F,100,46,0,46
Trequon,M,100,0,46,46
Treyvaughn,M,100,0,46,46
Tykeyah,F,100,46,0,46
Tyquavion,M,100,0,46,46
Tyrike,M,100,0,46,46
Tyrionna,F,100,46,0,46
Voltaire,M,100,0,46,46
Wanika,F,100,46,0,46
Xazier,M,100,0,46,46
Yadirah,F,100,46,0,46
Yandriel,M,100,0,46,46
Yelonda,F,100,46,0,46
Yenty,F,100,46,0,46
Yogesh,M,100,0,46,46
Yumeka,F,100,46,0,46
Zayuri,F,100,46,0,46
Zionnah,F,100,46,0,46
Abhijeet,M,100,0,45,45
Adaire,F,100,45,0,45
Adebola,F,78,35,10,45
Adream,F,100,45,0,45
Adwin,M,100,0,45,45
Ailia,F,100,45,0,45
Ajwa,F,100,45,0,45
Alcario,M,100,0,45,45
Aldine,F,78,35,10,45
Aleshanee,F,100,45,0,45
Aleyiah,F,100,45,0,45
Aljandro,M,100,0,45,45
Allyzon,F,100,45,0,45
Alylah,F,100,45,0,45
Alyzon,F,100,45,0,45
Amary,F,89,40,5,45
Ambrey,F,100,45,0,45
Ameriyah,F,100,45,0,45
Amishi,F,100,45,0,45
Amiyha,F,100,45,0,45
Amoriah,F,100,45,0,45
Anachristina,F,100,45,0,45
Aneres,F,100,45,0,45
Anezka,F,100,45,0,45
Anglie,F,100,45,0,45
Annakaren,F,100,45,0,45
Anonda,F,100,45,0,45
Antanesha,F,100,45,0,45
Antravious,M,100,0,45,45
Antwanique,F,100,45,0,45
Arieyanna,F,100,45,0,45
Armahni,F,64,29,16,45
Asherah,F,100,45,0,45
Astraea,F,100,45,0,45
Athene,F,100,45,0,45
Atsushi,M,100,0,45,45
Avacyn,F,100,45,0,45
Avaeh,F,100,45,0,45
Axzel,M,100,0,45,45
Ayvin,M,100,0,45,45
Ayvree,F,100,45,0,45
Azarah,F,100,45,0,45
Baani,F,100,45,0,45
Banning,M,100,0,45,45
Berny,M,100,0,45,45
Bilma,F,100,45,0,45
Bismark,M,100,0,45,45
Blayz,M,100,0,45,45
Bona,F,78,35,10,45
Bopha,F,100,45,0,45
Bradlie,F,76,34,11,45
Breece,F,76,34,11,45
Breonne,F,100,45,0,45
Britnei,F,100,45,0,45
Bryella,F,100,45,0,45
Calianne,F,100,45,0,45
Candler,M,89,5,40,45
Canela,F,100,45,0,45
Cassee,F,100,45,0,45
Cassiopia,F,100,45,0,45
Catisha,F,100,45,0,45
Cenedra,F,100,45,0,45
Chaderick,M,100,0,45,45
Chantina,F,100,45,0,45
Cheslea,F,100,45,0,45
Chesna,F,100,45,0,45
Chloemarie,F,100,45,0,45
Chrystin,F,100,45,0,45
Chystal,F,100,45,0,45
Cielle,F,100,45,0,45
Claudy,M,100,0,45,45
Claytin,M,100,0,45,45
Corionna,F,100,45,0,45
Crhistopher,M,100,0,45,45
Cyree,M,100,0,45,45
Daleiza,F,100,45,0,45
Damarrius,M,100,0,45,45
Deari,F,89,40,5,45
Deaundria,F,100,45,0,45
Dederick,M,100,0,45,45
Deenna,F,100,45,0,45
Demba,M,100,0,45,45
Dezrae,F,100,45,0,45
Dim,F,100,45,0,45
Donaldson,M,100,0,45,45
Donnavon,M,100,0,45,45
Donterious,M,100,0,45,45
Dorinne,F,100,45,0,45
Dristin,M,73,12,33,45
Duel,M,100,0,45,45
Eja,F,100,45,0,45
Elaena,F,100,45,0,45
Eliahs,M,100,0,45,45
Elijuah,M,100,0,45,45
Eliyanna,F,100,45,0,45
Enia,F,100,45,0,45
Estafani,F,100,45,0,45
Eulene,F,100,45,0,45
Faelynn,F,100,45,0,45
Faraji,M,100,0,45,45
Ferrari,F,84,38,7,45
Fierra,F,100,45,0,45
Fikisha,F,100,45,0,45
Fiyinfoluwa,F,71,32,13,45
Frann,F,100,45,0,45
Garrod,M,100,0,45,45
Genessy,F,100,45,0,45
Gezelle,F,100,45,0,45
Gib,M,100,0,45,45
Gili,F,100,45,0,45
Gizele,F,100,45,0,45
Glender,F,100,45,0,45
Gloribel,F,100,45,0,45
Grete,F,100,45,0,45
Hager,F,87,39,6,45
Hallel,F,100,45,0,45
Hannahrose,F,100,45,0,45
Hannalee,F,100,45,0,45
Hayliegh,F,100,45,0,45
Henslee,F,100,45,0,45
Hiroyuki,M,100,0,45,45
Hollin,F,100,45,0,45
Hollynn,F,100,45,0,45
Ifra,F,100,45,0,45
Ingo,M,100,0,45,45
Irulan,F,100,45,0,45
Italya,F,100,45,0,45
Izebella,F,100,45,0,45
Jaemarie,F,100,45,0,45
Jahzion,M,100,0,45,45
Jaleh,F,100,45,0,45
Japonica,F,100,45,0,45
Jashauna,F,100,45,0,45
Javaya,F,100,45,0,45
Jaxzen,M,100,0,45,45
Jayann,F,100,45,0,45
Jaydden,M,100,0,45,45
Jayziah,M,100,0,45,45
Jeffri,M,100,0,45,45
Jenavecia,F,100,45,0,45
Jerissa,F,100,45,0,45
Jesselin,F,100,45,0,45
Jex,M,100,0,45,45
Jhared,M,100,0,45,45
Jmar,M,100,0,45,45
Johnchristian,M,100,0,45,45
Jonina,F,100,45,0,45
Jorin,M,100,0,45,45
Josefrancisco,M,100,0,45,45
Juanalberto,M,100,0,45,45
Justian,M,100,0,45,45
Jvonte,M,100,0,45,45
Jye,M,100,0,45,45
Jyquez,M,100,0,45,45
Kadeyn,M,100,0,45,45
Kaelly,F,100,45,0,45
Kairyn,M,78,10,35,45
Kalayna,F,100,45,0,45
Kalique,M,100,0,45,45
Kameesha,F,100,45,0,45
Kamyria,F,100,45,0,45
Kapree,F,100,45,0,45
Karar,M,100,0,45,45
Karicia,F,100,45,0,45
Katarena,F,100,45,0,45
Kaziya,F,100,45,0,45
Kealyn,F,100,45,0,45
Kellijo,F,100,45,0,45
Kemonta,M,100,0,45,45
Kenaniah,M,100,0,45,45
Kenicia,F,100,45,0,45
Kenroy,M,100,0,45,45
Kentral,M,100,0,45,45
Kenyun,M,100,0,45,45
Kerolos,M,100,0,45,45
Keundre,M,100,0,45,45
Khamren,M,100,0,45,45
Kherrington,F,100,45,0,45
Khristal,F,100,45,0,45
Kinyatta,F,100,45,0,45
Klani,F,100,45,0,45
Kloei,F,100,45,0,45
Krisette,F,100,45,0,45
Kunj,M,100,0,45,45
Kurstie,F,100,45,0,45
Kydan,M,100,0,45,45
Ladaijah,F,100,45,0,45
Lafondra,F,100,45,0,45
Laim,M,100,0,45,45
Latascha,F,100,45,0,45
Laythen,M,100,0,45,45
Leeandrew,M,100,0,45,45
Leilanee,F,100,45,0,45
Lenyx,F,76,34,11,45
Leondria,F,100,45,0,45
Levaeh,F,100,45,0,45
Leyonna,F,100,45,0,45
Liannah,F,100,45,0,45
Libertee,F,100,45,0,45
Lillard,M,100,0,45,45
Longino,M,100,0,45,45
Lorryn,F,100,45,0,45
Luiseduardo,M,100,0,45,45
Lylianah,F,100,45,0,45
Lyneisha,F,100,45,0,45
Mabeline,F,100,45,0,45
Macgyver,M,100,0,45,45
Mackson,M,100,0,45,45
Maezie,F,100,45,0,45
Mahniya,F,100,45,0,45
Makynleigh,F,100,45,0,45
Malibu,F,100,45,0,45
Malo,M,100,0,45,45
Malyki,M,100,0,45,45
Maneh,F,100,45,0,45
Maret,F,100,45,0,45
Marikate,F,100,45,0,45
Markavion,M,100,0,45,45
Marleta,F,100,45,0,45
Marrina,F,100,45,0,45
Matthiew,M,100,0,45,45
Meca,F,100,45,0,45
Micahya,F,100,45,0,45
Michalea,F,100,45,0,45
Michol,F,100,45,0,45
Minji,F,100,45,0,45
Naleyah,F,100,45,0,45
Natya,F,100,45,0,45
Navreet,F,100,45,0,45
Nerea,F,100,45,0,45
Neyo,M,100,0,45,45
Nihira,F,100,45,0,45
Novali,F,100,45,0,45
Omere,M,100,0,45,45
Patte,F,100,45,0,45
Prahlad,M,100,0,45,45
Prestan,M,100,0,45,45
Quamane,M,100,0,45,45
Quaneesha,F,100,45,0,45
Raiah,F,100,45,0,45
Raishawn,M,100,0,45,45
Ranijah,F,100,45,0,45
Ransome,M,100,0,45,45
Rashiem,M,100,0,45,45
Reata,F,100,45,0,45
Regenald,M,100,0,45,45
Renesme,F,100,45,0,45
Renezmae,F,100,45,0,45
Renly,M,89,5,40,45
Rhealyn,F,100,45,0,45
Robertjohn,M,100,0,45,45
Romance,M,100,0,45,45
Rondo,M,100,0,45,45
Rosmeri,F,100,45,0,45
Roz,F,100,45,0,45
Ruqaiyah,F,100,45,0,45
Ryanchristopher,M,100,0,45,45
Sabatino,M,100,0,45,45
Samantah,F,100,45,0,45
Samiria,F,100,45,0,45
Samuelle,M,87,6,39,45
Sanovia,F,100,45,0,45
Seleana,F,100,45,0,45
Senaya,F,100,45,0,45
Shaianna,F,100,45,0,45
Shaiquan,M,100,0,45,45
Shakeal,M,100,0,45,45
Shakota,F,100,45,0,45
Shalim,M,100,0,45,45
Shamelia,F,100,45,0,45
Shammah,M,87,6,39,45
Shanterrica,F,100,45,0,45
Sharlonda,F,100,45,0,45
Shivank,M,100,0,45,45
Silbia,F,100,45,0,45
Sionna,F,100,45,0,45
Skky,F,100,45,0,45
Sonie,F,100,45,0,45
Suave,M,100,0,45,45
Sude,F,100,45,0,45
Sumire,F,100,45,0,45
Tahiri,F,100,45,0,45
Tahni,F,100,45,0,45
Taimur,M,100,0,45,45
Taleea,F,100,45,0,45
Talijah,F,100,45,0,45
Tamicia,F,100,45,0,45
Taquasha,F,100,45,0,45
Tasheen,F,100,45,0,45
Telley,M,100,0,45,45
Teres,F,100,45,0,45
Thaddeous,M,100,0,45,45
Thaliyah,F,100,45,0,45
Tomar,M,100,0,45,45
Torreon,M,100,0,45,45
Trayana,F,100,45,0,45
Trenidy,F,100,45,0,45
Treye,M,100,0,45,45
Trinell,F,89,40,5,45
Tripton,M,100,0,45,45
Tunesia,F,100,45,0,45
Tyquana,F,100,45,0,45
Tyres,M,100,0,45,45
Urmi,F,100,45,0,45
Vedad,M,100,0,45,45
Vineta,F,100,45,0,45
Vollie,M,100,0,45,45
Yaelis,F,100,45,0,45
Yagmur,F,100,45,0,45
Yanae,F,100,45,0,45
Yaricza,F,100,45,0,45
Yeili,F,100,45,0,45
Yurico,F,100,45,0,45
Zafiro,F,100,45,0,45
Zamyrah,F,100,45,0,45
Zarie,F,100,45,0,45
Zeki,M,100,0,45,45
Zeni,F,100,45,0,45
Zhion,M,100,0,45,45
Zyniyah,F,100,45,0,45
Zyrihanna,F,100,45,0,45
Achyut,M,100,0,44,44
Adalyna,F,100,44,0,44
Adriell,M,100,0,44,44
Airielle,F,100,44,0,44
Akheem,M,100,0,44,44
Akshith,M,100,0,44,44
Akyrah,F,100,44,0,44
Alaisia,F,100,44,0,44
Alamea,F,100,44,0,44
Alaniz,F,100,44,0,44
Aleshea,F,100,44,0,44
Alianny,F,100,44,0,44
Allisia,F,100,44,0,44
Amaja,F,100,44,0,44
Amandah,F,100,44,0,44
Amane,F,100,44,0,44
Amelina,F,100,44,0,44
Anjellica,F,100,44,0,44
Annakatherine,F,100,44,0,44
Anthonella,F,100,44,0,44
Anthonyjoseph,M,100,0,44,44
Aquira,F,100,44,0,44
Ardys,F,100,44,0,44
Aribelle,F,100,44,0,44
Arieliz,F,100,44,0,44
Ariene,F,100,44,0,44
Artimus,M,100,0,44,44
Aryian,F,59,26,18,44
Ashmit,M,100,0,44,44
Avyaan,M,100,0,44,44
Avynn,F,100,44,0,44
Aydeen,M,100,0,44,44
Aythan,M,100,0,44,44
Azania,F,100,44,0,44
Azar,M,100,0,44,44
Azeriah,F,89,39,5,44
Babajide,M,100,0,44,44
Bashawn,M,100,0,44,44
Bayah,F,100,44,0,44
Bayani,M,100,0,44,44
Bensyn,M,100,0,44,44
Besty,F,100,44,0,44
Bibianna,F,100,44,0,44
Bonham,M,100,0,44,44
Braedy,M,100,0,44,44
Bretney,F,100,44,0,44
Bridey,F,100,44,0,44
Cadarrius,M,100,0,44,44
Caisey,F,100,44,0,44
Camdynn,F,89,39,5,44
Candina,F,100,44,0,44
Cati,F,100,44,0,44
Celissa,F,100,44,0,44
Champaigne,F,100,44,0,44
Chanteal,F,100,44,0,44
Chealsie,F,100,44,0,44
Cheryce,F,100,44,0,44
Chord,M,100,0,44,44
Christalynn,F,100,44,0,44
Cindylou,F,100,44,0,44
Clevester,M,100,0,44,44
Conita,F,100,44,0,44
Corbitt,M,100,0,44,44
Coryon,M,100,0,44,44
Covin,M,100,0,44,44
Crews,M,100,0,44,44
Daemeon,M,100,0,44,44
Daiya,F,100,44,0,44
Daiyana,F,100,44,0,44
Daizah,F,100,44,0,44
Dakaria,F,100,44,0,44
Daleigh,F,100,44,0,44
Danahi,F,100,44,0,44
Danikka,F,100,44,0,44
Davana,F,100,44,0,44
Deboah,F,100,44,0,44
Decory,M,100,0,44,44
Dedre,F,100,44,0,44
Deklynn,F,100,44,0,44
Dellia,F,100,44,0,44
Devory,F,100,44,0,44
Dezmund,M,100,0,44,44
Dianelis,F,100,44,0,44
Dianira,F,100,44,0,44
Divit,M,100,0,44,44
Donnise,F,100,44,0,44
Dshon,M,100,0,44,44
Eames,M,100,0,44,44
Eizabeth,F,100,44,0,44
Elior,M,100,0,44,44
Elven,M,100,0,44,44
Emer,F,89,39,5,44
Evaleen,F,100,44,0,44
Eyla,F,100,44,0,44
Faison,M,100,0,44,44
Faylinn,F,100,44,0,44
Florice,F,100,44,0,44
Gabryle,M,100,0,44,44
Garvis,M,100,0,44,44
Gearl,M,89,5,39,44
Genaveve,F,100,44,0,44
Geordon,M,100,0,44,44
Gerone,M,100,0,44,44
Gradin,M,100,0,44,44
Guadlupe,F,61,27,17,44
Gurtej,M,100,0,44,44
Hadara,F,100,44,0,44
Hibo,F,100,44,0,44
Hilaree,F,100,44,0,44
Ilce,F,100,44,0,44
Infinite,M,100,0,44,44
Irean,F,100,44,0,44
Isia,F,89,39,5,44
Ivannah,F,100,44,0,44
Jacenta,F,100,44,0,44
Jaevyn,M,100,0,44,44
Jagdeep,M,100,0,44,44
Jailenne,F,100,44,0,44
Jakaylee,F,100,44,0,44
Jakaylin,F,77,34,10,44
Jakenzie,F,100,44,0,44
Jakylen,M,100,0,44,44
Jaleshia,F,100,44,0,44
Jali,F,100,44,0,44
Jamiera,F,100,44,0,44
Janajah,F,100,44,0,44
Januari,F,100,44,0,44
Jaquline,F,100,44,0,44
Jaszmin,F,100,44,0,44
Jazaya,F,100,44,0,44
Jemika,F,100,44,0,44
Jennalise,F,100,44,0,44
Jennavive,F,100,44,0,44
Jesee,M,89,5,39,44
Johnia,F,100,44,0,44
Jomary,F,100,44,0,44
Joselina,F,100,44,0,44
Juriel,M,100,0,44,44
Kacin,M,100,0,44,44
Kailand,M,82,8,36,44
Kalice,F,100,44,0,44
Kanard,M,100,0,44,44
Karmyne,M,100,0,44,44
Kashyap,M,100,0,44,44
Kataleah,F,100,44,0,44
Kelene,F,100,44,0,44
Kestin,M,100,0,44,44
Keviona,F,100,44,0,44
Khyan,M,100,0,44,44
Khylah,F,100,44,0,44
Kiany,F,100,44,0,44
Kijah,F,100,44,0,44
Kimbrly,F,100,44,0,44
Kippie,F,75,33,11,44
Kiralyn,F,100,44,0,44
Kiwanda,F,100,44,0,44
Klare,F,100,44,0,44
Kyauna,F,100,44,0,44
Kylynne,F,100,44,0,44
Kynzli,F,100,44,0,44
Kyros,M,100,0,44,44
Labiba,F,100,44,0,44
Lachonda,F,100,44,0,44
Lakaiya,F,100,44,0,44
Lakeish,F,100,44,0,44
Lamyiah,F,100,44,0,44
Lassie,F,100,44,0,44
Lataija,F,100,44,0,44
Latonna,F,100,44,0,44
Latory,F,100,44,0,44
Latsha,F,100,44,0,44
Lavasha,F,100,44,0,44
Leeshawn,M,100,0,44,44
Lekiesha,F,100,44,0,44
Lewayne,M,100,0,44,44
Llewelyn,M,100,0,44,44
Lujane,F,100,44,0,44
Luretta,F,100,44,0,44
Lynnzee,F,100,44,0,44
Maclaren,F,75,33,11,44
Madyline,F,100,44,0,44
Makaih,M,100,0,44,44
Makinsley,F,100,44,0,44
Manasvini,F,100,44,0,44
Maneka,F,100,44,0,44
Marcis,M,100,0,44,44
Marioalberto,M,100,0,44,44
Marisleysis,F,100,44,0,44
Markal,M,100,0,44,44
Marquiese,M,100,0,44,44
Masun,M,100,0,44,44
Matigan,F,100,44,0,44
Mattan,M,100,0,44,44
Mattheo,M,100,0,44,44
Mavin,M,100,0,44,44
Mavryk,M,100,0,44,44
Maylei,F,100,44,0,44
Mead,M,100,0,44,44
Meilah,F,100,44,0,44
Meiya,F,100,44,0,44
Melynn,F,100,44,0,44
Miamarie,F,100,44,0,44
Michelleann,F,100,44,0,44
Michielle,F,100,44,0,44
Mikinley,F,100,44,0,44
Mircale,F,100,44,0,44
Mitchum,M,100,0,44,44
Moishy,M,100,0,44,44
Montaya,F,100,44,0,44
Myong,F,100,44,0,44
Nahiara,F,100,44,0,44
Nasri,M,100,0,44,44
Neeya,F,100,44,0,44
Nellene,F,100,44,0,44
Nermin,M,73,12,32,44
Neviyah,F,100,44,0,44
Nickolous,M,100,0,44,44
Nidra,F,100,44,0,44
Nussen,M,100,0,44,44
Nykea,F,100,44,0,44
Orquidia,F,100,44,0,44
Owenn,M,100,0,44,44
Paislei,F,100,44,0,44
Para,F,100,44,0,44
Pepsi,F,100,44,0,44
Peterjohn,M,100,0,44,44
Prinston,M,100,0,44,44
Quinshawn,M,100,0,44,44
Quiona,F,100,44,0,44
Rachiel,F,100,44,0,44
Raetta,F,100,44,0,44
Rahmere,M,100,0,44,44
Rashima,F,100,44,0,44
Relena,F,100,44,0,44
Renaya,F,100,44,0,44
Renota,F,100,44,0,44
Rhonin,M,100,0,44,44
Rihaan,M,100,0,44,44
Rittany,F,100,44,0,44
Rivaan,M,100,0,44,44
Rollan,M,100,0,44,44
Ronalyn,F,100,44,0,44
Rosheda,F,100,44,0,44
Rosyln,F,100,44,0,44
Rozelyn,F,100,44,0,44
Rukaya,F,100,44,0,44
Rushelle,F,100,44,0,44
Rustie,F,100,44,0,44
Ruthvik,M,100,0,44,44
Rynesha,F,100,44,0,44
Sabrenia,F,100,44,0,44
Saidey,F,100,44,0,44
Sajada,F,100,44,0,44
Sanket,M,100,0,44,44
Sayquan,M,100,0,44,44
Schaun,M,100,0,44,44
Sedgwick,M,100,0,44,44
Shadimon,F,100,44,0,44
Shakel,M,64,16,28,44
Shakiel,M,100,0,44,44
Shametria,F,100,44,0,44
Shannara,F,100,44,0,44
Shanthi,F,100,44,0,44
Shaqueal,M,100,0,44,44
Sharieka,F,100,44,0,44
Shatanya,F,100,44,0,44
Sheadon,M,100,0,44,44
Shekila,F,100,44,0,44
Sheraz,M,100,0,44,44
Sherelyn,F,100,44,0,44
Sherrae,F,100,44,0,44
Sherrilee,F,100,44,0,44
Sholem,M,100,0,44,44
Shradha,F,100,44,0,44
Shreshta,F,100,44,0,44
Shruthika,F,100,44,0,44
Siany,F,100,44,0,44
Simrit,F,100,44,0,44
Sirinity,F,100,44,0,44
Siyanna,F,100,44,0,44
Smya,F,100,44,0,44
Solene,F,100,44,0,44
Sorelle,F,100,44,0,44
Starrla,F,100,44,0,44
Sueanna,F,100,44,0,44
Sujal,M,100,0,44,44
Surai,F,100,44,0,44
Taahir,M,100,0,44,44
Tahitia,F,100,44,0,44
Tajiana,F,100,44,0,44
Taliek,M,100,0,44,44
Taliq,M,100,0,44,44
Tangina,F,100,44,0,44
Taniyha,F,100,44,0,44
Taquasia,F,100,44,0,44
Tearria,F,100,44,0,44
Teerica,F,100,44,0,44
Teiona,F,100,44,0,44
Tenay,F,100,44,0,44
Teneya,F,100,44,0,44
Tennisha,F,100,44,0,44
Thaddues,M,100,0,44,44
Thuong,F,84,37,7,44
Tildon,M,100,0,44,44
Timyah,F,100,44,0,44
Tjaden,M,100,0,44,44
Torriano,M,100,0,44,44
Toshiro,M,100,0,44,44
Traysen,M,100,0,44,44
Tristion,M,100,0,44,44
Tymari,M,100,0,44,44
Tynita,F,100,44,0,44
Utopia,F,100,44,0,44
Vandella,F,100,44,0,44
Veida,F,100,44,0,44
Verba,F,100,44,0,44
Vernonica,F,100,44,0,44
Versa,F,100,44,0,44
Vianet,F,100,44,0,44
Victoriaann,F,100,44,0,44
Virgilia,F,100,44,0,44
Vista,F,100,44,0,44
Viyan,M,100,0,44,44
Vlora,F,100,44,0,44
Walda,F,100,44,0,44
Wayna,F,100,44,0,44
Yakeline,F,100,44,0,44
Yamely,F,100,44,0,44
Yeiren,M,100,0,44,44
Yita,F,100,44,0,44
Yittel,F,100,44,0,44
Yori,F,86,38,6,44
Yuliya,F,100,44,0,44
Yutaro,M,100,0,44,44
Zahriya,F,100,44,0,44
Zaliah,F,100,44,0,44
Zamyria,F,100,44,0,44
Zavery,M,89,5,39,44
Zoel,M,75,11,33,44
Zoriyah,F,100,44,0,44
Zyaria,F,100,44,0,44
Zyden,M,100,0,44,44
Zyiere,M,100,0,44,44
Aalana,F,100,43,0,43
Aareon,M,77,10,33,43
Aarsh,M,100,0,43,43
Abdo,M,100,0,43,43
Abimelec,M,100,0,43,43
Abony,F,100,43,0,43
Adaryll,M,100,0,43,43
Adedeji,M,100,0,43,43
Ahmer,M,100,0,43,43
Ahmi,M,88,5,38,43
Ahonesty,F,100,43,0,43
Aile,F,100,43,0,43
Ajaysia,F,100,43,0,43
Akea,F,100,43,0,43
Alesya,F,100,43,0,43
Aleyana,F,100,43,0,43
Alian,M,100,0,43,43
Alondo,M,100,0,43,43
Alvarez,M,100,0,43,43
Amandia,F,100,43,0,43
Ambrianna,F,100,43,0,43
Amram,M,100,0,43,43
Anderw,M,100,0,43,43
Aneira,F,100,43,0,43
Anglique,F,100,43,0,43
Anquette,F,100,43,0,43
Aragorn,M,100,0,43,43
Araiyah,F,100,43,0,43
Archimedes,M,100,0,43,43
Arhiana,F,100,43,0,43
Arlyce,F,100,43,0,43
Arnela,F,100,43,0,43
Arsha,F,77,33,10,43
Athalie,F,100,43,0,43
Avrahom,M,100,0,43,43
Basit,M,100,0,43,43
Bentlei,F,51,22,21,43
Blakleigh,F,100,43,0,43
Blanchard,M,100,0,43,43
Blondine,F,100,43,0,43
Braileigh,F,100,43,0,43
Braily,F,100,43,0,43
Brantleigh,F,100,43,0,43
Briellah,F,100,43,0,43
Bruk,M,100,0,43,43
Bryker,M,100,0,43,43
Camiren,M,100,0,43,43
Chadi,M,100,0,43,43
Charito,F,100,43,0,43
Chemise,F,100,43,0,43
Chiron,M,88,5,38,43
Chloi,F,100,43,0,43
Chyra,F,100,43,0,43
Clemence,F,84,36,7,43
Colleene,F,100,43,0,43
Cope,M,100,0,43,43
Coraleigh,F,100,43,0,43
Coronda,F,100,43,0,43
Crestina,F,100,43,0,43
Cristion,M,100,0,43,43
Cylah,F,100,43,0,43
Cynai,F,100,43,0,43
Dakarri,M,100,0,43,43
Danan,M,100,0,43,43
Dannilynn,F,100,43,0,43
Darleene,F,100,43,0,43
Darreyl,M,100,0,43,43
Dasya,F,100,43,0,43
Daveed,M,100,0,43,43
Deagon,M,100,0,43,43
Delanny,F,100,43,0,43
Delinah,F,100,43,0,43
Delishia,F,100,43,0,43
Demarri,M,100,0,43,43
Demeria,F,100,43,0,43
Denaye,F,100,43,0,43
Devida,F,100,43,0,43
Dibbie,F,100,43,0,43
Diondria,F,100,43,0,43
Dounia,F,100,43,0,43
Edahi,M,100,0,43,43
Eddieberto,M,100,0,43,43
Edman,M,100,0,43,43
Edmonia,F,100,43,0,43
Elsia,F,100,43,0,43
Emanii,F,100,43,0,43
Ennio,M,100,0,43,43
Erleen,F,100,43,0,43
Ermina,F,100,43,0,43
Evalene,F,100,43,0,43
Evangelin,F,100,43,0,43
Eyva,F,100,43,0,43
Forrestine,F,100,43,0,43
Fritzgerald,M,100,0,43,43
Genasis,F,100,43,0,43
Geraldyne,F,100,43,0,43
Gerred,M,100,0,43,43
Gloris,F,100,43,0,43
Gregorie,M,100,0,43,43
Gunar,M,100,0,43,43
Hamnah,F,100,43,0,43
Hasib,M,100,0,43,43
Hawo,F,100,43,0,43
Hazely,F,100,43,0,43
Hendricks,M,100,0,43,43
Hinley,F,100,43,0,43
Hoan,M,100,0,43,43
Ilaina,F,100,43,0,43
Ismari,F,100,43,0,43
Izza,F,100,43,0,43
Jahsean,M,100,0,43,43
Jaily,F,100,43,0,43
Jakeith,M,100,0,43,43
Jakyrin,M,100,0,43,43
Jametria,F,100,43,0,43
Janaea,F,100,43,0,43
Janelyn,F,100,43,0,43
Janni,F,100,43,0,43
Jaquante,M,100,0,43,43
Jaskarn,M,100,0,43,43
Jayanah,F,100,43,0,43
Jaylien,M,67,14,29,43
Jayz,M,100,0,43,43
Jee,F,88,38,5,43
Jeimi,F,100,43,0,43
Jelaine,F,100,43,0,43
Jerian,M,100,0,43,43
Jerramy,M,100,0,43,43
Jhenna,F,100,43,0,43
Johnandrew,M,100,0,43,43
Jonthomas,M,100,0,43,43
Jonya,F,100,43,0,43
Jorah,F,84,36,7,43
Joris,M,100,0,43,43
Josephyne,F,100,43,0,43
Julissia,F,100,43,0,43
Kaala,F,100,43,0,43
Kaele,F,100,43,0,43
Kaileia,F,100,43,0,43
Kanessa,F,100,43,0,43
Karilee,F,100,43,0,43
Karlette,F,100,43,0,43
Karnesha,F,100,43,0,43
Kaslyn,F,100,43,0,43
Kastin,M,100,0,43,43
Kayliee,F,100,43,0,43
Keanah,F,100,43,0,43
Keshanti,F,100,43,0,43
Keyaun,M,100,0,43,43
Khair,M,100,0,43,43
Khalyn,F,100,43,0,43
Kimar,M,100,0,43,43
Kimery,F,100,43,0,43
Kimsey,M,100,0,43,43
Kinlea,F,100,43,0,43
Kiomara,F,100,43,0,43
Kolawole,M,100,0,43,43
Kordelia,F,100,43,0,43
Krieg,M,100,0,43,43
Krischan,M,100,0,43,43
Kristafer,M,100,0,43,43
Kristos,M,100,0,43,43
Kristye,F,100,43,0,43
Krunal,M,100,0,43,43
Kuzey,M,100,0,43,43
Kwanita,F,100,43,0,43
Kwynn,F,100,43,0,43
Laiklyn,F,100,43,0,43
Lanajah,F,100,43,0,43
Laquette,F,100,43,0,43
Latazia,F,100,43,0,43
Latea,F,100,43,0,43
Latoyah,F,100,43,0,43
Latoyya,F,100,43,0,43
Laurenda,F,100,43,0,43
Lavor,M,100,0,43,43
Lawsyn,F,53,23,20,43
Layann,F,100,43,0,43
Leelu,F,100,43,0,43
Legina,F,100,43,0,43
Leilyn,F,100,43,0,43
Lesbia,F,100,43,0,43
Litzzy,F,100,43,0,43
Loana,F,100,43,0,43
Locklan,M,100,0,43,43
Loveleen,F,100,43,0,43
Lovelyn,F,100,43,0,43
Lunette,F,100,43,0,43
Luxe,F,100,43,0,43
Lyrics,F,100,43,0,43
Madasin,F,100,43,0,43
Madora,F,100,43,0,43
Maketa,F,100,43,0,43
Mandana,F,100,43,0,43
Markeece,M,100,0,43,43
Markjoseph,M,100,0,43,43
Markyla,F,100,43,0,43
Marynell,F,100,43,0,43
Matayo,M,100,0,43,43
Meuy,F,100,43,0,43
Mikyra,F,100,43,0,43
Milano,M,100,0,43,43
Milez,M,100,0,43,43
Mireyli,F,100,43,0,43
Mohamedali,M,100,0,43,43
Montinique,F,100,43,0,43
Motty,M,100,0,43,43
Murriel,F,77,33,10,43
Mursal,F,74,32,11,43
Myani,F,100,43,0,43
Naason,M,100,0,43,43
Nakasha,F,100,43,0,43
Nakshatra,F,100,43,0,43
Namiya,F,100,43,0,43
Naomii,F,100,43,0,43
Narin,M,74,11,32,43
Nasheem,M,100,0,43,43
Nataysha,F,100,43,0,43
Nathainel,M,100,0,43,43
Nathnael,M,100,0,43,43
Nazalia,F,100,43,0,43
Nenad,M,100,0,43,43
Neomiah,M,100,0,43,43
Nichloas,M,100,0,43,43
Nickelas,M,100,0,43,43
Nijha,F,100,43,0,43
Nikyra,F,100,43,0,43
Nir,M,100,0,43,43
Noelie,F,100,43,0,43
Norlan,M,100,0,43,43
Norleen,F,100,43,0,43
Normandy,F,100,43,0,43
Norrine,F,100,43,0,43
Nyairah,F,100,43,0,43
Nykera,F,100,43,0,43
Odile,F,100,43,0,43
Odyn,M,100,0,43,43
Ollis,M,100,0,43,43
Orlean,F,100,43,0,43
Orquidea,F,100,43,0,43
Petrea,F,100,43,0,43
Prema,F,100,43,0,43
Presious,F,100,43,0,43
Priscille,F,100,43,0,43
Quamari,M,100,0,43,43
Quenetta,F,100,43,0,43
Quinnisha,F,100,43,0,43
Quintisha,F,100,43,0,43
Ragnar,M,100,0,43,43
Ramyiah,F,100,43,0,43
Rashonna,F,100,43,0,43
Rawad,M,100,0,43,43
Rayahna,F,100,43,0,43
Rechell,F,100,43,0,43
Redia,F,100,43,0,43
Renya,F,100,43,0,43
Rodner,M,100,0,43,43
Roselynne,F,100,43,0,43
Sadiah,F,100,43,0,43
Saije,F,100,43,0,43
Samoya,F,100,43,0,43
Sandler,M,100,0,43,43
Saniaa,F,100,43,0,43
Sanvika,F,100,43,0,43
Saphera,F,100,43,0,43
Sasheen,F,100,43,0,43
Savilla,F,100,43,0,43
Scheherazade,F,100,43,0,43
Selassie,M,100,0,43,43
Shabrina,F,100,43,0,43
Shadaria,F,100,43,0,43
Shaffer,M,100,0,43,43
Shahadah,F,100,43,0,43
Shakeshia,F,100,43,0,43
Shakiria,F,100,43,0,43
Shantall,F,100,43,0,43
Shareefah,F,100,43,0,43
Sharonn,F,100,43,0,43
Shavannah,F,100,43,0,43
Shawona,F,100,43,0,43
Shen,M,100,0,43,43
Shenette,F,100,43,0,43
Shiley,F,100,43,0,43
Shimere,F,100,43,0,43
Shireka,F,100,43,0,43
Shohei,M,100,0,43,43
Skyylar,F,88,38,5,43
Sophiana,F,100,43,0,43
Sthefany,F,100,43,0,43
Sumayo,F,100,43,0,43
Suniya,F,100,43,0,43
Syera,F,100,43,0,43
Taffi,F,100,43,0,43
Taisean,M,100,0,43,43
Taisiya,F,100,43,0,43
Taketa,F,100,43,0,43
Tamike,F,100,43,0,43
Tanisi,F,100,43,0,43
Tarion,M,100,0,43,43
Tashelle,F,100,43,0,43
Teashia,F,100,43,0,43
Temidayo,M,77,10,33,43
Tenaj,F,100,43,0,43
Terecita,F,100,43,0,43
Teuila,F,100,43,0,43
Teuta,F,100,43,0,43
Tikeya,F,100,43,0,43
Titanna,F,100,43,0,43
Tomarra,F,100,43,0,43
Torrien,M,100,0,43,43
Treyanna,F,100,43,0,43
Treyquan,M,100,0,43,43
Tyajah,F,100,43,0,43
Tykeya,F,100,43,0,43
Tymire,M,100,0,43,43
Tynnetta,F,100,43,0,43
Tyrance,M,100,0,43,43
Tyrhianna,F,100,43,0,43
Tysheria,F,100,43,0,43
Tyvan,M,100,0,43,43
Umi,F,100,43,0,43
Vandon,M,100,0,43,43
Vedansh,M,100,0,43,43
Veletta,F,100,43,0,43
Velora,F,100,43,0,43
Vikkie,F,100,43,0,43
Voni,F,100,43,0,43
Wendalyn,F,100,43,0,43
Wilmot,M,100,0,43,43
Wrenna,F,100,43,0,43
Wykesha,F,100,43,0,43
Xsavior,M,100,0,43,43
Xzorion,M,100,0,43,43
Yakisha,F,100,43,0,43
Yali,F,60,26,17,43
Yamani,F,88,38,5,43
Yamiles,F,100,43,0,43
Yamille,F,100,43,0,43
Yanisha,F,100,43,0,43
Yavonda,F,100,43,0,43
Zaharia,F,100,43,0,43
Zaima,F,100,43,0,43
Zarae,F,100,43,0,43
Zytavious,M,100,0,43,43
Abhijit,M,100,0,42,42
Abigahil,F,100,42,0,42
Abraam,M,100,0,42,42
Adaugo,F,100,42,0,42
Adeoluwa,M,100,0,42,42
Adhira,F,100,42,0,42
Ahmoni,F,100,42,0,42
Aleksy,M,100,0,42,42
Alexix,F,88,37,5,42
Alii,M,86,6,36,42
Allise,F,100,42,0,42
Allyx,F,100,42,0,42
Alphonsus,M,100,0,42,42
Alyrica,F,100,42,0,42
Amaliya,F,100,42,0,42
Amiayah,F,100,42,0,42
Amii,F,100,42,0,42
Andrewjohn,M,100,0,42,42
Andro,M,100,0,42,42
Anisty,F,100,42,0,42
Annettee,F,100,42,0,42
Antonnio,M,100,0,42,42
Arib,M,100,0,42,42
Armeda,F,100,42,0,42
Aser,M,100,0,42,42
Asharie,F,100,42,0,42
Atlai,M,100,0,42,42
Audriauna,F,100,42,0,42
Avaleen,F,100,42,0,42
Avenly,F,100,42,0,42
Avya,F,100,42,0,42
Axtyn,M,100,0,42,42
Ayaansh,M,100,0,42,42
Ayad,M,100,0,42,42
Azani,F,100,42,0,42
Barabra,F,100,42,0,42
Benz,M,100,0,42,42
Breannon,F,100,42,0,42
Breina,F,100,42,0,42
Briesha,F,100,42,0,42
Brig,M,100,0,42,42
Burech,M,100,0,42,42
Caiman,M,100,0,42,42
Caleyah,F,100,42,0,42
Caresa,F,100,42,0,42
Carmenlita,F,100,42,0,42
Carre,F,100,42,0,42
Ceon,M,100,0,42,42
Chenequa,F,100,42,0,42
Chenique,F,100,42,0,42
Cherece,F,100,42,0,42
Chrishanna,F,100,42,0,42
Christoval,M,100,0,42,42
Cirsten,F,100,42,0,42
Crislynn,F,100,42,0,42
Crystiana,F,100,42,0,42
Curits,M,100,0,42,42
Cyrina,F,100,42,0,42
Daanya,F,100,42,0,42
Dagem,M,100,0,42,42
Daileen,F,100,42,0,42
Daiquiri,F,100,42,0,42
Daleisa,F,100,42,0,42
Daquavious,M,100,0,42,42
Darain,M,100,0,42,42
Dariyan,F,55,23,19,42
Daryk,M,100,0,42,42
Dasiyah,F,100,42,0,42
Daxter,M,100,0,42,42
Delvina,F,100,42,0,42
Denease,F,100,42,0,42
Derotha,F,100,42,0,42
Deyonta,M,100,0,42,42
Dezare,F,100,42,0,42
Doulgas,M,100,0,42,42
Drago,M,100,0,42,42
Dreydan,M,100,0,42,42
Drucella,F,100,42,0,42
Dwanye,M,100,0,42,42
Edom,F,100,42,0,42
Edras,M,100,0,42,42
Edrina,F,100,42,0,42
Elizabelle,F,100,42,0,42
Emmalei,F,100,42,0,42
Emmilynn,F,100,42,0,42
Enan,M,100,0,42,42
Enio,M,100,0,42,42
Enzio,M,100,0,42,42
Esker,M,100,0,42,42
Ethann,M,100,0,42,42
Fabrienne,F,100,42,0,42
Fitzpatrick,M,100,0,42,42
Gailya,F,100,42,0,42
Galene,F,100,42,0,42
Gearldean,F,100,42,0,42
Giovann,M,100,0,42,42
Gracelee,F,100,42,0,42
Graisyn,F,76,32,10,42
Gwendlyon,F,100,42,0,42
Hamidou,M,100,0,42,42
Hany,M,88,5,37,42
Harjas,M,60,17,25,42
Harvis,M,100,0,42,42
Hassana,F,100,42,0,42
Hatley,F,100,42,0,42
Huxton,M,100,0,42,42
Iliani,F,100,42,0,42
Illiam,M,100,0,42,42
Inisha,F,100,42,0,42
Issys,F,100,42,0,42
Izellah,F,100,42,0,42
Jabraylon,M,100,0,42,42
Jadalise,F,100,42,0,42
Jailia,F,100,42,0,42
Jaimir,M,100,0,42,42
Jakiria,F,100,42,0,42
Jalaia,F,100,42,0,42
Jamarah,F,100,42,0,42
Jamesdavid,M,100,0,42,42
Jamieann,F,100,42,0,42
Janat,F,100,42,0,42
Jarard,M,100,0,42,42
Jaynae,F,100,42,0,42
Jaysion,M,100,0,42,42
Jazer,M,100,0,42,42
Jeanmichel,M,100,0,42,42
Jemica,F,100,42,0,42
Jeneffer,F,100,42,0,42
Jerrius,M,100,0,42,42
Joen,M,76,10,32,42
Johnnyray,M,100,0,42,42
Joseenrique,M,100,0,42,42
Juanandres,M,100,0,42,42
Juridia,F,100,42,0,42
Kadidia,F,100,42,0,42
Kaidee,F,100,42,0,42
Kairen,M,100,0,42,42
Kaleese,F,100,42,0,42
Kamariana,F,100,42,0,42
Karline,F,100,42,0,42
Kayshia,F,100,42,0,42
Kazmir,M,100,0,42,42
Kebba,M,100,0,42,42
Keden,M,100,0,42,42
Keimoni,M,60,17,25,42
Keiryn,F,100,42,0,42
Keiya,F,100,42,0,42
Kenaya,F,100,42,0,42
Kener,M,100,0,42,42
Keyanni,F,100,42,0,42
Keydy,F,100,42,0,42
Khadyn,M,100,0,42,42
Kharlie,F,100,42,0,42
Khrystopher,M,100,0,42,42
Kida,F,100,42,0,42
Kielynn,F,100,42,0,42
Kiswana,F,100,42,0,42
Kitten,F,100,42,0,42
Kizmet,F,100,42,0,42
Klohie,F,100,42,0,42
Kolie,F,100,42,0,42
Koralee,F,100,42,0,42
Krishang,M,100,0,42,42
Ladamion,M,100,0,42,42
Laikynn,F,100,42,0,42
Lailaa,F,100,42,0,42
Laily,F,100,42,0,42
Lamell,M,100,0,42,42
Lamontez,M,100,0,42,42
Laquann,M,100,0,42,42
Laramy,M,100,0,42,42
Lashonia,F,100,42,0,42
Latifha,F,100,42,0,42
Latwana,F,100,42,0,42
Lawryn,F,100,42,0,42
Laylynn,F,100,42,0,42
Leaanne,F,100,42,0,42
Leeloo,F,100,42,0,42
Lenford,M,100,0,42,42
Lenka,F,100,42,0,42
Lesther,M,100,0,42,42
Levada,F,100,42,0,42
Lewellyn,M,100,0,42,42
Libi,F,100,42,0,42
Lille,F,100,42,0,42
Linae,F,100,42,0,42
Lizabella,F,100,42,0,42
Louisiana,F,100,42,0,42
Loyola,F,100,42,0,42
Maddoc,M,100,0,42,42
Maecyn,F,100,42,0,42
Mairlyn,F,100,42,0,42
Makiba,F,100,42,0,42
Manyah,F,100,42,0,42
Marguise,M,100,0,42,42
Markai,M,76,10,32,42
Markaya,F,100,42,0,42
Marnice,F,100,42,0,42
Marqueisha,F,100,42,0,42
Masoud,M,100,0,42,42
Mate,M,100,0,42,42
Maxxon,M,100,0,42,42
Mekka,F,100,42,0,42
Mertie,F,100,42,0,42
Metzly,F,100,42,0,42
Mikhal,M,88,5,37,42
Milfred,M,100,0,42,42
Milliani,F,100,42,0,42
Mirari,F,100,42,0,42
Mosese,M,100,0,42,42
Mubashir,M,100,0,42,42
Muhammadali,M,100,0,42,42
Mylisha,F,100,42,0,42
Myoshi,F,100,42,0,42
Nahim,M,100,0,42,42
Nathenial,M,100,0,42,42
Neasha,F,100,42,0,42
Nethanel,M,100,0,42,42
Niome,F,100,42,0,42
Nylen,M,88,5,37,42
Ofa,F,88,37,5,42
Oluwaferanmi,M,71,12,30,42
Pamalee,F,100,42,0,42
Pasco,M,100,0,42,42
Pashence,F,100,42,0,42
Patreece,F,100,42,0,42
Payshence,F,100,42,0,42
Persaeus,F,100,42,0,42
Porshay,F,100,42,0,42
Pragna,F,100,42,0,42
Pristine,F,100,42,0,42
Pual,M,100,0,42,42
Pujan,M,100,0,42,42
Purav,M,100,0,42,42
Raeshell,F,100,42,0,42
Rakita,F,100,42,0,42
Ralik,M,100,0,42,42
Rayfus,M,100,0,42,42
Reyly,M,100,0,42,42
Reynel,M,100,0,42,42
Rickye,M,100,0,42,42
Rihonna,F,100,42,0,42
Romanita,F,100,42,0,42
Rotasha,F,100,42,0,42
Rumor,F,100,42,0,42
Ruthellen,F,100,42,0,42
Sadiyyah,F,100,42,0,42
Sagen,F,55,23,19,42
Sahan,M,100,0,42,42
Samih,M,100,0,42,42
Samrawit,F,100,42,0,42
Saraha,F,100,42,0,42
Sararose,F,100,42,0,42
Schafer,M,100,0,42,42
Segio,M,100,0,42,42
Seqouia,F,100,42,0,42
Seyla,F,100,42,0,42
Seylah,F,100,42,0,42
Shaian,F,100,42,0,42
Shannika,F,100,42,0,42
Shantrel,F,100,42,0,42
Shareda,F,100,42,0,42
Shaunell,F,100,42,0,42
Shaurice,F,100,42,0,42
Shawta,F,100,42,0,42
Sheleta,F,100,42,0,42
Shenel,F,100,42,0,42
Shenitha,F,100,42,0,42
Shikia,F,100,42,0,42
Shmaya,M,100,0,42,42
Shuana,F,100,42,0,42
Silke,F,100,42,0,42
Skilyn,F,100,42,0,42
Skyrah,F,100,42,0,42
Solomiya,F,100,42,0,42
Somiya,F,100,42,0,42
Sriansh,M,100,0,42,42
Success,M,69,13,29,42
Suniyah,F,100,42,0,42
Syasia,F,100,42,0,42
Sylvi,F,100,42,0,42
Taiton,M,100,0,42,42
Talma,F,100,42,0,42
Tamye,F,100,42,0,42
Taneha,F,100,42,0,42
Tasa,F,100,42,0,42
Tawon,M,100,0,42,42
Teasa,F,100,42,0,42
Tenny,F,50,21,21,42
Terrol,M,100,0,42,42
Teygan,F,64,27,15,42
Thanvi,F,100,42,0,42
Thiara,F,100,42,0,42
Tracker,M,100,0,42,42
Tregg,M,100,0,42,42
Tshombe,M,100,0,42,42
Tykevious,M,100,0,42,42
Tyquesha,F,100,42,0,42
Usamah,M,100,0,42,42
Velissa,F,100,42,0,42
Venora,F,100,42,0,42
Verlee,F,100,42,0,42
Victoire,F,100,42,0,42
Viriginia,F,100,42,0,42
Vyvy,F,100,42,0,42
Wana,F,100,42,0,42
Wardah,F,100,42,0,42
Xayne,M,100,0,42,42
Yanaira,F,100,42,0,42
Yaresli,F,100,42,0,42
Yarisbeth,F,100,42,0,42
Yeremi,M,100,0,42,42
Ysamar,F,100,42,0,42
Zakhai,M,100,0,42,42
Zakyiah,F,100,42,0,42
Zalan,M,100,0,42,42
Zanovia,F,100,42,0,42
Zaydah,F,100,42,0,42
Zeola,F,100,42,0,42
Zerik,M,100,0,42,42
Zhoie,F,100,42,0,42
Ziyona,F,100,42,0,42
Aashrita,F,100,41,0,41
Abrahem,M,100,0,41,41
Abriela,F,100,41,0,41
Adalea,F,100,41,0,41
Adaleena,F,100,41,0,41
Adalida,F,100,41,0,41
Addaleigh,F,100,41,0,41
Adlin,F,100,41,0,41
Afshan,F,100,41,0,41
Ahlijah,M,100,0,41,41
Aimon,M,100,0,41,41
Ajae,F,73,30,11,41
Ajana,F,100,41,0,41
Alegna,F,100,41,0,41
Alexies,F,100,41,0,41
Alexious,F,100,41,0,41
Alleyna,F,100,41,0,41
Allyshia,F,100,41,0,41
Aluel,F,100,41,0,41
Amaly,F,100,41,0,41
Ameilya,F,100,41,0,41
Amilea,F,100,41,0,41
Anamaris,F,100,41,0,41
Aneatra,F,100,41,0,41
Anevaeh,F,100,41,0,41
Angeljesus,M,100,0,41,41
Anglina,F,100,41,0,41
Anjay,M,100,0,41,41
Annely,F,100,41,0,41
Anwesha,F,100,41,0,41
Aqil,M,100,0,41,41
Aremi,F,100,41,0,41
Argelis,M,88,5,36,41
Arietta,F,100,41,0,41
Arlander,M,100,0,41,41
Arneta,F,100,41,0,41
Asar,M,100,0,41,41
Asbury,M,100,0,41,41
Ashleyn,F,100,41,0,41
Astri,F,100,41,0,41
Aubin,M,73,11,30,41
Aubrye,F,100,41,0,41
Audon,M,100,0,41,41
Audyn,F,88,36,5,41
Aukai,M,100,0,41,41
Aulden,M,100,0,41,41
Avaclaire,F,100,41,0,41
Aviraj,M,100,0,41,41
Aws,M,100,0,41,41
Azahria,F,100,41,0,41
Azelin,F,100,41,0,41
Baiden,M,100,0,41,41
Baileyann,F,100,41,0,41
Bassem,M,100,0,41,41
Batuhan,M,100,0,41,41
Bautista,M,100,0,41,41
Beva,F,100,41,0,41
Bintu,F,100,41,0,41
Bion,M,100,0,41,41
Bismah,F,100,41,0,41
Brandlyn,F,100,41,0,41
Braxson,M,100,0,41,41
Breeah,F,100,41,0,41
Brisen,M,100,0,41,41
Brittanye,F,100,41,0,41
Broly,M,100,0,41,41
Cadien,M,100,0,41,41
Caity,F,100,41,0,41
Calijah,M,100,0,41,41
Caneshia,F,100,41,0,41
Catiana,F,100,41,0,41
Cavalli,M,100,0,41,41
Cearia,F,100,41,0,41
Celedonio,M,100,0,41,41
Chandre,F,100,41,0,41
Charitee,F,100,41,0,41
Charlesha,F,100,41,0,41
Chavi,F,100,41,0,41
Cheena,F,100,41,0,41
Cherolyn,F,100,41,0,41
Chidimma,F,100,41,0,41
Chimera,F,100,41,0,41
Christhopher,M,100,0,41,41
Cithlaly,F,100,41,0,41
Clinique,F,100,41,0,41
Colita,F,100,41,0,41
Collett,F,100,41,0,41
Conagher,M,100,0,41,41
Coralia,F,100,41,0,41
Cordario,M,100,0,41,41
Cornella,F,100,41,0,41
Cristelle,F,100,41,0,41
Crucita,F,100,41,0,41
Cung,M,100,0,41,41
Dailah,F,100,41,0,41
Damarr,M,100,0,41,41
Danina,F,100,41,0,41
Dart,M,100,0,41,41
Dashanay,F,100,41,0,41
Deanine,F,100,41,0,41
Decota,M,88,5,36,41
Delone,M,88,5,36,41
Demmi,F,100,41,0,41
Derryk,M,100,0,41,41
Devonya,F,100,41,0,41
Devoris,M,100,0,41,41
Dezha,F,100,41,0,41
Dijana,F,100,41,0,41
Doane,M,100,0,41,41
Doanld,M,100,0,41,41
Domineque,F,63,26,15,41
Drevan,M,100,0,41,41
Drita,F,100,41,0,41
Dynah,F,100,41,0,41
Eanna,F,100,41,0,41
Ebonne,F,100,41,0,41
Efram,M,100,0,41,41
Elleni,F,100,41,0,41
Ellian,M,100,0,41,41
Elta,F,100,41,0,41
Elysium,F,88,36,5,41
Emeraude,F,100,41,0,41
Emilyelizabeth,F,100,41,0,41
Eriks,M,100,0,41,41
Ertha,F,100,41,0,41
Everline,F,100,41,0,41
Fayelynn,F,100,41,0,41
Freeland,M,100,0,41,41
Frona,F,100,41,0,41
Gagan,M,85,6,35,41
Garick,M,100,0,41,41
Generra,F,100,41,0,41
Glennisha,F,100,41,0,41
Grindl,F,100,41,0,41
Gwinda,F,100,41,0,41
Hallye,F,100,41,0,41
Harshan,M,100,0,41,41
Harshika,F,100,41,0,41
Harvel,M,100,0,41,41
Hilinai,F,100,41,0,41
Hoai,M,85,6,35,41
Hulises,M,100,0,41,41
Ikechi,M,100,0,41,41
Ilynn,F,100,41,0,41
Imalay,F,100,41,0,41
Imon,M,61,16,25,41
Inmar,M,100,0,41,41
Isamu,M,100,0,41,41
Isata,F,100,41,0,41
Ivionna,F,100,41,0,41
Jackhenry,M,100,0,41,41
Jaecion,M,100,0,41,41
Jaemi,F,100,41,0,41
Jaffer,M,100,0,41,41
Jahod,M,100,0,41,41
Jakailah,F,100,41,0,41
Jalaiah,F,100,41,0,41
Jaleisha,F,100,41,0,41
Jalese,F,100,41,0,41
Jamane,M,100,0,41,41
Jamei,F,100,41,0,41
Jamorie,M,100,0,41,41
Janil,F,100,41,0,41
Janinne,F,100,41,0,41
Jaquela,F,100,41,0,41
Jashya,F,100,41,0,41
Jaspar,M,100,0,41,41
Jayanthony,M,100,0,41,41
Jazmia,F,100,41,0,41
Jeleah,F,100,41,0,41
Jenalise,F,100,41,0,41
Jenkins,M,100,0,41,41
Jeraline,F,100,41,0,41
Jerimi,M,100,0,41,41
Jezlynn,F,100,41,0,41
Jisaiah,M,100,0,41,41
Joceyln,F,100,41,0,41
Jocqui,M,100,0,41,41
Joeb,M,100,0,41,41
Joene,F,100,41,0,41
Johnavan,M,100,0,41,41
Johnese,F,100,41,0,41
Jonattan,M,100,0,41,41
Jonuel,M,100,0,41,41
Joreen,F,100,41,0,41
Jos,M,100,0,41,41
Josiahs,M,100,0,41,41
Joury,F,100,41,0,41
Joycee,F,100,41,0,41
Julisia,F,100,41,0,41
Juniya,F,100,41,0,41
Kadijatu,F,100,41,0,41
Kaenan,M,100,0,41,41
Kaitylyn,F,100,41,0,41
Kalmen,M,100,0,41,41
Kanyiah,F,100,41,0,41
Karian,F,100,41,0,41
Kashanda,F,100,41,0,41
Kashten,M,100,0,41,41
Katai,M,100,0,41,41
Kaylany,F,100,41,0,41
Kaynan,M,100,0,41,41
Keavin,M,100,0,41,41
Keeran,M,100,0,41,41
Kelana,F,100,41,0,41
Kenslei,F,100,41,0,41
Keywanna,F,100,41,0,41
Khoen,M,100,0,41,41
Kianne,F,100,41,0,41
Kieonna,F,100,41,0,41
Kinslea,F,100,41,0,41
Kirklan,M,100,0,41,41
Kolene,F,100,41,0,41
Kortnei,F,100,41,0,41
Kristana,F,100,41,0,41
Krystil,F,100,41,0,41
Kwanisha,F,100,41,0,41
Kylianne,F,100,41,0,41
Laconia,F,100,41,0,41
Laena,F,100,41,0,41
Lakerria,F,100,41,0,41
Lakim,M,100,0,41,41
Laneesha,F,100,41,0,41
Lany,F,100,41,0,41
Larmar,M,100,0,41,41
Lataysia,F,100,41,0,41
Latreace,F,100,41,0,41
Latrista,F,100,41,0,41
Laurier,M,100,0,41,41
Laziyah,F,100,41,0,41
Leanore,F,100,41,0,41
Leighland,M,100,0,41,41
Leium,M,100,0,41,41
Leodegario,M,100,0,41,41
Lexxis,F,100,41,0,41
Loistine,F,100,41,0,41
Louan,F,100,41,0,41
Luwam,F,100,41,0,41
Luzclarita,F,100,41,0,41
Lynsy,F,100,41,0,41
Maelea,F,100,41,0,41
Maeven,F,100,41,0,41
Maiana,F,100,41,0,41
Makeesha,F,100,41,0,41
Malaquias,M,100,0,41,41
Marchae,F,100,41,0,41
Merecedes,F,100,41,0,41
Michaelray,M,100,0,41,41
Mijah,F,100,41,0,41
Mironda,F,100,41,0,41
Mondrell,M,100,0,41,41
Morriah,F,100,41,0,41
Mridula,F,100,41,0,41
Mussie,M,100,0,41,41
Myami,F,100,41,0,41
Mystica,F,100,41,0,41
Najiah,F,100,41,0,41
Nanayaa,F,100,41,0,41
Nayshaun,M,100,0,41,41
Nazyiah,F,100,41,0,41
Nehan,M,100,0,41,41
Neliah,F,100,41,0,41
Nkechinyere,F,100,41,0,41
Nusayba,F,100,41,0,41
Nyleen,F,100,41,0,41
Oria,F,100,41,0,41
Oriya,F,100,41,0,41
Oshane,M,100,0,41,41
Ova,M,61,16,25,41
Pailynn,F,100,41,0,41
Paislea,F,100,41,0,41
Pearle,F,100,41,0,41
Peretz,M,100,0,41,41
Ponda,F,100,41,0,41
Priyah,F,100,41,0,41
Qadriyyah,F,100,41,0,41
Quandell,M,100,0,41,41
Quetzally,F,100,41,0,41
Ramiel,M,100,0,41,41
Ranasia,F,100,41,0,41
Randilynn,F,100,41,0,41
Rashele,F,100,41,0,41
Rayniyah,F,100,41,0,41
Reagin,F,100,41,0,41
Reha,F,100,41,0,41
Reizy,F,100,41,0,41
Reyaansh,M,100,0,41,41
Rhae,F,100,41,0,41
Rickiyah,F,100,41,0,41
Riddhima,F,100,41,0,41
Roche,M,63,15,26,41
Rodnie,M,100,0,41,41
Rokisha,F,100,41,0,41
Ronice,F,100,41,0,41
Ronon,M,100,0,41,41
Roula,F,100,41,0,41
Ryesha,F,100,41,0,41
Rykar,M,100,0,41,41
Sahory,F,100,41,0,41
Sairy,F,100,41,0,41
Samere,M,100,0,41,41
Sapphyre,F,100,41,0,41
Sathya,M,85,6,35,41
Searcy,M,100,0,41,41
Seleni,F,100,41,0,41
Semiya,F,100,41,0,41
Sendi,F,100,41,0,41
Seydina,M,100,0,41,41
Shahbaz,M,100,0,41,41
Shahna,F,100,41,0,41
Shakeyia,F,100,41,0,41
Shamekka,F,100,41,0,41
Shanga,M,88,5,36,41
Shantiqua,F,100,41,0,41
Shaqualla,F,100,41,0,41
Sharil,F,100,41,0,41
Sharquita,F,100,41,0,41
Shaunise,F,100,41,0,41
Shinae,F,100,41,0,41
Shirita,F,100,41,0,41
Shoniqua,F,100,41,0,41
Shontee,F,100,41,0,41
Shunika,F,100,41,0,41
Siren,F,100,41,0,41
Sivani,F,100,41,0,41
Smit,M,100,0,41,41
Solena,F,100,41,0,41
Sotiria,F,100,41,0,41
Stillman,M,100,0,41,41
Sudarshan,M,100,0,41,41
Suheyb,M,100,0,41,41
Suleyka,F,100,41,0,41
Syara,F,100,41,0,41
Tahnia,F,100,41,0,41
Tailey,F,100,41,0,41
Tajahnae,F,100,41,0,41
Taleiyah,F,100,41,0,41
Tanaijah,F,100,41,0,41
Tanley,F,100,41,0,41
Tatianah,F,100,41,0,41
Tazz,M,100,0,41,41
Teagin,F,63,26,15,41
Tejan,M,100,0,41,41
Theory,F,73,30,11,41
Theresaann,F,100,41,0,41
Tilak,M,100,0,41,41
Torean,M,100,0,41,41
Tradd,M,100,0,41,41
Tranquilino,M,100,0,41,41
Travarious,M,100,0,41,41
Travien,M,100,0,41,41
Treycen,M,100,0,41,41
Truston,M,100,0,41,41
Tymeisha,F,100,41,0,41
Tyshanna,F,100,41,0,41
Vaanya,F,100,41,0,41
Valynda,F,100,41,0,41
Vannary,F,100,41,0,41
Venia,F,100,41,0,41
Vylet,F,100,41,0,41
Wendella,F,100,41,0,41
Weslynn,F,100,41,0,41
Winny,F,100,41,0,41
Wynonia,F,100,41,0,41
Xania,F,100,41,0,41
Yairi,F,100,41,0,41
Yanara,F,100,41,0,41
Yasuri,F,100,41,0,41
Yehia,M,100,0,41,41
Yifan,M,88,5,36,41
Yodit,F,100,41,0,41
Youlonda,F,100,41,0,41
Yuchen,M,85,6,35,41
Zaharra,F,100,41,0,41
Zakyrah,F,100,41,0,41
Zamarah,F,100,41,0,41
Zay,M,100,0,41,41
Zayshawn,M,100,0,41,41
Zeda,F,100,41,0,41
Zinab,F,100,41,0,41
Zurisaday,F,100,41,0,41
Zygmunt,M,100,0,41,41
Zyrianna,F,100,41,0,41
Aarvi,F,100,40,0,40
Aayat,F,100,40,0,40
Abasi,M,100,0,40,40
Abha,F,100,40,0,40
Achol,F,100,40,0,40
Adaleen,F,100,40,0,40
Adysin,F,100,40,0,40
Ahaana,F,100,40,0,40
Aidrian,M,100,0,40,40
Aiiden,M,100,0,40,40
Aisen,M,100,0,40,40
Aithen,M,100,0,40,40
Aleph,M,100,0,40,40
Aleyza,F,100,40,0,40
Allexia,F,100,40,0,40
Allondra,F,100,40,0,40
Alveria,F,100,40,0,40
Amelinda,F,100,40,0,40
Anariah,F,100,40,0,40
Anatalia,F,100,40,0,40
Andjela,F,100,40,0,40
Andralyn,F,100,40,0,40
Andreika,F,100,40,0,40
Anglica,F,100,40,0,40
Anneleise,F,100,40,0,40
Annesophie,F,100,40,0,40
Annique,F,100,40,0,40
Antwun,M,100,0,40,40
Arayia,F,100,40,0,40
Arpit,M,100,0,40,40
Arreon,F,60,24,16,40
Ashvath,M,100,0,40,40
Asmita,F,100,40,0,40
Astor,M,100,0,40,40
Atiksh,M,100,0,40,40
Audriella,F,100,40,0,40
Aveen,F,100,40,0,40
Avidan,M,100,0,40,40
Aylla,F,100,40,0,40
Ayrian,F,70,28,12,40
Azka,F,100,40,0,40
Badia,F,100,40,0,40
Bates,M,100,0,40,40
Beija,F,100,40,0,40
Bernina,F,100,40,0,40
Betzi,F,100,40,0,40
Biancia,F,100,40,0,40
Borna,M,100,0,40,40
Bozena,F,100,40,0,40
Brittina,F,100,40,0,40
Cadesha,F,100,40,0,40
Cairra,F,100,40,0,40
Caoilinn,F,100,40,0,40
Carnelia,F,100,40,0,40
Carolle,F,100,40,0,40
Caydince,F,100,40,0,40
Chandal,F,100,40,0,40
Chastelin,F,100,40,0,40
Christey,F,100,40,0,40
Christienne,F,100,40,0,40
Confesor,M,100,0,40,40
Cordy,M,80,8,32,40
Corniya,F,100,40,0,40
Cotter,M,100,0,40,40
Cynnamon,F,100,40,0,40
Cyntoria,F,100,40,0,40
Cyron,M,100,0,40,40
Daijia,F,100,40,0,40
Daiona,F,100,40,0,40
Dair,M,100,0,40,40
Dairin,F,100,40,0,40
Dalson,M,100,0,40,40
Damine,M,100,0,40,40
Damitra,F,100,40,0,40
Dariella,F,100,40,0,40
Daries,M,100,0,40,40
Darreld,M,100,0,40,40
Davesha,F,100,40,0,40
Daxen,M,100,0,40,40
Dekeisha,F,100,40,0,40
Demilade,M,68,13,27,40
Denasha,F,100,40,0,40
Devoria,F,100,40,0,40
Dirrick,M,100,0,40,40
Dollene,F,100,40,0,40
Donecia,F,100,40,0,40
Donshae,F,68,27,13,40
Dorit,F,100,40,0,40
Draysen,M,100,0,40,40
Dredon,M,100,0,40,40
Dreyon,M,100,0,40,40
Durron,M,100,0,40,40
Dushon,M,85,6,34,40
Dynette,F,100,40,0,40
Dynisty,F,100,40,0,40
Dyvon,M,100,0,40,40
Elianys,F,100,40,0,40
Elison,M,88,5,35,40
Emberley,F,100,40,0,40
Emberlin,F,100,40,0,40
Emyly,F,100,40,0,40
Enisha,F,100,40,0,40
Erland,M,100,0,40,40
Esco,M,100,0,40,40
Eshana,F,100,40,0,40
Essien,M,100,0,40,40
Evaluna,F,100,40,0,40
Evanthia,F,100,40,0,40
Evelen,F,100,40,0,40
Evella,F,100,40,0,40
Everick,M,100,0,40,40
Eyasu,M,100,0,40,40
Faina,F,100,40,0,40
Falak,F,100,40,0,40
Frankye,F,85,34,6,40
Gaea,F,100,40,0,40
Gamalier,M,100,0,40,40
Gareld,M,100,0,40,40
Geet,F,100,40,0,40
Genaya,F,100,40,0,40
Geneice,F,100,40,0,40
Genesy,F,100,40,0,40
Genises,F,100,40,0,40
Giorgi,M,100,0,40,40
Gitanjali,F,100,40,0,40
Gordana,F,100,40,0,40
Hadiyyah,F,100,40,0,40
Hadlei,F,100,40,0,40
Henli,F,100,40,0,40
Hiromy,F,100,40,0,40
Holliday,F,100,40,0,40
Hossein,M,100,0,40,40
Hrishi,M,100,0,40,40
Hud,M,100,0,40,40
Ibukunoluwa,M,58,17,23,40
Ilicia,F,100,40,0,40
Itcel,F,100,40,0,40
Izekiel,M,100,0,40,40
Jacere,M,100,0,40,40
Jadenn,M,88,5,35,40
Jaemin,M,100,0,40,40
Jagur,M,100,0,40,40
Jahvion,M,100,0,40,40
Jalanda,F,100,40,0,40
Jalexa,F,100,40,0,40
Jamesedward,M,100,0,40,40
Janon,F,100,40,0,40
Jaquae,M,85,6,34,40
Jaqualon,M,100,0,40,40
Jaqui,M,58,17,23,40
Jaquill,M,100,0,40,40
Jaquinn,M,100,0,40,40
Jarianna,F,100,40,0,40
Jasire,M,100,0,40,40
Jayniah,F,100,40,0,40
Jayvonn,M,100,0,40,40
Jazarion,M,100,0,40,40
Jeeya,F,100,40,0,40
Jeneal,F,100,40,0,40
Jennavicia,F,100,40,0,40
Jeramee,M,100,0,40,40
Jermarius,M,100,0,40,40
Jermonte,M,100,0,40,40
Jeromi,M,100,0,40,40
Jesselynn,F,100,40,0,40
Jessicalee,F,100,40,0,40
Jevion,M,100,0,40,40
Jeyleen,F,100,40,0,40
Jleigh,F,100,40,0,40
Johniel,M,100,0,40,40
Johnlee,M,100,0,40,40
Jorjia,F,100,40,0,40
Juliea,F,100,40,0,40
Kalita,F,100,40,0,40
Kanwal,F,100,40,0,40
Karryn,F,100,40,0,40
Kartina,F,100,40,0,40
Kataleena,F,100,40,0,40
Kathelene,F,100,40,0,40
Kavien,M,100,0,40,40
Kaylise,F,100,40,0,40
Keaka,M,100,0,40,40
Keerica,F,100,40,0,40
Keleah,F,100,40,0,40
Kelston,M,100,0,40,40
Kerian,F,60,24,16,40
Kessiah,F,100,40,0,40
Khaalis,M,88,5,35,40
Khael,M,100,0,40,40
Khalessi,F,100,40,0,40
Khalie,F,100,40,0,40
Khalief,M,100,0,40,40
Khiyah,F,100,40,0,40
Khuong,M,100,0,40,40
Khurram,M,100,0,40,40
Kieshawn,M,100,0,40,40
Knolan,M,100,0,40,40
Kricket,F,100,40,0,40
Krishi,M,70,12,28,40
Krystell,F,100,40,0,40
Kyala,F,100,40,0,40
Kyasha,F,100,40,0,40
Kymira,F,100,40,0,40
Kyrsti,F,100,40,0,40
Lakan,F,100,40,0,40
Lakeira,F,100,40,0,40
Lareisha,F,100,40,0,40
Lashiya,F,100,40,0,40
Lauraashley,F,100,40,0,40
Lawarence,M,100,0,40,40
Laxmi,F,100,40,0,40
Leim,M,100,0,40,40
Lekeysha,F,100,40,0,40
Lelu,F,100,40,0,40
Leonitus,M,100,0,40,40
Levonda,F,100,40,0,40
Liahm,M,100,0,40,40
Liddy,F,100,40,0,40
Lilliannah,F,100,40,0,40
Lilyen,F,100,40,0,40
Lindita,F,100,40,0,40
Lulani,F,100,40,0,40
Lymari,F,100,40,0,40
Lyrae,F,100,40,0,40
Lyrika,F,100,40,0,40
Macade,M,100,0,40,40
Macalah,F,100,40,0,40
Madylan,F,100,40,0,40
Makiaya,F,100,40,0,40
Makinly,F,100,40,0,40
Makynze,F,100,40,0,40
Maliyha,F,100,40,0,40
Mareka,F,100,40,0,40
Mariatheresa,F,100,40,0,40
Mariele,F,100,40,0,40
Marielly,F,100,40,0,40
Markiese,M,100,0,40,40
Marleana,F,100,40,0,40
Marlyse,F,100,40,0,40
Mase,M,100,0,40,40
Matiana,F,100,40,0,40
Matthue,M,100,0,40,40
Mber,F,100,40,0,40
Mcallister,M,72,11,29,40
Mckai,M,100,0,40,40
Mehana,F,100,40,0,40
Melasia,F,100,40,0,40
Melecia,F,100,40,0,40
Merika,F,100,40,0,40
Merlon,M,100,0,40,40
Micahla,F,100,40,0,40
Mikayli,F,100,40,0,40
Milianna,F,100,40,0,40
Miren,F,100,40,0,40
Mishti,F,100,40,0,40
Misk,F,100,40,0,40
Mitchal,M,100,0,40,40
Miwa,F,100,40,0,40
Miyona,F,100,40,0,40
Mohab,M,100,0,40,40
Mohnish,M,100,0,40,40
Muhanad,M,100,0,40,40
Nalea,F,100,40,0,40
Nayleah,F,100,40,0,40
Nedia,F,100,40,0,40
Neimar,M,100,0,40,40
Niayla,F,100,40,0,40
Nichlaus,M,100,0,40,40
Nicohlas,M,100,0,40,40
Nikalus,M,100,0,40,40
Nikolle,F,100,40,0,40
Ninetta,F,100,40,0,40
Ninna,F,100,40,0,40
Norville,M,100,0,40,40
Nykisha,F,100,40,0,40
Nykita,F,100,40,0,40
Odali,F,100,40,0,40
Oriyah,F,100,40,0,40
Pagan,F,100,40,0,40
Patzy,F,100,40,0,40
Peggye,F,100,40,0,40
Perpetua,F,100,40,0,40
Phalyn,F,100,40,0,40
Philmore,M,100,0,40,40
Piere,M,100,0,40,40
Prakriti,F,100,40,0,40
Prezley,F,100,40,0,40
Pricillia,F,100,40,0,40
Qadirah,F,100,40,0,40
Quamar,M,100,0,40,40
Quentrell,M,100,0,40,40
Quevon,M,100,0,40,40
Quineisha,F,100,40,0,40
Quintera,F,100,40,0,40
Rahzel,M,100,0,40,40
Rayza,F,100,40,0,40
Renatha,F,100,40,0,40
Rephael,M,100,0,40,40
Rhawnie,F,100,40,0,40
Rickson,M,100,0,40,40
Riyansh,M,100,0,40,40
Rocke,M,100,0,40,40
Romio,M,100,0,40,40
Rondre,M,100,0,40,40
Rosalinde,F,100,40,0,40
Rosamarie,F,100,40,0,40
Rosea,F,100,40,0,40
Roshani,F,100,40,0,40
Ryiah,F,100,40,0,40
Saam,M,100,0,40,40
Saeeda,F,100,40,0,40
Saily,F,100,40,0,40
Sajed,M,100,0,40,40
Sammijo,F,100,40,0,40
Samorah,F,100,40,0,40
Santeria,F,100,40,0,40
Sarajo,F,100,40,0,40
Schaefer,M,100,0,40,40
Sebatian,M,100,0,40,40
Seina,F,100,40,0,40
Selima,F,100,40,0,40
Semhar,F,100,40,0,40
Sephra,F,100,40,0,40
Seresa,F,100,40,0,40
Shaarav,M,100,0,40,40
Shakthi,F,100,40,0,40
Shalonna,F,100,40,0,40
Shandolyn,F,100,40,0,40
Shanetria,F,100,40,0,40
Shaniel,F,100,40,0,40
Sharmika,F,100,40,0,40
Shaunt,M,100,0,40,40
Shaunya,F,100,40,0,40
Sheeva,F,100,40,0,40
Sherrlyn,F,100,40,0,40
Sherrol,F,100,40,0,40
Shivaan,M,100,0,40,40
Shmya,F,100,40,0,40
Siarrah,F,100,40,0,40
Sisilia,F,100,40,0,40
Slone,M,82,7,33,40
Snezana,F,100,40,0,40
Solea,F,100,40,0,40
Soli,F,100,40,0,40
Sorsha,F,100,40,0,40
Stav,F,52,21,19,40
Stefenie,F,100,40,0,40
Stphanie,F,100,40,0,40
Sushant,M,100,0,40,40
Sylinda,F,100,40,0,40
Symaria,F,100,40,0,40
Symphani,F,100,40,0,40
Symya,F,100,40,0,40
Taedyn,M,88,5,35,40
Takea,F,100,40,0,40
Tamija,F,65,26,14,40
Tancy,F,100,40,0,40
Tanyetta,F,100,40,0,40
Tayshia,F,100,40,0,40
Terone,M,100,0,40,40
Terrail,M,100,0,40,40
Tieraney,F,100,40,0,40
Tiko,M,100,0,40,40
Timolin,F,100,40,0,40
Tooba,F,100,40,0,40
Toraino,M,100,0,40,40
Trenecia,F,100,40,0,40
Tyasha,F,100,40,0,40
Tykeira,F,100,40,0,40
Tylo,M,68,13,27,40
Tyonia,F,100,40,0,40
Tyrann,M,100,0,40,40
Tyveon,M,100,0,40,40
Unborn,F,80,32,8,40
Uzoamaka,F,100,40,0,40
Vanessamarie,F,100,40,0,40
Vaneta,F,100,40,0,40
Vernitta,F,100,40,0,40
Vesenia,F,100,40,0,40
Victori,F,100,40,0,40
Vidit,M,100,0,40,40
Vinette,F,100,40,0,40
Walley,M,100,0,40,40
Waverley,F,100,40,0,40
Welles,M,100,0,40,40
Williemae,F,100,40,0,40
Xaviana,F,100,40,0,40
Xylan,M,100,0,40,40
Xzaveon,M,100,0,40,40
Yacqub,M,100,0,40,40
Yaelin,F,100,40,0,40
Yalani,F,100,40,0,40
Yaquelyn,F,100,40,0,40
Yaretsy,F,100,40,0,40
Yavette,F,100,40,0,40
Yeeleng,M,100,0,40,40
Yehonatan,M,100,0,40,40
Yengkong,M,100,0,40,40
Yosseline,F,100,40,0,40
Zainub,F,100,40,0,40
Zarionna,F,100,40,0,40
Zeldy,F,100,40,0,40
Zeya,F,100,40,0,40
Zigmund,M,100,0,40,40
Zimir,M,100,0,40,40
Zipora,F,100,40,0,40
Zoeya,F,100,40,0,40
Zorria,F,100,40,0,40
Zy,M,85,6,34,40
Zyeria,F,100,40,0,40
Aadith,M,100,0,39,39
Aalaiyah,F,100,39,0,39
Aanisah,F,100,39,0,39
Aarib,M,100,0,39,39
Abdishakur,M,100,0,39,39
Abdula,M,100,0,39,39
Abreana,F,100,39,0,39
Abrum,M,100,0,39,39
Aceton,M,100,0,39,39
Aceyn,M,100,0,39,39
Achel,F,100,39,0,39
Acy,M,87,5,34,39
Addalynne,F,100,39,0,39
Adelade,F,100,39,0,39
Adileny,F,100,39,0,39
Adnrew,M,100,0,39,39
Ahmeer,M,100,0,39,39
Aidia,F,100,39,0,39
Akaia,F,100,39,0,39
Akiria,F,100,39,0,39
Alaijha,F,100,39,0,39
Aleise,F,100,39,0,39
Aley,F,85,33,6,39
Alfio,M,100,0,39,39
Alianys,F,100,39,0,39
Aliecia,F,100,39,0,39
Alimah,F,100,39,0,39
Amancio,M,100,0,39,39
Amarious,M,100,0,39,39
Amarre,M,100,0,39,39
Aminda,F,100,39,0,39
Analecia,F,100,39,0,39
Andreaus,M,100,0,39,39
Andrie,M,100,0,39,39
Aneesia,F,100,39,0,39
Anelys,F,100,39,0,39
Angilee,F,100,39,0,39
Anjalie,F,100,39,0,39
Annesa,F,100,39,0,39
Anuva,F,100,39,0,39
Arelyn,F,100,39,0,39
Aretzy,F,100,39,0,39
Armenta,F,100,39,0,39
Artemas,M,100,0,39,39
Ashunte,F,100,39,0,39
Attison,F,100,39,0,39
Aveleen,F,100,39,0,39
Ayvion,M,100,0,39,39
Bam,M,100,0,39,39
Bardo,M,100,0,39,39
Bazil,M,100,0,39,39
Bearett,M,100,0,39,39
Betel,F,100,39,0,39
Bracie,F,100,39,0,39
Brandeis,F,100,39,0,39
Breanca,F,100,39,0,39
Brenasia,F,100,39,0,39
Byrne,M,100,0,39,39
Cambra,F,100,39,0,39
Cantina,F,100,39,0,39
Carneisha,F,100,39,0,39
Caryss,F,100,39,0,39
Cassedy,F,100,39,0,39
Catrin,F,100,39,0,39
Chantall,F,100,39,0,39
Chaviva,F,100,39,0,39
Ched,M,100,0,39,39
Chinda,F,100,39,0,39
Cinder,F,100,39,0,39
Cniya,F,100,39,0,39
Conleigh,F,100,39,0,39
Coyt,M,100,0,39,39
Crisanta,F,100,39,0,39
Crishawn,M,100,0,39,39
Crystaline,F,100,39,0,39
Cyniyah,F,100,39,0,39
Cyre,F,100,39,0,39
Dahl,M,100,0,39,39
Daking,M,100,0,39,39
Damorion,M,100,0,39,39
Danara,F,100,39,0,39
Dannial,M,100,0,39,39
Danylo,M,100,0,39,39
Daronda,F,100,39,0,39
Dasmond,M,100,0,39,39
Dawnyell,F,100,39,0,39
Dazion,M,100,0,39,39
Dazon,M,100,0,39,39
Deantonio,M,100,0,39,39
Deaundrea,F,85,33,6,39
Deedre,F,100,39,0,39
Delee,F,100,39,0,39
Demareo,M,100,0,39,39
Demaryius,M,100,0,39,39
Denico,M,100,0,39,39
Devontez,M,100,0,39,39
Dewone,M,100,0,39,39
Diore,F,100,39,0,39
Dmoni,M,100,0,39,39
Donene,F,100,39,0,39
Doniece,F,100,39,0,39
Donquarius,M,100,0,39,39
Doriane,F,100,39,0,39
Dorrene,F,100,39,0,39
Durga,F,100,39,0,39
Eilan,M,100,0,39,39
Eleazer,M,100,0,39,39
Emahni,F,100,39,0,39
Emberlie,F,100,39,0,39
Emerly,F,100,39,0,39
Emileah,F,100,39,0,39
Emiliya,F,100,39,0,39
Emilye,F,100,39,0,39
Emrik,M,100,0,39,39
Eryana,F,100,39,0,39
Esgardo,M,100,0,39,39
Eufemio,M,100,0,39,39
Evoni,F,100,39,0,39
Faithmarie,F,100,39,0,39
Fanisha,F,100,39,0,39
Fender,M,100,0,39,39
Fleet,M,100,0,39,39
Floridalma,F,100,39,0,39
Francess,F,100,39,0,39
Franchesco,M,100,0,39,39
Gabrieal,M,54,18,21,39
Garson,M,100,0,39,39
Geannie,F,100,39,0,39
Georga,F,100,39,0,39
Gered,M,100,0,39,39
Gihanna,F,100,39,0,39
Gioni,M,100,0,39,39
Gradie,M,87,5,34,39
Hartleigh,F,100,39,0,39
Hawra,F,100,39,0,39
Heri,M,100,0,39,39
Hevyn,F,100,39,0,39
Hines,M,100,0,39,39
Ihan,M,100,0,39,39
Imarion,M,100,0,39,39
Iretta,F,100,39,0,39
Iria,F,100,39,0,39
Isidor,M,100,0,39,39
Isiss,F,100,39,0,39
Itaty,F,100,39,0,39
Izeiah,M,100,0,39,39
Jacqline,F,100,39,0,39
Jaeana,F,100,39,0,39
Jaeonna,F,100,39,0,39
Jakaia,F,100,39,0,39
Jakalya,F,100,39,0,39
Jakenya,F,100,39,0,39
Jamer,M,100,0,39,39
Janeia,F,100,39,0,39
Janhavi,F,100,39,0,39
Janieya,F,100,39,0,39
Jasneet,F,100,39,0,39
Jathaniel,M,100,0,39,39
Javarous,M,100,0,39,39
Jayk,M,100,0,39,39
Jayseon,M,100,0,39,39
Jazelynn,F,100,39,0,39
Jeilani,F,100,39,0,39
Jenella,F,100,39,0,39
Jennasis,F,100,39,0,39
Jesmarie,F,100,39,0,39
Jetzabel,F,100,39,0,39
Jewelisa,F,100,39,0,39
Joanell,F,100,39,0,39
Jonnah,F,74,29,10,39
Jonothon,M,100,0,39,39
Josealejandro,M,100,0,39,39
Joshalynn,F,100,39,0,39
Jynesis,F,100,39,0,39
Jyree,M,100,0,39,39
Kaelum,M,100,0,39,39
Kaikea,M,100,0,39,39
Kalliyan,F,100,39,0,39
Kalyana,F,100,39,0,39
Kalyce,F,100,39,0,39
Kamecia,F,100,39,0,39
Kanaiya,F,100,39,0,39
Kanylah,F,100,39,0,39
Karitza,F,100,39,0,39
Karlan,M,100,0,39,39
Kashden,M,100,0,39,39
Kashima,F,100,39,0,39
Kashyra,F,100,39,0,39
Katika,F,100,39,0,39
Katlynd,F,100,39,0,39
Kaylissa,F,100,39,0,39
Keaven,M,100,0,39,39
Kemberley,F,100,39,0,39
Kendis,F,77,30,9,39
Kendyle,F,100,39,0,39
Kentoria,F,100,39,0,39
Kerris,F,100,39,0,39
Kesan,M,100,0,39,39
Keshae,F,100,39,0,39
Kevianna,F,100,39,0,39
Keyannah,F,100,39,0,39
Khmari,M,100,0,39,39
Kholton,M,100,0,39,39
Kiabeth,F,100,39,0,39
Kialey,F,100,39,0,39
Kiamber,F,100,39,0,39
Kimly,F,100,39,0,39
Kiz,F,100,39,0,39
Kristinamarie,F,100,39,0,39
Kulsum,F,100,39,0,39
Lachana,F,100,39,0,39
Laihla,F,100,39,0,39
Lamarria,F,100,39,0,39
Larome,M,100,0,39,39
Larona,F,100,39,0,39
Lasey,F,100,39,0,39
Lashaunna,F,100,39,0,39
Lastarr,F,100,39,0,39
Lauriano,M,100,0,39,39
Layia,F,100,39,0,39
Layke,M,87,5,34,39
Laylie,F,100,39,0,39
Lazerick,M,100,0,39,39
Leiby,M,100,0,39,39
Linelle,F,100,39,0,39
Liridon,M,100,0,39,39
Lizbette,F,100,39,0,39
Loganne,F,100,39,0,39
Lonne,M,100,0,39,39
Loresa,F,100,39,0,39
Luzmarie,F,100,39,0,39
Macedonio,M,100,0,39,39
Madolynn,F,100,39,0,39
Mahrosh,F,100,39,0,39
Majesti,F,100,39,0,39
Makeia,F,100,39,0,39
Makyrah,F,100,39,0,39
Mamta,F,100,39,0,39
Manica,F,100,39,0,39
Marcita,F,100,39,0,39
Mariade,F,100,39,0,39
Marizza,F,100,39,0,39
Markaila,F,100,39,0,39
Marle,F,100,39,0,39
Marleyna,F,100,39,0,39
Marquece,M,100,0,39,39
Mata,F,100,39,0,39
Matis,M,100,0,39,39
Mauresha,F,100,39,0,39
Meridyth,F,100,39,0,39
Mersaydes,F,100,39,0,39
Meschelle,F,100,39,0,39
Mey,F,100,39,0,39
Mikelyn,F,100,39,0,39
Mistydawn,F,100,39,0,39
Mythili,F,100,39,0,39
Naiesha,F,100,39,0,39
Narali,F,100,39,0,39
Natile,F,100,39,0,39
Navion,M,100,0,39,39
Naviya,F,100,39,0,39
Neleah,F,100,39,0,39
Nephtalie,F,100,39,0,39
Nerick,M,100,0,39,39
Nevina,F,100,39,0,39
Nickalis,M,100,0,39,39
Nijia,F,100,39,0,39
Nischal,M,100,0,39,39
Niv,M,100,0,39,39
Noorah,F,100,39,0,39
Norie,F,100,39,0,39
Nykel,M,100,0,39,39
Oberon,M,100,0,39,39
Palynn,F,100,39,0,39
Phalen,M,54,18,21,39
Phillippa,F,100,39,0,39
Prianka,F,100,39,0,39
Priyana,F,100,39,0,39
Quintavion,M,100,0,39,39
Raedean,F,100,39,0,39
Raford,M,100,0,39,39
Raith,M,100,0,39,39
Rajvi,F,100,39,0,39
Ramos,M,100,0,39,39
Raylena,F,100,39,0,39
Raynel,M,87,5,34,39
Renauld,M,100,0,39,39
Rhaegan,F,100,39,0,39
Rhaelyn,F,100,39,0,39
Rhodney,M,100,0,39,39
Ries,M,100,0,39,39
Rodrigue,M,100,0,39,39
Romando,M,100,0,39,39
Romarion,M,100,0,39,39
Rommy,M,77,9,30,39
Ronata,F,100,39,0,39
Roschell,F,100,39,0,39
Ruchika,F,100,39,0,39
Rushell,F,100,39,0,39
Sammer,M,100,0,39,39
Sarahjean,F,100,39,0,39
Sashae,F,100,39,0,39
Serigo,M,100,0,39,39
Sethan,M,100,0,39,39
Seva,F,100,39,0,39
Shacole,F,100,39,0,39
Shahnaz,F,100,39,0,39
Shakell,M,74,10,29,39
Shalyce,F,100,39,0,39
Shamaka,F,100,39,0,39
Shamiqua,F,100,39,0,39
Shamonte,F,56,22,17,39
Shanaria,F,100,39,0,39
Shanden,M,100,0,39,39
Shavez,M,100,0,39,39
Shawnah,F,100,39,0,39
Shehab,M,100,0,39,39
Sheik,M,100,0,39,39
Shelbye,F,100,39,0,39
Shonetta,F,100,39,0,39
Shonnette,F,100,39,0,39
Siniah,F,100,39,0,39
Solay,F,100,39,0,39
Stephy,F,100,39,0,39
Sukhpreet,F,85,33,6,39
Syniya,F,100,39,0,39
Taekwon,M,100,0,39,39
Taheim,M,100,0,39,39
Tajir,M,100,0,39,39
Taleena,F,100,39,0,39
Talithia,F,100,39,0,39
Talliyah,F,100,39,0,39
Tamauri,M,74,10,29,39
Tamonica,F,100,39,0,39
Tandria,F,100,39,0,39
Tangerine,F,100,39,0,39
Tarrant,M,100,0,39,39
Tasja,F,100,39,0,39
Tateana,F,100,39,0,39
Taurice,M,100,0,39,39
Tavara,F,100,39,0,39
Tayiah,F,100,39,0,39
Tayyab,M,100,0,39,39
Temujin,M,100,0,39,39
Teneal,F,100,39,0,39
Teressia,F,100,39,0,39
Thailer,M,85,6,33,39
Thuytien,F,100,39,0,39
Thyme,F,100,39,0,39
Timaka,F,100,39,0,39
Tiree,M,100,0,39,39
Tolan,M,100,0,39,39
Torionna,F,100,39,0,39
Torunn,F,100,39,0,39
Tremarion,M,100,0,39,39
Trenard,M,100,0,39,39
Triniece,F,100,39,0,39
Tsubasa,M,100,0,39,39
Turk,M,100,0,39,39
Tybria,F,100,39,0,39
Tyreq,M,100,0,39,39
Tyvell,M,100,0,39,39
Vandan,M,100,0,39,39
Vanezza,F,100,39,0,39
Veneda,F,100,39,0,39
Wahab,M,100,0,39,39
Wilbern,M,100,0,39,39
Willistine,F,100,39,0,39
Xaine,M,100,0,39,39
Xaniya,F,100,39,0,39
Ya,F,87,34,5,39
Yansel,M,100,0,39,39
Yanziel,M,100,0,39,39
Yenna,F,100,39,0,39
Yesmeen,F,100,39,0,39
Yeudiel,M,100,0,39,39
Yosiel,M,100,0,39,39
Zahniyah,F,100,39,0,39
Zakiyya,F,100,39,0,39
Zarela,F,100,39,0,39
Zashawn,M,100,0,39,39
Zef,M,100,0,39,39
Zephyra,F,100,39,0,39
Zeriyah,F,100,39,0,39
Zikia,F,100,39,0,39
Zisel,F,100,39,0,39
Zoeyjane,F,100,39,0,39
Zynique,F,100,39,0,39
Aaidan,M,100,0,38,38
Aaidyn,M,100,0,38,38
Aaya,F,100,38,0,38
Aayanna,F,100,38,0,38
Adarion,M,100,0,38,38
Adelayde,F,100,38,0,38
Adoniah,M,63,14,24,38
Ajon,M,100,0,38,38
Akiles,M,100,0,38,38
Aleasia,F,100,38,0,38
Alionna,F,100,38,0,38
Almas,F,100,38,0,38
Amiliya,F,100,38,0,38
Ammanuel,M,100,0,38,38
Anahli,F,100,38,0,38
Anilu,F,100,38,0,38
Anishia,F,100,38,0,38
Anshuman,M,100,0,38,38
Antiana,F,100,38,0,38
Antranette,F,100,38,0,38
Aquisha,F,100,38,0,38
Armita,F,100,38,0,38
Artemisia,F,100,38,0,38
Arteria,F,100,38,0,38
Aryal,F,100,38,0,38
Ashelee,F,100,38,0,38
Astella,F,100,38,0,38
Asten,M,79,8,30,38
Aunyae,F,100,38,0,38
Avalena,F,100,38,0,38
Ayelene,F,100,38,0,38
Ayen,F,100,38,0,38
Ayrica,F,100,38,0,38
Barlow,M,100,0,38,38
Barren,M,100,0,38,38
Bezawit,F,100,38,0,38
Binah,F,100,38,0,38
Bobbiejean,F,100,38,0,38
Brandn,M,100,0,38,38
Breighton,M,100,0,38,38
Brenay,F,100,38,0,38
Breonca,F,100,38,0,38
Breshauna,F,100,38,0,38
Briden,M,100,0,38,38
Brieona,F,100,38,0,38
Brittnea,F,100,38,0,38
Brye,M,74,10,28,38
Bryland,M,100,0,38,38
Canice,F,100,38,0,38
Catalea,F,100,38,0,38
Catonya,F,100,38,0,38
Cedria,F,100,38,0,38
Cezanne,F,100,38,0,38
Chadsity,F,100,38,0,38
Chamere,F,100,38,0,38
Charesse,F,100,38,0,38
Chariss,F,100,38,0,38
Charlcie,F,100,38,0,38
Charleene,F,100,38,0,38
Charlii,F,100,38,0,38
Charmen,F,100,38,0,38
Chavely,F,100,38,0,38
Chinna,F,100,38,0,38
Chrishell,F,100,38,0,38
Christhian,M,100,0,38,38
Chrstina,F,100,38,0,38
Clarese,F,100,38,0,38
Clydette,F,100,38,0,38
Crysal,F,100,38,0,38
Cytlali,F,100,38,0,38
Dahlya,F,100,38,0,38
Daiwik,M,100,0,38,38
Daken,M,100,0,38,38
Dalay,F,100,38,0,38
Damber,F,100,38,0,38
Danari,M,79,8,30,38
Dangel,M,61,15,23,38
Dannett,F,100,38,0,38
Dashai,F,100,38,0,38
Daylani,F,100,38,0,38
Declynn,F,100,38,0,38
Dejonae,F,100,38,0,38
Delaysia,F,100,38,0,38
Delvonta,M,100,0,38,38
Demyia,F,100,38,0,38
Dennell,F,74,28,10,38
Derianna,F,100,38,0,38
Desmine,M,100,0,38,38
Destoni,F,100,38,0,38
Devry,M,71,11,27,38
Dohnovan,M,100,0,38,38
Domita,F,100,38,0,38
Donnah,F,100,38,0,38
Draycen,M,100,0,38,38
Dymone,F,100,38,0,38
Ebecca,F,100,38,0,38
Efrin,M,100,0,38,38
Elfrida,F,100,38,0,38
Elige,M,100,0,38,38
Elijaha,M,100,0,38,38
Elizebath,F,100,38,0,38
Elrico,M,100,0,38,38
Elvir,M,100,0,38,38
Elzabeth,F,100,38,0,38
Emelinda,F,100,38,0,38
Evangelynn,F,100,38,0,38
Everlina,F,100,38,0,38
Fineas,M,100,0,38,38
Garette,M,100,0,38,38
Garred,M,100,0,38,38
Gazelle,F,100,38,0,38
Geff,M,100,0,38,38
Ghia,F,100,38,0,38
Gibbs,M,100,0,38,38
Gifty,F,100,38,0,38
Gillianne,F,100,38,0,38
Glendal,M,100,0,38,38
Godson,M,100,0,38,38
Gralyn,M,100,0,38,38
Grettell,F,100,38,0,38
Hayvin,F,100,38,0,38
Healy,F,100,38,0,38
Heraldo,M,100,0,38,38
Hidie,F,100,38,0,38
Husayn,M,100,0,38,38
Idalie,F,100,38,0,38
Imahni,F,100,38,0,38
Imhotep,M,100,0,38,38
Indeya,F,100,38,0,38
Iyanuoluwa,F,84,32,6,38
Jacayden,M,100,0,38,38
Jacelle,F,100,38,0,38
Jacorius,M,100,0,38,38
Jahliel,M,100,0,38,38
Jaili,F,100,38,0,38
Jaimelyn,F,100,38,0,38
Jakiem,M,100,0,38,38
Jaleaha,F,100,38,0,38
Jameison,M,100,0,38,38
Jare,M,100,0,38,38
Jarelys,F,100,38,0,38
Jasly,F,100,38,0,38
Jasmie,F,100,38,0,38
Jassmyn,F,100,38,0,38
Javy,M,100,0,38,38
Jaylinne,F,100,38,0,38
Jaynelle,F,100,38,0,38
Jcion,M,100,0,38,38
Jecory,M,100,0,38,38
Jennnifer,F,100,38,0,38
Jessicka,F,100,38,0,38
Jesslin,F,100,38,0,38
Judine,F,100,38,0,38
Julean,M,100,0,38,38
Jumal,M,100,0,38,38
Justinlee,M,100,0,38,38
Jykeria,F,100,38,0,38
Kaigen,M,87,5,33,38
Kalany,F,100,38,0,38
Kanta,M,100,0,38,38
Kaprisha,F,100,38,0,38
Karelys,F,100,38,0,38
Kasan,M,100,0,38,38
Kataleyah,F,100,38,0,38
Kath,F,100,38,0,38
Kathlyne,F,100,38,0,38
Keeshaun,M,100,0,38,38
Keishauna,F,100,38,0,38
Kemet,M,100,0,38,38
Kennetra,F,100,38,0,38
Kenysha,F,100,38,0,38
Kham,M,84,6,32,38
Khian,M,100,0,38,38
Khiyon,M,100,0,38,38
Khylon,M,100,0,38,38
Kieshia,F,100,38,0,38
Kihara,F,100,38,0,38
Kingson,M,100,0,38,38
Kinyetta,F,100,38,0,38
Kishawna,F,100,38,0,38
Kitra,F,100,38,0,38
Konan,M,100,0,38,38
Kyriah,F,100,38,0,38
Labreeska,F,100,38,0,38
Laima,F,100,38,0,38
Lakish,F,100,38,0,38
Lakiska,F,100,38,0,38
Lakrystal,F,100,38,0,38
Lamarious,M,100,0,38,38
Laniaya,F,100,38,0,38
Laquavious,M,100,0,38,38
Laruth,F,100,38,0,38
Lastar,F,100,38,0,38
Latacia,F,100,38,0,38
Latarius,M,100,0,38,38
Latita,F,100,38,0,38
Layaan,F,100,38,0,38
Leisly,F,100,38,0,38
Leshanda,F,100,38,0,38
Leysha,F,100,38,0,38
Liezel,F,100,38,0,38
Lilienne,F,100,38,0,38
Littzy,F,100,38,0,38
Llewyn,M,100,0,38,38
Lo,M,87,5,33,38
Lohith,M,100,0,38,38
Lor,M,100,0,38,38
Mahd,M,100,0,38,38
Maikou,F,100,38,0,38
Malakiah,M,100,0,38,38
Malonie,F,100,38,0,38
Malyka,F,100,38,0,38
Manina,F,100,38,0,38
Marcal,M,100,0,38,38
Marcquise,M,100,0,38,38
Markael,M,100,0,38,38
Markeyla,F,100,38,0,38
Marquisia,F,100,38,0,38
Mavi,F,100,38,0,38
Mayely,F,100,38,0,38
Meladee,F,100,38,0,38
Melesia,F,100,38,0,38
Meraiah,F,100,38,0,38
Mercia,F,100,38,0,38
Mickela,F,100,38,0,38
Miha,F,100,38,0,38
Mikenzy,F,100,38,0,38
Mildreth,F,100,38,0,38
Miliano,M,100,0,38,38
Monson,M,100,0,38,38
Monterious,M,100,0,38,38
Montine,F,100,38,0,38
Mossimo,M,100,0,38,38
Muse,M,100,0,38,38
Mylove,F,100,38,0,38
Myshia,F,100,38,0,38
Naa,F,100,38,0,38
Nafi,M,100,0,38,38
Nahjee,M,100,0,38,38
Naiden,M,100,0,38,38
Naiema,F,100,38,0,38
Nakaia,F,100,38,0,38
Nakishia,F,100,38,0,38
Naporsha,F,100,38,0,38
Nasheka,F,100,38,0,38
Nashely,F,100,38,0,38
Nevelyn,F,100,38,0,38
Nickki,F,100,38,0,38
Nijal,M,100,0,38,38
Nikema,F,100,38,0,38
Nilka,F,100,38,0,38
Nyliyah,F,100,38,0,38
Octayvia,F,100,38,0,38
Omoro,M,100,0,38,38
Onofrio,M,100,0,38,38
Onterio,M,100,0,38,38
Paget,F,100,38,0,38
Paizlie,F,100,38,0,38
Petter,M,100,0,38,38
Ples,M,100,0,38,38
Quashun,M,100,0,38,38
Quintoria,F,100,38,0,38
Rachad,M,100,0,38,38
Raelyne,F,100,38,0,38
Raffinee,F,100,38,0,38
Rahmaan,M,100,0,38,38
Ramyia,F,100,38,0,38
Ranaldo,M,100,0,38,38
Raneka,F,100,38,0,38
Raydyn,M,100,0,38,38
Raymir,M,100,0,38,38
Regann,F,100,38,0,38
Renji,M,100,0,38,38
Rhaniya,F,100,38,0,38
Rhemi,F,87,33,5,38
Rhiya,F,100,38,0,38
Rhylea,F,100,38,0,38
Richardine,F,100,38,0,38
Riston,M,100,0,38,38
Riza,F,100,38,0,38
Romas,M,100,0,38,38
Rowell,M,100,0,38,38
Ruhee,F,100,38,0,38
Rylynne,F,100,38,0,38
Sadaya,F,100,38,0,38
Sahniya,F,100,38,0,38
Saidie,F,100,38,0,38
Salema,F,100,38,0,38
Salle,F,100,38,0,38
Samarya,F,100,38,0,38
Sanjida,F,100,38,0,38
Sareya,F,100,38,0,38
Sedina,F,100,38,0,38
Senait,F,100,38,0,38
Sepehr,M,100,0,38,38
Shaelynne,F,100,38,0,38
Shahada,F,100,38,0,38
Shaleek,M,100,0,38,38
Shaleya,F,100,38,0,38
Shanija,F,100,38,0,38
Shanoa,F,100,38,0,38
Shantrelle,F,100,38,0,38
Shaquielle,M,100,0,38,38
Sharilee,F,100,38,0,38
Sharity,F,100,38,0,38
Sheeba,F,100,38,0,38
Sheindel,F,100,38,0,38
Shekeria,F,100,38,0,38
Sherrylynn,F,100,38,0,38
Sheyly,F,100,38,0,38
Shinya,M,58,16,22,38
Shylar,F,100,38,0,38
Skyah,F,100,38,0,38
Sonrisa,F,100,38,0,38
Sopheak,M,100,0,38,38
Sophianna,F,100,38,0,38
Srithan,M,100,0,38,38
Stacha,F,100,38,0,38
Stephney,F,100,38,0,38
Stevy,F,87,33,5,38
Swain,M,100,0,38,38
Taitym,F,100,38,0,38
Talore,F,100,38,0,38
Tammyjo,F,100,38,0,38
Taquira,F,100,38,0,38
Tasiana,F,100,38,0,38
Tavare,M,100,0,38,38
Temeshia,F,100,38,0,38
Temya,F,100,38,0,38
Tesfa,M,100,0,38,38
Tesslyn,F,100,38,0,38
Tharen,M,100,0,38,38
Thienkim,F,100,38,0,38
Thurl,M,100,0,38,38
Tifa,F,100,38,0,38
Tiffanyamber,F,100,38,0,38
Tiina,F,100,38,0,38
Tionni,F,100,38,0,38
Tivona,F,100,38,0,38
Tomiya,F,100,38,0,38
Tommia,F,100,38,0,38
Tonoa,F,100,38,0,38
Torilynn,F,100,38,0,38
Travyn,M,100,0,38,38
Trayten,M,100,0,38,38
Treniti,F,100,38,0,38
Treyvan,M,100,0,38,38
Trulie,F,100,38,0,38
Tyerell,M,100,0,38,38
Tykeia,F,100,38,0,38
Vandetta,F,100,38,0,38
Venesia,F,100,38,0,38
Vickiana,F,100,38,0,38
Vontez,M,100,0,38,38
Wajiha,F,100,38,0,38
Wandell,M,100,0,38,38
Waris,M,100,0,38,38
Wasyl,M,100,0,38,38
Waylyn,M,100,0,38,38
Weber,M,100,0,38,38
Willeen,F,100,38,0,38
Wynelle,F,100,38,0,38
Yarexy,F,100,38,0,38
Yarisel,F,100,38,0,38
Yegor,M,100,0,38,38
Yihan,F,68,26,12,38
Yisela,F,100,38,0,38
Yolet,F,100,38,0,38
Yordanos,F,100,38,0,38
Yorick,M,100,0,38,38
Zacorey,M,100,0,38,38
Zaela,F,100,38,0,38
Zeal,M,87,5,33,38
Zelpha,F,100,38,0,38
Zenola,F,100,38,0,38
Ziann,F,100,38,0,38
Zitlalli,F,100,38,0,38
Zymirah,F,100,38,0,38
Zyquez,M,100,0,38,38
Abygael,F,100,37,0,37
Adnaan,M,100,0,37,37
Aethan,M,100,0,37,37
Afraz,M,100,0,37,37
Ahlyssa,F,100,37,0,37
Albree,F,100,37,0,37
Alexiyah,F,100,37,0,37
Alexxys,F,100,37,0,37
Alezay,F,100,37,0,37
Alheli,F,100,37,0,37
Allissia,F,100,37,0,37
Altan,M,100,0,37,37
Analisha,F,100,37,0,37
Andrel,M,86,5,32,37
Anele,F,100,37,0,37
Antoinio,M,100,0,37,37
Antwonne,M,100,0,37,37
Anyssia,F,100,37,0,37
Aronde,M,100,0,37,37
Ascension,M,100,0,37,37
Ashtun,M,100,0,37,37
Assael,M,100,0,37,37
Astyn,M,51,18,19,37
Atherine,F,100,37,0,37
Atyana,F,100,37,0,37
Aubyn,F,100,37,0,37
Austinjames,M,100,0,37,37
Aveer,M,100,0,37,37
Avereigh,F,100,37,0,37
Barre,M,100,0,37,37
Benelli,F,100,37,0,37
Berman,M,100,0,37,37
Betzabel,F,100,37,0,37
Bonnee,F,100,37,0,37
Brantson,M,100,0,37,37
Brayde,M,100,0,37,37
Breeza,F,100,37,0,37
Breighanna,F,100,37,0,37
Brenesha,F,100,37,0,37
Breonda,F,100,37,0,37
Briceton,M,100,0,37,37
Bristen,F,59,22,15,37
Britan,M,70,11,26,37
Britanya,F,100,37,0,37
Buzzy,M,100,0,37,37
Caelon,M,100,0,37,37
Caliope,F,100,37,0,37
Cameisha,F,100,37,0,37
Camily,F,100,37,0,37
Catasha,F,100,37,0,37
Caynen,M,100,0,37,37
Cecy,F,100,37,0,37
Cerah,F,100,37,0,37
Chadwyck,M,100,0,37,37
Chakakhan,F,100,37,0,37
Chap,M,100,0,37,37
Chappell,M,86,5,32,37
Charlin,F,100,37,0,37
Chealsy,F,100,37,0,37
Chelita,F,100,37,0,37
Chely,F,100,37,0,37
Chenice,F,100,37,0,37
Chereka,F,100,37,0,37
Ciella,F,100,37,0,37
Cjay,M,100,0,37,37
Cloteal,F,100,37,0,37
Coletin,M,100,0,37,37
Columba,F,100,37,0,37
Corlene,F,100,37,0,37
Cressie,F,100,37,0,37
Dajanai,F,100,37,0,37
Danixa,F,100,37,0,37
Darlah,F,100,37,0,37
Darshaun,M,100,0,37,37
Davron,M,100,0,37,37
Dayjon,M,100,0,37,37
Debroha,F,100,37,0,37
Denaysha,F,100,37,0,37
Denedra,F,100,37,0,37
Denison,M,100,0,37,37
Derious,M,100,0,37,37
Destinye,F,100,37,0,37
Devanna,F,100,37,0,37
Devoiry,F,100,37,0,37
Diamonde,F,100,37,0,37
Doresa,F,100,37,0,37
Dorwin,M,100,0,37,37
Doye,M,100,0,37,37
Draegan,M,100,0,37,37
Drelon,M,100,0,37,37
Dreveon,M,100,0,37,37
Druann,F,100,37,0,37
Dynesty,F,100,37,0,37
Dywayne,M,100,0,37,37
Earica,F,100,37,0,37
Eevee,F,100,37,0,37
Eibhlin,F,100,37,0,37
Ekram,F,100,37,0,37
Eliijah,M,100,0,37,37
Elijsha,M,100,0,37,37
Ellenie,F,100,37,0,37
Enrike,M,100,0,37,37
Enson,M,100,0,37,37
Esley,M,86,5,32,37
Ethanmichael,M,100,0,37,37
Eusebia,F,100,37,0,37
Evynne,F,100,37,0,37
Fallynn,F,100,37,0,37
Fania,F,100,37,0,37
Fatemeh,F,100,37,0,37
Feigy,F,100,37,0,37
Ferenc,M,100,0,37,37
Finch,M,100,0,37,37
Fion,F,100,37,0,37
Fitzhugh,M,100,0,37,37
Floris,F,100,37,0,37
Formeka,F,100,37,0,37
Franchester,F,100,37,0,37
Frazer,M,100,0,37,37
Genet,F,100,37,0,37
Giano,M,100,0,37,37
Glorietta,F,100,37,0,37
Glorya,F,100,37,0,37
Grabriela,F,100,37,0,37
Habibah,F,100,37,0,37
Haeun,F,100,37,0,37
Haivyn,F,100,37,0,37
Harleyann,F,100,37,0,37
Harvetta,F,100,37,0,37
Harwood,M,100,0,37,37
Hatti,F,100,37,0,37
Hazley,F,100,37,0,37
Heldana,F,100,37,0,37
Helin,F,100,37,0,37
Hessie,F,100,37,0,37
Hiley,F,100,37,0,37
Ihsaan,M,100,0,37,37
Ikey,M,100,0,37,37
Ikisha,F,100,37,0,37
Ismaila,M,100,0,37,37
Izai,M,100,0,37,37
Jacarion,M,100,0,37,37
Jackquelin,F,100,37,0,37
Jadeline,F,100,37,0,37
Jaethan,M,100,0,37,37
Jahmair,M,100,0,37,37
Jaithan,M,100,0,37,37
Jaiyda,F,100,37,0,37
Jakobey,M,100,0,37,37
Jamah,M,100,0,37,37
Jamarrie,M,100,0,37,37
Janeyah,F,100,37,0,37
Japeth,M,100,0,37,37
Jaquira,F,100,37,0,37
Jasel,F,100,37,0,37
Jasi,F,70,26,11,37
Jasmynne,F,100,37,0,37
Jatana,F,100,37,0,37
Java,M,54,17,20,37
Jaydelyn,F,100,37,0,37
Jayvaughn,M,100,0,37,37
Jeannete,F,100,37,0,37
Jenaiya,F,100,37,0,37
Jerit,M,100,0,37,37
Jermyah,M,51,18,19,37
Jerryn,M,100,0,37,37
Jhayda,F,100,37,0,37
Jhonnie,M,100,0,37,37
Johne,M,86,5,32,37
Johnise,F,100,37,0,37
Joiya,F,100,37,0,37
Jolia,F,100,37,0,37
Jumanah,F,100,37,0,37
Kadaisha,F,100,37,0,37
Kaddie,F,100,37,0,37
Kahlani,F,100,37,0,37
Kailas,M,100,0,37,37
Kailiyah,F,100,37,0,37
Kalyne,F,100,37,0,37
Kameya,F,100,37,0,37
Kanishka,F,100,37,0,37
Karynne,F,100,37,0,37
Kashunda,F,100,37,0,37
Kathlena,F,100,37,0,37
Kattya,F,100,37,0,37
Kawaski,M,100,0,37,37
Kayja,F,100,37,0,37
Kaylanna,F,100,37,0,37
Keiven,M,100,0,37,37
Kellum,M,100,0,37,37
Keneesha,F,100,37,0,37
Kenjuan,M,100,0,37,37
Keylly,F,100,37,0,37
Khadjah,F,100,37,0,37
Khalique,M,100,0,37,37
Khusbu,F,100,37,0,37
Kianga,F,100,37,0,37
Kinsly,F,100,37,0,37
Kliyah,F,100,37,0,37
Krishelle,F,100,37,0,37
Kumail,M,100,0,37,37
Kymon,M,100,0,37,37
Lailey,F,100,37,0,37
Lajayla,F,100,37,0,37
Lajohn,M,100,0,37,37
Larika,F,100,37,0,37
Lashekia,F,100,37,0,37
Lashera,F,100,37,0,37
Lashyra,F,100,37,0,37
Latorra,F,100,37,0,37
Latwanda,F,100,37,0,37
Lavasia,F,100,37,0,37
Lealani,F,100,37,0,37
Levente,M,100,0,37,37
Lewi,M,100,0,37,37
Lexius,F,100,37,0,37
Lieutenant,M,100,0,37,37
Linett,F,100,37,0,37
Lizveth,F,100,37,0,37
Lonzetta,F,100,37,0,37
Loreatha,F,100,37,0,37
Louana,F,100,37,0,37
Luqmaan,M,100,0,37,37
Lyden,M,100,0,37,37
Lynx,M,100,0,37,37
Lynzey,F,100,37,0,37
Machenzie,F,86,32,5,37
Macklyn,F,100,37,0,37
Maden,M,100,0,37,37
Madissyn,F,100,37,0,37
Maijor,M,100,0,37,37
Maileen,F,100,37,0,37
Majeed,M,100,0,37,37
Makalie,F,100,37,0,37
Malikk,M,100,0,37,37
Maragret,F,100,37,0,37
Mareen,F,100,37,0,37
Marial,F,100,37,0,37
Marianah,F,100,37,0,37
Mariani,F,100,37,0,37
Marivi,F,100,37,0,37
Martial,M,100,0,37,37
Marytheresa,F,100,37,0,37
Maxsim,M,100,0,37,37
Maykala,F,100,37,0,37
Mazlyn,F,100,37,0,37
Mclaren,M,100,0,37,37
Meekah,F,100,37,0,37
Mekhiya,F,100,37,0,37
Mendell,M,100,0,37,37
Merian,F,100,37,0,37
Mican,M,100,0,37,37
Micayah,F,100,37,0,37
Michelee,F,100,37,0,37
Mielle,F,100,37,0,37
Mikila,F,100,37,0,37
Mlynn,F,100,37,0,37
Monolito,M,100,0,37,37
Montica,F,100,37,0,37
Morrighan,F,100,37,0,37
Muaaz,M,100,0,37,37
Naiem,M,100,0,37,37
Nairoby,F,100,37,0,37
Nakhiya,F,100,37,0,37
Nakida,F,100,37,0,37
Natiyah,F,100,37,0,37
Navleen,F,100,37,0,37
Nazarene,F,100,37,0,37
Nazari,F,73,27,10,37
Neariah,F,100,37,0,37
Needham,M,100,0,37,37
Nelani,F,100,37,0,37
Neydi,F,100,37,0,37
Nishaan,M,100,0,37,37
Nyirah,F,100,37,0,37
Nylea,F,100,37,0,37
Nylene,F,100,37,0,37
Nyya,F,100,37,0,37
Oba,M,100,0,37,37
Omareon,M,100,0,37,37
Orna,F,100,37,0,37
Othoniel,M,100,0,37,37
Paitlyn,F,100,37,0,37
Pawan,M,100,0,37,37
Prabhnoor,F,54,20,17,37
Prarthana,F,100,37,0,37
Pressly,F,100,37,0,37
Quiniya,F,100,37,0,37
Quinlee,F,100,37,0,37
Raizo,M,100,0,37,37
Rakhia,F,100,37,0,37
Rameka,F,100,37,0,37
Ramira,F,100,37,0,37
Raymere,M,100,0,37,37
Reighlynn,F,100,37,0,37
Reino,M,100,0,37,37
Rhyanne,F,100,37,0,37
Rickel,F,100,37,0,37
Ricole,F,100,37,0,37
Rigoverto,M,100,0,37,37
Roanin,M,100,0,37,37
Robertjames,M,100,0,37,37
Robine,F,100,37,0,37
Rocelyn,F,100,37,0,37
Rodert,M,100,0,37,37
Rohun,M,100,0,37,37
Romaro,M,100,0,37,37
Romonica,F,100,37,0,37
Rosean,M,86,5,32,37
Royelle,F,100,37,0,37
Rupinder,F,100,37,0,37
Rychelle,F,100,37,0,37
Ryotaro,M,100,0,37,37
Sahori,F,100,37,0,37
Sakariye,M,100,0,37,37
Sakita,F,100,37,0,37
Samaiah,F,100,37,0,37
Sanne,F,100,37,0,37
Saraye,F,100,37,0,37
Serai,F,100,37,0,37
Sereta,F,100,37,0,37
Sevak,M,100,0,37,37
Shakiem,M,100,0,37,37
Shanaz,F,100,37,0,37
Shanitta,F,100,37,0,37
Shantey,F,100,37,0,37
Shareika,F,100,37,0,37
Sharletta,F,100,37,0,37
Shawndee,F,100,37,0,37
Shaylei,F,100,37,0,37
Sheka,F,100,37,0,37
Shelleen,F,100,37,0,37
Sheneeka,F,100,37,0,37
Sherye,F,100,37,0,37
Shilonda,F,100,37,0,37
Shyrone,M,100,0,37,37
Siriyah,F,100,37,0,37
Sjon,M,100,0,37,37
Skylyr,F,100,37,0,37
Solstice,F,100,37,0,37
Sookie,F,100,37,0,37
Sophal,M,100,0,37,37
Srihaas,M,100,0,37,37
Srikrishna,M,100,0,37,37
Stafanie,F,100,37,0,37
Straton,M,100,0,37,37
Subhaan,M,100,0,37,37
Taleaha,F,100,37,0,37
Talesa,F,100,37,0,37
Tamitra,F,100,37,0,37
Taos,M,100,0,37,37
Taquanda,F,100,37,0,37
Tarya,F,100,37,0,37
Tashvi,F,100,37,0,37
Tatyania,F,100,37,0,37
Taundra,F,100,37,0,37
Tegen,M,86,5,32,37
Tenica,F,100,37,0,37
Terriel,M,86,5,32,37
Ticey,F,100,37,0,37
Tiffinay,F,100,37,0,37
Timeko,F,100,37,0,37
Tinzlee,F,100,37,0,37
Torran,M,100,0,37,37
Travonda,F,100,37,0,37
Treyvian,M,100,0,37,37
Tyhesia,F,100,37,0,37
Tynequa,F,100,37,0,37
Tynslee,F,100,37,0,37
Tysa,F,100,37,0,37
Tyshonna,F,100,37,0,37
Tyteana,F,100,37,0,37
Tyyanna,F,100,37,0,37
Unica,F,100,37,0,37
Urja,F,100,37,0,37
Valree,F,100,37,0,37
Vassie,F,100,37,0,37
Venis,F,100,37,0,37
Veranda,F,100,37,0,37
Vernett,F,100,37,0,37
Vernona,F,100,37,0,37
Victorianna,F,100,37,0,37
Vidushi,F,100,37,0,37
Vuthy,M,100,0,37,37
Wanakee,F,100,37,0,37
Wilene,F,100,37,0,37
Wyitt,M,100,0,37,37
Xanthia,F,100,37,0,37
Yamiled,F,100,37,0,37
Yanzel,M,100,0,37,37
Yejin,F,100,37,0,37
Yenia,F,100,37,0,37
Yeremy,M,100,0,37,37
Yohaan,M,100,0,37,37
Yosha,F,100,37,0,37
Zaakir,M,100,0,37,37
Zamayah,F,100,37,0,37
Zayyan,M,100,0,37,37
Zendayah,F,100,37,0,37
Zhuri,F,100,37,0,37
Zoeigh,F,100,37,0,37
Zuriyah,F,100,37,0,37
Zymira,F,100,37,0,37
Aalina,F,100,36,0,36
Aania,F,100,36,0,36
Abbra,F,100,36,0,36
Abisha,F,100,36,0,36
Adhemar,M,100,0,36,36
Admiral,M,100,0,36,36
Ahlina,F,100,36,0,36
Aileth,F,100,36,0,36
Airin,F,86,31,5,36
Aisleen,F,100,36,0,36
Aislynne,F,100,36,0,36
Akilles,M,100,0,36,36
Aleene,F,100,36,0,36
Alexnader,M,100,0,36,36
Alick,M,100,0,36,36
Alisande,F,100,36,0,36
Alizeah,F,100,36,0,36
Alleena,F,100,36,0,36
Allysin,F,100,36,0,36
Alphia,F,100,36,0,36
Amanni,F,100,36,0,36
Amillio,M,100,0,36,36
Andilynn,F,100,36,0,36
Andraea,F,100,36,0,36
Anjanetta,F,100,36,0,36
Anjie,F,100,36,0,36
Annlouise,F,100,36,0,36
Anothny,M,100,0,36,36
Antanae,F,100,36,0,36
Anthia,F,100,36,0,36
Anthonyjohn,M,100,0,36,36
Arbutus,F,100,36,0,36
Arihaan,M,100,0,36,36
Ario,M,100,0,36,36
Aristea,F,100,36,0,36
Arnissa,F,100,36,0,36
Ashae,F,100,36,0,36
Ashonda,F,100,36,0,36
Aubrianah,F,100,36,0,36
Auja,F,100,36,0,36
Avalea,F,100,36,0,36
Ayelin,F,100,36,0,36
Azera,F,100,36,0,36
Barbe,F,100,36,0,36
Bassy,F,100,36,0,36
Beckhem,M,100,0,36,36
Bellany,F,100,36,0,36
Bellarae,F,100,36,0,36
Bhavna,F,100,36,0,36
Bingham,M,100,0,36,36
Borden,M,100,0,36,36
Brackston,M,100,0,36,36
Brayland,M,100,0,36,36
Breaja,F,100,36,0,36
Breaker,M,100,0,36,36
Brentan,M,100,0,36,36
Bridgetta,F,100,36,0,36
Bryla,F,100,36,0,36
Brynly,F,100,36,0,36
Caimen,M,100,0,36,36
Caitilin,F,100,36,0,36
Caleesi,F,100,36,0,36
Calida,F,100,36,0,36
Carlasia,F,100,36,0,36
Carmyne,M,100,0,36,36
Chaille,F,100,36,0,36
Chalea,F,100,36,0,36
Chastine,F,100,36,0,36
Chavone,F,100,36,0,36
Chinasa,F,100,36,0,36
Christanna,F,100,36,0,36
Ciona,F,100,36,0,36
Clemetine,F,100,36,0,36
Clintonia,F,100,36,0,36
Cloria,F,100,36,0,36
Corderra,M,100,0,36,36
Cressa,F,100,36,0,36
Daejanae,F,100,36,0,36
Dairy,F,100,36,0,36
Daiyan,M,100,0,36,36
Damariae,M,100,0,36,36
Dameir,M,100,0,36,36
Damiyon,M,100,0,36,36
Dano,M,100,0,36,36
Dantavius,M,100,0,36,36
Danyiah,F,100,36,0,36
Danysha,F,100,36,0,36
Daquante,M,100,0,36,36
Dariene,F,100,36,0,36
Darrington,M,100,0,36,36
Dauson,M,100,0,36,36
Daviontae,M,100,0,36,36
Dedorah,F,100,36,0,36
Deeba,F,100,36,0,36
Deedie,F,100,36,0,36
Deianira,F,100,36,0,36
Dejiah,F,100,36,0,36
Dereion,M,100,0,36,36
Derrelle,M,100,0,36,36
Desrae,F,100,36,0,36
Dette,F,100,36,0,36
Devang,M,100,0,36,36
Devarus,M,100,0,36,36
Dezariah,F,100,36,0,36
Dezmarie,F,100,36,0,36
Dioni,F,56,20,16,36
Domingos,M,100,0,36,36
Doncella,F,100,36,0,36
Dorathea,F,100,36,0,36
Drace,M,100,0,36,36
Dreena,F,100,36,0,36
Duska,F,100,36,0,36
Elfida,F,100,36,0,36
Ellea,F,100,36,0,36
Elliahna,F,100,36,0,36
Elmarie,F,100,36,0,36
Emanda,F,100,36,0,36
Emercyn,F,100,36,0,36
Emmabelle,F,100,36,0,36
Emmelina,F,100,36,0,36
Ethanjacob,M,100,0,36,36
Ettore,M,100,0,36,36
Eulices,M,100,0,36,36
Everlynn,F,100,36,0,36
Fardin,M,100,0,36,36
Fatme,F,100,36,0,36
Fatoumatta,F,100,36,0,36
Floyde,M,100,0,36,36
Garyson,M,100,0,36,36
Gaylee,F,100,36,0,36
Gerardette,F,100,36,0,36
Gizzel,F,100,36,0,36
Glenny,F,69,25,11,36
Graecyn,F,100,36,0,36
Gretchin,F,100,36,0,36
Gumecindo,M,100,0,36,36
Haleah,F,100,36,0,36
Haleyann,F,100,36,0,36
Harkirat,M,67,12,24,36
Harshit,M,100,0,36,36
Heathr,F,100,36,0,36
Heshimu,M,100,0,36,36
Hetvi,F,100,36,0,36
Hilery,F,100,36,0,36
Huntleigh,F,100,36,0,36
Husani,M,100,0,36,36
Iiesha,F,100,36,0,36
Iktan,M,100,0,36,36
Issael,M,100,0,36,36
Ithiel,M,100,0,36,36
Jacquin,M,86,5,31,36
Jahmon,M,100,0,36,36
Jahnvi,F,100,36,0,36
Janessah,F,100,36,0,36
Jasser,M,100,0,36,36
Jayvonne,M,100,0,36,36
Jazale,F,100,36,0,36
Jecorey,M,100,0,36,36
Jekayla,F,100,36,0,36
Jenniver,F,100,36,0,36
Jerius,M,100,0,36,36
Jeshuah,M,100,0,36,36
Jezrael,M,100,0,36,36
Jimmia,F,100,36,0,36
Jjuan,M,100,0,36,36
Jmiyah,F,100,36,0,36
Joelisa,F,100,36,0,36
Jontavis,M,100,0,36,36
Josuah,M,100,0,36,36
Journye,F,100,36,0,36
Ju,F,67,24,12,36
Juanell,F,100,36,0,36
Kamiko,F,100,36,0,36
Kanosha,F,100,36,0,36
Karac,M,100,0,36,36
Kashea,F,100,36,0,36
Kashonna,F,100,36,0,36
Kathiria,F,100,36,0,36
Kazeem,M,100,0,36,36
Keba,F,100,36,0,36
Kerena,F,100,36,0,36
Keshawnna,F,100,36,0,36
Khadidja,F,100,36,0,36
Khaia,F,100,36,0,36
Khyia,F,100,36,0,36
Kimbre,F,100,36,0,36
Kiriaki,F,100,36,0,36
Kmiyah,F,100,36,0,36
Knyla,F,100,36,0,36
Konda,F,100,36,0,36
Kyanah,F,100,36,0,36
Lailonie,F,100,36,0,36
Lakema,F,100,36,0,36
Lakietha,F,100,36,0,36
Lakiva,F,100,36,0,36
Lashonte,F,100,36,0,36
Laterika,F,100,36,0,36
Latrez,M,100,0,36,36
Lawence,M,100,0,36,36
Leannie,F,100,36,0,36
Leather,F,100,36,0,36
Leelen,M,100,0,36,36
Leelin,M,100,0,36,36
Leldon,M,100,0,36,36
Lennex,M,72,10,26,36
Lexes,F,100,36,0,36
Lileana,F,100,36,0,36
Lilykate,F,100,36,0,36
Lindwood,M,100,0,36,36
Loman,M,100,0,36,36
Lourene,F,100,36,0,36
Lucino,M,100,0,36,36
Lylith,F,100,36,0,36
Lyndse,F,100,36,0,36
Macady,F,100,36,0,36
Madylynn,F,100,36,0,36
Madysson,F,100,36,0,36
Maelene,F,100,36,0,36
Makeena,F,100,36,0,36
Makhyla,F,100,36,0,36
Mancel,M,100,0,36,36
Mane,F,100,36,0,36
Manus,M,100,0,36,36
Mardene,F,100,36,0,36
Marget,F,100,36,0,36
Maricza,F,100,36,0,36
Mariessa,F,100,36,0,36
Marigene,F,100,36,0,36
Marihanna,F,100,36,0,36
Markquis,M,100,0,36,36
Marlasia,F,100,36,0,36
Marlem,F,100,36,0,36
Mayerlin,F,100,36,0,36
Mccarthy,M,100,0,36,36
Mckynleigh,F,100,36,0,36
Megana,F,100,36,0,36
Meghaan,F,100,36,0,36
Mekah,F,100,36,0,36
Meliha,F,100,36,0,36
Mennie,F,100,36,0,36
Merilynn,F,100,36,0,36
Merliah,F,100,36,0,36
Merriah,F,100,36,0,36
Miani,F,100,36,0,36
Miccah,M,83,6,30,36
Mihaela,F,100,36,0,36
Milissia,F,100,36,0,36
Monecia,F,100,36,0,36
Nabeela,F,100,36,0,36
Nadin,F,100,36,0,36
Nafees,M,100,0,36,36
Nakala,F,100,36,0,36
Naszier,M,100,0,36,36
Nathanual,M,100,0,36,36
Navar,M,100,0,36,36
Nicos,M,100,0,36,36
Niger,F,69,25,11,36
Nilmar,M,100,0,36,36
Nizaiah,M,100,0,36,36
Noberto,M,100,0,36,36
Nolia,F,100,36,0,36
Novian,M,100,0,36,36
Nuriyah,F,100,36,0,36
Obeth,M,100,0,36,36
Onterrio,M,100,0,36,36
Osirus,M,100,0,36,36
Osvin,M,100,0,36,36
Parin,M,100,0,36,36
Parv,M,100,0,36,36
Patiance,F,100,36,0,36
Quatesha,F,100,36,0,36
Quatez,M,100,0,36,36
Quinasia,F,100,36,0,36
Radin,M,100,0,36,36
Raegann,F,100,36,0,36
Ramier,M,100,0,36,36
Ramisha,F,100,36,0,36
Raquita,F,100,36,0,36
Rasheta,F,100,36,0,36
Ratisha,F,100,36,0,36
Rayanthony,M,100,0,36,36
Remonica,F,100,36,0,36
Renona,F,100,36,0,36
Rhon,M,100,0,36,36
Rhyannon,F,100,36,0,36
Rickeisha,F,100,36,0,36
Riviera,F,100,36,0,36
Rokeisha,F,100,36,0,36
Rolena,F,100,36,0,36
Ronada,F,100,36,0,36
Ronecia,F,100,36,0,36
Rosealie,F,100,36,0,36
Rosheena,F,100,36,0,36
Rubia,F,100,36,0,36
Rubicela,F,100,36,0,36
Ryanmichael,M,100,0,36,36
Sadiki,M,100,0,36,36
Sahwn,M,100,0,36,36
Salesi,M,100,0,36,36
Samee,M,100,0,36,36
Samsam,F,100,36,0,36
Samwise,M,100,0,36,36
Sashank,M,100,0,36,36
Satvika,F,100,36,0,36
Seananthony,M,100,0,36,36
Selenna,F,100,36,0,36
Senad,M,100,0,36,36
Sesha,F,100,36,0,36
Seydi,F,100,36,0,36
Shadiya,F,100,36,0,36
Shameia,F,100,36,0,36
Shanovia,F,100,36,0,36
Shanteka,F,100,36,0,36
Shanterra,F,100,36,0,36
Shauntina,F,100,36,0,36
Shekena,F,100,36,0,36
Shely,F,100,36,0,36
Sherray,F,100,36,0,36
Shirene,F,100,36,0,36
Sierre,F,100,36,0,36
Sioban,F,100,36,0,36
Sneh,M,86,5,31,36
Sok,M,78,8,28,36
Sophey,F,100,36,0,36
Soumaya,F,100,36,0,36
Sovereign,M,56,16,20,36
Sumana,F,100,36,0,36
Sundie,F,100,36,0,36
Surenity,F,100,36,0,36
Suszanne,F,100,36,0,36
Swayam,M,100,0,36,36
Sylvette,F,100,36,0,36
Taku,M,100,0,36,36
Taleeah,F,100,36,0,36
Taleiah,F,100,36,0,36
Talus,M,100,0,36,36
Tangla,F,100,36,0,36
Tannaz,F,100,36,0,36
Tarajii,F,100,36,0,36
Taramarie,F,100,36,0,36
Tarrick,M,100,0,36,36
Tatyona,F,100,36,0,36
Teaunna,F,100,36,0,36
Tennia,F,100,36,0,36
Terric,M,100,0,36,36
Tevonte,M,100,0,36,36
Than,M,100,0,36,36
Thana,F,100,36,0,36
Thandi,F,100,36,0,36
Tialisa,F,100,36,0,36
Tifanee,F,100,36,0,36
Timberland,M,100,0,36,36
Tramia,F,100,36,0,36
Tramika,F,100,36,0,36
Trance,M,100,0,36,36
Trenady,F,100,36,0,36
Treya,F,100,36,0,36
Trimeka,F,100,36,0,36
Trinice,F,100,36,0,36
Tundra,F,100,36,0,36
Tyhiem,M,100,0,36,36
Tynishia,F,100,36,0,36
Tzippora,F,100,36,0,36
Uber,M,100,0,36,36
Ulla,F,100,36,0,36
Valonda,F,100,36,0,36
Valri,F,100,36,0,36
Varish,M,100,0,36,36
Vatsal,M,100,0,36,36
Vernicia,F,100,36,0,36
Virgene,F,100,36,0,36
Woodward,M,100,0,36,36
Xabier,M,100,0,36,36
Yackelin,F,100,36,0,36
Yanixa,F,100,36,0,36
Yazlene,F,100,36,0,36
Yefri,M,100,0,36,36
Yekusiel,M,100,0,36,36
Yola,F,100,36,0,36
Yomna,F,100,36,0,36
Yuleidi,F,100,36,0,36
Yusei,M,100,0,36,36
Zaheem,M,100,0,36,36
Zariaha,F,100,36,0,36
Zeshawn,M,100,0,36,36
Zhariyah,F,100,36,0,36
Zurich,M,100,0,36,36
Zynah,F,100,36,0,36
Abuk,F,100,35,0,35
Achante,F,100,35,0,35
Adalaya,F,100,35,0,35
Adaobi,F,100,35,0,35
Adein,M,100,0,35,35
Adiyah,F,100,35,0,35
Adona,F,100,35,0,35
Afsa,F,100,35,0,35
Ahamad,M,100,0,35,35
Airionna,F,100,35,0,35
Aleira,F,100,35,0,35
Alexssa,F,100,35,0,35
Alexuis,F,100,35,0,35
Aliona,F,100,35,0,35
Allysandra,F,100,35,0,35
Alvetta,F,100,35,0,35
Amai,F,100,35,0,35
Ameyalli,F,100,35,0,35
Amneris,F,100,35,0,35
Analayah,F,100,35,0,35
Analuiza,F,100,35,0,35
Anavel,F,100,35,0,35
Andrella,F,100,35,0,35
Anegla,F,100,35,0,35
Aneil,M,100,0,35,35
Anhar,F,100,35,0,35
Anndria,F,100,35,0,35
Annikka,F,100,35,0,35
Antanique,F,100,35,0,35
Antaniyah,F,100,35,0,35
Antoya,F,100,35,0,35
Anuhya,F,100,35,0,35
Anuoluwapo,F,100,35,0,35
Anureet,F,100,35,0,35
Arai,F,100,35,0,35
Argel,M,100,0,35,35
Arianis,F,100,35,0,35
Armetta,F,100,35,0,35
Arri,M,57,15,20,35
Arshaun,M,100,0,35,35
Aryani,F,100,35,0,35
Arynne,F,100,35,0,35
Ashantay,F,100,35,0,35
Athenea,F,100,35,0,35
Atwood,M,100,0,35,35
Avimael,M,100,0,35,35
Aziana,F,100,35,0,35
Azja,F,100,35,0,35
Azzaria,F,100,35,0,35
Barnet,M,100,0,35,35
Beki,F,100,35,0,35
Berney,M,100,0,35,35
Bitania,F,100,35,0,35
Bocephus,M,100,0,35,35
Bowan,M,100,0,35,35
Bravery,M,86,5,30,35
Brawley,M,100,0,35,35
Braylah,F,100,35,0,35
Breyelle,F,100,35,0,35
Brionnah,F,100,35,0,35
Brixon,M,100,0,35,35
Brizia,F,100,35,0,35
Busra,F,100,35,0,35
Calliana,F,100,35,0,35
Camyia,F,100,35,0,35
Carlysia,F,100,35,0,35
Cassell,M,100,0,35,35
Cathal,M,100,0,35,35
Ceretha,F,100,35,0,35
Charia,F,100,35,0,35
Chariyah,F,100,35,0,35
Charmaigne,F,100,35,0,35
Chaynce,M,100,0,35,35
Chazmine,F,100,35,0,35
Chedva,F,100,35,0,35
Chinemerem,M,86,5,30,35
Christiopher,M,100,0,35,35
Chylee,F,100,35,0,35
Claresa,F,100,35,0,35
Clee,M,100,0,35,35
Coleta,F,100,35,0,35
Conswello,F,100,35,0,35
Cordellia,F,100,35,0,35
Cortnei,F,100,35,0,35
Corvell,M,100,0,35,35
Cotie,F,51,18,17,35
Cristain,M,100,0,35,35
Cristos,M,100,0,35,35
Cyarra,F,100,35,0,35
Daiven,M,100,0,35,35
Damerius,M,100,0,35,35
Darrein,M,80,7,28,35
Darrett,M,100,0,35,35
Dashara,F,100,35,0,35
Dayany,F,100,35,0,35
Dayquon,M,100,0,35,35
Dazariah,F,100,35,0,35
Dazhon,M,100,0,35,35
Dedan,M,100,0,35,35
Deici,F,100,35,0,35
Delacey,F,100,35,0,35
Delaini,F,100,35,0,35
Delynne,F,100,35,0,35
Demetrous,M,100,0,35,35
Demri,F,100,35,0,35
Derly,M,100,0,35,35
Detavion,M,100,0,35,35
Devie,F,100,35,0,35
Devondra,F,100,35,0,35
Devontai,M,100,0,35,35
Deyla,F,100,35,0,35
Dijion,M,100,0,35,35
Dijonay,F,100,35,0,35
Dilen,M,100,0,35,35
Dmaya,F,100,35,0,35
Dondria,F,100,35,0,35
Drazen,M,100,0,35,35
Dredan,M,100,0,35,35
Earlyn,F,100,35,0,35
Efthimia,F,100,35,0,35
Eilam,M,100,0,35,35
Ekamjot,M,86,5,30,35
Ekene,M,54,16,19,35
Elante,M,100,0,35,35
Elga,F,100,35,0,35
Ellinore,F,100,35,0,35
Elsha,F,100,35,0,35
Emaria,F,100,35,0,35
Emilse,F,100,35,0,35
Emmaley,F,100,35,0,35
Eniah,F,100,35,0,35
Enock,M,100,0,35,35
Ephrata,F,100,35,0,35
Eria,F,100,35,0,35
Evona,F,100,35,0,35
Evora,F,100,35,0,35
Faviana,F,100,35,0,35
Felichia,F,100,35,0,35
Finnlee,F,57,20,15,35
Flynt,M,100,0,35,35
Fyodor,M,100,0,35,35
Gambit,M,100,0,35,35
Gelinda,F,100,35,0,35
Genevy,F,100,35,0,35
Gentle,M,100,0,35,35
Georgiy,M,100,0,35,35
Gethsemane,F,100,35,0,35
Ghita,F,100,35,0,35
Graclynn,F,100,35,0,35
Grzegorz,M,100,0,35,35
Halimatou,F,100,35,0,35
Hanford,M,100,0,35,35
Hawkin,M,100,0,35,35
Heliana,F,100,35,0,35
Heven,F,100,35,0,35
Hillis,M,100,0,35,35
Holdon,M,100,0,35,35
Holliann,F,100,35,0,35
Ilithyia,F,100,35,0,35
Iqbal,M,100,0,35,35
Irelan,F,100,35,0,35
Izhar,M,100,0,35,35
Jabrell,M,100,0,35,35
Jacian,M,100,0,35,35
Jadir,M,100,0,35,35
Jaking,M,100,0,35,35
Jaliyiah,F,100,35,0,35
Jamauria,F,100,35,0,35
Jameira,F,100,35,0,35
Jammel,M,100,0,35,35
Janyll,F,100,35,0,35
Jarette,M,100,0,35,35
Jarien,M,100,0,35,35
Jarrica,F,100,35,0,35
Jaterrion,M,100,0,35,35
Jayc,M,100,0,35,35
Jaymier,M,100,0,35,35
Jazariyah,F,100,35,0,35
Jeaneth,F,100,35,0,35
Jeffary,M,100,0,35,35
Jemiya,F,100,35,0,35
Jenrry,M,100,0,35,35
Jerquan,M,100,0,35,35
Jevontae,M,100,0,35,35
Jhoseline,F,100,35,0,35
Jillena,F,100,35,0,35
Joa,F,86,30,5,35
Johel,M,100,0,35,35
Johua,M,100,0,35,35
Jomara,F,100,35,0,35
Jonath,M,100,0,35,35
Jorley,F,100,35,0,35
Josmary,F,100,35,0,35
Jyrese,M,100,0,35,35
Kadasha,F,100,35,0,35
Kaegen,M,100,0,35,35
Kailiana,F,100,35,0,35
Kaitlee,F,100,35,0,35
Kambell,F,100,35,0,35
Kamberlyn,F,100,35,0,35
Kamorra,F,100,35,0,35
Karenda,F,100,35,0,35
Kashan,M,100,0,35,35
Katherleen,F,100,35,0,35
Katon,M,100,0,35,35
Kavonna,F,100,35,0,35
Kaylaa,F,100,35,0,35
Kayzen,M,100,0,35,35
Kd,F,100,35,0,35
Kedarrius,M,100,0,35,35
Keishun,M,100,0,35,35
Kejuana,F,100,35,0,35
Kellea,F,100,35,0,35
Kelvion,M,100,0,35,35
Kentavia,F,100,35,0,35
Kerel,M,100,0,35,35
Kesaun,M,100,0,35,35
Keydon,M,100,0,35,35
Keydra,F,100,35,0,35
Keylyn,F,100,35,0,35
Keyson,M,100,0,35,35
Kiahra,F,100,35,0,35
Kiaundra,F,100,35,0,35
Kierney,F,100,35,0,35
Kileah,F,100,35,0,35
Kimana,F,100,35,0,35
Kimbelry,F,100,35,0,35
Kingsly,M,100,0,35,35
Kiyen,M,100,0,35,35
Knut,M,100,0,35,35
Koko,F,100,35,0,35
Kristara,F,100,35,0,35
Kyshia,F,100,35,0,35
Laeton,M,100,0,35,35
Lakeema,F,100,35,0,35
Lakiera,F,100,35,0,35
Lali,F,100,35,0,35
Lameika,F,100,35,0,35
Laquaisha,F,100,35,0,35
Lashanique,F,100,35,0,35
Laurelei,F,100,35,0,35
Laylin,F,100,35,0,35
Leary,M,100,0,35,35
Leiny,F,100,35,0,35
Lensey,F,100,35,0,35
Leto,M,100,0,35,35
Lilium,F,100,35,0,35
Lillyanah,F,100,35,0,35
Lolitta,F,100,35,0,35
Lowanna,F,100,35,0,35
Luchana,F,100,35,0,35
Luisafernanda,F,100,35,0,35
Luisanna,F,100,35,0,35
Luree,F,100,35,0,35
Lynnanne,F,100,35,0,35
Madilin,F,100,35,0,35
Maikol,M,100,0,35,35
Makar,M,100,0,35,35
Malari,F,100,35,0,35
Maleyna,F,100,35,0,35
Maliyani,F,100,35,0,35
Marcelous,M,100,0,35,35
Mareya,F,100,35,0,35
Marietou,F,100,35,0,35
Marilouise,F,100,35,0,35
Markeil,M,100,0,35,35
Marrian,F,100,35,0,35
Marrin,F,100,35,0,35
Marshelia,F,100,35,0,35
Marteen,F,100,35,0,35
Marus,M,100,0,35,35
Marymar,F,100,35,0,35
Mato,M,100,0,35,35
Matthen,M,100,0,35,35
Maxden,M,100,0,35,35
Maxence,M,100,0,35,35
Maximous,M,100,0,35,35
Maxin,M,100,0,35,35
Meki,M,100,0,35,35
Melodey,F,100,35,0,35
Mely,F,100,35,0,35
Memori,F,100,35,0,35
Merion,M,57,15,20,35
Miaja,F,100,35,0,35
Mickale,M,100,0,35,35
Miran,M,100,0,35,35
Mirren,F,100,35,0,35
Mirsa,F,100,35,0,35
Misato,F,100,35,0,35
Mohib,M,100,0,35,35
Motaz,M,100,0,35,35
Muaad,M,100,0,35,35
Murline,F,100,35,0,35
Nacy,F,100,35,0,35
Nadeja,F,100,35,0,35
Naelle,F,100,35,0,35
Narjes,F,100,35,0,35
Natrone,M,100,0,35,35
Navika,F,100,35,0,35
Nayef,M,100,0,35,35
Neetu,F,100,35,0,35
Nehemia,M,100,0,35,35
Neile,F,100,35,0,35
Neketa,F,100,35,0,35
Nerik,M,100,0,35,35
Nigella,F,100,35,0,35
Nikida,F,100,35,0,35
Niloufar,F,100,35,0,35
Nithilan,M,100,0,35,35
Nitra,F,100,35,0,35
Nokomis,F,100,35,0,35
Nooh,M,100,0,35,35
Noriyah,F,100,35,0,35
Novalynn,F,100,35,0,35
Octave,M,100,0,35,35
Oliviamarie,F,100,35,0,35
Oluwatofunmi,F,86,30,5,35
Oman,M,100,0,35,35
Omarii,M,100,0,35,35
Padma,F,100,35,0,35
Pamale,F,100,35,0,35
Phan,M,57,15,20,35
Pinkney,M,100,0,35,35
Prayer,F,100,35,0,35
Preya,F,100,35,0,35
Quadira,F,100,35,0,35
Quentine,M,100,0,35,35
Raahi,F,100,35,0,35
Rabeka,F,100,35,0,35
Racquell,F,100,35,0,35
Rafat,M,100,0,35,35
Rajai,M,100,0,35,35
Rakira,F,100,35,0,35
Ralinda,F,100,35,0,35
Ramika,F,100,35,0,35
Ranyiah,F,100,35,0,35
Rasheika,F,100,35,0,35
Rayhanna,F,100,35,0,35
Rayvaughn,M,100,0,35,35
Reauna,F,100,35,0,35
Rediet,F,100,35,0,35
Reenie,F,100,35,0,35
Reven,M,83,6,29,35
Reverie,F,100,35,0,35
Rexine,F,100,35,0,35
Rhionna,F,100,35,0,35
Richards,M,100,0,35,35
Rikhil,M,100,0,35,35
Riky,M,100,0,35,35
Roary,M,100,0,35,35
Rodnika,F,100,35,0,35
Roree,F,100,35,0,35
Rosezella,F,100,35,0,35
Roxette,F,100,35,0,35
Rozan,F,100,35,0,35
Saied,M,100,0,35,35
Sakiah,F,100,35,0,35
Samatar,M,100,0,35,35
Saquita,F,100,35,0,35
Satira,F,100,35,0,35
Savi,F,100,35,0,35
Schwanna,F,100,35,0,35
Sebastiaan,M,100,0,35,35
Sedarius,M,100,0,35,35
Segen,F,100,35,0,35
Selden,M,100,0,35,35
Semih,M,100,0,35,35
Sephanie,F,100,35,0,35
Sergi,M,100,0,35,35
Sevion,M,100,0,35,35
Shadaja,F,100,35,0,35
Shalynne,F,100,35,0,35
Shaneria,F,100,35,0,35
Shantavious,F,100,35,0,35
Sharmen,F,100,35,0,35
Shawney,F,100,35,0,35
Sheilda,F,100,35,0,35
Sheldrick,M,100,0,35,35
Shema,F,100,35,0,35
Shontaye,F,100,35,0,35
Shreyash,M,100,0,35,35
Shylene,F,100,35,0,35
Sidne,F,100,35,0,35
Sophelia,F,100,35,0,35
Sovann,M,100,0,35,35
Starkesha,F,100,35,0,35
Stellar,F,66,23,12,35
Stellarose,F,100,35,0,35
Supreet,F,100,35,0,35
Suttyn,F,100,35,0,35
Suzonne,F,100,35,0,35
Sylivia,F,100,35,0,35
Symba,F,100,35,0,35
Tahniya,F,100,35,0,35
Taimi,F,100,35,0,35
Takeyia,F,100,35,0,35
Tamaia,F,100,35,0,35
Tamaki,F,100,35,0,35
Tanitra,F,100,35,0,35
Tanjanika,F,100,35,0,35
Tashieka,F,100,35,0,35
Tason,M,100,0,35,35
Teak,M,100,0,35,35
Terrico,M,100,0,35,35
Tewanda,F,100,35,0,35
Thema,F,100,35,0,35
Thembi,F,100,35,0,35
Tifney,F,100,35,0,35
Tijera,F,100,35,0,35
Tishon,M,100,0,35,35
Tomohiro,M,100,0,35,35
Toniah,F,100,35,0,35
Toshi,F,100,35,0,35
Tovi,M,100,0,35,35
Traeshawn,M,100,0,35,35
Tramine,M,86,5,30,35
Traylin,M,100,0,35,35
Trisden,M,100,0,35,35
Tug,M,100,0,35,35
Tuongvi,F,100,35,0,35
Tuscany,F,100,35,0,35
Tylashia,F,100,35,0,35
Umeko,F,100,35,0,35
Uraina,F,100,35,0,35
Ursela,F,100,35,0,35
Uwe,M,100,0,35,35
Vanida,F,100,35,0,35
Vear,F,100,35,0,35
Velen,F,100,35,0,35
Vidur,M,100,0,35,35
Violanda,F,100,35,0,35
Virgin,F,86,30,5,35
Vontrice,F,100,35,0,35
Wiktor,M,100,0,35,35
Wynnette,F,100,35,0,35
Yamillet,F,100,35,0,35
Yancarlo,M,100,0,35,35
Yanelys,F,100,35,0,35
Yaneri,F,100,35,0,35
Yarenis,F,100,35,0,35
Yaretzie,F,100,35,0,35
Yaya,M,100,0,35,35
Yesina,F,100,35,0,35
Yigit,M,100,0,35,35
Youness,M,100,0,35,35
Yugo,M,100,0,35,35
Yujin,F,100,35,0,35
Yumalai,F,100,35,0,35
Zabriel,M,100,0,35,35
Zecharia,M,100,0,35,35
Zenaido,M,100,0,35,35
Zenayda,F,100,35,0,35
Zendre,F,100,35,0,35
Zohara,F,100,35,0,35
Zoren,M,100,0,35,35
Zurielle,F,100,35,0,35
Zyionna,F,100,35,0,35
Zykel,M,100,0,35,35
Aalani,F,100,34,0,34
Aayansh,M,100,0,34,34
Adaija,F,100,34,0,34
Aderyn,F,100,34,0,34
Adrienn,F,79,27,7,34
Ahsaki,F,100,34,0,34
Ahzaria,F,100,34,0,34
Aivree,F,100,34,0,34
Ajeet,M,100,0,34,34
Akala,F,100,34,0,34
Alaiyna,F,100,34,0,34
Alexamarie,F,100,34,0,34
Alexs,M,100,0,34,34
Alijiah,M,100,0,34,34
Aliyas,M,100,0,34,34
Alliannah,F,100,34,0,34
Allisan,F,100,34,0,34
Amandy,F,100,34,0,34
Amichai,M,100,0,34,34
Amiela,F,100,34,0,34
Anakarina,F,100,34,0,34
Anchal,F,100,34,0,34
Andreis,M,100,0,34,34
Angenetta,F,100,34,0,34
Aniece,F,100,34,0,34
Anycia,F,100,34,0,34
Arby,M,100,0,34,34
Ardarius,M,100,0,34,34
Ardenia,F,100,34,0,34
Aretina,F,100,34,0,34
Armahn,M,100,0,34,34
Armentha,F,100,34,0,34
Armstrong,M,100,0,34,34
Arnika,F,100,34,0,34
Arrianne,F,100,34,0,34
Asheli,F,100,34,0,34
Ashleylynn,F,100,34,0,34
Asija,F,100,34,0,34
Astrea,F,100,34,0,34
Ausencio,M,100,0,34,34
Avaiya,F,100,34,0,34
Avetis,M,100,0,34,34
Avlynn,F,100,34,0,34
Awanda,F,100,34,0,34
Ayhem,M,100,0,34,34
Ayira,F,100,34,0,34
Aylan,M,100,0,34,34
Ayleth,F,100,34,0,34
Ayzha,F,100,34,0,34
Azareya,F,100,34,0,34
Azriela,F,100,34,0,34
Azza,F,100,34,0,34
Babby,F,100,34,0,34
Bb,M,100,0,34,34
Berke,M,100,0,34,34
Blaik,M,100,0,34,34
Bogar,M,100,0,34,34
Braniah,F,100,34,0,34
Brashawn,M,100,0,34,34
Breale,F,100,34,0,34
Brelin,M,100,0,34,34
Brierra,F,100,34,0,34
Brionca,F,100,34,0,34
Brisyn,M,100,0,34,34
Brittish,F,100,34,0,34
Brylinn,F,100,34,0,34
Cabel,M,100,0,34,34
Cadia,F,100,34,0,34
Caisyn,F,56,19,15,34
Camas,F,100,34,0,34
Carsynn,F,100,34,0,34
Catherene,F,100,34,0,34
Cathia,F,100,34,0,34
Cavell,M,100,0,34,34
Caycie,F,100,34,0,34
Chandini,F,100,34,0,34
Charlyze,F,100,34,0,34
Charryse,F,100,34,0,34
Chauntell,F,100,34,0,34
Chemar,M,100,0,34,34
Cheniya,F,100,34,0,34
Chicago,M,100,0,34,34
Chloelynn,F,100,34,0,34
Chrisshawn,M,100,0,34,34
Cindylee,F,100,34,0,34
Ciri,F,100,34,0,34
Cocoa,F,100,34,0,34
Conell,M,100,0,34,34
Corkey,M,100,0,34,34
Cramer,M,100,0,34,34
Cubby,M,100,0,34,34
Daedra,F,100,34,0,34
Dafnee,F,100,34,0,34
Daizie,F,100,34,0,34
Daleyssa,F,100,34,0,34
Damu,M,100,0,34,34
Damyla,F,100,34,0,34
Danayja,F,100,34,0,34
Dariell,M,71,10,24,34
Darrean,F,53,18,16,34
Darryan,F,56,19,15,34
Daryla,F,100,34,0,34
Dashona,F,100,34,0,34
Dasiya,F,100,34,0,34
Dayshun,M,100,0,34,34
Deaunta,M,100,0,34,34
Decimus,M,100,0,34,34
Dejahnae,F,100,34,0,34
Deken,M,100,0,34,34
Dekwan,M,100,0,34,34
Deleta,F,100,34,0,34
Dellie,F,100,34,0,34
Dellon,M,100,0,34,34
Delmarie,F,100,34,0,34
Denille,F,100,34,0,34
Denique,F,100,34,0,34
Denley,M,100,0,34,34
Deonka,F,100,34,0,34
Dequana,F,100,34,0,34
Derby,M,85,5,29,34
Deyanara,F,100,34,0,34
Dezera,F,100,34,0,34
Diamondnique,F,100,34,0,34
Dimari,M,100,0,34,34
Dinetta,F,100,34,0,34
Diomar,M,100,0,34,34
Djay,M,100,0,34,34
Dmitrius,M,100,0,34,34
Dnia,F,100,34,0,34
Dominion,M,100,0,34,34
Donneshia,F,100,34,0,34
Donniesha,F,100,34,0,34
Edessa,F,100,34,0,34
Editha,F,100,34,0,34
Elainie,F,100,34,0,34
Elizabethmarie,F,100,34,0,34
Ellajane,F,100,34,0,34
Elmar,M,100,0,34,34
Elzy,M,100,0,34,34
Emalin,F,100,34,0,34
Emariah,F,100,34,0,34
Embrey,F,100,34,0,34
Eme,F,100,34,0,34
Enslee,F,100,34,0,34
Eril,M,100,0,34,34
Erven,M,100,0,34,34
Esosa,F,71,24,10,34
Estin,M,100,0,34,34
Eunise,F,100,34,0,34
Farm,F,100,34,0,34
Faruk,M,100,0,34,34
Fenway,M,100,0,34,34
Finton,M,100,0,34,34
Galylea,F,100,34,0,34
Garrik,M,100,0,34,34
Genisha,F,100,34,0,34
Gianluigi,M,100,0,34,34
Godswill,M,100,0,34,34
Greidis,F,100,34,0,34
Gretchan,F,100,34,0,34
Greyer,M,100,0,34,34
Guadelupe,F,100,34,0,34
Gwendell,F,100,34,0,34
Hafeezah,F,100,34,0,34
Hajrah,F,100,34,0,34
Hertha,F,100,34,0,34
Hughston,M,100,0,34,34
Humbert,M,100,0,34,34
Idamae,F,100,34,0,34
Indianna,F,100,34,0,34
Insiya,F,100,34,0,34
Iratze,F,100,34,0,34
Isolina,F,100,34,0,34
Izair,M,100,0,34,34
Jaalen,M,100,0,34,34
Jabaris,M,100,0,34,34
Jacarious,M,100,0,34,34
Jacquella,F,100,34,0,34
Jaen,M,100,0,34,34
Jahkye,M,100,0,34,34
Jahlaya,F,100,34,0,34
Jahmiah,F,85,29,5,34
Jaicion,M,100,0,34,34
Jaie,F,85,29,5,34
Jamicka,F,100,34,0,34
Jamual,M,100,0,34,34
Jandre,M,100,0,34,34
Japji,F,100,34,0,34
Jaquain,M,100,0,34,34
Jaquaylon,M,100,0,34,34
Jaquelina,F,100,34,0,34
Jaretssi,F,100,34,0,34
Jatina,F,100,34,0,34
Jatinder,M,100,0,34,34
Jaurice,M,100,0,34,34
Jayliani,F,100,34,0,34
Jayn,F,100,34,0,34
Jazminne,F,100,34,0,34
Jebb,M,100,0,34,34
Jenevy,F,100,34,0,34
Jeniene,F,100,34,0,34
Jep,M,100,0,34,34
Jequetta,F,100,34,0,34
Jeremai,M,100,0,34,34
Jeremmy,M,100,0,34,34
Jeriesha,F,100,34,0,34
Jermail,M,100,0,34,34
Jerode,M,100,0,34,34
Jessical,F,100,34,0,34
Jezell,F,100,34,0,34
Jmarie,F,100,34,0,34
Joandry,M,100,0,34,34
Joddie,F,100,34,0,34
Joemar,M,100,0,34,34
Johnathn,M,100,0,34,34
Johnjames,M,100,0,34,34
Josephene,F,100,34,0,34
Josgar,M,100,0,34,34
Jovonnie,M,82,6,28,34
Juanitta,F,100,34,0,34
Jubei,M,100,0,34,34
Judiah,M,100,0,34,34
Juleanna,F,100,34,0,34
Juleidy,F,100,34,0,34
Julis,M,85,5,29,34
Jyotsna,F,100,34,0,34
Kado,M,100,0,34,34
Kapria,F,100,34,0,34
Karissma,F,100,34,0,34
Karmynn,F,100,34,0,34
Katonia,F,100,34,0,34
Kayliann,F,100,34,0,34
Keeyan,M,100,0,34,34
Keidyn,M,100,0,34,34
Kendricka,F,100,34,0,34
Kenniel,M,100,0,34,34
Kesleigh,F,100,34,0,34
Ketti,F,100,34,0,34
Keylor,M,100,0,34,34
Khailyn,F,100,34,0,34
Khandice,F,100,34,0,34
Khanye,M,100,0,34,34
Khy,M,100,0,34,34
Kierian,M,100,0,34,34
Kiersti,F,100,34,0,34
Kilia,F,100,34,0,34
Kilik,M,100,0,34,34
Kinard,M,100,0,34,34
Kitanna,F,100,34,0,34
Klhoe,F,100,34,0,34
Koan,M,100,0,34,34
Koharu,F,100,34,0,34
Kristabella,F,100,34,0,34
Kshaun,M,100,0,34,34
Kwami,M,100,0,34,34
Kwanzaa,F,85,29,5,34
Kwon,M,100,0,34,34
Kymbree,F,100,34,0,34
Kyris,M,100,0,34,34
Labarbara,F,100,34,0,34
Ladarris,M,100,0,34,34
Laerica,F,100,34,0,34
Laesha,F,100,34,0,34
Lalinda,F,100,34,0,34
Lariana,F,100,34,0,34
Lashema,F,100,34,0,34
Lashondria,F,100,34,0,34
Latarcha,F,100,34,0,34
Latrivia,F,100,34,0,34
Lattie,M,85,5,29,34
Laureli,F,100,34,0,34
Lechia,F,100,34,0,34
Leellen,F,100,34,0,34
Leonella,F,100,34,0,34
Lethaniel,M,100,0,34,34
Leva,F,100,34,0,34
Lianet,F,100,34,0,34
Lillienne,F,100,34,0,34
Lillyannah,F,100,34,0,34
Linita,F,100,34,0,34
Liyat,F,100,34,0,34
Ltonya,F,100,34,0,34
Luevenia,F,100,34,0,34
Lunah,F,100,34,0,34
Luxie,F,100,34,0,34
Lyba,F,100,34,0,34
Lyndle,M,100,0,34,34
Lynneah,F,100,34,0,34
Lytonia,F,100,34,0,34
Macaleb,M,100,0,34,34
Macelyn,F,100,34,0,34
Maiesha,F,100,34,0,34
Makenya,F,100,34,0,34
Malaija,F,100,34,0,34
Malery,F,100,34,0,34
Mandilyn,F,100,34,0,34
Mardochee,M,100,0,34,34
Mariaelizabeth,F,100,34,0,34
Marinah,F,100,34,0,34
Markandrew,M,100,0,34,34
Marvins,M,100,0,34,34
Matthais,M,100,0,34,34
Mavery,F,100,34,0,34
Maximina,F,100,34,0,34
Medhansh,M,100,0,34,34
Meradith,F,100,34,0,34
Merisha,F,100,34,0,34
Michaelvincent,M,100,0,34,34
Mikalynn,F,100,34,0,34
Mirla,F,100,34,0,34
Mohmmed,M,100,0,34,34
Moniesha,F,100,34,0,34
Mung,M,100,0,34,34
Mynesha,F,100,34,0,34
Nacona,F,100,34,0,34
Nadija,F,100,34,0,34
Naitik,M,100,0,34,34
Name,M,68,11,23,34
Nashanda,F,100,34,0,34
Nateshia,F,100,34,0,34
Natica,F,100,34,0,34
Natrell,M,100,0,34,34
Nayel,M,100,0,34,34
Necalli,M,100,0,34,34
Nefeli,F,100,34,0,34
Nefretiri,F,100,34,0,34
Nel,F,100,34,0,34
Neola,F,100,34,0,34
Nequan,M,100,0,34,34
Neveya,F,100,34,0,34
Nimrah,F,100,34,0,34
Niveen,F,100,34,0,34
Nixxon,M,100,0,34,34
Noshin,F,100,34,0,34
Novelle,F,100,34,0,34
Nube,F,100,34,0,34
Nylani,F,100,34,0,34
Nytasha,F,100,34,0,34
Olean,F,100,34,0,34
Olufunmilayo,F,100,34,0,34
Oree,M,100,0,34,34
Paiyton,F,100,34,0,34
Paysley,F,100,34,0,34
Paytton,F,100,34,0,34
Phala,F,100,34,0,34
Philadelphia,F,100,34,0,34
Phillicia,F,100,34,0,34
Poul,M,100,0,34,34
Prapti,F,100,34,0,34
Qadry,M,100,0,34,34
Rafer,M,100,0,34,34
Ranique,F,100,34,0,34
Rasan,M,100,0,34,34
Rashone,M,82,6,28,34
Raz,M,100,0,34,34
Reemas,F,100,34,0,34
Reneasha,F,100,34,0,34
Renold,M,100,0,34,34
Reyaan,M,100,0,34,34
Reylan,M,100,0,34,34
Rhyden,M,100,0,34,34
Roise,F,100,34,0,34
Rope,M,100,0,34,34
Rosaleah,F,100,34,0,34
Roshandra,F,100,34,0,34
Roshundra,F,100,34,0,34
Ryelin,M,68,11,23,34
Sabrinah,F,100,34,0,34
Sajni,F,100,34,0,34
Samanvitha,F,100,34,0,34
Samisoni,M,100,0,34,34
Sancho,M,100,0,34,34
Santasha,F,100,34,0,34
Sarada,F,100,34,0,34
Sarahmae,F,100,34,0,34
Sarriah,F,100,34,0,34
Sayon,M,100,0,34,34
Shahn,M,100,0,34,34
Shakeyra,F,100,34,0,34
Shamaar,M,100,0,34,34
Shamaree,F,85,29,5,34
Shambhavi,F,100,34,0,34
Shambra,F,100,34,0,34
Shamier,M,100,0,34,34
Shanann,F,100,34,0,34
Shanlee,F,100,34,0,34
Shanquetta,F,100,34,0,34
Shantisha,F,100,34,0,34
Shanyra,F,100,34,0,34
Shaquida,F,100,34,0,34
Shastelyn,F,100,34,0,34
Shatema,F,100,34,0,34
Shaundria,F,100,34,0,34
Shealy,F,100,34,0,34
Sheindy,F,100,34,0,34
Shekima,F,100,34,0,34
Shondreka,F,100,34,0,34
Shria,F,100,34,0,34
Shylan,F,85,29,5,34
Sibylla,F,100,34,0,34
Sindel,F,100,34,0,34
Smyan,M,100,0,34,34
Solai,F,100,34,0,34
Solmayra,F,100,34,0,34
Sorangel,F,100,34,0,34
Starlite,F,100,34,0,34
Steva,F,100,34,0,34
Storee,F,100,34,0,34
Sufia,F,100,34,0,34
Susanah,F,100,34,0,34
Suvir,M,100,0,34,34
Swanzetta,F,100,34,0,34
Tahaj,M,100,0,34,34
Taiah,F,100,34,0,34
Taleesha,F,100,34,0,34
Taliyha,F,100,34,0,34
Tandon,M,100,0,34,34
Taraja,F,100,34,0,34
Tasharia,F,100,34,0,34
Tawaina,F,100,34,0,34
Tedarius,M,100,0,34,34
Temesgen,M,100,0,34,34
Tempe,F,100,34,0,34
Tenequa,F,100,34,0,34
Teniah,F,100,34,0,34
Teoman,M,100,0,34,34
Thecla,F,100,34,0,34
Tigh,M,100,0,34,34
Tionnie,F,100,34,0,34
Toka,F,100,34,0,34
Tomarion,M,100,0,34,34
Tosheba,F,100,34,0,34
Totianna,F,100,34,0,34
Trashon,M,100,0,34,34
Travys,M,100,0,34,34
Tremika,F,100,34,0,34
Trevius,M,100,0,34,34
Trez,M,100,0,34,34
Trillium,F,100,34,0,34
Truda,F,100,34,0,34
Tryon,M,100,0,34,34
Tyahna,F,100,34,0,34
Tyleik,M,100,0,34,34
Tylil,M,100,0,34,34
Tysun,M,100,0,34,34
Uliana,F,100,34,0,34
Vaiden,M,100,0,34,34
Valiyah,F,100,34,0,34
Vandi,F,100,34,0,34
Vannette,F,100,34,0,34
Vaune,F,100,34,0,34
Venya,F,100,34,0,34
Verdella,F,100,34,0,34
Verletta,F,100,34,0,34
Viviene,F,100,34,0,34
Vylette,F,100,34,0,34
Wandalyn,F,100,34,0,34
Willine,F,100,34,0,34
Woodard,M,100,0,34,34
Xiola,F,100,34,0,34
Xzavyer,M,100,0,34,34
Yairis,F,100,34,0,34
Yarelyn,F,100,34,0,34
Yavin,M,100,0,34,34
Yilin,F,100,34,0,34
Yoandy,M,100,0,34,34
Yochanon,M,100,0,34,34
Yohei,M,100,0,34,34
Yorleny,F,100,34,0,34
Yubia,F,100,34,0,34
Yuriria,F,100,34,0,34
Zacheria,M,100,0,34,34
Zaequan,M,100,0,34,34
Zaiyden,M,100,0,34,34
Zakarya,M,100,0,34,34
Zalie,F,100,34,0,34
Zamauria,F,100,34,0,34
Zathan,M,100,0,34,34
Zeltzin,F,100,34,0,34
Zyliah,F,100,34,0,34
Zyshaun,M,100,0,34,34
Aaniah,F,100,33,0,33
Absalon,M,100,0,33,33
Acheron,M,100,0,33,33
Addicyn,F,100,33,0,33
Adila,F,100,33,0,33
Adylee,F,100,33,0,33
Ahmaria,F,100,33,0,33
Ahriyah,F,100,33,0,33
Ailanie,F,100,33,0,33
Airlie,F,100,33,0,33
Aisatou,F,100,33,0,33
Aishling,F,100,33,0,33
Alathea,F,100,33,0,33
Alauni,F,100,33,0,33
Alcindor,M,100,0,33,33
Alejos,M,100,0,33,33
Alevia,F,100,33,0,33
Aleycia,F,100,33,0,33
Alfons,M,100,0,33,33
Alhasan,M,100,0,33,33
Alissya,F,100,33,0,33
Alitha,F,100,33,0,33
Almedina,F,100,33,0,33
Alvonte,M,100,0,33,33
Alyshea,F,100,33,0,33
Amaani,F,100,33,0,33
Amabella,F,100,33,0,33
Amarae,F,100,33,0,33
Amayra,F,100,33,0,33
Amner,M,100,0,33,33
Amyracle,F,100,33,0,33
Anabrenda,F,100,33,0,33
Anacani,F,100,33,0,33
Andretti,M,100,0,33,33
Andrianne,F,100,33,0,33
Andrica,F,100,33,0,33
Anjuan,M,100,0,33,33
Annetra,F,100,33,0,33
Aprilmarie,F,100,33,0,33
Arelene,F,100,33,0,33
Arelli,F,100,33,0,33
Areyonna,F,100,33,0,33
Arlenys,F,100,33,0,33
Armad,M,100,0,33,33
Armiya,F,100,33,0,33
Assante,M,100,0,33,33
Aubreyann,F,100,33,0,33
Aubriona,F,100,33,0,33
Austinmichael,M,100,0,33,33
Ayna,F,100,33,0,33
Aynslie,F,100,33,0,33
Azaela,F,100,33,0,33
Azula,F,100,33,0,33
Azyia,F,100,33,0,33
Baptiste,M,100,0,33,33
Barbarajo,F,100,33,0,33
Bedelia,F,100,33,0,33
Beniamin,M,100,0,33,33
Beny,M,100,0,33,33
Beverli,F,100,33,0,33
Bianica,F,100,33,0,33
Blayk,M,100,0,33,33
Blazen,M,100,0,33,33
Bogart,M,100,0,33,33
Braydenn,M,100,0,33,33
Briania,F,100,33,0,33
Brik,M,100,0,33,33
Brindle,F,100,33,0,33
Bronsyn,M,100,0,33,33
Bryian,M,100,0,33,33
Brynae,F,100,33,0,33
Brynner,M,100,0,33,33
Buz,M,100,0,33,33
Cajun,M,100,0,33,33
Calayah,F,100,33,0,33
Calei,F,100,33,0,33
Camon,M,100,0,33,33
Candece,F,100,33,0,33
Capree,F,85,28,5,33
Carlett,F,100,33,0,33
Carlyssa,F,100,33,0,33
Carmeshia,F,100,33,0,33
Carmilita,F,100,33,0,33
Cassiana,F,100,33,0,33
Catiria,F,100,33,0,33
Cergio,M,100,0,33,33
Chalino,M,100,0,33,33
Chanyah,F,100,33,0,33
Charliee,F,100,33,0,33
Charquita,F,100,33,0,33
Chaylin,F,100,33,0,33
Cheyney,F,85,28,5,33
Chitra,F,100,33,0,33
Claudel,M,100,0,33,33
Coetta,F,100,33,0,33
Colena,F,100,33,0,33
Corrinn,F,100,33,0,33
Corron,M,100,0,33,33
Cristabella,F,100,33,0,33
Cristene,F,100,33,0,33
Cruiz,M,100,0,33,33
Daeson,M,100,0,33,33
Damaine,M,100,0,33,33
Damitri,M,100,0,33,33
Danalynn,F,100,33,0,33
Darhonda,F,100,33,0,33
Dashelle,F,100,33,0,33
Dashiya,F,100,33,0,33
Daughtry,M,100,0,33,33
Dawniel,F,100,33,0,33
Daytron,M,100,0,33,33
Dazjah,F,100,33,0,33
Dazsha,F,100,33,0,33
Deahna,F,100,33,0,33
Deangel,F,100,33,0,33
Deboran,F,100,33,0,33
Delcenia,F,100,33,0,33
Demarquise,M,100,0,33,33
Dennon,M,100,0,33,33
Deontea,M,100,0,33,33
Deshala,F,100,33,0,33
Dhanvin,M,100,0,33,33
Dianette,F,100,33,0,33
Dionysia,F,100,33,0,33
Dkari,M,100,0,33,33
Donterrious,M,100,0,33,33
Dorrance,M,100,0,33,33
Dreshun,M,100,0,33,33
Earlyne,F,100,33,0,33
Ecrin,F,100,33,0,33
Edrena,F,100,33,0,33
Edyson,M,100,0,33,33
Efran,M,100,0,33,33
Efrayim,M,100,0,33,33
Egon,M,100,0,33,33
Eireann,F,100,33,0,33
Elira,F,100,33,0,33
Ellenmarie,F,100,33,0,33
Emmee,F,100,33,0,33
Esmie,F,100,33,0,33
Evelett,F,100,33,0,33
Everth,M,100,0,33,33
Ewald,M,100,0,33,33
Ezaiah,M,100,0,33,33
Ezekiah,M,100,0,33,33
Fanita,F,100,33,0,33
Fredonia,F,100,33,0,33
Gabbriel,F,100,33,0,33
Gabija,F,100,33,0,33
Genesa,F,100,33,0,33
Geoge,M,100,0,33,33
Geoggrey,M,100,0,33,33
Gillie,M,67,11,22,33
Gloristine,F,100,33,0,33
Hamin,M,100,0,33,33
Hannahlee,F,100,33,0,33
Hannya,F,100,33,0,33
Harloe,F,100,33,0,33
Harut,M,100,0,33,33
Hazaiah,M,100,0,33,33
Heavynn,F,100,33,0,33
Helenna,F,100,33,0,33
Hli,F,100,33,0,33
Horizon,F,100,33,0,33
Hovsep,M,100,0,33,33
Ignasio,M,100,0,33,33
Ilany,F,100,33,0,33
Imagen,F,100,33,0,33
Isandro,M,100,0,33,33
Ishawn,M,100,0,33,33
Itta,F,100,33,0,33
Iwona,F,100,33,0,33
Iyon,M,100,0,33,33
Izma,F,100,33,0,33
Jaaden,M,100,0,33,33
Jabriah,F,100,33,0,33
Jaciana,F,100,33,0,33
Jacintha,F,100,33,0,33
Jacklynne,F,100,33,0,33
Jackman,M,100,0,33,33
Jacqua,F,100,33,0,33
Jacquia,F,100,33,0,33
Jahem,M,100,0,33,33
Jakaylen,M,100,0,33,33
Jalayshia,F,100,33,0,33
Jaleeza,F,100,33,0,33
Jallisa,F,100,33,0,33
Jamarquez,M,100,0,33,33
Jammar,M,100,0,33,33
Janora,F,100,33,0,33
Janyssa,F,100,33,0,33
Jaquai,M,100,0,33,33
Jaquette,F,100,33,0,33
Jareese,M,100,0,33,33
Jarielis,F,100,33,0,33
Jashonna,F,100,33,0,33
Jaylanni,F,100,33,0,33
Jeannee,F,100,33,0,33
Jeanphilippe,M,100,0,33,33
Jemil,M,100,0,33,33
Jemiyah,F,100,33,0,33
Jessinia,F,100,33,0,33
Jeylah,F,100,33,0,33
Jiliana,F,100,33,0,33
Jilliyn,F,100,33,0,33
Jobey,M,100,0,33,33
Johnnita,F,100,33,0,33
Jolett,F,100,33,0,33
Joses,M,100,0,33,33
Joshuia,M,100,0,33,33
Joviana,F,100,33,0,33
Joylin,F,100,33,0,33
Jubril,M,100,0,33,33
Juliessa,F,100,33,0,33
Jurea,F,100,33,0,33
Jutta,F,100,33,0,33
Jyson,M,100,0,33,33
Kadmiel,M,100,0,33,33
Kaleiya,F,100,33,0,33
Kalenna,F,100,33,0,33
Kaleth,M,100,0,33,33
Kamai,M,100,0,33,33
Kamaurie,M,67,11,22,33
Kashun,M,100,0,33,33
Katavia,F,100,33,0,33
Katron,M,100,0,33,33
Kavious,M,100,0,33,33
Kaybrie,F,100,33,0,33
Kedus,M,100,0,33,33
Keeler,M,100,0,33,33
Kellisha,F,100,33,0,33
Kene,M,85,5,28,33
Kensuke,M,100,0,33,33
Kentra,F,100,33,0,33
Kerilynn,F,100,33,0,33
Kerstan,F,100,33,0,33
Kertina,F,100,33,0,33
Kes,F,100,33,0,33
Kevinmichael,M,100,0,33,33
Keyala,F,100,33,0,33
Keyoshia,F,100,33,0,33
Khadra,F,100,33,0,33
Khailey,F,100,33,0,33
Khaira,F,100,33,0,33
Khassidy,F,100,33,0,33
Kieleigh,F,100,33,0,33
Kijon,M,100,0,33,33
Kinara,F,100,33,0,33
Kindyl,F,100,33,0,33
Kmora,F,100,33,0,33
Kordale,M,100,0,33,33
Kristalee,F,100,33,0,33
Krystalin,F,100,33,0,33
Krysty,F,100,33,0,33
Kydon,M,100,0,33,33
Laithen,M,100,0,33,33
Lalla,F,100,33,0,33
Lameek,M,100,0,33,33
Lanaysha,F,100,33,0,33
Landrea,F,100,33,0,33
Lanel,F,85,28,5,33
Lanz,M,100,0,33,33
Laralee,F,100,33,0,33
Latoysha,F,100,33,0,33
Laveya,F,100,33,0,33
Leavy,M,100,0,33,33
Leaya,F,100,33,0,33
Ledion,M,100,0,33,33
Lenayah,F,100,33,0,33
Lenelle,F,100,33,0,33
Lerenzo,M,100,0,33,33
Leston,M,100,0,33,33
Lierin,F,100,33,0,33
Liezl,F,100,33,0,33
Lilburn,M,100,0,33,33
Liselle,F,100,33,0,33
Livvie,F,100,33,0,33
Livya,F,100,33,0,33
Lorance,M,100,0,33,33
Loza,F,100,33,0,33
Luckas,M,100,0,33,33
Lundin,F,100,33,0,33
Lydianna,F,100,33,0,33
Lynnix,F,100,33,0,33
Machayla,F,100,33,0,33
Macilynn,F,100,33,0,33
Mailan,F,100,33,0,33
Makali,F,100,33,0,33
Malaree,F,100,33,0,33
Marhta,F,100,33,0,33
Maricris,F,100,33,0,33
Markida,F,100,33,0,33
Markieta,F,100,33,0,33
Marlando,M,100,0,33,33
Marquella,F,100,33,0,33
Martene,F,100,33,0,33
Mayle,F,100,33,0,33
Maytee,F,100,33,0,33
Mchale,M,100,0,33,33
Mckailey,F,100,33,0,33
Measha,F,100,33,0,33
Melise,F,100,33,0,33
Mensah,M,100,0,33,33
Meziah,M,100,0,33,33
Michaeel,M,100,0,33,33
Milbert,M,100,0,33,33
Milenia,F,100,33,0,33
Mirrah,F,100,33,0,33
Mishay,F,100,33,0,33
Mondo,M,100,0,33,33
Moneca,F,100,33,0,33
Mubeen,M,100,0,33,33
Murvin,M,100,0,33,33
Mykalia,F,100,33,0,33
Myon,M,100,0,33,33
Myona,F,100,33,0,33
Myshaun,M,100,0,33,33
Nail,M,100,0,33,33
Najha,F,100,33,0,33
Nakedra,F,100,33,0,33
Nakylah,F,100,33,0,33
Nas,M,100,0,33,33
Nashara,F,100,33,0,33
Natilyn,F,100,33,0,33
Nay,M,67,11,22,33
Nayari,F,100,33,0,33
Nayela,F,100,33,0,33
Neharika,F,100,33,0,33
Nelsa,F,100,33,0,33
Nicoleanne,F,100,33,0,33
Nishelle,F,100,33,0,33
Nivedh,M,100,0,33,33
Nivedha,F,100,33,0,33
Nivriti,F,100,33,0,33
Nyjel,M,100,0,33,33
Oladimeji,M,100,0,33,33
Oluseyi,M,100,0,33,33
Onesimus,M,100,0,33,33
Orange,M,100,0,33,33
Parveen,F,100,33,0,33
Paublo,M,100,0,33,33
Philecia,F,100,33,0,33
Phinley,F,85,28,5,33
Phoebie,F,100,33,0,33
Pietrina,F,100,33,0,33
Pragnya,F,100,33,0,33
Priyanshi,F,100,33,0,33
Quiniyah,F,100,33,0,33
Raaghav,M,100,0,33,33
Rachale,F,100,33,0,33
Rafeeq,M,100,0,33,33
Rahem,M,100,0,33,33
Ramarion,M,100,0,33,33
Rashita,F,100,33,0,33
Raushan,M,100,0,33,33
Ravae,F,100,33,0,33
Raymen,M,100,0,33,33
Rechard,M,100,0,33,33
Redonda,F,100,33,0,33
Remond,M,100,0,33,33
Rickya,F,100,33,0,33
Romari,M,100,0,33,33
Rube,M,100,0,33,33
Runako,M,85,5,28,33
Rystal,F,100,33,0,33
Ryszard,M,100,0,33,33
Saffiyah,F,100,33,0,33
Saiyuri,F,100,33,0,33
Salatiel,M,100,0,33,33
Salyna,F,100,33,0,33
Samrah,F,100,33,0,33
Sariel,M,100,0,33,33
Saviour,M,100,0,33,33
Sentell,M,100,0,33,33
Seretta,F,100,33,0,33
Serynity,F,100,33,0,33
Shaelene,F,100,33,0,33
Shanella,F,100,33,0,33
Shaniese,F,100,33,0,33
Shaqueria,F,100,33,0,33
Shaquez,M,85,5,28,33
Sharian,F,100,33,0,33
Sharieff,M,100,0,33,33
Sharyle,F,100,33,0,33
Shateek,M,100,0,33,33
Shatrice,F,100,33,0,33
Shawntal,F,100,33,0,33
Shayvon,F,85,28,5,33
Shemya,F,100,33,0,33
Sirina,F,100,33,0,33
Siyon,M,100,0,33,33
Soctt,M,100,0,33,33
Soleia,F,100,33,0,33
Srisha,F,100,33,0,33
Staffon,M,100,0,33,33
Sufiyan,M,100,0,33,33
Suheyla,F,100,33,0,33
Summerlin,F,100,33,0,33
Sussy,F,100,33,0,33
Symere,M,100,0,33,33
Tade,M,100,0,33,33
Taitlyn,F,100,33,0,33
Talayna,F,100,33,0,33
Talullah,F,100,33,0,33
Tango,F,100,33,0,33
Taniko,F,100,33,0,33
Tasman,M,100,0,33,33
Taurie,F,100,33,0,33
Teaja,F,100,33,0,33
Teandrea,F,100,33,0,33
Tehron,M,100,0,33,33
Telah,F,100,33,0,33
Teraji,F,100,33,0,33
Terrylynn,F,100,33,0,33
Thomesha,F,100,33,0,33
Tice,M,100,0,33,33
Tichelle,F,100,33,0,33
Tilar,F,61,20,13,33
Tolga,M,100,0,33,33
Tramiya,F,100,33,0,33
Trela,F,100,33,0,33
Trenny,F,100,33,0,33
Trestyn,M,100,0,33,33
Treyonna,F,100,33,0,33
Trillion,M,100,0,33,33
Tyiona,F,100,33,0,33
Tyjohn,M,100,0,33,33
Tykell,M,100,0,33,33
Tynecia,F,100,33,0,33
Tynise,F,100,33,0,33
Tyquell,M,100,0,33,33
Tyquise,M,100,0,33,33
Tyriah,F,100,33,0,33
Tyriel,F,100,33,0,33
Uhuru,M,85,5,28,33
Umaima,F,100,33,0,33
Vaneisha,F,100,33,0,33
Vannya,F,100,33,0,33
Varenya,F,100,33,0,33
Vashanti,F,100,33,0,33
Vearl,M,100,0,33,33
Veralyn,F,100,33,0,33
Vessica,F,100,33,0,33
Waniya,F,100,33,0,33
Welsey,M,100,0,33,33
Wondra,F,100,33,0,33
Wyndham,M,100,0,33,33
Yaneira,F,100,33,0,33
Yaneiry,F,100,33,0,33
Yeneisy,F,100,33,0,33
Yilda,F,100,33,0,33
Yoeli,F,100,33,0,33
Yoselynn,F,100,33,0,33
Yovonda,F,100,33,0,33
Yulie,F,100,33,0,33
Yvelisse,F,100,33,0,33
Zacheus,M,100,0,33,33
Zacoria,F,100,33,0,33
Zamorah,F,100,33,0,33
Zandalee,F,100,33,0,33
Zaniyha,F,100,33,0,33
Zarriyah,F,100,33,0,33
Zaylia,F,100,33,0,33
Zidaan,M,100,0,33,33
Zolie,F,100,33,0,33
Zuleidy,F,100,33,0,33
Zulmy,F,100,33,0,33
Zyannah,F,100,33,0,33
Zymia,F,100,33,0,33
Aaleiyah,F,100,32,0,32
Aalya,F,100,32,0,32
Aamilah,F,100,32,0,32
Abdu,M,100,0,32,32
Abhijot,M,100,0,32,32
Abryelle,F,100,32,0,32
Achary,M,100,0,32,32
Ackeem,M,100,0,32,32
Adrita,F,100,32,0,32
Adriyan,M,100,0,32,32
Adysyn,F,100,32,0,32
Aevah,F,100,32,0,32
Ahlea,F,100,32,0,32
Aires,M,78,7,25,32
Airic,M,100,0,32,32
Akihiro,M,100,0,32,32
Aleacia,F,100,32,0,32
Alenia,F,100,32,0,32
Alexanne,F,100,32,0,32
Algeria,F,100,32,0,32
Allorah,F,100,32,0,32
Alveda,F,100,32,0,32
Alyciana,F,100,32,0,32
Alyus,M,100,0,32,32
Alyxa,F,100,32,0,32
Amelda,F,100,32,0,32
Amenia,F,100,32,0,32
Amerra,F,100,32,0,32
Amoya,F,100,32,0,32
Amyree,F,100,32,0,32
Anagrace,F,100,32,0,32
Anaie,F,100,32,0,32
Andrewjoseph,M,100,0,32,32
Angeliqua,F,100,32,0,32
Aniecia,F,100,32,0,32
Annalize,F,100,32,0,32
Anta,F,100,32,0,32
Antina,F,100,32,0,32
Antinique,F,100,32,0,32
Aquilah,F,100,32,0,32
Ardel,F,84,27,5,32
Aresha,F,100,32,0,32
Aricia,F,100,32,0,32
Aristotelis,M,100,0,32,32
Arnessa,F,100,32,0,32
Arooj,F,100,32,0,32
Aryauna,F,100,32,0,32
Arzella,F,100,32,0,32
Asata,F,100,32,0,32
Asberry,M,100,0,32,32
Ashelly,F,100,32,0,32
Ashka,F,100,32,0,32
Ashleyrose,F,100,32,0,32
Asriel,M,62,12,20,32
Avorie,F,100,32,0,32
Ayram,F,100,32,0,32
Azelea,F,100,32,0,32
Azusa,F,100,32,0,32
Azzareya,F,100,32,0,32
Balbina,F,100,32,0,32
Bania,F,100,32,0,32
Beatrize,F,100,32,0,32
Benino,M,100,0,32,32
Besim,M,100,0,32,32
Betzayra,F,100,32,0,32
Bhoomi,F,100,32,0,32
Blaiz,M,100,0,32,32
Braelan,M,100,0,32,32
Braelie,F,100,32,0,32
Brenlie,F,100,32,0,32
Briam,M,100,0,32,32
Brox,M,100,0,32,32
Bryent,M,100,0,32,32
Byntlee,M,84,5,27,32
Calisi,F,100,32,0,32
Camaro,F,59,19,13,32
Casimira,F,100,32,0,32
Cateria,F,100,32,0,32
Cavanaugh,M,100,0,32,32
Caynan,M,100,0,32,32
Ceceila,F,100,32,0,32
Cedriana,F,100,32,0,32
Celida,F,100,32,0,32
Chans,M,100,0,32,32
Chariya,F,100,32,0,32
Charmell,F,100,32,0,32
Charnissa,F,100,32,0,32
Chauntia,F,100,32,0,32
Chayan,M,84,5,27,32
Cherrel,F,100,32,0,32
Cherrice,F,100,32,0,32
Chesa,F,100,32,0,32
Chie,F,100,32,0,32
Christopherlee,M,100,0,32,32
Christye,F,100,32,0,32
Citalli,F,100,32,0,32
Coi,M,69,10,22,32
Cordairo,M,100,0,32,32
Cornetta,F,100,32,0,32
Corona,F,100,32,0,32
Crystalrose,F,100,32,0,32
Daizon,M,100,0,32,32
Dajhon,M,100,0,32,32
Dallyce,F,100,32,0,32
Dalyah,F,100,32,0,32
Danaejah,F,100,32,0,32
Danajia,F,100,32,0,32
Danazia,F,100,32,0,32
Darnika,F,100,32,0,32
Darrica,F,100,32,0,32
Datavion,M,100,0,32,32
Daurice,F,84,27,5,32
Davious,M,100,0,32,32
Dawt,F,100,32,0,32
Deani,F,100,32,0,32
Delsey,F,100,32,0,32
Demariae,M,100,0,32,32
Demeko,M,100,0,32,32
Denari,M,84,5,27,32
Denyel,F,100,32,0,32
Denzale,M,100,0,32,32
Deryle,M,100,0,32,32
Desyree,F,100,32,0,32
Detavius,M,100,0,32,32
Diahanna,F,100,32,0,32
Diar,M,100,0,32,32
Dimario,M,100,0,32,32
Dobie,M,100,0,32,32
Edelia,F,100,32,0,32
Edher,M,100,0,32,32
Eilah,F,100,32,0,32
Elainea,F,100,32,0,32
Eleasar,M,100,0,32,32
Elioenai,M,100,0,32,32
Ellisen,F,100,32,0,32
Empriss,F,100,32,0,32
Emslee,F,100,32,0,32
Enriquez,M,100,0,32,32
Exzavion,M,100,0,32,32
Ezaria,F,100,32,0,32
Fynley,F,100,32,0,32
Garnie,M,100,0,32,32
Genay,F,100,32,0,32
Gerrilyn,F,100,32,0,32
Given,M,100,0,32,32
Glennetta,F,100,32,0,32
Grandon,M,100,0,32,32
Graylyn,F,84,27,5,32
Gregry,M,100,0,32,32
Halton,M,100,0,32,32
Hamse,M,100,0,32,32
Hannes,M,100,0,32,32
Hannon,M,69,10,22,32
Harmanie,F,100,32,0,32
Heela,F,100,32,0,32
Hima,F,100,32,0,32
Hylee,F,100,32,0,32
Iancarlo,M,100,0,32,32
Ianthe,F,100,32,0,32
Ibet,F,100,32,0,32
Innis,M,100,0,32,32
Iree,F,100,32,0,32
Ivah,F,100,32,0,32
Iyonia,F,100,32,0,32
Jacaleb,M,100,0,32,32
Jaeshon,M,100,0,32,32
Jahmarley,M,100,0,32,32
Jakaiyah,F,100,32,0,32
Jaleese,F,100,32,0,32
Jamaari,M,100,0,32,32
Jamard,M,100,0,32,32
Jamesjoseph,M,100,0,32,32
Janariah,F,100,32,0,32
Janyria,F,100,32,0,32
Jardon,M,100,0,32,32
Jaremiah,M,100,0,32,32
Jascha,M,100,0,32,32
Jasion,M,100,0,32,32
Javionne,M,100,0,32,32
Jaza,F,100,32,0,32
Jelessa,F,100,32,0,32
Jemere,M,100,0,32,32
Jerricho,M,100,0,32,32
Jesalynn,F,100,32,0,32
Jewlia,F,100,32,0,32
Josett,F,100,32,0,32
Joshualee,M,100,0,32,32
Juane,M,100,0,32,32
Judye,F,100,32,0,32
Jusuf,M,100,0,32,32
Kadijatou,F,100,32,0,32
Kahlif,M,100,0,32,32
Kainin,M,100,0,32,32
Kalaysha,F,100,32,0,32
Kaleil,M,100,0,32,32
Kaleshia,F,100,32,0,32
Kalynda,F,100,32,0,32
Kamahao,M,100,0,32,32
Kamaia,F,100,32,0,32
Kanetha,F,100,32,0,32
Karaleigh,F,100,32,0,32
Katiuska,F,100,32,0,32
Katosha,F,100,32,0,32
Kawhi,M,100,0,32,32
Kaybri,F,100,32,0,32
Kayori,F,100,32,0,32
Kayston,M,100,0,32,32
Kazden,M,100,0,32,32
Keegin,M,100,0,32,32
Keertana,F,100,32,0,32
Keeyana,F,100,32,0,32
Keiler,M,100,0,32,32
Kensei,M,100,0,32,32
Kentavis,M,100,0,32,32
Kenwood,M,100,0,32,32
Kerek,M,100,0,32,32
Khareem,M,100,0,32,32
Kierce,M,100,0,32,32
Kimalee,F,100,32,0,32
Kirstee,F,100,32,0,32
Knightley,F,69,22,10,32
Krisanna,F,100,32,0,32
Kruthi,F,100,32,0,32
Krymson,F,84,27,5,32
Kutler,M,100,0,32,32
Kylianna,F,100,32,0,32
Kyrstle,F,100,32,0,32
Kyseem,M,100,0,32,32
Kysin,M,100,0,32,32
Ladaniel,M,100,0,32,32
Ladestiny,F,100,32,0,32
Ladre,M,100,0,32,32
Lamare,M,100,0,32,32
Lamarrion,M,100,0,32,32
Lao,M,100,0,32,32
Laquata,F,100,32,0,32
Lashonn,F,100,32,0,32
Latha,F,100,32,0,32
Laurelai,F,100,32,0,32
Laylarose,F,100,32,0,32
Leahana,F,100,32,0,32
Lealon,M,100,0,32,32
Leksi,F,100,32,0,32
Lemichael,M,100,0,32,32
Lexiann,F,100,32,0,32
Likita,F,100,32,0,32
Lillyin,F,100,32,0,32
Liviah,F,100,32,0,32
Lizamarie,F,100,32,0,32
Lizmar,F,100,32,0,32
Lladira,F,100,32,0,32
Lonia,F,100,32,0,32
Loron,M,100,0,32,32
Lorrianne,F,100,32,0,32
Luian,M,100,0,32,32
Lunabelle,F,100,32,0,32
Lyliah,F,100,32,0,32
Lynnley,F,100,32,0,32
Maeghen,F,100,32,0,32
Maejor,M,100,0,32,32
Mahita,F,100,32,0,32
Malaun,F,100,32,0,32
Malenie,F,100,32,0,32
Malesa,F,100,32,0,32
Maneesh,M,100,0,32,32
Marangely,F,100,32,0,32
Mardarius,M,100,0,32,32
Mareah,F,100,32,0,32
Mareshah,F,100,32,0,32
Mariadelrosari,F,100,32,0,32
Mariamawit,F,100,32,0,32
Marks,M,100,0,32,32
Marquitia,F,100,32,0,32
Marreon,M,100,0,32,32
Marypatricia,F,100,32,0,32
Maykel,M,100,0,32,32
Maziar,M,100,0,32,32
Mckinney,F,53,17,15,32
Merleen,F,100,32,0,32
Messiyah,M,69,10,22,32
Michalah,F,100,32,0,32
Millennium,F,100,32,0,32
Millianna,F,100,32,0,32
Minelly,F,100,32,0,32
Mini,F,100,32,0,32
Mizell,M,100,0,32,32
Montavion,M,100,0,32,32
Mustafaa,M,100,0,32,32
Naquesha,F,100,32,0,32
Narcissa,F,100,32,0,32
Nasro,F,100,32,0,32
Natavius,M,100,0,32,32
Naticia,F,100,32,0,32
Natylee,F,100,32,0,32
Nayomie,F,100,32,0,32
Nebiyu,M,100,0,32,32
Nehemyah,M,100,0,32,32
Neils,M,100,0,32,32
Niria,F,100,32,0,32
Nirmal,M,100,0,32,32
Normalinda,F,100,32,0,32
Nourhan,F,100,32,0,32
Nyarah,F,100,32,0,32
Nyha,F,100,32,0,32
Olajide,M,100,0,32,32
Olita,F,100,32,0,32
Ollen,M,100,0,32,32
Onel,M,100,0,32,32
Onetta,F,100,32,0,32
Orene,F,100,32,0,32
Osiah,M,100,0,32,32
Ozioma,F,100,32,0,32
Paidyn,F,100,32,0,32
Pailey,F,100,32,0,32
Paresh,M,100,0,32,32
Payce,M,100,0,32,32
Periann,F,100,32,0,32
Phaith,F,100,32,0,32
Pratheek,M,100,0,32,32
Quasha,F,100,32,0,32
Quatavius,M,100,0,32,32
Raelena,F,100,32,0,32
Raenelle,F,100,32,0,32
Rayniya,F,100,32,0,32
Reik,M,100,0,32,32
Renica,F,100,32,0,32
Rhondia,F,100,32,0,32
Romolo,M,100,0,32,32
Rosealynn,F,100,32,0,32
Rosine,F,100,32,0,32
Royzell,M,100,0,32,32
Rudis,M,100,0,32,32
Runette,F,100,32,0,32
Saby,F,100,32,0,32
Sacario,M,100,0,32,32
Saffire,F,100,32,0,32
Sahr,M,100,0,32,32
Samoni,F,100,32,0,32
Samrat,M,100,0,32,32
Sanil,M,100,0,32,32
Saquana,F,100,32,0,32
Schelby,F,100,32,0,32
Seferina,F,100,32,0,32
Seriya,F,100,32,0,32
Sethe,M,100,0,32,32
Shahzain,M,100,0,32,32
Shakenia,F,100,32,0,32
Shakierra,F,100,32,0,32
Shakonda,F,100,32,0,32
Shamyla,F,100,32,0,32
Shandrica,F,100,32,0,32
Shardey,F,100,32,0,32
Sharmell,F,100,32,0,32
Shavante,F,100,32,0,32
Shavna,F,100,32,0,32
Shealene,F,100,32,0,32
Shelea,F,100,32,0,32
Sheley,F,100,32,0,32
Shellina,F,100,32,0,32
Shermane,F,100,32,0,32
Shewanna,F,100,32,0,32
Shinice,F,100,32,0,32
Shivang,M,100,0,32,32
Shmeka,F,100,32,0,32
Shola,F,84,27,5,32
Siva,M,100,0,32,32
Sklyer,M,84,5,27,32
Skyller,M,72,9,23,32
Sommar,F,100,32,0,32
Srinath,M,100,0,32,32
Srivatsa,M,100,0,32,32
Srujan,M,100,0,32,32
Sruly,M,100,0,32,32
Statham,M,100,0,32,32
Steely,F,84,27,5,32
Stefane,F,100,32,0,32
Stetsen,M,100,0,32,32
Stihl,M,100,0,32,32
Suany,F,100,32,0,32
Sujin,F,100,32,0,32
Suley,F,100,32,0,32
Syah,F,100,32,0,32
Syreta,F,100,32,0,32
Tahjee,M,100,0,32,32
Taiyah,F,100,32,0,32
Takylah,F,100,32,0,32
Tambrey,F,100,32,0,32
Tameica,F,100,32,0,32
Tanmayi,F,100,32,0,32
Taresha,F,100,32,0,32
Tatianya,F,100,32,0,32
Tavan,M,100,0,32,32
Teeya,F,100,32,0,32
Teianna,F,100,32,0,32
Thomasenia,F,100,32,0,32
Tikvah,F,100,32,0,32
Timikia,F,100,32,0,32
Tkiyah,F,100,32,0,32
Toccora,F,100,32,0,32
Trene,F,100,32,0,32
Treyvonn,M,100,0,32,32
Tuba,F,100,32,0,32
Tyleisha,F,100,32,0,32
Tyshema,F,100,32,0,32
Uhura,F,100,32,0,32
Utkarsh,M,100,0,32,32
Vallon,F,69,22,10,32
Varen,M,100,0,32,32
Venicio,M,100,0,32,32
Vicktor,M,100,0,32,32
Vivyana,F,100,32,0,32
Wareesha,F,100,32,0,32
Willye,F,100,32,0,32
Xaven,M,100,0,32,32
Xaveon,M,100,0,32,32
Yasaira,F,100,32,0,32
Yashasvi,F,100,32,0,32
Yashi,F,100,32,0,32
Yia,M,100,0,32,32
Yoandra,F,100,32,0,32
Yoandri,M,100,0,32,32
Yohanes,M,100,0,32,32
Zafira,F,100,32,0,32
Zali,F,100,32,0,32
Zavin,M,100,0,32,32
Zeyna,F,100,32,0,32
Zhaniyah,F,100,32,0,32
Zhariah,F,100,32,0,32
Zila,F,100,32,0,32
Zykirah,F,100,32,0,32
Zylar,M,100,0,32,32
Zylin,M,100,0,32,32
Zymeer,M,100,0,32,32
Aaliyiah,F,100,31,0,31
Aamiya,F,100,31,0,31
Aaven,M,100,0,31,31
Aayaan,M,100,0,31,31
Abigel,F,100,31,0,31
Abirami,F,100,31,0,31
Adalise,F,100,31,0,31
Addalyne,F,100,31,0,31
Adedayo,M,100,0,31,31
Adilyne,F,100,31,0,31
Adran,M,100,0,31,31
Adrew,M,100,0,31,31
Aeralynn,F,100,31,0,31
Aeriell,F,100,31,0,31
Ahslee,F,100,31,0,31
Albertus,M,100,0,31,31
Alianis,F,100,31,0,31
Alitzah,F,100,31,0,31
Allaura,F,100,31,0,31
Alvey,M,100,0,31,31
Alynda,F,100,31,0,31
Alythia,F,100,31,0,31
Ambellina,F,100,31,0,31
Amiliano,M,100,0,31,31
Amillian,F,100,31,0,31
Amiyra,F,100,31,0,31
Anacelia,F,100,31,0,31
Anar,M,100,0,31,31
Aneissa,F,100,31,0,31
Angeldaniel,M,100,0,31,31
Angelinah,F,100,31,0,31
Anitza,F,100,31,0,31
Annaelle,F,100,31,0,31
Annelisse,F,100,31,0,31
Anselma,F,100,31,0,31
Anthoy,M,100,0,31,31
Anzel,M,100,0,31,31
Aquasia,F,100,31,0,31
Areion,F,100,31,0,31
Arkell,M,100,0,31,31
Artorius,M,100,0,31,31
Arykah,F,100,31,0,31
Asalia,F,100,31,0,31
Asialyn,F,100,31,0,31
Asmir,M,100,0,31,31
Aubren,F,65,20,11,31
Audiana,F,100,31,0,31
Avaley,F,100,31,0,31
Avishi,F,100,31,0,31
Avonta,M,100,0,31,31
Axten,M,100,0,31,31
Aydriana,F,100,31,0,31
Ayedin,M,100,0,31,31
Azarea,F,100,31,0,31
Baelee,F,100,31,0,31
Benajmin,M,100,0,31,31
Bernaldo,M,100,0,31,31
Bernhardt,M,100,0,31,31
Beryle,F,100,31,0,31
Bhuvan,M,100,0,31,31
Braely,F,100,31,0,31
Brana,F,100,31,0,31
Brandall,M,100,0,31,31
Branwen,F,100,31,0,31
Brekin,M,100,0,31,31
Brinlynn,F,100,31,0,31
Brisco,M,100,0,31,31
Brittine,F,100,31,0,31
Brooklan,F,100,31,0,31
Bry,M,100,0,31,31
Bryshawn,M,100,0,31,31
Byrl,M,100,0,31,31
Camyrn,F,100,31,0,31
Cappie,F,100,31,0,31
Carmaleta,F,100,31,0,31
Cebrina,F,100,31,0,31
Cecelie,F,100,31,0,31
Chadwich,M,100,0,31,31
Chalen,M,100,0,31,31
Chalena,F,100,31,0,31
Chanty,F,100,31,0,31
Chaquan,M,84,5,26,31
Charlis,M,84,5,26,31
Charyn,F,100,31,0,31
Chrissey,F,100,31,0,31
Cielita,F,100,31,0,31
Clennon,M,100,0,31,31
Cosetta,F,100,31,0,31
Crystalin,F,100,31,0,31
Cyson,M,100,0,31,31
Dadrien,M,100,0,31,31
Dahlyla,F,100,31,0,31
Dalli,F,100,31,0,31
Dalma,F,100,31,0,31
Damiane,M,100,0,31,31
Damyria,F,100,31,0,31
Danger,M,100,0,31,31
Daniyla,F,100,31,0,31
Darelyn,F,100,31,0,31
Darrianna,F,100,31,0,31
Darshae,F,100,31,0,31
Dasaun,M,100,0,31,31
Davyne,F,100,31,0,31
Deashawn,M,100,0,31,31
Debony,F,100,31,0,31
Deighton,M,100,0,31,31
Demekia,F,100,31,0,31
Demetricus,M,100,0,31,31
Demetrise,F,81,25,6,31
Denija,F,100,31,0,31
Destri,F,84,26,5,31
Deyan,M,100,0,31,31
Diandria,F,100,31,0,31
Dikembe,M,100,0,31,31
Dioselin,F,100,31,0,31
Dlyla,F,100,31,0,31
Domynic,M,100,0,31,31
Dorotea,F,100,31,0,31
Drelynn,M,61,12,19,31
Dshanti,F,100,31,0,31
Durel,M,100,0,31,31
Duvon,M,100,0,31,31
Eastan,M,100,0,31,31
Ebert,M,100,0,31,31
Edil,M,84,5,26,31
Ednita,F,100,31,0,31
Edriana,F,100,31,0,31
Eileena,F,100,31,0,31
Emese,F,100,31,0,31
Emyia,F,100,31,0,31
Endiyah,F,100,31,0,31
Engie,F,100,31,0,31
Engracia,F,100,31,0,31
Enver,M,100,0,31,31
Etoya,F,100,31,0,31
Eyosias,M,100,0,31,31
Ezeriah,M,100,0,31,31
Fatimazahra,F,100,31,0,31
Felimon,M,100,0,31,31
Ferran,F,58,18,13,31
Finnleigh,F,100,31,0,31
Flabio,M,100,0,31,31
Garbriel,M,100,0,31,31
Gayanne,F,100,31,0,31
Gee,M,61,12,19,31
Geethika,F,100,31,0,31
Genesiss,F,100,31,0,31
Gennetta,F,100,31,0,31
Goldia,F,100,31,0,31
Gonzales,M,100,0,31,31
Greory,M,100,0,31,31
Gwena,F,100,31,0,31
Haliee,F,100,31,0,31
Hemal,M,100,0,31,31
Iaisha,F,100,31,0,31
Iffany,F,100,31,0,31
Ineshia,F,100,31,0,31
Izamary,F,100,31,0,31
Jabreia,F,100,31,0,31
Jacobanthony,M,100,0,31,31
Jacquana,F,100,31,0,31
Jacquell,M,52,15,16,31
Jadakis,M,100,0,31,31
Jahlea,F,100,31,0,31
Jahmila,F,100,31,0,31
Jakendrick,M,100,0,31,31
Jakirra,F,100,31,0,31
Jalique,M,100,0,31,31
Jamaka,F,100,31,0,31
Jamarqus,M,100,0,31,31
Jamarre,M,100,0,31,31
Jamerious,M,100,0,31,31
Jammes,M,100,0,31,31
Jammey,M,100,0,31,31
Jamyrion,M,100,0,31,31
Janziel,M,100,0,31,31
Jateria,F,100,31,0,31
Javaree,M,100,0,31,31
Jaxden,M,100,0,31,31
Jazael,M,100,0,31,31
Jazmane,F,100,31,0,31
Jearlene,F,100,31,0,31
Jereth,M,100,0,31,31
Jericah,F,100,31,0,31
Jessus,M,100,0,31,31
Jezabell,F,100,31,0,31
Jhaniyah,F,100,31,0,31
Jimie,M,84,5,26,31
Jineen,F,100,31,0,31
Jlisa,F,100,31,0,31
Joathan,M,100,0,31,31
Jocell,F,100,31,0,31
Jocely,F,100,31,0,31
Joellie,F,100,31,0,31
Joleta,F,100,31,0,31
Jolyon,M,100,0,31,31
Josenid,F,100,31,0,31
Josephe,M,100,0,31,31
Juliamarie,F,100,31,0,31
Julianni,F,84,26,5,31
Juliyana,F,100,31,0,31
Jynelle,F,100,31,0,31
Kaif,M,100,0,31,31
Kaite,F,100,31,0,31
Kallia,F,100,31,0,31
Kalpana,F,100,31,0,31
Kande,F,100,31,0,31
Kartikeya,M,100,0,31,31
Katine,F,100,31,0,31
Kaydience,F,100,31,0,31
Kayhla,F,100,31,0,31
Keagin,M,100,0,31,31
Kemoria,F,100,31,0,31
Kentlee,F,65,20,11,31
Kentravion,M,100,0,31,31
Kenyota,F,84,26,5,31
Kersha,F,100,31,0,31
Ketcher,M,100,0,31,31
Keyawna,F,100,31,0,31
Khaleeq,M,100,0,31,31
Khamyah,F,100,31,0,31
Kianny,F,100,31,0,31
Kiare,F,84,26,5,31
Kiaunna,F,100,31,0,31
Kieria,F,100,31,0,31
Kione,M,100,0,31,31
Kiristen,F,100,31,0,31
Kowsar,F,100,31,0,31
Kristo,M,100,0,31,31
Kyelle,F,100,31,0,31
Kymarion,M,100,0,31,31
Kyrion,M,100,0,31,31
Kysir,M,100,0,31,31
Kywan,M,100,0,31,31
Lahana,F,100,31,0,31
Lakendric,M,100,0,31,31
Lanaia,F,100,31,0,31
Laquila,F,100,31,0,31
Latedra,F,100,31,0,31
Latiara,F,100,31,0,31
Latoni,F,100,31,0,31
Latray,M,100,0,31,31
Leeor,M,52,15,16,31
Leketa,F,100,31,0,31
Lendia,F,100,31,0,31
Leosha,F,100,31,0,31
Lesvia,F,100,31,0,31
Lethea,F,100,31,0,31
Leum,M,100,0,31,31
Litia,F,100,31,0,31
Lizmari,F,100,31,0,31
Loany,F,100,31,0,31
Lyandra,F,100,31,0,31
Madan,M,100,0,31,31
Makade,M,100,0,31,31
Makii,M,100,0,31,31
Malachia,F,65,20,11,31
Malekhi,M,100,0,31,31
Mallak,F,100,31,0,31
Marg,F,100,31,0,31
Marianella,F,100,31,0,31
Marl,M,100,0,31,31
Marlik,M,100,0,31,31
Marshawna,F,100,31,0,31
Martica,F,100,31,0,31
Martinjr,M,100,0,31,31
Matoya,F,100,31,0,31
Maycon,M,100,0,31,31
Melode,F,100,31,0,31
Merriann,F,100,31,0,31
Michellie,F,100,31,0,31
Milie,F,100,31,0,31
Misheel,F,100,31,0,31
Myar,F,100,31,0,31
Nadarius,M,100,0,31,31
Naeomi,F,100,31,0,31
Nahir,M,100,0,31,31
Nalley,F,100,31,0,31
Nataiya,F,100,31,0,31
Natira,F,100,31,0,31
Naydeli,F,100,31,0,31
Nayia,F,100,31,0,31
Neerav,M,100,0,31,31
Neona,F,100,31,0,31
Ngawang,M,74,8,23,31
Nicoleta,F,100,31,0,31
Nicolett,F,100,31,0,31
Niha,F,100,31,0,31
Nishad,M,100,0,31,31
Nolana,F,100,31,0,31
Norena,F,100,31,0,31
Nyobi,F,100,31,0,31
Nyziah,M,100,0,31,31
Obryant,M,100,0,31,31
Oda,F,77,24,7,31
Olyviah,F,100,31,0,31
Oniesha,F,100,31,0,31
Orielle,F,100,31,0,31
Osagie,M,100,0,31,31
Osceola,M,100,0,31,31
Paladin,M,100,0,31,31
Parminder,M,52,15,16,31
Pavani,F,100,31,0,31
Pavlo,M,100,0,31,31
Peony,F,100,31,0,31
Perdita,F,100,31,0,31
Phares,M,100,0,31,31
Pierceson,M,100,0,31,31
Quetin,M,100,0,31,31
Quilla,F,84,26,5,31
Raemon,M,100,0,31,31
Rakya,F,100,31,0,31
Randey,M,100,0,31,31
Randilee,F,100,31,0,31
Rany,M,68,10,21,31
Rasheim,M,100,0,31,31
Raymonde,F,100,31,0,31
Reko,M,100,0,31,31
Revae,F,100,31,0,31
Reylynn,F,100,31,0,31
Richarda,F,100,31,0,31
Richardd,M,100,0,31,31
Riece,M,68,10,21,31
Risako,F,100,31,0,31
Robertta,F,100,31,0,31
Rohnan,M,100,0,31,31
Rumer,F,100,31,0,31
Ruthia,F,100,31,0,31
Saith,M,100,0,31,31
Sameh,M,100,0,31,31
Samirra,F,100,31,0,31
Samiul,M,100,0,31,31
Samori,M,100,0,31,31
Sarde,F,100,31,0,31
Savonne,F,84,26,5,31
Sehrish,F,100,31,0,31
Semiko,F,100,31,0,31
Shaiya,F,100,31,0,31
Shamea,F,100,31,0,31
Shamonda,F,100,31,0,31
Shanalee,F,100,31,0,31
Shanelly,F,100,31,0,31
Shanet,F,100,31,0,31
Shariann,F,100,31,0,31
Sharnel,F,100,31,0,31
Sharran,F,100,31,0,31
Sharrone,F,100,31,0,31
Shatari,F,100,31,0,31
Shaunelle,F,100,31,0,31
Shauntai,F,100,31,0,31
Shaylia,F,100,31,0,31
Shequana,F,100,31,0,31
Shermya,F,100,31,0,31
Sigal,F,100,31,0,31
Simion,M,100,0,31,31
Sinae,F,100,31,0,31
Siranthony,M,100,0,31,31
Skyanna,F,100,31,0,31
Stedmon,M,100,0,31,31
Stellina,F,100,31,0,31
Stephina,F,100,31,0,31
Sujeily,F,100,31,0,31
Sumara,F,100,31,0,31
Sundas,F,100,31,0,31
Suong,F,100,31,0,31
Taboris,M,100,0,31,31
Tanishq,M,100,0,31,31
Tarana,F,100,31,0,31
Tarmara,F,100,31,0,31
Tavie,F,100,31,0,31
Tavyon,M,100,0,31,31
Taydra,F,100,31,0,31
Taziya,F,100,31,0,31
Temaka,F,100,31,0,31
Temera,F,100,31,0,31
Temilola,F,100,31,0,31
Teriona,F,100,31,0,31
Thedora,F,100,31,0,31
Thiana,F,100,31,0,31
Toriah,F,100,31,0,31
Trad,M,100,0,31,31
Tramiyah,F,100,31,0,31
Treveyon,M,100,0,31,31
Trevour,M,100,0,31,31
Treyvor,M,100,0,31,31
Trichia,F,100,31,0,31
Trieste,F,100,31,0,31
Trillian,F,100,31,0,31
Tristany,F,100,31,0,31
Twanette,F,100,31,0,31
Tycie,F,100,31,0,31
Urooj,F,100,31,0,31
Vadin,M,100,0,31,31
Valia,F,100,31,0,31
Vanae,F,100,31,0,31
Vasudha,F,100,31,0,31
Velveeta,F,100,31,0,31
Vision,F,100,31,0,31
Vontella,F,100,31,0,31
Vyktoria,F,100,31,0,31
Warnetta,F,100,31,0,31
Whitnei,F,100,31,0,31
Xaidyn,M,100,0,31,31
Xylie,F,100,31,0,31
Yadel,M,100,0,31,31
Yahvi,F,100,31,0,31
Yanise,F,100,31,0,31
Yarin,M,84,5,26,31
Yazira,F,100,31,0,31
Yoona,F,100,31,0,31
Yoscar,M,100,0,31,31
Yvens,M,100,0,31,31
Zadarius,M,100,0,31,31
Zakhary,M,100,0,31,31
Zanah,F,100,31,0,31
Zaniyla,F,100,31,0,31
Zebbie,M,81,6,25,31
Zien,M,100,0,31,31
Zildjian,M,100,0,31,31
Zinda,F,100,31,0,31
Zonnique,F,100,31,0,31
Zydarius,M,100,0,31,31
Zyiona,F,100,31,0,31
Aakriti,F,100,30,0,30
Aalayna,F,100,30,0,30
Aalisha,F,100,30,0,30
Aamer,M,100,0,30,30
Aaryah,F,100,30,0,30
Abdulhakeem,M,100,0,30,30
Abdurrehman,M,100,0,30,30
Abida,F,100,30,0,30
Aboubakar,M,100,0,30,30
Abriah,F,100,30,0,30
Acer,M,100,0,30,30
Adalys,F,100,30,0,30
Addylin,F,100,30,0,30
Addylynn,F,100,30,0,30
Adejah,F,100,30,0,30
Ahlanna,F,100,30,0,30
Aidsa,F,100,30,0,30
Aileana,F,100,30,0,30
Airalyn,F,100,30,0,30
Akeil,M,100,0,30,30
Akwasi,M,100,0,30,30
Alcee,M,100,0,30,30
Alejando,M,100,0,30,30
Aliaya,F,100,30,0,30
Alieya,F,100,30,0,30
Alius,M,100,0,30,30
Aliyan,M,63,11,19,30
Alvy,M,100,0,30,30
Alxander,M,100,0,30,30
Amahni,F,100,30,0,30
Ambreal,F,100,30,0,30
Amielia,F,100,30,0,30
Amiylah,F,100,30,0,30
Anass,M,100,0,30,30
Angielina,F,100,30,0,30
Anistasia,F,100,30,0,30
Annagail,F,100,30,0,30
Annalaya,F,100,30,0,30
Anniece,F,100,30,0,30
Anoosha,F,100,30,0,30
Antwaan,M,100,0,30,30
Ariahnna,F,100,30,0,30
Arinn,F,100,30,0,30
Ariyelle,F,100,30,0,30
Arlynne,F,100,30,0,30
Arrietty,F,100,30,0,30
Ashdyn,M,80,6,24,30
Aulora,F,100,30,0,30
Aung,M,100,0,30,30
Ausitn,M,100,0,30,30
Aveanna,F,100,30,0,30
Axiel,M,100,0,30,30
Ayal,M,100,0,30,30
Ayli,F,100,30,0,30
Ayniah,F,100,30,0,30
Barnetta,F,100,30,0,30
Benney,M,100,0,30,30
Bettyjane,F,100,30,0,30
Bhargavi,F,100,30,0,30
Biko,M,100,0,30,30
Brandonmichael,M,100,0,30,30
Breashia,F,100,30,0,30
Brecca,F,100,30,0,30
Brely,F,100,30,0,30
Brenlynn,F,100,30,0,30
Breonah,F,100,30,0,30
Breyan,M,67,10,20,30
Briarrose,F,100,30,0,30
Briasha,F,100,30,0,30
Brinlyn,F,100,30,0,30
Britzel,F,100,30,0,30
Broch,M,100,0,30,30
Bunni,F,100,30,0,30
Burna,F,100,30,0,30
Cainon,M,100,0,30,30
Calesha,F,100,30,0,30
Calixta,F,100,30,0,30
Candase,F,100,30,0,30
Carshena,F,100,30,0,30
Cashlin,F,53,16,14,30
Cashtyn,M,100,0,30,30
Casundra,F,100,30,0,30
Cataleah,F,100,30,0,30
Chaison,M,100,0,30,30
Charleta,F,100,30,0,30
Charnisha,F,100,30,0,30
Charrissa,F,100,30,0,30
Christean,F,100,30,0,30
Christerfer,M,100,0,30,30
Cianan,M,100,0,30,30
Clayre,F,100,30,0,30
Cleaven,M,100,0,30,30
Clella,F,100,30,0,30
Clera,F,100,30,0,30
Clerissa,F,100,30,0,30
Clintin,M,100,0,30,30
Clintona,F,100,30,0,30
Corren,F,83,25,5,30
Cott,M,100,0,30,30
Curtisa,F,100,30,0,30
Cyanni,F,100,30,0,30
Cylar,M,100,0,30,30
Cyndle,F,100,30,0,30
Cyric,M,100,0,30,30
Dahani,M,100,0,30,30
Daigan,M,100,0,30,30
Daivik,M,100,0,30,30
Dalaysha,F,100,30,0,30
Dalston,M,100,0,30,30
Danaisa,F,100,30,0,30
Daneja,F,100,30,0,30
Danek,M,100,0,30,30
Danieliz,F,100,30,0,30
Danielys,F,100,30,0,30
Dantay,M,100,0,30,30
Daonte,M,100,0,30,30
Dawnella,F,100,30,0,30
Dayamy,F,100,30,0,30
Daylia,F,100,30,0,30
Dearie,F,100,30,0,30
Deckard,M,100,0,30,30
Deivy,M,100,0,30,30
Delain,F,100,30,0,30
Deola,F,100,30,0,30
Deontrez,M,100,0,30,30
Destinii,F,100,30,0,30
Destinny,F,100,30,0,30
Devanne,F,100,30,0,30
Dezerea,F,100,30,0,30
Dhrithi,F,100,30,0,30
Diandrea,F,100,30,0,30
Dmorea,M,100,0,30,30
Dnylah,F,100,30,0,30
Dollinda,F,100,30,0,30
Doneva,F,100,30,0,30
Dorca,F,100,30,0,30
Dreyah,F,100,30,0,30
Dyandra,F,100,30,0,30
Dyonte,M,100,0,30,30
Edden,M,80,6,24,30
Eilzabeth,F,100,30,0,30
Elainey,F,100,30,0,30
Elean,M,83,5,25,30
Elexcia,F,100,30,0,30
Elianie,F,100,30,0,30
Eliona,F,100,30,0,30
Eloiza,F,100,30,0,30
Elrick,M,100,0,30,30
Emiri,F,100,30,0,30
Emmaree,F,100,30,0,30
Emontae,M,100,0,30,30
Endea,F,100,30,0,30
Enessa,F,100,30,0,30
Esabelle,F,100,30,0,30
Estephen,M,100,0,30,30
Ethian,M,100,0,30,30
Evagelos,M,100,0,30,30
Evea,F,100,30,0,30
Faran,F,80,24,6,30
Fathi,M,100,0,30,30
Fathia,F,100,30,0,30
Felechia,F,100,30,0,30
Felicie,F,100,30,0,30
Frasier,M,100,0,30,30
Fredirick,M,100,0,30,30
Gabryl,M,100,0,30,30
Gayann,F,100,30,0,30
Gelissa,F,100,30,0,30
Geomar,M,100,0,30,30
Georgeen,F,100,30,0,30
Georgy,F,50,15,15,30
Giddeon,M,100,0,30,30
Gillermina,F,100,30,0,30
Givon,M,100,0,30,30
Glendoria,F,100,30,0,30
Greysin,M,100,0,30,30
Gurbani,F,100,30,0,30
Harlequin,F,100,30,0,30
Hermenia,F,100,30,0,30
Herron,M,100,0,30,30
Honestii,F,100,30,0,30
Hovhannes,M,100,0,30,30
Hui,F,100,30,0,30
Ifunanya,F,100,30,0,30
Ileane,F,100,30,0,30
Ilima,F,100,30,0,30
Imtiaz,M,100,0,30,30
Inis,F,100,30,0,30
Inti,M,100,0,30,30
Ipek,F,100,30,0,30
Iraima,F,100,30,0,30
Ishant,M,100,0,30,30
Iskander,M,100,0,30,30
Itsuki,M,100,0,30,30
Ivyona,F,100,30,0,30
Jacleen,F,100,30,0,30
Jaco,M,100,0,30,30
Jacquay,M,57,13,17,30
Jadaisha,F,100,30,0,30
Jahcere,M,100,0,30,30
Jahkayla,F,100,30,0,30
Jahsai,M,100,0,30,30
Jaivin,M,100,0,30,30
Jakavious,M,100,0,30,30
Jakeryan,M,100,0,30,30
Jakiyla,F,100,30,0,30
Jalonnie,M,100,0,30,30
Jalya,F,100,30,0,30
Jamarra,F,100,30,0,30
Jamette,F,100,30,0,30
Janeika,F,100,30,0,30
Jaquarion,M,100,0,30,30
Jatyra,F,100,30,0,30
Javale,M,100,0,30,30
Jaylianie,F,100,30,0,30
Jayvone,M,100,0,30,30
Jazya,F,100,30,0,30
Jazzilyn,F,100,30,0,30
Jeannet,F,100,30,0,30
Jefri,M,100,0,30,30
Jemelle,M,100,0,30,30
Jenely,F,100,30,0,30
Jennye,F,100,30,0,30
Jerramie,M,100,0,30,30
Jerrimiah,M,100,0,30,30
Jesusalberto,M,100,0,30,30
Jeton,M,100,0,30,30
Jewelissa,F,100,30,0,30
Jeydy,F,100,30,0,30
Jhai,M,83,5,25,30
Jilisa,F,100,30,0,30
Jobana,F,100,30,0,30
Johnpeter,M,100,0,30,30
Jolei,F,100,30,0,30
Jolianna,F,100,30,0,30
Jordache,M,100,0,30,30
Josaih,M,100,0,30,30
Joshlin,F,77,23,7,30
Juanfrancisco,M,100,0,30,30
Juliaann,F,100,30,0,30
Julieonna,F,100,30,0,30
Juliyan,M,100,0,30,30
Kaeda,F,100,30,0,30
Kailanie,F,100,30,0,30
Kaitlain,F,100,30,0,30
Kaliska,F,100,30,0,30
Kallissa,F,100,30,0,30
Kamillia,F,100,30,0,30
Kanasha,F,100,30,0,30
Kanitha,F,100,30,0,30
Karrson,M,100,0,30,30
Kasaan,M,100,0,30,30
Kasinda,F,100,30,0,30
Kassandre,F,100,30,0,30
Kastiel,M,100,0,30,30
Kathry,F,100,30,0,30
Kaustubh,M,100,0,30,30
Kayaan,M,100,0,30,30
Kayhan,M,100,0,30,30
Kaylann,F,100,30,0,30
Keair,M,100,0,30,30
Keitaro,M,100,0,30,30
Kellam,M,100,0,30,30
Kellymarie,F,100,30,0,30
Kelseyann,F,100,30,0,30
Kenra,F,100,30,0,30
Keontaye,M,100,0,30,30
Keran,F,83,25,5,30
Keshuna,F,100,30,0,30
Keson,M,100,0,30,30
Khaleya,F,100,30,0,30
Khamal,M,100,0,30,30
Khania,F,100,30,0,30
Khou,F,100,30,0,30
Kiere,M,100,0,30,30
Kija,F,100,30,0,30
Kimira,F,100,30,0,30
Kinlyn,F,100,30,0,30
Kishore,M,100,0,30,30
Kulsoom,F,100,30,0,30
Kyniah,F,100,30,0,30
Kyreem,M,100,0,30,30
Lajon,M,100,0,30,30
Lakenda,F,100,30,0,30
Lakeyn,F,100,30,0,30
Lakiea,F,100,30,0,30
Lanaiyah,F,100,30,0,30
Laryiah,F,100,30,0,30
Lashawanda,F,100,30,0,30
Latrevion,M,100,0,30,30
Latrinity,F,100,30,0,30
Laurencio,M,100,0,30,30
Lavenda,F,100,30,0,30
Lawrnce,M,100,0,30,30
Laylonnie,F,100,30,0,30
Leashia,F,100,30,0,30
Lennea,F,100,30,0,30
Leticha,F,100,30,0,30
Lilyah,F,100,30,0,30
Lindsley,F,50,15,15,30
Lolanda,F,100,30,0,30
Lonnisha,F,100,30,0,30
Lorik,M,100,0,30,30
Lorinzo,M,100,0,30,30
Louay,M,100,0,30,30
Louiza,F,100,30,0,30
Luby,M,100,0,30,30
Lucey,F,100,30,0,30
Lucillia,F,100,30,0,30
Ludy,F,100,30,0,30
Lyndale,M,83,5,25,30
Maanvi,F,100,30,0,30
Mabelene,F,100,30,0,30
Macaylee,F,100,30,0,30
Madelis,F,100,30,0,30
Mahana,F,100,30,0,30
Mahiyah,F,100,30,0,30
Mahria,F,100,30,0,30
Majel,F,100,30,0,30
Malise,F,100,30,0,30
Malke,F,100,30,0,30
Marcilla,F,100,30,0,30
Mardie,F,83,25,5,30
Marguarite,F,100,30,0,30
Markaylah,F,100,30,0,30
Marqavious,M,100,0,30,30
Marquiesha,F,100,30,0,30
Maryia,F,100,30,0,30
Marysia,F,100,30,0,30
Matao,M,100,0,30,30
Maybeline,F,100,30,0,30
Maylan,F,100,30,0,30
Mayukha,F,100,30,0,30
Mckinlie,F,100,30,0,30
Mckinly,F,100,30,0,30
Mcrae,M,83,5,25,30
Meichelle,F,100,30,0,30
Mekeba,F,100,30,0,30
Mekell,M,100,0,30,30
Meleigha,F,100,30,0,30
Melique,M,100,0,30,30
Metra,F,100,30,0,30
Metro,M,100,0,30,30
Michaelandrew,M,100,0,30,30
Michea,F,100,30,0,30
Mignonne,F,100,30,0,30
Mikira,F,100,30,0,30
Mirisa,F,100,30,0,30
Miste,F,100,30,0,30
Monday,F,100,30,0,30
Monise,F,100,30,0,30
Morene,F,100,30,0,30
Morocco,M,100,0,30,30
Morry,M,100,0,30,30
Mortez,M,100,0,30,30
Moselle,F,100,30,0,30
Muneera,F,100,30,0,30
Myasiah,F,100,30,0,30
Nabihah,F,100,30,0,30
Naiim,M,100,0,30,30
Nakera,F,100,30,0,30
Nakesia,F,100,30,0,30
Natusha,F,100,30,0,30
Nechole,F,100,30,0,30
Neer,M,100,0,30,30
Nejra,F,100,30,0,30
Nikil,M,100,0,30,30
Nimit,M,100,0,30,30
Nykhia,F,100,30,0,30
Obama,M,100,0,30,30
Orenda,F,100,30,0,30
Oretta,F,100,30,0,30
Orfelinda,F,100,30,0,30
Oshyn,F,100,30,0,30
Ovadia,M,100,0,30,30
Palani,M,100,0,30,30
Patriciajo,F,100,30,0,30
Penelopi,F,100,30,0,30
Porshae,F,100,30,0,30
Pranika,F,100,30,0,30
Pranish,M,100,0,30,30
Pranita,F,100,30,0,30
Preslynn,F,100,30,0,30
Quanae,F,100,30,0,30
Quanique,F,100,30,0,30
Quentavius,M,100,0,30,30
Rabih,M,100,0,30,30
Rajbir,M,100,0,30,30
Randoll,M,100,0,30,30
Rayannah,F,100,30,0,30
Rayniel,M,100,0,30,30
Rebekan,F,100,30,0,30
Rennick,M,100,0,30,30
Rhiyanna,F,100,30,0,30
Riahna,F,100,30,0,30
Ritwik,M,100,0,30,30
Robertocarlos,M,100,0,30,30
Roksana,F,100,30,0,30
Ronaldinho,M,100,0,30,30
Rosalynne,F,100,30,0,30
Roux,F,77,23,7,30
Rudean,F,100,30,0,30
Ryannah,F,100,30,0,30
Ryia,F,100,30,0,30
Ryuu,M,100,0,30,30
Saddam,M,100,0,30,30
Sadina,F,100,30,0,30
Salicia,F,100,30,0,30
Salmah,F,100,30,0,30
Saly,F,100,30,0,30
Sanaah,F,100,30,0,30
Saniyha,F,100,30,0,30
Sarisha,F,100,30,0,30
Saryia,F,100,30,0,30
Savanaha,F,100,30,0,30
Sayveon,M,100,0,30,30
Seath,M,100,0,30,30
Secora,F,100,30,0,30
Sekina,F,100,30,0,30
Semika,F,100,30,0,30
Shaikh,M,100,0,30,30
Shaketia,F,100,30,0,30
Shakilah,F,100,30,0,30
Shamauri,F,63,19,11,30
Shamesha,F,100,30,0,30
Shamoni,F,100,30,0,30
Shanylah,F,100,30,0,30
Shaqunda,F,100,30,0,30
Shardell,F,100,30,0,30
Sharida,F,100,30,0,30
Sharryl,F,100,30,0,30
Shashawna,F,100,30,0,30
Shateara,F,100,30,0,30
Shauntez,M,100,0,30,30
Shavetta,F,100,30,0,30
Shayera,F,100,30,0,30
Shekema,F,100,30,0,30
Shenetra,F,100,30,0,30
Shequille,M,100,0,30,30
Shiyan,F,100,30,0,30
Shoko,F,100,30,0,30
Shykeim,M,100,0,30,30
Shyleen,F,100,30,0,30
Simiya,F,100,30,0,30
Sirwilliam,M,100,0,30,30
Stokes,M,100,0,30,30
Sui,F,100,30,0,30
Sumanth,M,100,0,30,30
Sumya,F,100,30,0,30
Sushanth,M,100,0,30,30
Suzen,F,100,30,0,30
Sweden,F,100,30,0,30
Syren,F,80,24,6,30
Taleb,M,100,0,30,30
Tamerah,F,100,30,0,30
Tamiia,F,100,30,0,30
Tash,F,50,15,15,30
Tashee,F,100,30,0,30
Tashyia,F,100,30,0,30
Tavante,M,100,0,30,30
Tearza,F,100,30,0,30
Teather,F,100,30,0,30
Teina,F,100,30,0,30
Tennley,F,100,30,0,30
Terrice,F,50,15,15,30
Tersia,F,100,30,0,30
Theona,F,100,30,0,30
Thristan,M,100,0,30,30
Tierny,F,100,30,0,30
Tirah,F,100,30,0,30
Tomecka,F,100,30,0,30
Torilyn,F,100,30,0,30
Toriona,F,100,30,0,30
Trayvonne,M,100,0,30,30
Trendell,M,100,0,30,30
Trennen,M,100,0,30,30
Trynt,M,100,0,30,30
Tyair,M,100,0,30,30
Tyaun,M,100,0,30,30
Ubaid,M,100,0,30,30
Udana,F,100,30,0,30
Vahin,M,100,0,30,30
Vedaant,M,100,0,30,30
Vermon,M,100,0,30,30
Vianni,F,100,30,0,30
Vihana,F,100,30,0,30
Vikranth,M,100,0,30,30
Vyla,F,100,30,0,30
Wences,M,100,0,30,30
Wilkens,M,100,0,30,30
Williiam,M,100,0,30,30
Xiomari,F,100,30,0,30
Xzavious,M,100,0,30,30
Yakelyn,F,100,30,0,30
Yakita,F,100,30,0,30
Yanilet,F,100,30,0,30
Yasirah,F,100,30,0,30
Yassen,M,100,0,30,30
Yiovanni,M,100,0,30,30
Yoyo,F,100,30,0,30
Yukta,F,100,30,0,30
Zackeri,M,100,0,30,30
Zaelen,M,100,0,30,30
Zahmari,M,100,0,30,30
Zanaiyah,F,100,30,0,30
Zerita,F,100,30,0,30
Ziven,M,100,0,30,30
Zixuan,M,57,13,17,30
Zoeii,F,100,30,0,30
Zuhaib,M,100,0,30,30
Aadhira,F,100,29,0,29
Aajah,F,100,29,0,29
Aasir,M,100,0,29,29
Abbigayl,F,100,29,0,29
Abgail,F,100,29,0,29
Abihail,F,100,29,0,29
Abriya,F,100,29,0,29
Achintya,M,100,0,29,29
Adarryll,M,100,0,29,29
Adayla,F,100,29,0,29
Adreon,M,100,0,29,29
Ajooni,F,100,29,0,29
Akarsh,M,100,0,29,29
Akeena,F,100,29,0,29
Akeilah,F,100,29,0,29
Akerah,F,100,29,0,29
Alajha,F,100,29,0,29
Alaziah,F,100,29,0,29
Aleighia,F,100,29,0,29
Aleny,F,100,29,0,29
Alexyz,F,100,29,0,29
Alfrida,F,100,29,0,29
Aliaha,F,100,29,0,29
Aliandra,F,100,29,0,29
Alijandra,F,100,29,0,29
Allysun,F,100,29,0,29
Alnisha,F,100,29,0,29
Aluna,F,100,29,0,29
Alvi,M,100,0,29,29
Alyasia,F,100,29,0,29
Alynne,F,100,29,0,29
Amaud,M,100,0,29,29
Amazyn,F,100,29,0,29
Ambriah,F,100,29,0,29
Amija,F,100,29,0,29
Amiliah,F,100,29,0,29
Amilian,F,100,29,0,29
Amith,M,100,0,29,29
Ammarah,F,100,29,0,29
Amun,M,100,0,29,29
Anahlia,F,100,29,0,29
Anaum,F,100,29,0,29
Andarius,M,100,0,29,29
Andressa,F,100,29,0,29
Angelicamarie,F,100,29,0,29
Angellea,F,100,29,0,29
Anissah,F,100,29,0,29
Anslei,F,100,29,0,29
Antiqua,F,100,29,0,29
Antohny,M,100,0,29,29
Anzio,M,100,0,29,29
Araia,F,100,29,0,29
Ardita,F,100,29,0,29
Areti,F,100,29,0,29
Arfan,M,100,0,29,29
Ariceli,F,100,29,0,29
Arjanae,F,100,29,0,29
Arleni,F,100,29,0,29
Armonii,F,100,29,0,29
Armony,F,100,29,0,29
Aryk,M,100,0,29,29
Aschley,F,100,29,0,29
Asheena,F,100,29,0,29
Ashmita,F,100,29,0,29
Avalei,F,100,29,0,29
Avanelle,F,100,29,0,29
Avona,F,100,29,0,29
Avonne,F,100,29,0,29
Awan,M,100,0,29,29
Ayeesha,F,100,29,0,29
Ayshah,F,100,29,0,29
Azekiel,M,100,0,29,29
Azelynn,F,100,29,0,29
Bar,F,59,17,12,29
Behnam,M,100,0,29,29
Bernise,F,100,29,0,29
Bethe,F,100,29,0,29
Betzabet,F,100,29,0,29
Branya,F,100,29,0,29
Brelon,M,100,0,29,29
Bretley,M,100,0,29,29
Brettley,M,100,0,29,29
Brinesha,F,100,29,0,29
Brndon,M,100,0,29,29
Brysa,F,100,29,0,29
Burnard,M,100,0,29,29
Cacee,F,100,29,0,29
Capresha,F,100,29,0,29
Carolette,F,100,29,0,29
Cartney,F,100,29,0,29
Casmir,M,52,14,15,29
Castulo,M,100,0,29,29
Catessa,F,100,29,0,29
Cean,M,100,0,29,29
Ceazar,M,100,0,29,29
Celsea,F,100,29,0,29
Cequan,M,100,0,29,29
Chadae,F,100,29,0,29
Chaneta,F,100,29,0,29
Charel,F,100,29,0,29
Charlieann,F,100,29,0,29
Charniqua,F,100,29,0,29
Chasitity,F,100,29,0,29
Chelseaann,F,100,29,0,29
Chenin,F,100,29,0,29
Cherrill,F,100,29,0,29
Cherub,F,100,29,0,29
Chozen,M,100,0,29,29
Christafer,M,100,0,29,29
Ciin,F,100,29,0,29
Ciomara,F,100,29,0,29
Cordara,M,100,0,29,29
Cosby,M,100,0,29,29
Cristyan,M,100,0,29,29
Cyress,M,100,0,29,29
Daejohn,M,100,0,29,29
Daeonna,F,100,29,0,29
Dahja,F,100,29,0,29
Dahntay,M,100,0,29,29
Daid,M,100,0,29,29
Dajonae,F,100,29,0,29
Dalas,M,66,10,19,29
Dalea,F,100,29,0,29
Dalexa,F,100,29,0,29
Danesa,F,100,29,0,29
Danilah,F,100,29,0,29
Darico,M,100,0,29,29
Darri,F,100,29,0,29
Darth,M,100,0,29,29
Dartha,F,100,29,0,29
Davarian,M,100,0,29,29
Davd,M,100,0,29,29
Davinder,M,100,0,29,29
Dawton,M,100,0,29,29
Dayvid,M,100,0,29,29
Dazie,F,100,29,0,29
Decameron,M,100,0,29,29
Deethya,F,100,29,0,29
Delcine,F,100,29,0,29
Delontay,M,100,0,29,29
Delvante,M,100,0,29,29
Demark,M,100,0,29,29
Dentrell,M,100,0,29,29
Derold,M,100,0,29,29
Desarey,F,100,29,0,29
Desiyah,F,100,29,0,29
Devari,M,100,0,29,29
Devinee,F,100,29,0,29
Devlan,M,100,0,29,29
Dewand,M,100,0,29,29
Diajah,F,100,29,0,29
Djenaba,F,100,29,0,29
Dlorah,F,100,29,0,29
Donat,M,100,0,29,29
Dorsett,M,100,0,29,29
Drayah,F,100,29,0,29
Drin,M,100,0,29,29
Dwright,M,100,0,29,29
Dynver,F,100,29,0,29
Dziyah,F,100,29,0,29
Edword,M,100,0,29,29
Eldean,M,59,12,17,29
Elery,M,100,0,29,29
Eliran,M,100,0,29,29
Elius,M,100,0,29,29
Elyjiah,M,100,0,29,29
Emirhan,M,100,0,29,29
Emyle,F,100,29,0,29
Enora,F,100,29,0,29
Ensar,M,100,0,29,29
Eslie,F,100,29,0,29
Esrom,M,100,0,29,29
Evarose,F,100,29,0,29
Exequiel,M,100,0,29,29
Exton,M,100,0,29,29
Exzavior,M,100,0,29,29
Fantazia,F,100,29,0,29
Feona,F,100,29,0,29
Ferando,M,100,0,29,29
Fermon,M,100,0,29,29
Filberto,M,100,0,29,29
Francesc,F,66,19,10,29
Freemon,M,100,0,29,29
Gabrel,M,100,0,29,29
Gana,F,100,29,0,29
Gerika,F,100,29,0,29
Giavona,F,100,29,0,29
Gionny,M,100,0,29,29
Glenard,M,100,0,29,29
Gyllian,F,100,29,0,29
Haaken,M,100,0,29,29
Hakeim,M,100,0,29,29
Hakima,F,100,29,0,29
Halayah,F,100,29,0,29
Harmany,F,100,29,0,29
Hartlynn,F,100,29,0,29
Hasti,F,100,29,0,29
Hayzlee,F,100,29,0,29
Heida,F,100,29,0,29
Hernesto,M,100,0,29,29
Hinako,F,100,29,0,29
Hooman,M,100,0,29,29
Hooria,F,100,29,0,29
Hossam,M,100,0,29,29
Hser,F,76,22,7,29
Huberta,F,100,29,0,29
Ieashia,F,100,29,0,29
Inaky,M,100,0,29,29
Isamary,F,100,29,0,29
Ishitha,F,100,29,0,29
Itiel,M,100,0,29,29
Izzabel,F,100,29,0,29
Jadeveon,M,100,0,29,29
Jaheed,M,100,0,29,29
Jahiya,F,100,29,0,29
Jahquel,M,100,0,29,29
Jakesha,F,100,29,0,29
Jaklynn,F,100,29,0,29
Jaleon,M,100,0,29,29
Jalijah,M,100,0,29,29
Jaliyha,F,100,29,0,29
Jalysia,F,100,29,0,29
Jamariana,F,100,29,0,29
Jamerria,F,100,29,0,29
Jamiroquai,M,100,0,29,29
Jaquelle,M,100,0,29,29
Jaquori,M,100,0,29,29
Jaraad,M,100,0,29,29
Jareem,M,100,0,29,29
Jarvell,M,100,0,29,29
Jasias,M,100,0,29,29
Jatayvion,M,100,0,29,29
Javery,M,100,0,29,29
Javita,F,100,29,0,29
Jaxn,M,100,0,29,29
Jayauna,F,100,29,0,29
Jaython,M,100,0,29,29
Jaytin,M,100,0,29,29
Jazzleen,F,100,29,0,29
Jellisa,F,100,29,0,29
Jenasys,F,100,29,0,29
Jennesa,F,100,29,0,29
Jenniferanne,F,100,29,0,29
Jenyah,F,100,29,0,29
Jerion,M,100,0,29,29
Jermeisha,F,100,29,0,29
Jerriel,M,100,0,29,29
Jestiny,F,100,29,0,29
Jewelya,F,100,29,0,29
Jhavon,M,100,0,29,29
Jibrael,M,100,0,29,29
Jimarion,M,100,0,29,29
Jimenna,F,100,29,0,29
Jniah,F,100,29,0,29
Joanelle,F,100,29,0,29
Joevany,M,100,0,29,29
Johah,M,100,0,29,29
Johnesia,F,100,29,0,29
Joleesa,F,100,29,0,29
Jonnay,F,100,29,0,29
Jontia,F,100,29,0,29
Joselene,F,100,29,0,29
Josyiah,M,100,0,29,29
Juliannie,F,100,29,0,29
Juneau,F,79,23,6,29
Jvaughn,M,100,0,29,29
Jyanna,F,100,29,0,29
Kahn,M,100,0,29,29
Kaje,M,100,0,29,29
Kalisi,F,100,29,0,29
Kaman,M,100,0,29,29
Kamariona,F,100,29,0,29
Kanise,F,100,29,0,29
Karden,M,100,0,29,29
Kardin,M,100,0,29,29
Karelis,F,100,29,0,29
Kashief,M,100,0,29,29
Kastle,M,100,0,29,29
Kathileen,F,100,29,0,29
Kathyren,F,100,29,0,29
Katylin,F,100,29,0,29
Kaymarie,F,100,29,0,29
Kazen,M,100,0,29,29
Keayla,F,100,29,0,29
Keilei,F,100,29,0,29
Keiyonna,F,100,29,0,29
Kemily,F,100,29,0,29
Kenten,M,100,0,29,29
Kenyell,F,76,22,7,29
Keyonn,M,100,0,29,29
Khadisha,F,100,29,0,29
Khanya,F,100,29,0,29
Khrysten,F,100,29,0,29
Khyden,M,100,0,29,29
Kissey,F,100,29,0,29
Kisten,F,100,29,0,29
Kix,M,100,0,29,29
Koh,M,100,0,29,29
Konstandinos,M,100,0,29,29
Korianne,F,100,29,0,29
Korrah,F,100,29,0,29
Kriselda,F,100,29,0,29
Kristasia,F,100,29,0,29
Kurtus,M,100,0,29,29
Kwanda,F,100,29,0,29
Kyheim,M,100,0,29,29
Kymesha,F,100,29,0,29
Kynda,F,100,29,0,29
Kyomi,F,100,29,0,29
Lacarlos,M,100,0,29,29
Lafrances,F,100,29,0,29
Laguanda,F,100,29,0,29
Lajeune,F,100,29,0,29
Lakessa,F,100,29,0,29
Lakeysia,F,100,29,0,29
Lananh,F,100,29,0,29
Laquandria,F,100,29,0,29
Laquaya,F,100,29,0,29
Larelle,F,52,15,14,29
Laroya,F,100,29,0,29
Latravius,M,100,0,29,29
Lawona,F,100,29,0,29
Lazandra,F,100,29,0,29
Leart,M,100,0,29,29
Lebarron,M,100,0,29,29
Lesandra,F,100,29,0,29
Leshly,F,100,29,0,29
Lexas,F,100,29,0,29
Linne,F,100,29,0,29
Lizbeht,F,100,29,0,29
Loie,F,100,29,0,29
Loreda,F,100,29,0,29
Louvinia,F,100,29,0,29
Maaria,F,100,29,0,29
Maarten,M,100,0,29,29
Madalie,F,100,29,0,29
Madhumitha,F,100,29,0,29
Mahkenzie,F,100,29,0,29
Maitte,F,100,29,0,29
Maize,F,83,24,5,29
Majour,M,100,0,29,29
Makhail,M,100,0,29,29
Maleika,F,100,29,0,29
Maleko,M,100,0,29,29
Mandrill,M,100,0,29,29
Manit,M,100,0,29,29
Mansel,M,100,0,29,29
Maraiya,F,100,29,0,29
Maredith,F,100,29,0,29
Marell,M,100,0,29,29
Margus,M,100,0,29,29
Marisia,F,100,29,0,29
Markeal,M,100,0,29,29
Markeitha,F,100,29,0,29
Marquida,F,100,29,0,29
Marren,F,100,29,0,29
Marreo,M,100,0,29,29
Martravious,M,100,0,29,29
Mashiya,F,100,29,0,29
Mathaniel,M,100,0,29,29
Mayari,F,100,29,0,29
Mayjor,M,100,0,29,29
Maymunah,F,100,29,0,29
Mayukh,M,100,0,29,29
Mekyla,F,100,29,0,29
Melantha,F,100,29,0,29
Melloney,F,100,29,0,29
Mertis,F,100,29,0,29
Meryam,F,100,29,0,29
Meshayla,F,100,29,0,29
Micelle,F,100,29,0,29
Mikos,M,100,0,29,29
Miliany,F,100,29,0,29
Mitze,F,100,29,0,29
Modena,F,100,29,0,29
Mondre,M,100,0,29,29
Moniya,F,100,29,0,29
Montressa,F,100,29,0,29
Mosetta,F,100,29,0,29
Mystical,F,100,29,0,29
Nakye,M,100,0,29,29
Nanayaw,M,100,0,29,29
Narayah,F,100,29,0,29
Natachia,F,100,29,0,29
Natajha,F,100,29,0,29
Natthan,M,100,0,29,29
Nayma,F,100,29,0,29
Necol,F,100,29,0,29
Neeve,F,100,29,0,29
Nekko,M,100,0,29,29
Nemo,M,100,0,29,29
Neneh,F,100,29,0,29
Newborn,M,62,11,18,29
Nhyira,F,100,29,0,29
Niamiah,F,100,29,0,29
Niegel,M,100,0,29,29
Nikeeta,F,100,29,0,29
Ninive,F,100,29,0,29
Nisi,F,100,29,0,29
Niyathi,F,100,29,0,29
Noahjames,M,100,0,29,29
Noey,M,100,0,29,29
Noran,F,100,29,0,29
Nyalah,F,100,29,0,29
Oji,M,100,0,29,29
Oluwatomi,F,55,16,13,29
Orenthial,M,100,0,29,29
Orlie,M,100,0,29,29
Ovetta,F,100,29,0,29
Paedyn,F,100,29,0,29
Panya,F,100,29,0,29
Patriot,M,100,0,29,29
Pipper,F,100,29,0,29
Piyush,M,100,0,29,29
Prim,F,100,29,0,29
Rahwa,F,100,29,0,29
Rajahn,M,100,0,29,29
Rakeim,M,100,0,29,29
Rassan,M,100,0,29,29
Ravaughn,M,100,0,29,29
Ravleen,F,100,29,0,29
Rayveon,M,100,0,29,29
Reeghan,F,100,29,0,29
Reiden,M,100,0,29,29
Remya,F,100,29,0,29
Rennette,F,100,29,0,29
Reynelda,F,100,29,0,29
Rhyon,M,76,7,22,29
Robbe,M,79,6,23,29
Rodolpho,M,100,0,29,29
Rosemond,F,72,21,8,29
Russella,F,100,29,0,29
Ryanjoseph,M,100,0,29,29
Safal,M,100,0,29,29
Saheim,M,100,0,29,29
Sailee,F,100,29,0,29
Sallyjo,F,100,29,0,29
Samaura,F,100,29,0,29
Sebrenia,F,100,29,0,29
Sedalia,F,100,29,0,29
Selest,F,100,29,0,29
Sequena,F,100,29,0,29
Seychelle,F,100,29,0,29
Shakarra,F,100,29,0,29
Shakeara,F,100,29,0,29
Shakerah,F,100,29,0,29
Sharvil,M,100,0,29,29
Shatonna,F,100,29,0,29
Shauntrell,F,100,29,0,29
Shawnalee,F,100,29,0,29
Shawntea,F,100,29,0,29
Shawonna,F,100,29,0,29
Sheema,F,100,29,0,29
Shehzad,M,100,0,29,29
Shelana,F,100,29,0,29
Shelvie,F,100,29,0,29
Shiloe,F,100,29,0,29
Shniya,F,100,29,0,29
Shonie,F,100,29,0,29
Shritan,M,100,0,29,29
Shuhei,M,100,0,29,29
Shwetha,F,100,29,0,29
Sidhanth,M,100,0,29,29
Simranpreet,F,100,29,0,29
Simrun,F,100,29,0,29
Sindhuja,F,100,29,0,29
Sioux,F,100,29,0,29
Sisira,F,100,29,0,29
Skeet,M,100,0,29,29
Sonaya,F,100,29,0,29
Spartacus,M,100,0,29,29
Stavon,M,100,0,29,29
Steffin,M,100,0,29,29
Stehen,M,100,0,29,29
Stylez,M,100,0,29,29
Suheb,M,100,0,29,29
Sunna,F,100,29,0,29
Sunnye,F,100,29,0,29
Sydell,F,100,29,0,29
Syeira,F,100,29,0,29
Synclaire,F,100,29,0,29
Tacorey,M,100,0,29,29
Taijae,F,62,18,11,29
Tajane,F,100,29,0,29
Tajohn,M,100,0,29,29
Tamishia,F,100,29,0,29
Tammia,F,100,29,0,29
Tammylynn,F,100,29,0,29
Tanyka,F,100,29,0,29
Taquia,F,100,29,0,29
Tarna,F,100,29,0,29
Taurin,M,100,0,29,29
Tavar,M,100,0,29,29
Tedford,M,100,0,29,29
Tenaja,F,100,29,0,29
Teneeshia,F,100,29,0,29
Teree,F,100,29,0,29
Terrik,M,100,0,29,29
Teslyn,F,100,29,0,29
Thalmus,M,100,0,29,29
Tiaa,F,100,29,0,29
Tianca,F,100,29,0,29
Tierica,F,100,29,0,29
Tinishia,F,100,29,0,29
Tinsleigh,F,100,29,0,29
Tip,M,100,0,29,29
Tishauna,F,100,29,0,29
Tobbie,F,59,17,12,29
Tomaka,F,100,29,0,29
Tonasia,F,100,29,0,29
Tramone,M,100,0,29,29
Trampis,M,100,0,29,29
Trandon,M,100,0,29,29
Tranese,F,100,29,0,29
Trasha,F,100,29,0,29
Treasea,F,100,29,0,29
Trilla,F,100,29,0,29
Tyease,F,100,29,0,29
Tynley,F,100,29,0,29
Tyyana,F,100,29,0,29
Vanesse,F,100,29,0,29
Vanilla,F,100,29,0,29
Vaya,F,100,29,0,29
Veralynn,F,100,29,0,29
Vevelyn,F,100,29,0,29
Vidhya,F,100,29,0,29
Vidyut,M,100,0,29,29
Vincint,M,100,0,29,29
Vitina,F,100,29,0,29
Voncia,F,100,29,0,29
Wadiya,F,100,29,0,29
Wakeem,M,100,0,29,29
Warsame,M,100,0,29,29
Whiteny,F,100,29,0,29
Wittney,F,100,29,0,29
Xain,M,100,0,29,29
Xuxa,F,100,29,0,29
Yaindhi,F,100,29,0,29
Yakia,F,100,29,0,29
Yance,M,100,0,29,29
Yaneisi,F,100,29,0,29
Yatana,F,100,29,0,29
Yensi,F,100,29,0,29
Yeymi,F,100,29,0,29
Yma,F,100,29,0,29
Yonel,M,100,0,29,29
Yoseli,F,100,29,0,29
Yudelka,F,100,29,0,29
Zackaree,M,100,0,29,29
Zahkai,M,100,0,29,29
Zakkai,M,100,0,29,29
Zarak,M,100,0,29,29
Zayion,M,100,0,29,29
Zerin,M,100,0,29,29
Zharick,F,100,29,0,29
Ziham,F,100,29,0,29
Zihan,M,55,13,16,29
Zyquarius,M,100,0,29,29
Aaqil,M,100,0,28,28
Aavah,F,100,28,0,28
Abdullatif,M,100,0,28,28
Abdulrhman,M,100,0,28,28
Abeera,F,100,28,0,28
Abernathy,F,100,28,0,28
Abilgail,F,100,28,0,28
Abukar,M,100,0,28,28
Adanelly,F,100,28,0,28
Addaley,F,100,28,0,28
Adean,M,82,5,23,28
Adoree,F,100,28,0,28
Adrinna,F,100,28,0,28
Adylynn,F,100,28,0,28
Aemon,M,100,0,28,28
Afaf,F,100,28,0,28
Ahmeir,M,100,0,28,28
Ahnia,F,100,28,0,28
Aiyahna,F,100,28,0,28
Aizley,F,100,28,0,28
Ajanique,F,100,28,0,28
Alaetra,F,100,28,0,28
Alassandra,F,100,28,0,28
Aleidy,F,100,28,0,28
Aletse,F,100,28,0,28
Alexaner,M,100,0,28,28
Aliceia,F,100,28,0,28
Alondre,M,100,0,28,28
Alwaleed,M,100,0,28,28
Alyonna,F,100,28,0,28
Amanoa,F,100,28,0,28
Amarielle,F,100,28,0,28
Amarrie,F,100,28,0,28
Amby,F,100,28,0,28
Ameliarose,F,100,28,0,28
Amjed,M,100,0,28,28
Amneh,F,100,28,0,28
Analize,F,100,28,0,28
Andwele,M,100,0,28,28
Aniiyah,F,100,28,0,28
Anjum,F,100,28,0,28
Annyka,F,100,28,0,28
Antarius,M,100,0,28,28
Antawon,M,100,0,28,28
Anthem,M,100,0,28,28
Anylia,F,100,28,0,28
Aonesty,F,100,28,0,28
Araiah,F,100,28,0,28
Arethea,F,100,28,0,28
Arhonda,F,100,28,0,28
Arison,M,100,0,28,28
Armanee,F,100,28,0,28
Arshaan,M,100,0,28,28
Ashleymae,F,100,28,0,28
Asialynn,F,100,28,0,28
Asjha,F,100,28,0,28
Aubreelynn,F,100,28,0,28
Aunalee,F,100,28,0,28
Austinn,M,100,0,28,28
Avianca,F,100,28,0,28
Avra,F,100,28,0,28
Avron,M,100,0,28,28
Ayleigh,F,100,28,0,28
Aylia,F,100,28,0,28
Bacari,M,100,0,28,28
Bae,F,82,23,5,28
Bahareh,F,100,28,0,28
Balam,M,100,0,28,28
Baseemah,F,100,28,0,28
Baxton,M,100,0,28,28
Beckum,M,100,0,28,28
Bejan,M,100,0,28,28
Bellanie,F,100,28,0,28
Benedicta,F,100,28,0,28
Bentyn,M,100,0,28,28
Berat,M,100,0,28,28
Berenda,F,100,28,0,28
Bernett,F,64,18,10,28
Bishara,M,100,0,28,28
Brehana,F,100,28,0,28
Brendalynn,F,100,28,0,28
Bric,M,100,0,28,28
Bridgete,F,100,28,0,28
Brittoni,F,100,28,0,28
Burce,M,100,0,28,28
Burdell,M,100,0,28,28
Byson,M,100,0,28,28
Caely,F,100,28,0,28
Cairon,M,100,0,28,28
Caitie,F,100,28,0,28
Caleena,F,100,28,0,28
Calii,F,100,28,0,28
Callisto,F,100,28,0,28
Canan,M,82,5,23,28
Capriana,F,100,28,0,28
Carel,M,79,6,22,28
Catena,F,100,28,0,28
Caylum,M,100,0,28,28
Cedrika,F,100,28,0,28
Ceresa,F,100,28,0,28
Cerone,M,100,0,28,28
Chalita,F,100,28,0,28
Chantrelle,F,100,28,0,28
Charliegh,F,100,28,0,28
Chasidee,F,100,28,0,28
Chasie,F,100,28,0,28
Chauntee,F,100,28,0,28
Chavonna,F,100,28,0,28
Cherida,F,100,28,0,28
Cheslie,F,100,28,0,28
Cheza,F,100,28,0,28
Christophen,M,100,0,28,28
Chyrstal,F,100,28,0,28
Clance,M,100,0,28,28
Clarabella,F,100,28,0,28
Codye,M,100,0,28,28
Coletha,F,100,28,0,28
Contessia,F,100,28,0,28
Corolyn,F,100,28,0,28
Crash,M,100,0,28,28
Croy,M,100,0,28,28
Crystan,F,100,28,0,28
Crystine,F,100,28,0,28
Curissa,F,100,28,0,28
Daiyon,M,100,0,28,28
Dakar,M,100,0,28,28
Danaeja,F,100,28,0,28
Danieljames,M,100,0,28,28
Danson,M,100,0,28,28
Dar,M,100,0,28,28
Darnecia,F,100,28,0,28
Darquan,M,100,0,28,28
Darrence,M,100,0,28,28
Daryah,F,100,28,0,28
Dashira,F,100,28,0,28
Davantae,M,100,0,28,28
Deacan,M,100,0,28,28
Deem,F,100,28,0,28
Dejanna,F,100,28,0,28
Deljuan,M,100,0,28,28
Dennes,M,100,0,28,28
Deontavious,M,100,0,28,28
Deoveon,F,79,22,6,28
Deserey,F,100,28,0,28
Detroy,M,100,0,28,28
Devena,F,100,28,0,28
Dhylan,M,100,0,28,28
Dianny,F,100,28,0,28
Dijonnaise,F,100,28,0,28
Divyesh,M,100,0,28,28
Dmontae,M,100,0,28,28
Donivon,M,100,0,28,28
Donterrio,M,100,0,28,28
Donzetta,F,100,28,0,28
Doritha,F,100,28,0,28
Drennan,M,100,0,28,28
Ebonnie,F,100,28,0,28
Eghosa,M,100,0,28,28
Eimile,F,100,28,0,28
Eita,M,100,0,28,28
Elaini,F,100,28,0,28
Elenita,F,100,28,0,28
Elicio,M,100,0,28,28
Eliecer,M,100,0,28,28
Elinora,F,100,28,0,28
Elizaeth,F,100,28,0,28
Elizza,F,100,28,0,28
Elleson,F,100,28,0,28
Enjolie,F,100,28,0,28
Erike,F,61,17,11,28
Erilynn,F,100,28,0,28
Erisha,F,100,28,0,28
Erjon,M,100,0,28,28
Esmi,F,100,28,0,28
Esteve,M,100,0,28,28
Esthefani,F,100,28,0,28
Ezikiel,M,100,0,28,28
Fashionette,F,100,28,0,28
Ferol,F,100,28,0,28
Fiera,F,100,28,0,28
Floreen,F,100,28,0,28
Frankin,M,100,0,28,28
Gabrialle,F,100,28,0,28
Gaitlin,F,100,28,0,28
Garcelle,F,100,28,0,28
Genetha,F,100,28,0,28
Georgeana,F,100,28,0,28
Geralene,F,100,28,0,28
Ghalia,F,100,28,0,28
Gianpiero,M,100,0,28,28
Girish,M,100,0,28,28
Girtha,F,100,28,0,28
Graisen,M,100,0,28,28
Graylan,M,100,0,28,28
Graysyn,M,100,0,28,28
Greeley,F,82,23,5,28
Grishma,F,100,28,0,28
Gurtaj,M,100,0,28,28
Gwendoly,F,100,28,0,28
Habram,M,100,0,28,28
Hanniel,M,100,0,28,28
Harol,M,100,0,28,28
Havin,F,100,28,0,28
Hazeline,F,100,28,0,28
Henesis,F,100,28,0,28
Hibaq,F,100,28,0,28
Hoss,M,100,0,28,28
Hristos,M,100,0,28,28
Huel,M,100,0,28,28
Ilay,M,100,0,28,28
Indika,F,100,28,0,28
Irielle,F,100,28,0,28
Irihanna,F,100,28,0,28
Isabellagrace,F,100,28,0,28
Itzhak,M,100,0,28,28
Ivars,M,100,0,28,28
Ivyrose,F,100,28,0,28
Izaria,F,100,28,0,28
Izibella,F,100,28,0,28
Izzi,F,100,28,0,28
Jaboris,M,100,0,28,28
Jacklene,F,100,28,0,28
Jacsen,M,100,0,28,28
Jademarie,F,100,28,0,28
Jaetyn,M,100,0,28,28
Jahaida,F,100,28,0,28
Jahaire,M,100,0,28,28
Jahasia,F,100,28,0,28
Jahda,F,100,28,0,28
Jaheir,M,100,0,28,28
Jahnice,F,100,28,0,28
Jakaira,F,100,28,0,28
Jalean,M,100,0,28,28
Jaleek,M,100,0,28,28
Jamaire,M,100,0,28,28
Jameesha,F,100,28,0,28
Jamias,M,100,0,28,28
Jamiela,F,100,28,0,28
Jamor,M,100,0,28,28
Jandell,M,79,6,22,28
Janeiry,F,100,28,0,28
Janellys,F,100,28,0,28
Jannica,F,100,28,0,28
Jaquaris,M,100,0,28,28
Jardyn,F,100,28,0,28
Jassel,F,100,28,0,28
Javieon,M,100,0,28,28
Jaydem,M,100,0,28,28
Jaylannie,F,100,28,0,28
Jaynah,F,100,28,0,28
Jazaiah,M,64,10,18,28
Jazlee,F,100,28,0,28
Jazly,F,100,28,0,28
Jeantte,F,100,28,0,28
Jeramiha,M,100,0,28,28
Jerrilee,F,100,28,0,28
Jeshaun,M,100,0,28,28
Jessabella,F,100,28,0,28
Jessalin,F,100,28,0,28
Jeudy,M,100,0,28,28
Jeydon,M,100,0,28,28
Jhaiden,M,100,0,28,28
Jimmya,F,100,28,0,28
Joanetta,F,100,28,0,28
Johniyah,F,100,28,0,28
Johnphilip,M,100,0,28,28
Joleth,F,100,28,0,28
Jonquez,M,100,0,28,28
Joree,F,100,28,0,28
Josline,F,100,28,0,28
Jovel,M,100,0,28,28
Julana,F,100,28,0,28
Kahlila,F,100,28,0,28
Kaivion,M,100,0,28,28
Kamaira,F,100,28,0,28
Kamarien,M,100,0,28,28
Kamaurion,M,100,0,28,28
Kamlyn,F,100,28,0,28
Kaream,M,100,0,28,28
Karelin,F,100,28,0,28
Karreem,M,100,0,28,28
Kartel,M,100,0,28,28
Kashka,F,57,16,12,28
Kassidey,F,100,28,0,28
Katiemarie,F,100,28,0,28
Kavia,F,100,28,0,28
Kayliani,F,100,28,0,28
Keather,F,100,28,0,28
Keirrah,F,100,28,0,28
Kelila,F,100,28,0,28
Kendrianna,F,100,28,0,28
Kerre,F,100,28,0,28
Kerryanne,F,100,28,0,28
Khilynn,F,100,28,0,28
Khrysta,F,100,28,0,28
Kimera,F,100,28,0,28
Kimmya,F,100,28,0,28
Kinlei,F,100,28,0,28
Kleo,F,100,28,0,28
Koner,M,100,0,28,28
Krislin,F,100,28,0,28
Kristifer,M,100,0,28,28
Kyari,F,100,28,0,28
Kynslei,F,100,28,0,28
Kywon,M,100,0,28,28
Laguisha,F,100,28,0,28
Lakeba,F,100,28,0,28
Lakedria,F,100,28,0,28
Lakeeshia,F,100,28,0,28
Lakelia,F,100,28,0,28
Lakieta,F,100,28,0,28
Lamontre,M,100,0,28,28
Lamour,M,100,0,28,28
Landria,F,100,28,0,28
Landrum,M,100,0,28,28
Larwrence,M,100,0,28,28
Latefa,F,100,28,0,28
Latissha,F,100,28,0,28
Latonio,M,100,0,28,28
Latre,M,100,0,28,28
Laurenz,M,100,0,28,28
Leany,F,100,28,0,28
Leeonna,F,100,28,0,28
Lemanuel,M,100,0,28,28
Lennyx,F,79,22,6,28
Leshun,M,75,7,21,28
Liang,M,100,0,28,28
Lilibet,F,100,28,0,28
Limor,F,100,28,0,28
Liran,M,100,0,28,28
Lishia,F,100,28,0,28
Loisann,F,100,28,0,28
Lorimar,F,100,28,0,28
Lotte,F,100,28,0,28
Lylli,F,100,28,0,28
Lynnex,F,100,28,0,28
Macklen,M,100,0,28,28
Madline,F,100,28,0,28
Maebh,F,100,28,0,28
Maggee,F,100,28,0,28
Maichael,M,100,0,28,28
Makaden,M,100,0,28,28
Makaiyla,F,100,28,0,28
Makhila,F,100,28,0,28
Makinleigh,F,100,28,0,28
Malykai,M,100,0,28,28
Manesha,F,100,28,0,28
Marguette,M,100,0,28,28
Mariadelosangel,F,100,28,0,28
Maribela,F,100,28,0,28
Maribi,F,100,28,0,28
Maricelda,F,100,28,0,28
Marilia,F,100,28,0,28
Markiel,M,100,0,28,28
Marlone,M,100,0,28,28
Marqita,F,100,28,0,28
Marycarol,F,100,28,0,28
Maryjoy,F,100,28,0,28
Marylisa,F,100,28,0,28
Mathue,M,100,0,28,28
Matisyahu,M,100,0,28,28
Maxima,F,100,28,0,28
Maysam,F,100,28,0,28
Meldoy,F,100,28,0,28
Melene,F,100,28,0,28
Merie,F,100,28,0,28
Miguelito,M,100,0,28,28
Miliah,F,100,28,0,28
Millani,F,100,28,0,28
Minaya,F,100,28,0,28
Minica,F,100,28,0,28
Mirasol,F,100,28,0,28
Mishaela,F,100,28,0,28
Mondell,M,100,0,28,28
Moniquea,F,100,28,0,28
Morty,M,100,0,28,28
Mosses,M,100,0,28,28
Myaisha,F,100,28,0,28
Mychala,F,100,28,0,28
Mykhael,M,100,0,28,28
Myrlene,F,100,28,0,28
Najm,M,100,0,28,28
Nakaiyah,F,100,28,0,28
Nand,M,100,0,28,28
Nataysia,F,100,28,0,28
Natonia,F,100,28,0,28
Natsuki,F,100,28,0,28
Nickali,M,100,0,28,28
Nikkea,F,100,28,0,28
Nikunj,M,100,0,28,28
Ninos,M,100,0,28,28
Noehmi,F,100,28,0,28
Nonya,F,100,28,0,28
Nouh,M,100,0,28,28
Nuhamin,F,100,28,0,28
Nuzhat,F,100,28,0,28
Nyalee,F,100,28,0,28
Nyamal,F,100,28,0,28
Nyjia,F,100,28,0,28
Nylaya,F,100,28,0,28
Nysaiah,M,100,0,28,28
Nytia,F,100,28,0,28
Oakes,M,100,0,28,28
Oaklen,M,100,0,28,28
Obaloluwa,M,100,0,28,28
Oshai,M,64,10,18,28
Pacie,F,100,28,0,28
Paetynn,F,100,28,0,28
Paitin,F,100,28,0,28
Pamie,F,100,28,0,28
Pason,M,100,0,28,28
Patrise,F,100,28,0,28
Pennylane,F,100,28,0,28
Peris,F,79,22,6,28
Printice,M,100,0,28,28
Prissy,F,100,28,0,28
Quadasha,F,100,28,0,28
Quason,M,100,0,28,28
Quention,M,100,0,28,28
Quinell,M,100,0,28,28
Raedene,F,100,28,0,28
Raeesah,F,100,28,0,28
Rahmeek,M,100,0,28,28
Raighan,F,100,28,0,28
Rateel,F,100,28,0,28
Rayauna,F,100,28,0,28
Remedios,F,100,28,0,28
Renitta,F,100,28,0,28
Ridhwan,M,100,0,28,28
Rija,F,100,28,0,28
Romondo,M,100,0,28,28
Romya,F,100,28,0,28
Roniece,F,100,28,0,28
Ronneshia,F,100,28,0,28
Rosaelia,F,100,28,0,28
Roselena,F,100,28,0,28
Rozana,F,100,28,0,28
Ruan,M,100,0,28,28
Ruqiya,F,100,28,0,28
Ryett,M,100,0,28,28
Rykia,F,100,28,0,28
Ryman,M,100,0,28,28
Ryott,M,100,0,28,28
Ryusei,M,100,0,28,28
Sabrian,F,100,28,0,28
Sabriana,F,100,28,0,28
Sakhia,F,100,28,0,28
Saksham,M,100,0,28,28
Samaree,F,100,28,0,28
Samaris,F,100,28,0,28
Samhith,M,100,0,28,28
Samijo,F,100,28,0,28
Sanylah,F,100,28,0,28
Saretha,F,100,28,0,28
Satanya,F,100,28,0,28
Satish,M,100,0,28,28
Savannahrose,F,100,28,0,28
Schad,M,100,0,28,28
Senika,F,100,28,0,28
Shabaka,M,100,0,28,28
Shabsi,M,100,0,28,28
Shaelah,F,100,28,0,28
Shahmir,M,100,0,28,28
Shakeelah,F,100,28,0,28
Shalayla,F,100,28,0,28
Shamarah,F,100,28,0,28
Shambrica,F,100,28,0,28
Shango,M,100,0,28,28
Shanni,F,100,28,0,28
Shaqua,F,100,28,0,28
Shaquonna,F,100,28,0,28
Sharima,F,100,28,0,28
Sharonann,F,100,28,0,28
Shellane,F,100,28,0,28
Sheneice,F,100,28,0,28
Sheona,F,100,28,0,28
Sherease,F,100,28,0,28
Shinji,M,100,0,28,28
Shirletta,F,100,28,0,28
Shloak,M,100,0,28,28
Shunita,F,100,28,0,28
Sidh,M,100,0,28,28
Sofee,F,100,28,0,28
Solanch,F,100,28,0,28
Solie,F,100,28,0,28
Soojin,F,100,28,0,28
Sorren,M,100,0,28,28
Spiritual,F,100,28,0,28
Sterlyn,M,100,0,28,28
Stinson,M,100,0,28,28
Suli,F,100,28,0,28
Suliana,F,100,28,0,28
Sunay,M,100,0,28,28
Synae,F,100,28,0,28
Tabethia,F,100,28,0,28
Taff,M,100,0,28,28
Taiasha,F,100,28,0,28
Tailah,F,100,28,0,28
Tailee,F,100,28,0,28
Tamilia,F,100,28,0,28
Tamyla,F,100,28,0,28
Tany,F,100,28,0,28
Tarasa,F,100,28,0,28
Tashanique,F,100,28,0,28
Tavarous,M,100,0,28,28
Teodulo,M,100,0,28,28
Terilee,F,100,28,0,28
Terise,F,100,28,0,28
Ternisha,F,100,28,0,28
Terrial,M,100,0,28,28
Thanos,M,100,0,28,28
Theador,M,100,0,28,28
Thuyvi,F,100,28,0,28
Tiayana,F,100,28,0,28
Tiela,F,100,28,0,28
Tieran,M,79,6,22,28
Tiffaniamber,F,100,28,0,28
Timthy,M,100,0,28,28
Tmia,F,100,28,0,28
Tochukwu,M,100,0,28,28
Tola,F,79,22,6,28
Tracine,F,100,28,0,28
Traiden,M,100,0,28,28
Travina,F,100,28,0,28
Tremone,M,100,0,28,28
Trexton,M,100,0,28,28
Twisha,F,100,28,0,28
Tyani,F,100,28,0,28
Tychicus,M,100,0,28,28
Tyina,F,100,28,0,28
Tyleen,F,100,28,0,28
Tynasha,F,100,28,0,28
Tynette,F,100,28,0,28
Tyniece,F,100,28,0,28
Tywayne,M,100,0,28,28
Ulissa,F,100,28,0,28
Valek,M,100,0,28,28
Valere,F,100,28,0,28
Valeriya,F,100,28,0,28
Vardaan,M,100,0,28,28
Vesa,F,100,28,0,28
Vestal,M,100,0,28,28
Vidyuth,M,100,0,28,28
Vinchenzo,M,100,0,28,28
Virginio,M,100,0,28,28
Wateen,F,100,28,0,28
Waynisha,F,100,28,0,28
Wendye,F,100,28,0,28
Whitny,F,100,28,0,28
Wymon,M,100,0,28,28
Wyndy,F,100,28,0,28
Wyonna,F,100,28,0,28
Xiang,M,100,0,28,28
Yacov,M,100,0,28,28
Yareny,F,100,28,0,28
Yaribeth,F,100,28,0,28
Yasamine,F,100,28,0,28
Yazleemar,F,100,28,0,28
Yewande,F,100,28,0,28
Yohanan,M,100,0,28,28
Yosuke,M,100,0,28,28
Yovanka,F,100,28,0,28
Yovonne,F,100,28,0,28
Yudany,F,100,28,0,28
Yulinda,F,100,28,0,28
Yureli,F,100,28,0,28
Zahn,M,100,0,28,28
Zaily,F,100,28,0,28
Zakory,M,100,0,28,28
Zaman,M,100,0,28,28
Zanijah,F,100,28,0,28
Zaydenn,M,100,0,28,28
Zbigniew,M,100,0,28,28
Zeida,F,100,28,0,28
Zela,F,100,28,0,28
Zhen,M,100,0,28,28
Ziarah,F,100,28,0,28
Zier,M,100,0,28,28
Zoelynn,F,100,28,0,28
Zoeyann,F,100,28,0,28
Zujey,F,100,28,0,28
Aalim,M,100,0,27,27
Aba,F,81,22,5,27
Abba,M,100,0,27,27
Abdelkarim,M,100,0,27,27
Abduallah,M,100,0,27,27
Abdurrahim,M,100,0,27,27
Abey,F,63,17,10,27
Abhigna,F,100,27,0,27
Abigaille,F,100,27,0,27
Abrien,M,100,0,27,27
Adelay,F,100,27,0,27
Adiella,F,100,27,0,27
Adut,F,100,27,0,27
Advith,M,100,0,27,27
Agim,M,100,0,27,27
Ajha,F,100,27,0,27
Ajith,M,100,0,27,27
Akintunde,M,100,0,27,27
Aldridge,M,100,0,27,27
Alexanna,F,100,27,0,27
Aliera,F,100,27,0,27
Alissha,F,100,27,0,27
Alleson,F,100,27,0,27
Alyese,F,100,27,0,27
Amecia,F,100,27,0,27
Amerion,M,100,0,27,27
Amyas,M,100,0,27,27
Anaely,F,100,27,0,27
Anashia,F,100,27,0,27
Anautica,F,100,27,0,27
Anayancy,F,100,27,0,27
Andresha,F,100,27,0,27
Anelie,F,100,27,0,27
Annabellee,F,100,27,0,27
Anney,F,100,27,0,27
Annissia,F,100,27,0,27
Areiana,F,100,27,0,27
Arilene,F,100,27,0,27
Arkan,M,100,0,27,27
Arnab,M,100,0,27,27
Arnes,M,100,0,27,27
Arra,F,100,27,0,27
Ashala,F,100,27,0,27
Ashot,M,100,0,27,27
Asian,F,59,16,11,27
Atrayu,M,100,0,27,27
Atzhiri,F,100,27,0,27
Audrianne,F,100,27,0,27
Aunye,F,100,27,0,27
Avalise,F,100,27,0,27
Avanthika,F,100,27,0,27
Avrumi,M,100,0,27,27
Awesome,M,100,0,27,27
Aydrianna,F,100,27,0,27
Ayleene,F,100,27,0,27
Ayliana,F,100,27,0,27
Azende,M,100,0,27,27
Basmah,F,100,27,0,27
Bayardo,M,100,0,27,27
Bethena,F,100,27,0,27
Bonetta,F,100,27,0,27
Brandylee,F,100,27,0,27
Brehan,F,100,27,0,27
Breyen,M,100,0,27,27
Bronwynn,F,100,27,0,27
Caedance,F,100,27,0,27
Calicia,F,100,27,0,27
Calirose,F,100,27,0,27
Calliah,F,100,27,0,27
Camiryn,F,100,27,0,27
Carene,F,100,27,0,27
Carlecia,F,100,27,0,27
Carwyn,M,100,0,27,27
Cashten,M,100,0,27,27
Cevon,M,100,0,27,27
Chalyce,F,100,27,0,27
Chamique,F,100,27,0,27
Chamira,F,100,27,0,27
Changa,M,100,0,27,27
Chaning,F,52,14,13,27
Chaquille,M,81,5,22,27
Charlana,F,100,27,0,27
Chasney,F,100,27,0,27
Chato,M,100,0,27,27
Chaylen,F,100,27,0,27
Chaylene,F,100,27,0,27
Cherylle,F,100,27,0,27
Chevalier,M,100,0,27,27
Chikamso,F,52,14,13,27
Chinelle,F,100,27,0,27
Chueyee,M,100,0,27,27
Cion,M,100,0,27,27
Conesha,F,100,27,0,27
Coolidge,M,100,0,27,27
Copelan,M,100,0,27,27
Corell,M,100,0,27,27
Cortlen,M,100,0,27,27
Corvon,M,100,0,27,27
Costantino,M,100,0,27,27
Countney,F,100,27,0,27
Coyle,M,100,0,27,27
Crystl,F,100,27,0,27
Curtice,M,100,0,27,27
Cymantha,F,100,27,0,27
Cypher,M,100,0,27,27
Damaiya,F,100,27,0,27
Damariyon,M,100,0,27,27
Damorian,M,100,0,27,27
Danayla,F,100,27,0,27
Daneal,M,78,6,21,27
Daniellie,F,100,27,0,27
Daniels,M,100,0,27,27
Dantez,M,100,0,27,27
Daquez,M,100,0,27,27
Dariyana,F,100,27,0,27
Darletha,F,100,27,0,27
Darnasia,F,100,27,0,27
Dasie,F,100,27,0,27
Datavious,M,100,0,27,27
Davio,M,100,0,27,27
Dawnne,F,100,27,0,27
Deaudra,F,100,27,0,27
Deauntae,M,100,0,27,27
Dekyra,F,100,27,0,27
Demeta,F,100,27,0,27
Demetrik,M,100,0,27,27
Demetriss,F,100,27,0,27
Dequisha,F,100,27,0,27
Dervon,M,100,0,27,27
Derykah,F,100,27,0,27
Desiah,F,100,27,0,27
Desirree,F,100,27,0,27
Deslynn,F,100,27,0,27
Desmona,F,100,27,0,27
Devy,F,100,27,0,27
Dewell,M,100,0,27,27
Dezarea,F,100,27,0,27
Dezarey,F,100,27,0,27
Dezmend,M,100,0,27,27
Diep,F,78,21,6,27
Dimitar,M,100,0,27,27
Dionysius,M,100,0,27,27
Dionysus,M,100,0,27,27
Disiree,F,100,27,0,27
Doe,F,100,27,0,27
Donnajo,F,100,27,0,27
Donquez,M,100,0,27,27
Dregan,M,100,0,27,27
Dylanjames,M,100,0,27,27
Dylanne,F,100,27,0,27
Ebraheem,M,100,0,27,27
Edisson,M,100,0,27,27
Eivan,M,100,0,27,27
Elaf,F,100,27,0,27
Elfreida,F,100,27,0,27
Elii,M,100,0,27,27
Elijahjuan,M,100,0,27,27
Elisiah,M,100,0,27,27
Ellaine,F,100,27,0,27
Ellesyn,F,100,27,0,27
Erdem,M,100,0,27,27
Ervan,M,100,0,27,27
Esben,M,100,0,27,27
Eshanti,F,100,27,0,27
Esmael,M,100,0,27,27
Evaan,M,100,0,27,27
Evadne,F,100,27,0,27
Ezme,F,100,27,0,27
Ezmerelda,F,100,27,0,27
Fode,M,100,0,27,27
Friddie,M,100,0,27,27
Furnell,M,100,0,27,27
Gaspard,M,100,0,27,27
Gelacio,M,100,0,27,27
Geordy,M,100,0,27,27
Georginia,F,100,27,0,27
Giahna,F,100,27,0,27
Gianelly,F,100,27,0,27
Gilana,F,100,27,0,27
Gilroy,M,100,0,27,27
Gineen,F,100,27,0,27
Gizela,F,100,27,0,27
Gohar,F,100,27,0,27
Govinda,M,100,0,27,27
Gowtham,M,100,0,27,27
Gracye,F,100,27,0,27
Greylan,M,100,0,27,27
Gurfateh,M,100,0,27,27
Haran,M,100,0,27,27
Hartman,M,100,0,27,27
Harveer,M,100,0,27,27
Hunberto,M,100,0,27,27
Huzaifah,M,100,0,27,27
Hynlee,F,100,27,0,27
Imar,F,59,16,11,27
Inasia,F,100,27,0,27
Irelynne,F,100,27,0,27
Isamara,F,100,27,0,27
Isamari,F,100,27,0,27
Ishanth,M,100,0,27,27
Issah,M,100,0,27,27
Ivane,F,100,27,0,27
Ixayana,F,100,27,0,27
Izariah,F,100,27,0,27
Jacameron,M,100,0,27,27
Jacolbi,M,100,0,27,27
Jacueline,F,100,27,0,27
Jadus,M,100,0,27,27
Jakarion,M,100,0,27,27
Jakeyla,F,100,27,0,27
Jakylin,M,100,0,27,27
Jaleasa,F,100,27,0,27
Jalexy,F,100,27,0,27
Jamarus,M,100,0,27,27
Jamayra,F,100,27,0,27
Janeanne,F,100,27,0,27
Janvier,F,56,15,12,27
Jasmien,F,100,27,0,27
Jasyiah,F,63,17,10,27
Jaxi,F,100,27,0,27
Jaydalis,F,100,27,0,27
Jaylind,M,100,0,27,27
Jazmond,M,63,10,17,27
Jazzi,F,100,27,0,27
Jediel,M,100,0,27,27
Jeileen,F,100,27,0,27
Jenecia,F,100,27,0,27
Jennarae,F,100,27,0,27
Jerauld,M,100,0,27,27
Jernell,F,81,22,5,27
Jester,M,100,0,27,27
Jhonathon,M,100,0,27,27
Jincy,F,100,27,0,27
Jodan,M,100,0,27,27
Joeliz,F,100,27,0,27
Johnas,M,100,0,27,27
Jomanda,F,100,27,0,27
Jorda,M,100,0,27,27
Jordian,F,100,27,0,27
Josniel,M,100,0,27,27
Jovonn,M,81,5,22,27
Joyleen,F,100,27,0,27
Juarez,M,100,0,27,27
Julayne,F,100,27,0,27
Jurem,M,100,0,27,27
Justinpaul,M,100,0,27,27
Kainani,F,100,27,0,27
Kaleesha,F,100,27,0,27
Kaliopi,F,100,27,0,27
Kamarea,F,100,27,0,27
Kamilly,F,100,27,0,27
Kamini,F,100,27,0,27
Kamyri,F,100,27,0,27
Kandus,F,100,27,0,27
Kanesia,F,100,27,0,27
Kaplan,M,100,0,27,27
Karmesha,F,100,27,0,27
Karneisha,F,100,27,0,27
Kashala,F,100,27,0,27
Kataleia,F,100,27,0,27
Kathaleya,F,100,27,0,27
Katiann,F,100,27,0,27
Katlan,F,100,27,0,27
Katline,F,100,27,0,27
Kayvin,M,100,0,27,27
Keambria,F,100,27,0,27
Keeona,F,100,27,0,27
Keesa,F,100,27,0,27
Kemarri,M,100,0,27,27
Kency,F,81,22,5,27
Keshanda,F,100,27,0,27
Ketron,M,100,0,27,27
Keyanda,F,100,27,0,27
Keyeria,F,100,27,0,27
Keyiana,F,100,27,0,27
Keyonne,M,100,0,27,27
Kezaria,F,100,27,0,27
Khaiya,F,100,27,0,27
Khyson,M,100,0,27,27
Kibibi,F,100,27,0,27
Kitzie,F,100,27,0,27
Kjon,M,100,0,27,27
Kohlby,M,100,0,27,27
Komari,M,100,0,27,27
Koriann,F,100,27,0,27
Krishonda,F,100,27,0,27
Krisztina,F,100,27,0,27
Kuran,M,100,0,27,27
Kurtisha,F,100,27,0,27
Kwanna,F,100,27,0,27
Kyjah,F,100,27,0,27
Lacoria,F,100,27,0,27
Laguita,F,100,27,0,27
Lajasmine,F,100,27,0,27
Lakaysha,F,100,27,0,27
Lakinya,F,100,27,0,27
Laprincess,F,100,27,0,27
Latierra,F,100,27,0,27
Launie,F,100,27,0,27
Laurah,F,100,27,0,27
Lazaya,F,100,27,0,27
Leeda,F,100,27,0,27
Lender,F,100,27,0,27
Lerissa,F,100,27,0,27
Leshan,F,59,16,11,27
Leslian,F,100,27,0,27
Light,M,78,6,21,27
Lillieana,F,100,27,0,27
Lindasy,F,100,27,0,27
Lislie,F,100,27,0,27
Littie,F,100,27,0,27
Livio,M,100,0,27,27
Loriane,F,100,27,0,27
Lorrieann,F,100,27,0,27
Luckie,M,63,10,17,27
Lucyana,F,100,27,0,27
Lum,M,100,0,27,27
Lusila,F,100,27,0,27
Lyani,F,100,27,0,27
Lyli,F,100,27,0,27
Lynk,M,100,0,27,27
Lyzander,M,100,0,27,27
Mackinlee,F,100,27,0,27
Madeira,F,100,27,0,27
Maelena,F,100,27,0,27
Makailynn,F,100,27,0,27
Makinnley,F,100,27,0,27
Malae,F,100,27,0,27
Mandalynn,F,100,27,0,27
Marat,M,100,0,27,27
Mariauna,F,100,27,0,27
Marietherese,F,100,27,0,27
Marixsa,F,100,27,0,27
Markay,F,100,27,0,27
Marqez,M,100,0,27,27
Marsie,F,100,27,0,27
Maylah,F,100,27,0,27
Mayren,F,100,27,0,27
Mekael,M,100,0,27,27
Melakai,M,100,0,27,27
Melica,F,100,27,0,27
Melisaa,F,100,27,0,27
Mellinda,F,100,27,0,27
Melonia,F,100,27,0,27
Miabelle,F,100,27,0,27
Michaelthomas,M,100,0,27,27
Midas,M,100,0,27,27
Miechelle,F,100,27,0,27
Mikali,F,100,27,0,27
Mikaylie,F,100,27,0,27
Milei,F,100,27,0,27
Mitt,M,100,0,27,27
Miyanah,F,100,27,0,27
Monse,F,100,27,0,27
Monteria,F,100,27,0,27
Montrese,F,81,22,5,27
Muntaz,F,100,27,0,27
Muscab,M,100,0,27,27
Musiq,M,63,10,17,27
Myrene,F,100,27,0,27
Nacoma,M,100,0,27,27
Nakayah,F,100,27,0,27
Nakeira,F,100,27,0,27
Nandy,F,100,27,0,27
Nasyah,F,100,27,0,27
Natajia,F,100,27,0,27
Natessa,F,100,27,0,27
Nester,M,100,0,27,27
Nghi,F,81,22,5,27
Nicolino,M,100,0,27,27
Nicollas,M,100,0,27,27
Nijaya,F,100,27,0,27
Nikan,M,100,0,27,27
Nikela,F,100,27,0,27
Ninti,F,100,27,0,27
Nishil,M,100,0,27,27
Nivan,M,100,0,27,27
Nkiruka,F,100,27,0,27
Nkrumah,M,100,0,27,27
Nolon,M,100,0,27,27
Nuriah,F,100,27,0,27
Oather,M,100,0,27,27
Odera,F,52,14,13,27
Okima,F,100,27,0,27
Paigelyn,F,100,27,0,27
Paisely,F,100,27,0,27
Parmis,F,100,27,0,27
Patricha,F,100,27,0,27
Pattianne,F,100,27,0,27
Paylen,F,100,27,0,27
Payzlie,F,100,27,0,27
Pedrito,M,100,0,27,27
Pharoh,M,100,0,27,27
Primavera,F,100,27,0,27
Proctor,M,100,0,27,27
Quaniece,F,100,27,0,27
Quayla,F,100,27,0,27
Qwynn,F,100,27,0,27
Raashida,F,100,27,0,27
Rahsean,M,100,0,27,27
Raimond,M,100,0,27,27
Raiyah,F,100,27,0,27
Ranyla,F,100,27,0,27
Raseel,F,100,27,0,27
Rebba,F,100,27,0,27
Rebcca,F,100,27,0,27
Renasia,F,100,27,0,27
Revia,F,100,27,0,27
Rexene,F,100,27,0,27
Rhaven,F,100,27,0,27
Riayn,F,100,27,0,27
Rice,M,100,0,27,27
Rilda,F,100,27,0,27
Roko,M,100,0,27,27
Romaisa,F,100,27,0,27
Romale,M,100,0,27,27
Romika,F,100,27,0,27
Ronicia,F,100,27,0,27
Rossalyn,F,100,27,0,27
Roxianne,F,100,27,0,27
Rozay,F,59,16,11,27
Rupali,F,100,27,0,27
Sadhika,F,100,27,0,27
Sadielynn,F,100,27,0,27
Saimon,M,100,0,27,27
Samiuela,M,100,0,27,27
Sammara,F,100,27,0,27
Sancia,F,100,27,0,27
Saqqara,F,100,27,0,27
Sarahjo,F,100,27,0,27
Satasha,F,100,27,0,27
Senecca,M,100,0,27,27
Senequa,F,100,27,0,27
Seraj,M,100,0,27,27
Serendipity,F,100,27,0,27
Sevaeh,F,100,27,0,27
Shally,F,100,27,0,27
Shalya,F,100,27,0,27
Shandia,F,100,27,0,27
Shaniquea,F,100,27,0,27
Shanygne,F,100,27,0,27
Shealin,F,100,27,0,27
Shemariah,F,100,27,0,27
Shinequa,F,100,27,0,27
Shravani,F,100,27,0,27
Shyannah,F,100,27,0,27
Shykela,F,100,27,0,27
Silje,F,100,27,0,27
Sirita,F,100,27,0,27
Sirmichael,M,100,0,27,27
Skylon,M,100,0,27,27
Skylr,F,59,16,11,27
Sondrea,F,100,27,0,27
Soryn,F,63,17,10,27
Sosefina,F,100,27,0,27
Sra,F,100,27,0,27
Stevanna,F,100,27,0,27
Svanik,M,100,0,27,27
Tabaitha,F,100,27,0,27
Tabresha,F,100,27,0,27
Taionna,F,100,27,0,27
Taitiana,F,100,27,0,27
Takeena,F,100,27,0,27
Tampatha,F,100,27,0,27
Tanijha,F,100,27,0,27
Tashenna,F,100,27,0,27
Tassy,F,100,27,0,27
Taurence,M,100,0,27,27
Tawhid,M,100,0,27,27
Tayde,F,81,22,5,27
Taylea,F,100,27,0,27
Tekiyah,F,100,27,0,27
Tenly,F,100,27,0,27
Thade,M,100,0,27,27
Timmesha,F,100,27,0,27
Tione,F,56,15,12,27
Ton,M,100,0,27,27
Tonnisha,F,100,27,0,27
Towan,M,100,0,27,27
Trevina,F,100,27,0,27
Trevonna,F,100,27,0,27
Tripper,M,100,0,27,27
Trysha,F,100,27,0,27
Tyasiah,F,100,27,0,27
Tylere,M,100,0,27,27
Tyshonda,F,100,27,0,27
Tzuriel,M,100,0,27,27
Valenda,F,100,27,0,27
Vedia,F,100,27,0,27
Venette,F,100,27,0,27
Verlina,F,100,27,0,27
Viany,F,100,27,0,27
Vidia,F,100,27,0,27
Vitalina,F,100,27,0,27
Wadie,M,100,0,27,27
Waller,M,100,0,27,27
Weylyn,M,100,0,27,27
Willoe,F,100,27,0,27
Wilner,M,100,0,27,27
Wimberly,F,100,27,0,27
Winner,F,59,16,11,27
Wisin,M,100,0,27,27
Xao,M,100,0,27,27
Xotchil,F,100,27,0,27
Yalixa,F,100,27,0,27
Yaraliz,F,100,27,0,27
Yasheika,F,100,27,0,27
Yerin,F,100,27,0,27
Yeslie,F,100,27,0,27
Yiming,M,100,0,27,27
Yoshida,F,100,27,0,27
Zacarius,M,100,0,27,27
Zacharay,M,100,0,27,27
Zadan,M,100,0,27,27
Zadien,M,100,0,27,27
Zanari,F,100,27,0,27
Zandre,M,100,0,27,27
Zandyn,M,100,0,27,27
Zarra,F,100,27,0,27
Zatoria,F,100,27,0,27
Zaydi,F,100,27,0,27
Zimora,F,100,27,0,27
Zishan,M,100,0,27,27
Zuriya,F,100,27,0,27
Aaditri,F,100,26,0,26
Aadvik,M,100,0,26,26
Aarnavi,F,100,26,0,26
Abdulqadir,M,100,0,26,26
Abrigail,F,100,26,0,26
Accacia,F,100,26,0,26
Acura,F,100,26,0,26
Adabel,F,100,26,0,26
Adarah,F,100,26,0,26
Addilyne,F,100,26,0,26
Ademide,M,81,5,21,26
Adryn,M,77,6,20,26
Aeddon,M,100,0,26,26
Aeliana,F,100,26,0,26
Afeni,F,100,26,0,26
Ahadu,M,100,0,26,26
Aimme,F,100,26,0,26
Aiydan,M,100,0,26,26
Akeba,F,100,26,0,26
Aladino,M,100,0,26,26
Alainnah,F,100,26,0,26
Alasiah,F,100,26,0,26
Alhassane,M,100,0,26,26
Alyan,M,100,0,26,26
Alyeska,F,100,26,0,26
Alyisa,F,100,26,0,26
Amierah,F,100,26,0,26
Amitiel,F,100,26,0,26
Amod,M,100,0,26,26
Angelyca,F,100,26,0,26
Angelynne,F,100,26,0,26
Aniruddha,M,100,0,26,26
Annan,M,100,0,26,26
Annecia,F,100,26,0,26
Annleigh,F,100,26,0,26
Antonise,F,100,26,0,26
Anyka,F,100,26,0,26
Apache,M,62,10,16,26
Arata,M,100,0,26,26
Arenda,F,100,26,0,26
Ariellah,F,100,26,0,26
Arij,F,100,26,0,26
Arkeisha,F,100,26,0,26
Arkesha,F,100,26,0,26
Arloa,F,100,26,0,26
Asan,M,100,0,26,26
Asana,F,100,26,0,26
Ashita,F,100,26,0,26
Atalee,F,100,26,0,26
Audrick,M,100,0,26,26
Aundrae,M,100,0,26,26
Avelin,F,100,26,0,26
Aymaan,M,100,0,26,26
Ayushman,M,100,0,26,26
Baboucarr,M,100,0,26,26
Banelly,F,100,26,0,26
Barndon,M,100,0,26,26
Bartolome,M,100,0,26,26
Baylan,M,100,0,26,26
Bayro,M,100,0,26,26
Beeta,F,100,26,0,26
Bernal,M,100,0,26,26
Beunka,F,100,26,0,26
Bisceglia,F,100,26,0,26
Blaikley,F,100,26,0,26
Bobbiesue,F,100,26,0,26
Braxtan,M,100,0,26,26
Brenndon,M,100,0,26,26
Breseis,F,100,26,0,26
Bridges,M,100,0,26,26
Brindon,M,100,0,26,26
Bryheem,M,100,0,26,26
Cacia,F,100,26,0,26
Camill,F,100,26,0,26
Cammron,M,100,0,26,26
Caprecia,F,100,26,0,26
Carisse,F,100,26,0,26
Carleisha,F,100,26,0,26
Carrel,M,100,0,26,26
Cassanova,M,100,0,26,26
Cateleya,F,100,26,0,26
Cecili,F,100,26,0,26
Cedrianna,F,100,26,0,26
Cedrina,F,100,26,0,26
Chalina,F,100,26,0,26
Chardonae,F,100,26,0,26
Chardonnae,F,100,26,0,26
Charlicia,F,100,26,0,26
Chastina,F,100,26,0,26
Chatherine,F,100,26,0,26
Chatney,F,100,26,0,26
Cheenou,M,100,0,26,26
Chereen,F,100,26,0,26
Chiqueta,F,100,26,0,26
Christinejoy,F,100,26,0,26
Christinemarie,F,100,26,0,26
Chyvonne,F,100,26,0,26
Cierre,F,100,26,0,26
Claudeen,F,100,26,0,26
Colsten,M,100,0,26,26
Copelyn,F,100,26,0,26
Corinthians,M,100,0,26,26
Cortisha,F,100,26,0,26
Cowanda,F,100,26,0,26
Cybelle,F,100,26,0,26
Cyria,F,100,26,0,26
Daiyaan,M,100,0,26,26
Dakeem,M,100,0,26,26
Dalles,M,100,0,26,26
Damius,M,100,0,26,26
Daniece,F,100,26,0,26
Dannan,F,100,26,0,26
Daphni,F,100,26,0,26
Daveen,F,100,26,0,26
Daveona,F,100,26,0,26
Dayza,F,100,26,0,26
Deadria,F,100,26,0,26
Deaton,M,100,0,26,26
Deforrest,M,100,0,26,26
Dejuane,M,100,0,26,26
Dekhari,M,100,0,26,26
Demaj,M,100,0,26,26
Demaury,M,100,0,26,26
Demetree,M,100,0,26,26
Demorian,M,100,0,26,26
Demorion,M,100,0,26,26
Demyiah,F,100,26,0,26
Denaria,F,100,26,0,26
Denayah,F,100,26,0,26
Denesa,F,100,26,0,26
Dent,M,100,0,26,26
Desja,F,100,26,0,26
Detroit,M,100,0,26,26
Detwan,M,100,0,26,26
Deveda,F,100,26,0,26
Deztini,F,100,26,0,26
Donnamae,F,100,26,0,26
Donnett,F,100,26,0,26
Donnivin,M,100,0,26,26
Donterio,M,100,0,26,26
Dorothia,F,100,26,0,26
Dupri,M,100,0,26,26
Dyeisha,F,100,26,0,26
Dylanger,M,100,0,26,26
Dyonne,F,100,26,0,26
Edbert,M,100,0,26,26
Ederson,M,100,0,26,26
Elizandra,F,100,26,0,26
Elnita,F,100,26,0,26
Elvita,F,100,26,0,26
Emmasophia,F,100,26,0,26
Emmeri,F,100,26,0,26
Emperatriz,F,100,26,0,26
Emron,M,100,0,26,26
Erasmus,M,100,0,26,26
Ericsson,M,100,0,26,26
Ermila,F,100,26,0,26
Eulalie,F,100,26,0,26
Ezreal,M,100,0,26,26
Fayne,F,58,15,11,26
Ferry,M,62,10,16,26
Flordia,F,100,26,0,26
Franisco,M,100,0,26,26
Fredys,M,100,0,26,26
Garbiel,M,100,0,26,26
Gela,F,100,26,0,26
Genera,F,100,26,0,26
Genesha,F,100,26,0,26
Geonni,M,100,0,26,26
Geovonnie,M,100,0,26,26
Gerre,F,100,26,0,26
Gidgett,F,100,26,0,26
Giorgina,F,100,26,0,26
Gleda,F,100,26,0,26
Glenise,F,100,26,0,26
Goretti,F,100,26,0,26
Grainger,M,100,0,26,26
Gregeory,M,100,0,26,26
Gudalupe,F,81,21,5,26
Gudrun,F,100,26,0,26
Gurinder,M,100,0,26,26
Gursimran,F,77,20,6,26
Gwendylan,F,100,26,0,26
Haidin,M,81,5,21,26
Hailen,F,100,26,0,26
Haileymarie,F,100,26,0,26
Haizlee,F,100,26,0,26
Hamze,M,100,0,26,26
Hawi,F,100,26,0,26
Hawwa,F,100,26,0,26
Haydenn,F,77,20,6,26
Helon,F,100,26,0,26
Herlin,M,100,0,26,26
Hollen,F,100,26,0,26
Holman,M,100,0,26,26
Htoo,M,100,0,26,26
Hydi,F,100,26,0,26
Ibaad,M,100,0,26,26
Ices,F,100,26,0,26
Imaria,F,100,26,0,26
Iniyan,M,100,0,26,26
Ishea,F,100,26,0,26
Issabel,F,100,26,0,26
Itzela,F,100,26,0,26
Jaalah,F,100,26,0,26
Jabraylen,M,100,0,26,26
Jadaliz,F,100,26,0,26
Jaffar,M,100,0,26,26
Jaffet,M,100,0,26,26
Jakyree,M,100,0,26,26
Jaleiya,F,100,26,0,26
Jamaika,F,100,26,0,26
Jamary,M,81,5,21,26
Jamisa,F,100,26,0,26
Janeira,F,100,26,0,26
Janeisy,F,100,26,0,26
Jaqueta,F,100,26,0,26
Jaretsy,F,100,26,0,26
Jarlene,F,100,26,0,26
Jaruis,M,100,0,26,26
Jasmir,M,77,6,20,26
Jasmonique,F,100,26,0,26
Jatasha,F,100,26,0,26
Jaydiel,M,100,0,26,26
Jayzion,M,100,0,26,26
Jeanelly,F,100,26,0,26
Jeanmichael,M,100,0,26,26
Jekia,F,100,26,0,26
Jeremya,M,73,7,19,26
Jeru,M,100,0,26,26
Jesabel,F,100,26,0,26
Jevonne,F,100,26,0,26
Jiancarlo,M,100,0,26,26
Jiho,M,100,0,26,26
Jimisha,F,100,26,0,26
Johnaven,M,100,0,26,26
Johnene,F,100,26,0,26
Jonatham,M,100,0,26,26
Jonnisha,F,100,26,0,26
Jonnita,F,100,26,0,26
Josejavier,M,100,0,26,26
Jovia,F,100,26,0,26
Jyrin,M,100,0,26,26
Kabren,M,100,0,26,26
Kadashia,F,100,26,0,26
Kaelub,M,100,0,26,26
Kahlid,M,100,0,26,26
Kahlynn,F,100,26,0,26
Kahseem,M,100,0,26,26
Kainon,M,100,0,26,26
Kaiyen,M,100,0,26,26
Kajon,M,100,0,26,26
Kaladin,M,100,0,26,26
Kaleef,M,100,0,26,26
Kamelah,F,100,26,0,26
Kamyrn,F,100,26,0,26
Kannin,M,100,0,26,26
Kanyen,M,81,5,21,26
Karalena,F,100,26,0,26
Karensa,F,100,26,0,26
Karleena,F,100,26,0,26
Karyzma,F,100,26,0,26
Kasimir,M,100,0,26,26
Kateisha,F,100,26,0,26
Katin,M,77,6,20,26
Kavell,M,100,0,26,26
Kawther,F,100,26,0,26
Kayten,F,100,26,0,26
Kazmira,F,100,26,0,26
Kealon,M,100,0,26,26
Keaon,M,100,0,26,26
Keedra,F,100,26,0,26
Keeshon,M,100,0,26,26
Kemaurion,M,100,0,26,26
Kentae,M,100,0,26,26
Kentara,F,100,26,0,26
Kevonn,M,100,0,26,26
Khadajah,F,100,26,0,26
Khamir,M,100,0,26,26
Khisha,F,100,26,0,26
Khrystyn,F,100,26,0,26
Kiayla,F,100,26,0,26
Kieva,F,100,26,0,26
Kimore,F,100,26,0,26
Kindy,F,100,26,0,26
Kinnidi,F,100,26,0,26
Kinslei,F,100,26,0,26
Kiralynn,F,100,26,0,26
Kirstien,F,100,26,0,26
Kishara,F,81,21,5,26
Koryna,F,100,26,0,26
Kreighton,M,100,0,26,26
Kunte,M,100,0,26,26
Kwmane,M,100,0,26,26
Kyila,F,100,26,0,26
Kylisha,F,100,26,0,26
Lachlyn,F,100,26,0,26
Ladaria,F,100,26,0,26
Laelyn,F,100,26,0,26
Lafredrick,M,100,0,26,26
Laguan,M,100,0,26,26
Lajavion,M,100,0,26,26
Lakeicha,F,100,26,0,26
Lancy,M,100,0,26,26
Lanicia,F,100,26,0,26
Laryan,M,100,0,26,26
Lashaune,F,100,26,0,26
Latechia,F,100,26,0,26
Latianna,F,100,26,0,26
Latrinia,F,100,26,0,26
Lavondra,F,100,26,0,26
Lawrenc,M,100,0,26,26
Layleen,F,100,26,0,26
Lebrandon,M,100,0,26,26
Lecil,M,100,0,26,26
Leileen,F,100,26,0,26
Lemarr,M,100,0,26,26
Lemia,F,100,26,0,26
Leshell,F,100,26,0,26
Levontae,M,100,0,26,26
Levora,F,100,26,0,26
Lilandra,F,100,26,0,26
Lillynn,F,100,26,0,26
Lindan,M,100,0,26,26
Litonya,F,100,26,0,26
Lluliana,F,100,26,0,26
Loch,M,100,0,26,26
Lova,F,100,26,0,26
Lucion,M,100,0,26,26
Lucyanna,F,100,26,0,26
Luvina,F,100,26,0,26
Lyberty,F,100,26,0,26
Lyubov,F,100,26,0,26
Mabrie,F,100,26,0,26
Macii,F,100,26,0,26
Mackinzi,F,100,26,0,26
Madysn,F,100,26,0,26
Maesa,F,100,26,0,26
Mahelet,F,100,26,0,26
Maiara,F,100,26,0,26
Majer,M,100,0,26,26
Makhaila,F,100,26,0,26
Malayka,F,100,26,0,26
Manaya,F,100,26,0,26
Maraina,F,100,26,0,26
Marcellia,F,100,26,0,26
Marinn,F,100,26,0,26
Markenzie,F,100,26,0,26
Martini,F,100,26,0,26
Martis,M,100,0,26,26
Martrez,M,100,0,26,26
Marueen,F,100,26,0,26
Marykaye,F,100,26,0,26
Masood,M,100,0,26,26
Matrim,M,100,0,26,26
Mattigan,F,100,26,0,26
Mauren,F,100,26,0,26
Maveryk,M,100,0,26,26
Maxymilian,M,100,0,26,26
Mayuko,F,100,26,0,26
Melvis,M,58,11,15,26
Mic,M,100,0,26,26
Mikayel,M,100,0,26,26
Mischel,F,100,26,0,26
Mkai,M,100,0,26,26
Moices,M,100,0,26,26
Mollyanne,F,100,26,0,26
Moneke,F,100,26,0,26
Monye,F,100,26,0,26
Mordcha,M,100,0,26,26
Moxon,M,100,0,26,26
Murilo,M,100,0,26,26
Myricle,F,100,26,0,26
Nadyia,F,100,26,0,26
Nakisa,F,100,26,0,26
Nalen,M,100,0,26,26
Namirah,F,100,26,0,26
Nandhini,F,100,26,0,26
Narah,F,100,26,0,26
Narcedalia,F,100,26,0,26
Narvel,M,100,0,26,26
Nasair,M,100,0,26,26
Nashelle,F,100,26,0,26
Nashoba,M,100,0,26,26
Nashwan,M,100,0,26,26
Nasyr,M,100,0,26,26
Natea,F,100,26,0,26
Naun,M,100,0,26,26
Nayalee,F,100,26,0,26
Nektarios,M,100,0,26,26
Neno,M,100,0,26,26
Nethania,F,100,26,0,26
Neveaha,F,100,26,0,26
Nialani,F,100,26,0,26
Nieka,F,100,26,0,26
Nimue,F,100,26,0,26
Nivaya,F,100,26,0,26
Noan,M,100,0,26,26
Nore,M,81,5,21,26
Noreene,F,100,26,0,26
Nykeba,F,100,26,0,26
Obada,M,100,0,26,26
Obet,M,100,0,26,26
Ohara,F,77,20,6,26
Oluwapelumi,M,58,11,15,26
Ommar,M,100,0,26,26
Omotayo,M,62,10,16,26
Onyinye,F,100,26,0,26
Paislynn,F,100,26,0,26
Patresa,F,100,26,0,26
Perryn,M,77,6,20,26
Petey,M,100,0,26,26
Phenicia,F,100,26,0,26
Plato,M,100,0,26,26
Press,M,100,0,26,26
Quaniqua,F,100,26,0,26
Quinya,F,100,26,0,26
Qunesha,F,100,26,0,26
Raeah,F,100,26,0,26
Raelen,F,100,26,0,26
Raemond,M,100,0,26,26
Raevan,F,100,26,0,26
Raidan,M,100,0,26,26
Rameez,M,100,0,26,26
Rashanti,F,100,26,0,26
Raynen,M,100,0,26,26
Raynna,F,100,26,0,26
Rayshod,M,100,0,26,26
Razeen,M,100,0,26,26
Rececca,F,100,26,0,26
Redd,M,100,0,26,26
Redrick,M,100,0,26,26
Regal,M,100,0,26,26
Regenna,F,100,26,0,26
Reileigh,F,100,26,0,26
Rejean,M,69,8,18,26
Renoda,F,100,26,0,26
Rhakeem,M,100,0,26,26
Rhamel,M,100,0,26,26
Rickea,F,100,26,0,26
Rinad,F,100,26,0,26
Riott,M,100,0,26,26
Romane,M,100,0,26,26
Roye,M,100,0,26,26
Rus,F,58,15,11,26
Rusten,M,100,0,26,26
Ryeisha,F,100,26,0,26
Saana,F,100,26,0,26
Sahni,F,100,26,0,26
Sakyra,F,100,26,0,26
Salmai,F,100,26,0,26
Samory,M,100,0,26,26
Sanantha,F,100,26,0,26
Sanath,M,100,0,26,26
Sarann,F,100,26,0,26
Sarela,F,100,26,0,26
Saresa,F,100,26,0,26
Sayd,M,100,0,26,26
Secoya,F,100,26,0,26
Semajah,F,100,26,0,26
Semeka,F,100,26,0,26
Serentiy,F,100,26,0,26
Shadiamon,F,100,26,0,26
Shadora,F,100,26,0,26
Shalecia,F,100,26,0,26
Shalesha,F,100,26,0,26
Shalitha,F,100,26,0,26
Shanade,F,100,26,0,26
Shanean,F,100,26,0,26
Shantise,F,100,26,0,26
Shaqueen,F,100,26,0,26
Shaqunna,F,100,26,0,26
Shardonnay,F,100,26,0,26
Sharli,F,100,26,0,26
Sharvon,F,100,26,0,26
Shata,F,100,26,0,26
Shatiera,F,100,26,0,26
Shauntice,F,100,26,0,26
Shayd,M,100,0,26,26
Sheenamarie,F,100,26,0,26
Sherlock,M,100,0,26,26
Sherylyn,F,100,26,0,26
Shingo,M,100,0,26,26
Shintaro,M,100,0,26,26
Shmar,M,100,0,26,26
Shrinidhi,F,100,26,0,26
Shuwanda,F,100,26,0,26
Sinceer,M,58,11,15,26
Smanatha,F,100,26,0,26
Sorrell,M,100,0,26,26
Sothea,M,69,8,18,26
Sreeya,F,100,26,0,26
Stevanie,F,100,26,0,26
Stevette,F,100,26,0,26
Stevphen,M,100,0,26,26
Sumaira,F,100,26,0,26
Sundari,F,100,26,0,26
Syeeda,F,100,26,0,26
Synovia,F,100,26,0,26
Synquis,F,100,26,0,26
Syri,F,100,26,0,26
Tabbie,F,100,26,0,26
Tahiya,F,100,26,0,26
Tajiri,M,100,0,26,26
Takishia,F,100,26,0,26
Tanaisa,F,100,26,0,26
Tanyeka,F,100,26,0,26
Tanyjah,F,100,26,0,26
Tarian,M,100,0,26,26
Tathiana,F,100,26,0,26
Tavist,M,100,0,26,26
Thaina,F,100,26,0,26
Thonda,F,100,26,0,26
Tiarnan,M,100,0,26,26
Tijuanna,F,100,26,0,26
Tineisha,F,100,26,0,26
Tiziano,M,100,0,26,26
Toderick,M,100,0,26,26
Tongia,F,100,26,0,26
Toral,F,100,26,0,26
Traca,F,100,26,0,26
Trania,F,100,26,0,26
Travyon,M,100,0,26,26
Trenay,F,100,26,0,26
Treygan,M,100,0,26,26
Trinesha,F,100,26,0,26
Triumph,M,100,0,26,26
Tyaisa,F,100,26,0,26
Tyaja,F,100,26,0,26
Tyli,F,100,26,0,26
Tyshara,F,100,26,0,26
Vaibhavi,F,100,26,0,26
Valire,F,100,26,0,26
Vernique,F,100,26,0,26
Vicenzo,M,100,0,26,26
Virgal,M,100,0,26,26
Virginie,F,100,26,0,26
Weena,F,100,26,0,26
Windee,F,100,26,0,26
Xariyah,F,100,26,0,26
Xavianna,F,100,26,0,26
Yaireth,F,100,26,0,26
Yalina,F,100,26,0,26
Yanine,F,100,26,0,26
Yanitzia,F,100,26,0,26
Yasmean,F,100,26,0,26
Ye,F,62,16,10,26
Yetzael,M,100,0,26,26
Yleana,F,100,26,0,26
Yonny,M,100,0,26,26
Yorleni,F,100,26,0,26
Yosbel,M,100,0,26,26
Yozelin,F,100,26,0,26
Yudi,F,100,26,0,26
Yulma,F,100,26,0,26
Yuzuki,F,100,26,0,26
Zacara,F,100,26,0,26
Zaidon,M,100,0,26,26
Zamarius,M,100,0,26,26
Zamon,M,100,0,26,26
Zeana,F,100,26,0,26
Zephen,M,100,0,26,26
Zequan,M,100,0,26,26
Zeruiah,F,100,26,0,26
Zobeida,F,100,26,0,26
Zohie,F,100,26,0,26
Zyanah,F,100,26,0,26
Aalycia,F,100,25,0,25
Abdulazeez,M,100,0,25,25
Adalen,F,100,25,0,25
Addisin,F,100,25,0,25
Adrial,M,100,0,25,25
Afolabi,M,100,0,25,25
Agasthya,M,100,0,25,25
Ahlias,M,100,0,25,25
Ahmier,M,100,0,25,25
Aitza,F,100,25,0,25
Ajaylah,F,100,25,0,25
Akailah,F,100,25,0,25
Akevia,F,100,25,0,25
Akxel,M,100,0,25,25
Aleashia,F,100,25,0,25
Alexader,M,100,0,25,25
Alishan,M,100,0,25,25
Allexandra,F,100,25,0,25
Allizzon,F,100,25,0,25
Almedin,M,100,0,25,25
Alyis,M,100,0,25,25
Alyxia,F,100,25,0,25
Amajah,F,100,25,0,25
Amonee,F,100,25,0,25
Amunet,F,100,25,0,25
Anacamila,F,100,25,0,25
Anarose,F,100,25,0,25
Andan,M,100,0,25,25
Andrean,F,80,20,5,25
Andrene,F,100,25,0,25
Angelese,F,100,25,0,25
Angellena,F,100,25,0,25
Annaalicia,F,100,25,0,25
Annaley,F,100,25,0,25
Annanicole,F,100,25,0,25
Annelis,F,100,25,0,25
Anneta,F,100,25,0,25
Anslea,F,100,25,0,25
Antoinique,F,100,25,0,25
Antronette,F,100,25,0,25
Aquia,F,100,25,0,25
Aravis,F,100,25,0,25
Arbaz,M,100,0,25,25
Arceli,F,100,25,0,25
Areia,F,100,25,0,25
Arjenis,M,100,0,25,25
Armonni,F,100,25,0,25
Aroosh,F,80,20,5,25
Arriella,F,100,25,0,25
Arris,M,100,0,25,25
Ashanae,F,100,25,0,25
Astara,F,100,25,0,25
Aubrieanna,F,100,25,0,25
Aurore,F,100,25,0,25
Avella,F,100,25,0,25
Avneesh,M,100,0,25,25
Avontay,M,100,0,25,25
Aye,F,100,25,0,25
Ayrionna,F,100,25,0,25
Azita,F,100,25,0,25
Barbarella,F,100,25,0,25
Belden,M,100,0,25,25
Belky,F,100,25,0,25
Benecia,F,100,25,0,25
Benyam,M,100,0,25,25
Biancca,F,100,25,0,25
Bismarck,M,100,0,25,25
Blace,M,100,0,25,25
Blaydon,M,100,0,25,25
Bodhin,M,100,0,25,25
Bojan,M,100,0,25,25
Boneta,F,100,25,0,25
Bracyn,M,100,0,25,25
Branesha,F,100,25,0,25
Briaja,F,100,25,0,25
Briceidy,F,100,25,0,25
Brijette,F,100,25,0,25
Briyelle,F,100,25,0,25
Brunette,F,100,25,0,25
Canei,F,100,25,0,25
Cansas,F,100,25,0,25
Carbon,M,100,0,25,25
Carice,F,100,25,0,25
Caricia,F,100,25,0,25
Carlaysia,F,100,25,0,25
Carless,M,100,0,25,25
Cassiah,F,100,25,0,25
Caysin,M,100,0,25,25
Chadron,M,100,0,25,25
Chaisty,F,100,25,0,25
Chakera,F,100,25,0,25
Champaine,F,100,25,0,25
Chandar,M,52,12,13,25
Chanston,M,100,0,25,25
Charliene,F,100,25,0,25
Cheyton,M,100,0,25,25
Christofher,M,100,0,25,25
Chrsitina,F,100,25,0,25
Chrystyna,F,100,25,0,25
Chynia,F,100,25,0,25
Claria,F,100,25,0,25
Colsyn,M,100,0,25,25
Coralis,F,100,25,0,25
Corenna,F,100,25,0,25
Corielle,F,100,25,0,25
Coua,F,100,25,0,25
Council,M,100,0,25,25
Courey,M,100,0,25,25
Cruize,M,100,0,25,25
Cruse,M,100,0,25,25
Cyaira,F,100,25,0,25
Daemond,M,100,0,25,25
Daeon,M,100,0,25,25
Dairyn,F,100,25,0,25
Dajonna,F,100,25,0,25
Dakoata,M,100,0,25,25
Daneah,F,100,25,0,25
Danequa,F,100,25,0,25
Daniyel,M,100,0,25,25
Danyalle,F,100,25,0,25
Darbey,F,100,25,0,25
Dasany,F,100,25,0,25
Datha,F,100,25,0,25
Dawnie,F,100,25,0,25
Dayamin,F,100,25,0,25
Daycen,M,100,0,25,25
Ddnna,F,100,25,0,25
Deatrick,M,100,0,25,25
Delvia,F,100,25,0,25
Demery,F,80,20,5,25
Demontrey,M,100,0,25,25
Denahi,M,100,0,25,25
Deresha,F,100,25,0,25
Deria,F,100,25,0,25
Deriah,F,100,25,0,25
Deronta,M,100,0,25,25
Devinity,F,100,25,0,25
Devrick,M,100,0,25,25
Dijohn,M,100,0,25,25
Dillynn,F,100,25,0,25
Dnaya,F,100,25,0,25
Domminic,M,100,0,25,25
Donnal,M,100,0,25,25
Dreah,F,100,25,0,25
Duain,M,100,0,25,25
Dujuana,F,100,25,0,25
Dwann,M,80,5,20,25
Dymonique,F,100,25,0,25
Dywan,M,100,0,25,25
Earnstine,F,100,25,0,25
Ecker,M,100,0,25,25
Eliyanah,F,100,25,0,25
Elizabe,F,100,25,0,25
Elliyana,F,100,25,0,25
Enyia,F,100,25,0,25
Erene,F,100,25,0,25
Erva,F,100,25,0,25
Essey,M,100,0,25,25
Evalyne,F,100,25,0,25
Faisa,F,100,25,0,25
Falonda,F,100,25,0,25
Fateema,F,100,25,0,25
Feng,M,100,0,25,25
Frayda,F,100,25,0,25
Fritzie,F,100,25,0,25
Gabina,F,100,25,0,25
Gabirel,M,100,0,25,25
Galiana,F,100,25,0,25
Galiyah,F,100,25,0,25
Ganiya,F,100,25,0,25
Gilead,M,100,0,25,25
Gloriajean,F,100,25,0,25
Graylee,F,100,25,0,25
Gustavia,F,100,25,0,25
Haleh,F,100,25,0,25
Harbour,F,80,20,5,25
Hariharan,M,100,0,25,25
Hayvn,F,100,25,0,25
Hebron,M,80,5,20,25
Helmuth,M,100,0,25,25
Hewan,F,100,25,0,25
Himanshu,M,100,0,25,25
Hooper,M,100,0,25,25
Ilayna,F,100,25,0,25
Ineke,F,100,25,0,25
Ingry,F,100,25,0,25
Iquan,M,100,0,25,25
Ireri,F,100,25,0,25
Ishraq,M,100,0,25,25
Izaeah,M,100,0,25,25
Izais,M,100,0,25,25
Izelle,F,100,25,0,25
Jacks,M,100,0,25,25
Jadora,F,100,25,0,25
Jagan,M,100,0,25,25
Jagr,M,100,0,25,25
Jahlin,M,100,0,25,25
Jahliya,F,100,25,0,25
Jahmali,M,100,0,25,25
Jahmi,M,100,0,25,25
Jahnna,F,100,25,0,25
Jahsier,M,100,0,25,25
Jaiannah,F,100,25,0,25
Jainil,M,100,0,25,25
Jakayah,F,100,25,0,25
Jakea,F,100,25,0,25
Jakila,F,100,25,0,25
Jakoda,M,100,0,25,25
Jalun,M,100,0,25,25
Jamariona,F,100,25,0,25
Janaja,F,100,25,0,25
Janlucas,M,100,0,25,25
Janorris,M,100,0,25,25
Jansyn,F,100,25,0,25
Jarratt,M,100,0,25,25
Jarule,M,100,0,25,25
Jatanna,F,100,25,0,25
Jaterria,F,100,25,0,25
Jaunice,F,100,25,0,25
Jaycek,M,100,0,25,25
Jayceona,F,100,25,0,25
Jazirah,F,100,25,0,25
Jazzlynne,F,100,25,0,25
Jeanella,F,100,25,0,25
Jebron,M,100,0,25,25
Jeffer,M,100,0,25,25
Jeniva,F,100,25,0,25
Jentrie,F,100,25,0,25
Jephte,M,100,0,25,25
Jharline,F,100,25,0,25
Jhovanni,M,100,0,25,25
Jino,M,100,0,25,25
Jitzel,F,100,25,0,25
Jonahs,M,100,0,25,25
Jonathanmichael,M,100,0,25,25
Jonathn,M,100,0,25,25
Jordaan,M,100,0,25,25
Joretha,F,100,25,0,25
Josedavid,M,100,0,25,25
Jouri,F,100,25,0,25
Judithe,F,100,25,0,25
Junnie,F,100,25,0,25
Juvens,M,100,0,25,25
Jynessa,F,100,25,0,25
Kadejia,F,100,25,0,25
Kaillou,M,100,0,25,25
Kaleaha,F,100,25,0,25
Kaliyana,F,100,25,0,25
Kandrea,F,100,25,0,25
Kaos,M,100,0,25,25
Kap,M,100,0,25,25
Katenia,F,100,25,0,25
Katleyn,F,100,25,0,25
Kaveion,M,100,0,25,25
Kawaii,F,100,25,0,25
Kayleigha,F,100,25,0,25
Kdynce,F,100,25,0,25
Ke,M,100,0,25,25
Keaire,F,60,15,10,25
Keerti,F,100,25,0,25
Keif,M,100,0,25,25
Keilie,F,100,25,0,25
Keitlyn,F,100,25,0,25
Keiwan,M,100,0,25,25
Kelce,F,100,25,0,25
Kelisa,F,100,25,0,25
Kentasia,F,100,25,0,25
Kentleigh,F,100,25,0,25
Kenzlei,F,100,25,0,25
Kerriana,F,100,25,0,25
Keylei,F,100,25,0,25
Khadedra,F,100,25,0,25
Khadesha,F,100,25,0,25
Khadesia,F,100,25,0,25
Khail,M,100,0,25,25
Khane,M,100,0,25,25
Khaylah,F,100,25,0,25
Khelsey,F,100,25,0,25
Khyon,M,100,0,25,25
Kiaeem,M,100,0,25,25
Kinberli,F,100,25,0,25
Kinli,F,100,25,0,25
Kinna,F,100,25,0,25
Kipten,M,100,0,25,25
Kirkpatrick,M,100,0,25,25
Kirpa,F,100,25,0,25
Kisty,F,100,25,0,25
Klowie,F,100,25,0,25
Koey,F,100,25,0,25
Kohlman,M,100,0,25,25
Krisalynn,F,100,25,0,25
Kristhian,M,100,0,25,25
Kristiona,F,100,25,0,25
Kriz,M,100,0,25,25
Kruse,M,100,0,25,25
Kyelee,F,100,25,0,25
Kylo,M,100,0,25,25
Labryan,M,100,0,25,25
Ladejah,F,100,25,0,25
Laianna,F,100,25,0,25
Laicee,F,100,25,0,25
Lakeiya,F,100,25,0,25
Lakken,F,100,25,0,25
Laman,M,100,0,25,25
Lamani,F,100,25,0,25
Lanadia,F,100,25,0,25
Lanesia,F,100,25,0,25
Laterrence,M,100,0,25,25
Latiera,F,100,25,0,25
Lawrene,F,60,15,10,25
Leeani,F,100,25,0,25
Leelee,F,100,25,0,25
Legrande,M,100,0,25,25
Lema,F,100,25,0,25
Leniel,M,100,0,25,25
Lenni,F,100,25,0,25
Leonta,M,100,0,25,25
Leovanni,M,100,0,25,25
Lianys,F,100,25,0,25
Liduvina,F,100,25,0,25
Liliannah,F,100,25,0,25
Liliany,F,100,25,0,25
Litasha,F,100,25,0,25
Littleton,M,100,0,25,25
Lium,M,100,0,25,25
Lolisa,F,100,25,0,25
Lorana,F,100,25,0,25
Lott,M,100,0,25,25
Louvina,F,100,25,0,25
Luanda,F,100,25,0,25
Mackinnon,M,100,0,25,25
Maebree,F,100,25,0,25
Mahlaya,F,100,25,0,25
Makenzii,F,100,25,0,25
Malloy,M,100,0,25,25
Manase,M,100,0,25,25
Marcelius,M,100,0,25,25
Marcquez,M,100,0,25,25
Marelis,F,100,25,0,25
Margreat,F,100,25,0,25
Mariali,F,100,25,0,25
Marjori,F,100,25,0,25
Marliese,F,100,25,0,25
Marshana,F,100,25,0,25
Martelle,M,100,0,25,25
Martize,M,100,0,25,25
Maryagnes,F,100,25,0,25
Mayetta,F,100,25,0,25
Mccray,M,100,0,25,25
Meikhi,M,100,0,25,25
Melly,F,100,25,0,25
Memoree,F,100,25,0,25
Merel,M,72,7,18,25
Mergim,M,100,0,25,25
Miatta,F,100,25,0,25
Minday,F,100,25,0,25
Mistica,F,100,25,0,25
Miyabi,F,100,25,0,25
Miykael,M,100,0,25,25
Mkenna,F,100,25,0,25
Molinda,F,100,25,0,25
Morgandy,F,100,25,0,25
Mozetta,F,100,25,0,25
Mumina,F,100,25,0,25
Muntas,F,100,25,0,25
Muntasir,M,100,0,25,25
Muslimah,F,100,25,0,25
Mykol,M,100,0,25,25
Myzel,M,100,0,25,25
Nahid,F,52,13,12,25
Nakitta,F,100,25,0,25
Nalisha,F,100,25,0,25
Naloni,F,100,25,0,25
Natazia,F,100,25,0,25
Nathane,M,100,0,25,25
Nazyah,F,100,25,0,25
Nelah,F,100,25,0,25
Netisha,F,100,25,0,25
Nichollette,F,100,25,0,25
Nieem,M,100,0,25,25
Nivaeh,F,100,25,0,25
Nixson,M,100,0,25,25
Niyoka,F,100,25,0,25
Odessey,F,100,25,0,25
Olana,F,100,25,0,25
Olisha,F,100,25,0,25
Orlo,M,100,0,25,25
Orlyn,M,100,0,25,25
Oryn,M,100,0,25,25
Pacience,F,100,25,0,25
Pahal,F,100,25,0,25
Pamler,F,100,25,0,25
Pashance,F,100,25,0,25
Patsi,F,100,25,0,25
Paulie,M,56,11,14,25
Paying,F,100,25,0,25
Pessel,F,100,25,0,25
Pharah,F,100,25,0,25
Phillipp,M,100,0,25,25
Pincus,M,100,0,25,25
Pono,M,100,0,25,25
Poorvi,F,100,25,0,25
Promize,F,100,25,0,25
Quadri,M,100,0,25,25
Quentarius,M,100,0,25,25
Radu,M,100,0,25,25
Rakiem,M,100,0,25,25
Ralphel,M,100,0,25,25
Reagon,F,100,25,0,25
Regeana,F,100,25,0,25
Remee,F,100,25,0,25
Ressa,F,100,25,0,25
Rhandy,M,100,0,25,25
Rhemy,F,80,20,5,25
Rhunette,F,100,25,0,25
Riquel,F,100,25,0,25
Rital,F,100,25,0,25
Ritch,M,100,0,25,25
Robertanthony,M,100,0,25,25
Rodericka,F,100,25,0,25
Romere,M,100,0,25,25
Rosealyn,F,100,25,0,25
Rosslynn,F,100,25,0,25
Rowley,M,100,0,25,25
Rwan,F,100,25,0,25
Ryananthony,M,100,0,25,25
Saevion,M,100,0,25,25
Sahel,M,100,0,25,25
Samsara,F,100,25,0,25
Sanaria,F,100,25,0,25
Sanskar,M,100,0,25,25
Saranne,F,100,25,0,25
Satsuki,F,100,25,0,25
Savitri,F,100,25,0,25
Schnell,F,100,25,0,25
Schronda,F,100,25,0,25
Sepideh,F,100,25,0,25
Sequia,F,100,25,0,25
Serani,M,76,6,19,25
Sevasti,F,100,25,0,25
Sevren,M,100,0,25,25
Shadarius,M,100,0,25,25
Shadava,F,100,25,0,25
Shakaira,F,100,25,0,25
Shamille,F,100,25,0,25
Shaneia,F,100,25,0,25
Shang,M,100,0,25,25
Shanicia,F,100,25,0,25
Shaniequa,F,100,25,0,25
Shanila,F,100,25,0,25
Shaniqa,F,100,25,0,25
Shanleigh,F,100,25,0,25
Shannone,F,100,25,0,25
Shanza,F,100,25,0,25
Shaparis,F,100,25,0,25
Shaquail,F,100,25,0,25
Sharenda,F,100,25,0,25
Shashanna,F,100,25,0,25
Shashona,F,100,25,0,25
Shaunetta,F,100,25,0,25
Shavonia,F,100,25,0,25
Shayvonne,F,100,25,0,25
Sheel,M,100,0,25,25
Sheen,M,60,10,15,25
Shelee,F,100,25,0,25
Shenitra,F,100,25,0,25
Sherlita,F,100,25,0,25
Shonterria,F,100,25,0,25
Shulonda,F,100,25,0,25
Shyli,F,100,25,0,25
Shyrah,F,100,25,0,25
Siannah,F,100,25,0,25
Simba,M,100,0,25,25
Sisi,F,100,25,0,25
Skyela,F,100,25,0,25
Skylei,F,100,25,0,25
Soane,M,100,0,25,25
Sokhom,M,52,12,13,25
Spoorthi,F,100,25,0,25
Stamatis,M,100,0,25,25
Steeven,M,100,0,25,25
Stphen,M,100,0,25,25
Sushil,M,100,0,25,25
Symora,F,100,25,0,25
Taeisha,F,100,25,0,25
Taide,F,100,25,0,25
Taifa,F,100,25,0,25
Tajiddin,M,100,0,25,25
Takyrah,F,100,25,0,25
Talaiya,F,100,25,0,25
Talona,F,100,25,0,25
Talysha,F,100,25,0,25
Tammica,F,100,25,0,25
Tanjala,F,100,25,0,25
Tanvee,F,100,25,0,25
Tarajah,F,100,25,0,25
Tasheanna,F,100,25,0,25
Tashuna,F,100,25,0,25
Tatanya,F,100,25,0,25
Tauris,M,100,0,25,25
Tedman,M,100,0,25,25
Temur,M,100,0,25,25
Tenile,F,100,25,0,25
Terrencia,F,100,25,0,25
Territa,F,100,25,0,25
Terrylee,F,80,20,5,25
Teyonce,F,100,25,0,25
Tiffanymarie,F,100,25,0,25
Titana,F,100,25,0,25
Tmothy,M,100,0,25,25
Toland,M,100,0,25,25
Toliver,M,100,0,25,25
Tomya,F,100,25,0,25
Traegan,M,100,0,25,25
Traymon,M,100,0,25,25
Trence,M,100,0,25,25
Treneka,F,100,25,0,25
Triena,F,100,25,0,25
Trinese,F,100,25,0,25
Trionna,F,100,25,0,25
Tristana,F,100,25,0,25
Tristi,F,100,25,0,25
Tuesdae,F,100,25,0,25
Tyshai,F,100,25,0,25
Tyshera,F,100,25,0,25
Tyvone,M,100,0,25,25
Uniquia,F,100,25,0,25
Ute,F,100,25,0,25
Vatche,M,100,0,25,25
Vila,F,100,25,0,25
Virak,M,100,0,25,25
Waukesha,F,100,25,0,25
Wiiliam,M,100,0,25,25
Willmer,M,100,0,25,25
Woodroe,M,100,0,25,25
Xandyr,M,100,0,25,25
Xen,M,80,5,20,25
Xyaire,M,100,0,25,25
Yabdiel,M,100,0,25,25
Yatzel,F,100,25,0,25
Yelissa,F,100,25,0,25
Yissachar,M,100,0,25,25
Zahrya,F,100,25,0,25
Zanab,F,100,25,0,25
Zaren,M,100,0,25,25
Zariyha,F,100,25,0,25
Zaviera,F,100,25,0,25
Zaylei,F,100,25,0,25
Zechary,M,100,0,25,25
Zecheriah,M,100,0,25,25
Zhyaire,M,100,0,25,25
Ziaira,F,100,25,0,25
Ziel,M,52,12,13,25
Zimal,F,100,25,0,25
Zolan,M,100,0,25,25
Zorie,F,100,25,0,25
Zyheim,M,100,0,25,25
Aahliyah,F,100,24,0,24
Aairah,F,100,24,0,24
Aarielle,F,100,24,0,24
Aashay,M,100,0,24,24
Aayah,F,100,24,0,24
Abbriella,F,100,24,0,24
Abdihakim,M,100,0,24,24
Abinav,M,100,0,24,24
Adarious,M,100,0,24,24
Addiley,F,100,24,0,24
Adhav,M,100,0,24,24
Adhithi,F,100,24,0,24
Adilah,F,100,24,0,24
Aeryal,F,100,24,0,24
Afrin,F,100,24,0,24
Ahlexis,F,100,24,0,24
Ahriya,F,100,24,0,24
Ajanai,F,100,24,0,24
Akaylia,F,100,24,0,24
Akzel,M,100,0,24,24
Alexondria,F,100,24,0,24
Alidia,F,100,24,0,24
Aliyonna,F,100,24,0,24
Alizayah,F,100,24,0,24
Allijah,M,100,0,24,24
Almitra,F,100,24,0,24
Alyea,F,100,24,0,24
Amythest,F,100,24,0,24
Anaceli,F,100,24,0,24
Anathea,F,100,24,0,24
Aneela,F,100,24,0,24
Aneila,F,100,24,0,24
Anfal,F,100,24,0,24
Angelicamaria,F,100,24,0,24
Anhad,M,100,0,24,24
Aniyjah,F,100,24,0,24
Anjan,M,100,0,24,24
Anjelicia,F,100,24,0,24
Annahy,F,100,24,0,24
Annajo,F,100,24,0,24
Annaleia,F,100,24,0,24
Annavictoria,F,100,24,0,24
Annyah,F,100,24,0,24
Antorio,M,100,0,24,24
Antwand,M,100,0,24,24
Apiffany,F,100,24,0,24
Ardan,M,100,0,24,24
Arneda,F,100,24,0,24
Arretta,F,100,24,0,24
Asharee,F,100,24,0,24
Ashonta,F,100,24,0,24
Assa,F,100,24,0,24
Asser,M,100,0,24,24
Atenas,F,100,24,0,24
Audriena,F,100,24,0,24
Aungelique,F,100,24,0,24
Axil,M,100,0,24,24
Axtin,M,100,0,24,24
Azlaan,M,100,0,24,24
Azlee,F,100,24,0,24
Balee,F,100,24,0,24
Basheba,F,100,24,0,24
Beka,M,100,0,24,24
Bendetta,F,100,24,0,24
Berda,F,100,24,0,24
Binti,F,100,24,0,24
Bodyn,M,100,0,24,24
Bohan,M,100,0,24,24
Branten,M,100,0,24,24
Brendell,F,79,19,5,24
Brender,F,100,24,0,24
Brenli,F,100,24,0,24
Breshawna,F,100,24,0,24
Caanan,M,100,0,24,24
Caetlin,F,100,24,0,24
Candle,F,100,24,0,24
Cantrece,F,100,24,0,24
Caolan,M,100,0,24,24
Caralena,F,100,24,0,24
Cashen,M,100,0,24,24
Cassander,F,100,24,0,24
Cecilla,F,100,24,0,24
Celeta,F,100,24,0,24
Cepeda,M,100,0,24,24
Ceres,F,100,24,0,24
Cessily,F,100,24,0,24
Chaliyah,F,100,24,0,24
Charlisse,F,100,24,0,24
Charnea,F,100,24,0,24
Charvette,F,100,24,0,24
Chazlynn,F,100,24,0,24
Cheresse,F,100,24,0,24
Cherril,F,100,24,0,24
Christlyn,F,100,24,0,24
Chua,F,100,24,0,24
Cleatis,M,100,0,24,24
Cledith,M,79,5,19,24
Compton,M,100,0,24,24
Concettina,F,100,24,0,24
Corderio,M,100,0,24,24
Coston,M,100,0,24,24
Cresencia,F,100,24,0,24
Crisel,F,100,24,0,24
Crit,M,100,0,24,24
Crystopher,M,100,0,24,24
Cyenthia,F,100,24,0,24
Cyrenity,F,100,24,0,24
Daela,F,100,24,0,24
Dagim,M,100,0,24,24
Dajean,M,100,0,24,24
Dakita,F,100,24,0,24
Dalecia,F,100,24,0,24
Dalys,F,71,17,7,24
Damarques,M,100,0,24,24
Damie,F,75,18,6,24
Daniely,F,100,24,0,24
Dannye,M,100,0,24,24
Darnay,M,100,0,24,24
Dasheem,M,100,0,24,24
Dauphine,F,100,24,0,24
Davyan,M,100,0,24,24
Dawnyelle,F,100,24,0,24
Deairah,F,100,24,0,24
Deajia,F,100,24,0,24
Deashley,F,100,24,0,24
Deavonte,M,100,0,24,24
Debro,F,100,24,0,24
Decklen,M,100,0,24,24
Declen,M,100,0,24,24
Dekiya,F,100,24,0,24
Deleshia,F,100,24,0,24
Demante,M,100,0,24,24
Denelda,F,100,24,0,24
Desdemona,F,100,24,0,24
Deshelia,F,100,24,0,24
Detravious,M,100,0,24,24
Devana,F,100,24,0,24
Devonaire,M,100,0,24,24
Devonie,F,100,24,0,24
Devyani,F,100,24,0,24
Deyvion,M,100,0,24,24
Diasy,F,100,24,0,24
Dijonae,F,100,24,0,24
Dijonna,F,100,24,0,24
Dilin,M,100,0,24,24
Dimitric,M,100,0,24,24
Dinasia,F,100,24,0,24
Dinelle,F,100,24,0,24
Diony,M,100,0,24,24
Dita,F,100,24,0,24
Dlila,F,100,24,0,24
Dollicia,F,100,24,0,24
Donovann,M,100,0,24,24
Dreson,M,100,0,24,24
Driston,M,100,0,24,24
Drystal,F,100,24,0,24
Dyanni,F,100,24,0,24
Edell,F,58,14,10,24
Edid,F,100,24,0,24
Effrem,M,100,0,24,24
Ekrem,M,100,0,24,24
Elby,M,100,0,24,24
Eldina,F,100,24,0,24
Elexsis,F,100,24,0,24
Elijaah,M,100,0,24,24
Eliotte,F,100,24,0,24
Elisey,M,100,0,24,24
Elizia,F,100,24,0,24
Eliziah,M,100,0,24,24
Elkan,M,100,0,24,24
Elliah,F,100,24,0,24
Emiree,F,100,24,0,24
Emmelie,F,100,24,0,24
Enga,F,100,24,0,24
Enneth,M,100,0,24,24
Enzi,M,100,0,24,24
Eralynn,F,100,24,0,24
Erianny,F,100,24,0,24
Eriqa,F,100,24,0,24
Ersula,F,100,24,0,24
Escarleth,F,100,24,0,24
Estrelita,F,100,24,0,24
Ethanalexander,M,100,0,24,24
Etheline,F,100,24,0,24
Ethlyn,F,100,24,0,24
Evangline,F,100,24,0,24
Ezkiel,M,100,0,24,24
Fanya,F,100,24,0,24
Flamur,M,100,0,24,24
Fleshia,F,100,24,0,24
Flormaria,F,100,24,0,24
Foua,F,100,24,0,24
Gabriyel,F,54,13,11,24
Gariel,M,75,6,18,24
Garrus,M,100,0,24,24
Gatsby,M,100,0,24,24
Genel,F,100,24,0,24
Genieva,F,100,24,0,24
Gent,M,100,0,24,24
Geralda,F,100,24,0,24
Gerene,F,100,24,0,24
Ghina,F,100,24,0,24
Gilliana,F,100,24,0,24
Gionnie,M,100,0,24,24
Gomer,M,100,0,24,24
Goodwin,M,100,0,24,24
Greycen,M,100,0,24,24
Greydi,F,100,24,0,24
Guinness,M,100,0,24,24
Hailo,F,100,24,0,24
Hardik,M,100,0,24,24
Heilyn,F,100,24,0,24
Henoch,M,100,0,24,24
Henos,M,100,0,24,24
Heshy,M,100,0,24,24
Hezzie,M,100,0,24,24
Hiatt,M,100,0,24,24
Hollice,F,71,17,7,24
Hooriya,F,100,24,0,24
Hulices,M,100,0,24,24
Huntlee,M,54,11,13,24
Ialiyah,F,100,24,0,24
Iliyan,M,100,0,24,24
Imo,F,79,19,5,24
Ironesha,F,100,24,0,24
Isabelita,F,100,24,0,24
Ishya,F,100,24,0,24
Ivylynn,F,100,24,0,24
Jabulani,M,100,0,24,24
Jacelin,F,100,24,0,24
Jahking,M,100,0,24,24
Jahnari,F,79,19,5,24
Jahzarah,F,100,24,0,24
Jaivien,M,100,0,24,24
Jakkia,F,67,16,8,24
Jaland,M,100,0,24,24
Jameion,M,100,0,24,24
Jamiemarie,F,100,24,0,24
Jamikal,M,100,0,24,24
Janaija,F,100,24,0,24
Janarius,M,100,0,24,24
Janiris,F,100,24,0,24
Jaquarrius,M,100,0,24,24
Jaquinton,M,100,0,24,24
Jaraya,F,100,24,0,24
Jarethzy,F,100,24,0,24
Jarques,M,100,0,24,24
Jasleene,F,100,24,0,24
Jasmere,F,100,24,0,24
Jassiem,M,100,0,24,24
Jassir,M,100,0,24,24
Jatori,F,79,19,5,24
Javontez,M,100,0,24,24
Jayco,M,100,0,24,24
Jaydus,M,100,0,24,24
Jaylisa,F,100,24,0,24
Jayvonni,M,100,0,24,24
Jazavion,M,100,0,24,24
Jeanea,F,100,24,0,24
Jemale,M,100,0,24,24
Jenelly,F,100,24,0,24
Jenitza,F,100,24,0,24
Jenniferlee,F,100,24,0,24
Jenri,M,100,0,24,24
Jereline,F,100,24,0,24
Jesha,F,100,24,0,24
Jessicarose,F,100,24,0,24
Jevonta,M,100,0,24,24
Jewelian,F,58,14,10,24
Jeweline,F,100,24,0,24
Jhovana,F,100,24,0,24
Jiani,F,100,24,0,24
Joplyn,F,100,24,0,24
Jorrel,M,100,0,24,24
Josejesus,M,100,0,24,24
Joshuel,M,100,0,24,24
Journiee,F,100,24,0,24
Judeen,F,100,24,0,24
Juleana,F,100,24,0,24
Juleesa,F,100,24,0,24
Junella,F,100,24,0,24
Jurline,F,100,24,0,24
Kadiatu,F,100,24,0,24
Kadiesha,F,100,24,0,24
Kahliah,F,100,24,0,24
Kahmiya,F,100,24,0,24
Kaisee,F,100,24,0,24
Kalobe,M,100,0,24,24
Kanaloa,M,100,0,24,24
Kandyse,F,100,24,0,24
Kanishia,F,100,24,0,24
Katresa,F,100,24,0,24
Kaygen,F,50,12,12,24
Kayslee,F,100,24,0,24
Kazuo,M,100,0,24,24
Kci,M,100,0,24,24
Kelah,F,100,24,0,24
Kenay,M,100,0,24,24
Kennedii,F,100,24,0,24
Kenyae,M,75,6,18,24
Kerionna,F,100,24,0,24
Keunna,F,100,24,0,24
Kevinn,M,100,0,24,24
Keyashia,F,100,24,0,24
Keyvion,M,100,0,24,24
Kiersyn,F,100,24,0,24
Kimahri,M,100,0,24,24
Kimorra,F,100,24,0,24
Kizzey,F,100,24,0,24
Kristabelle,F,100,24,0,24
Krystalann,F,100,24,0,24
Kuan,M,100,0,24,24
Kushagra,M,100,0,24,24
Kwentin,M,100,0,24,24
Kyianna,F,100,24,0,24
Kymel,M,100,0,24,24
Lachaka,F,100,24,0,24
Laciana,F,100,24,0,24
Lacree,F,100,24,0,24
Ladrena,F,100,24,0,24
Laelynn,F,100,24,0,24
Lakaila,F,100,24,0,24
Lakeila,F,100,24,0,24
Lakreshia,F,100,24,0,24
Laredo,M,79,5,19,24
Laremy,M,100,0,24,24
Lashundria,F,100,24,0,24
Lauraanne,F,100,24,0,24
Laurianna,F,100,24,0,24
Lauron,F,100,24,0,24
Lavarious,M,100,0,24,24
Layona,F,100,24,0,24
Lealah,F,100,24,0,24
Lency,F,100,24,0,24
Lessli,F,100,24,0,24
Letosha,F,100,24,0,24
Lileah,F,100,24,0,24
Lilikoi,F,100,24,0,24
Lillieanne,F,100,24,0,24
Lillyrose,F,100,24,0,24
Lisbed,F,100,24,0,24
Lisi,F,100,24,0,24
Lizbhet,F,100,24,0,24
Loay,M,100,0,24,24
Lorainne,F,100,24,0,24
Lorijo,F,100,24,0,24
Ludmilla,F,100,24,0,24
Maddielynn,F,100,24,0,24
Madine,F,100,24,0,24
Madsion,F,100,24,0,24
Mahagany,F,100,24,0,24
Mahya,F,100,24,0,24
Mailinh,F,100,24,0,24
Mais,F,100,24,0,24
Makalla,F,100,24,0,24
Malhar,M,100,0,24,24
Mannan,M,100,0,24,24
Manroop,F,100,24,0,24
Manvik,M,100,0,24,24
Maquel,F,100,24,0,24
Marcinda,F,100,24,0,24
Markya,F,100,24,0,24
Marquale,M,100,0,24,24
Marshala,F,100,24,0,24
Marshanna,F,100,24,0,24
Martinus,M,100,0,24,24
Masao,M,100,0,24,24
Mashaun,M,100,0,24,24
Mashona,F,100,24,0,24
Masiela,F,100,24,0,24
Mathais,M,100,0,24,24
Mattye,F,100,24,0,24
Mauriyah,F,100,24,0,24
Mavourneen,F,100,24,0,24
Mckaylyn,F,100,24,0,24
Mckennzie,F,100,24,0,24
Mecole,F,100,24,0,24
Mehmed,M,100,0,24,24
Mekalah,F,100,24,0,24
Melaki,M,100,0,24,24
Melih,M,100,0,24,24
Melinah,F,100,24,0,24
Melo,M,100,0,24,24
Merab,F,100,24,0,24
Merdis,F,100,24,0,24
Michaelryan,M,100,0,24,24
Milaan,F,100,24,0,24
Milek,M,100,0,24,24
Milenna,F,100,24,0,24
Mileny,F,100,24,0,24
Milian,F,100,24,0,24
Mitzel,F,100,24,0,24
Mkya,F,100,24,0,24
Mondarius,M,100,0,24,24
Monsserrat,F,100,24,0,24
Monteco,M,100,0,24,24
Moyra,F,100,24,0,24
Moziah,M,100,0,24,24
Murjani,F,100,24,0,24
Mykisha,F,100,24,0,24
Myshon,M,100,0,24,24
Naadira,F,100,24,0,24
Nace,M,100,0,24,24
Nacho,M,100,0,24,24
Nadeya,F,100,24,0,24
Nafia,F,100,24,0,24
Nahmir,M,100,0,24,24
Nairah,F,100,24,0,24
Nalijah,F,100,24,0,24
Nashiyah,F,100,24,0,24
Nasr,M,100,0,24,24
Nataija,F,100,24,0,24
Nehir,F,100,24,0,24
Nichlous,M,100,0,24,24
Nilani,F,100,24,0,24
Niven,M,100,0,24,24
Nixen,M,100,0,24,24
Niyasia,F,100,24,0,24
Nygil,M,100,0,24,24
Nylaa,F,100,24,0,24
Nyota,F,100,24,0,24
Onelia,F,100,24,0,24
Paislyn,F,100,24,0,24
Parson,M,100,0,24,24
Peirre,M,100,0,24,24
Pennee,F,100,24,0,24
Perseis,F,100,24,0,24
Peydon,M,100,0,24,24
Porcsha,F,100,24,0,24
Posie,F,100,24,0,24
Qadree,M,100,0,24,24
Quantella,F,100,24,0,24
Quartney,F,100,24,0,24
Quatavia,F,100,24,0,24
Quentel,M,100,0,24,24
Ragad,F,100,24,0,24
Rahjon,M,100,0,24,24
Ralna,F,100,24,0,24
Rameek,M,100,0,24,24
Randalph,M,100,0,24,24
Raquelin,F,100,24,0,24
Rashadd,M,100,0,24,24
Rashetta,F,100,24,0,24
Rawlins,M,100,0,24,24
Raydene,F,100,24,0,24
Raynita,F,100,24,0,24
Regniald,M,100,0,24,24
Remiah,F,100,24,0,24
Renault,M,100,0,24,24
Richael,F,100,24,0,24
Ricquan,M,100,0,24,24
Riella,F,100,24,0,24
Rileyanne,F,100,24,0,24
Rodolph,M,100,0,24,24
Roert,M,100,0,24,24
Ronise,F,100,24,0,24
Rosela,F,100,24,0,24
Rosicela,F,100,24,0,24
Royel,M,79,5,19,24
Rozlin,F,100,24,0,24
Rubith,F,100,24,0,24
Russchelle,F,100,24,0,24
Ruy,M,100,0,24,24
Saleisha,F,100,24,0,24
Samanthe,F,100,24,0,24
Samiir,M,100,0,24,24
Sammyjo,F,100,24,0,24
Saniaya,F,100,24,0,24
Sanniyah,F,100,24,0,24
Sapan,M,100,0,24,24
Saquoya,F,100,24,0,24
Savy,F,100,24,0,24
Sayumi,F,100,24,0,24
Scotia,F,100,24,0,24
Searria,F,100,24,0,24
Shaheerah,F,100,24,0,24
Shaherah,F,100,24,0,24
Shainah,F,100,24,0,24
Shakeer,M,100,0,24,24
Shakida,F,100,24,0,24
Shambre,F,100,24,0,24
Shamequa,F,100,24,0,24
Shanethia,F,100,24,0,24
Shanisa,F,100,24,0,24
Shanny,F,100,24,0,24
Shaqwan,M,100,0,24,24
Sharayne,F,100,24,0,24
Sharesse,F,100,24,0,24
Shavanda,F,100,24,0,24
Shawda,F,100,24,0,24
Shawnequa,F,100,24,0,24
Shawntaya,F,100,24,0,24
Shaydee,F,100,24,0,24
Shazil,M,100,0,24,24
Sherette,F,100,24,0,24
Shermica,F,100,24,0,24
Shikeem,M,100,0,24,24
Shinique,F,100,24,0,24
Shiona,F,100,24,0,24
Shivika,F,100,24,0,24
Shrish,M,100,0,24,24
Shuban,M,100,0,24,24
Sidnei,F,100,24,0,24
Silpa,F,100,24,0,24
Silvan,M,100,0,24,24
Simao,M,100,0,24,24
Smayan,M,100,0,24,24
Snapper,M,100,0,24,24
Sofina,F,100,24,0,24
Solangie,F,100,24,0,24
Sonique,F,100,24,0,24
Stonie,M,58,10,14,24
Sucely,F,100,24,0,24
Sujan,M,100,0,24,24
Suyapa,F,100,24,0,24
Swapna,F,100,24,0,24
Syndney,F,100,24,0,24
Tacoria,F,100,24,0,24
Takaria,F,100,24,0,24
Taksh,M,100,0,24,24
Tamesa,F,100,24,0,24
Tanira,F,100,24,0,24
Taska,F,100,24,0,24
Tatasha,F,100,24,0,24
Tawatha,F,100,24,0,24
Tayseer,M,100,0,24,24
Teadra,F,100,24,0,24
Tegra,F,100,24,0,24
Tenasha,F,100,24,0,24
Tenielle,F,100,24,0,24
Terriance,M,100,0,24,24
Thibault,M,100,0,24,24
Thomos,M,100,0,24,24
Thuytrang,F,100,24,0,24
Tieesha,F,100,24,0,24
Tiese,F,100,24,0,24
Tiffy,F,100,24,0,24
Tihani,F,100,24,0,24
Timeca,F,100,24,0,24
Titia,F,100,24,0,24
Tjuan,M,100,0,24,24
Torron,M,100,0,24,24
Tracyn,M,100,0,24,24
Tramanh,F,100,24,0,24
Trevahn,M,100,0,24,24
Tritan,M,100,0,24,24
Tshawn,M,100,0,24,24
Turi,F,79,19,5,24
Tustin,M,100,0,24,24
Tycee,F,100,24,0,24
Tydarrius,M,100,0,24,24
Tydre,M,100,0,24,24
Tymeria,F,100,24,0,24
Tyral,M,100,0,24,24
Tytana,F,100,24,0,24
Tyyon,M,100,0,24,24
Ullanda,F,100,24,0,24
Urwa,F,100,24,0,24
Valle,F,100,24,0,24
Vanely,F,100,24,0,24
Varad,M,100,0,24,24
Verdine,F,100,24,0,24
Viky,F,100,24,0,24
Vivie,F,100,24,0,24
Westan,M,100,0,24,24
Winna,F,100,24,0,24
Xang,M,100,0,24,24
Xyion,M,79,5,19,24
Yagaira,F,100,24,0,24
Yaheli,F,100,24,0,24
Yar,F,100,24,0,24
Yeremiah,M,100,0,24,24
Yezen,M,100,0,24,24
Yocelyne,F,100,24,0,24
Yomari,F,100,24,0,24
Yonason,M,100,0,24,24
Yosif,M,100,0,24,24
Ysatis,F,100,24,0,24
Zaith,M,100,0,24,24
Zaliya,F,100,24,0,24
Zanariah,F,100,24,0,24
Zanea,F,100,24,0,24
Zarifa,F,100,24,0,24
Zenae,F,100,24,0,24
Zevion,M,100,0,24,24
Zoella,F,100,24,0,24
Zolton,M,100,0,24,24
Zurii,F,100,24,0,24
Zurri,F,100,24,0,24
Zyel,M,100,0,24,24
Zyriana,F,100,24,0,24
Abegayle,F,100,23,0,23
Adahli,F,100,23,0,23
Addelynne,F,100,23,0,23
Ademir,M,100,0,23,23
Aderonke,F,100,23,0,23
Adesh,M,100,0,23,23
Adhvaith,M,100,0,23,23
Adma,M,100,0,23,23
Adrija,F,100,23,0,23
Agamjot,M,100,0,23,23
Ahmare,M,100,0,23,23
Aidean,M,100,0,23,23
Ainzlee,F,100,23,0,23
Aitor,M,100,0,23,23
Aizlee,F,100,23,0,23
Akshata,F,100,23,0,23
Alaire,F,100,23,0,23
Alcia,F,100,23,0,23
Aleasa,F,100,23,0,23
Aleksandria,F,100,23,0,23
Alexana,F,100,23,0,23
Alexeia,F,100,23,0,23
Alez,M,100,0,23,23
Algin,M,100,0,23,23
Aliyaha,F,100,23,0,23
Allard,M,100,0,23,23
Allinson,F,100,23,0,23
Allysah,F,100,23,0,23
Alman,M,100,0,23,23
Alundra,F,100,23,0,23
Alyssaann,F,100,23,0,23
Amaje,M,100,0,23,23
Amandra,F,100,23,0,23
Amannda,F,100,23,0,23
Amartya,M,100,0,23,23
Amberdawn,F,100,23,0,23
Ambernicole,F,100,23,0,23
Ambi,F,100,23,0,23
Ambor,F,100,23,0,23
Amelianna,F,100,23,0,23
Amondre,M,100,0,23,23
Anahly,F,100,23,0,23
Anayjah,F,100,23,0,23
Anchor,M,100,0,23,23
Andony,M,100,0,23,23
Andreaz,M,100,0,23,23
Anfrenee,M,100,0,23,23
Angiela,F,100,23,0,23
Anieyah,F,100,23,0,23
Anjelah,F,100,23,0,23
Annakay,F,100,23,0,23
Annarosa,F,100,23,0,23
Anqunette,F,100,23,0,23
Antiona,M,78,5,18,23
Arabell,F,100,23,0,23
Archisha,F,100,23,0,23
Arethia,F,100,23,0,23
Ariano,M,100,0,23,23
Aribah,F,100,23,0,23
Aridai,F,100,23,0,23
Arielly,F,100,23,0,23
Arthella,F,100,23,0,23
Ashalee,F,100,23,0,23
Ashanda,F,100,23,0,23
Ashi,F,100,23,0,23
Athaniel,M,100,0,23,23
Athyna,F,100,23,0,23
Auriah,F,100,23,0,23
Avilynn,F,100,23,0,23
Avroham,M,100,0,23,23
Ayaa,F,100,23,0,23
Ayon,M,100,0,23,23
Ayotunde,M,100,0,23,23
Azaelia,F,100,23,0,23
Azi,M,100,0,23,23
Baba,M,100,0,23,23
Baelin,M,100,0,23,23
Bartholome,M,100,0,23,23
Beanna,F,100,23,0,23
Beloved,F,100,23,0,23
Beneta,F,100,23,0,23
Bengamin,M,100,0,23,23
Betsua,F,100,23,0,23
Bevyn,F,100,23,0,23
Bhavani,F,100,23,0,23
Bhavini,F,100,23,0,23
Bhumika,F,100,23,0,23
Bibian,F,100,23,0,23
Bineta,F,100,23,0,23
Birute,F,100,23,0,23
Bisan,F,100,23,0,23
Blerta,F,100,23,0,23
Braidy,F,74,17,6,23
Brannigan,M,70,7,16,23
Brashaun,M,100,0,23,23
Breazia,F,100,23,0,23
Breilyn,F,100,23,0,23
Brenette,F,100,23,0,23
Brey,M,100,0,23,23
Brianica,F,100,23,0,23
Brielee,F,100,23,0,23
Brittinay,F,100,23,0,23
Briyon,M,100,0,23,23
Brookleigh,F,100,23,0,23
Brytnie,F,100,23,0,23
Cairi,F,100,23,0,23
Caisha,F,100,23,0,23
Caleya,F,100,23,0,23
Calistro,M,100,0,23,23
Callianne,F,100,23,0,23
Camareon,M,100,0,23,23
Cambreigh,F,100,23,0,23
Camerina,F,100,23,0,23
Camorah,F,100,23,0,23
Candias,F,100,23,0,23
Canya,F,100,23,0,23
Caral,F,100,23,0,23
Cardero,M,100,0,23,23
Carington,F,100,23,0,23
Carrye,F,100,23,0,23
Carvis,M,100,0,23,23
Cassandrea,F,100,23,0,23
Catara,F,100,23,0,23
Cedell,M,100,0,23,23
Cedella,F,100,23,0,23
Champaign,F,100,23,0,23
Chanceller,M,100,0,23,23
Chano,M,100,0,23,23
Chareen,F,100,23,0,23
Charlanne,F,100,23,0,23
Charlia,F,100,23,0,23
Charnesha,F,100,23,0,23
Charnessa,F,100,23,0,23
Charolotte,F,100,23,0,23
Chavelle,F,100,23,0,23
Chemaine,F,100,23,0,23
Chenda,F,100,23,0,23
Chenea,F,100,23,0,23
Cherilee,F,100,23,0,23
Chevas,M,100,0,23,23
Chyrell,F,100,23,0,23
Cloretta,F,100,23,0,23
Codyjames,M,100,0,23,23
Colbee,F,78,18,5,23
Corella,F,100,23,0,23
Corenthia,F,100,23,0,23
Corisha,F,100,23,0,23
Courtlan,M,100,0,23,23
Coven,M,100,0,23,23
Coyote,M,100,0,23,23
Cyonna,F,100,23,0,23
Dache,F,100,23,0,23
Daejha,F,100,23,0,23
Damayah,F,100,23,0,23
Damerion,M,100,0,23,23
Danapaola,F,100,23,0,23
Daral,M,100,0,23,23
Dariany,F,100,23,0,23
Darie,F,100,23,0,23
Darko,M,100,0,23,23
Dayanah,F,100,23,0,23
Dazzlyn,F,100,23,0,23
Deborahh,F,100,23,0,23
Decia,F,100,23,0,23
Decorius,M,100,0,23,23
Deidree,F,100,23,0,23
Deilyn,F,100,23,0,23
Deleyza,F,100,23,0,23
Delimar,F,100,23,0,23
Demariah,F,100,23,0,23
Demeterius,M,100,0,23,23
Demetrics,M,100,0,23,23
Demii,F,100,23,0,23
Demyra,F,100,23,0,23
Derck,M,100,0,23,23
Destene,F,100,23,0,23
Deterrius,M,100,0,23,23
Deveyon,M,100,0,23,23
Devindra,M,100,0,23,23
Devlen,M,100,0,23,23
Diamontae,M,100,0,23,23
Dioselyn,F,100,23,0,23
Distiny,F,100,23,0,23
Donld,M,100,0,23,23
Dorcia,F,100,23,0,23
Dunte,M,100,0,23,23
Dzaria,F,100,23,0,23
Eathin,M,100,0,23,23
Eathyn,M,100,0,23,23
Edrin,M,100,0,23,23
Efstathia,F,100,23,0,23
Elanora,F,100,23,0,23
Elanore,F,100,23,0,23
Elcie,F,100,23,0,23
Eleesa,F,100,23,0,23
Elgar,M,100,0,23,23
Elisaul,M,100,0,23,23
Elliett,F,100,23,0,23
Elrey,M,100,0,23,23
Emerzon,M,100,0,23,23
Emiliah,F,100,23,0,23
Emilin,F,100,23,0,23
Emmelynn,F,100,23,0,23
Emyiah,F,100,23,0,23
Enedino,M,100,0,23,23
Eriane,F,100,23,0,23
Erianne,F,100,23,0,23
Ermal,M,100,0,23,23
Esabel,F,100,23,0,23
Ethane,M,100,0,23,23
Etzio,M,100,0,23,23
Evaly,F,100,23,0,23
Evenie,F,100,23,0,23
Evlin,F,100,23,0,23
Ezequel,M,100,0,23,23
Eztli,F,100,23,0,23
Fahren,F,100,23,0,23
Fawwaz,M,100,0,23,23
Fayeth,F,100,23,0,23
Filippa,F,100,23,0,23
Fonta,F,52,12,11,23
Fonzie,M,100,0,23,23
Friday,F,100,23,0,23
Gabiel,M,100,0,23,23
Gant,M,100,0,23,23
Geetha,F,100,23,0,23
Genece,F,100,23,0,23
Gensis,F,100,23,0,23
Geriyah,F,100,23,0,23
Gervis,M,100,0,23,23
Gessel,F,100,23,0,23
Getzemani,F,100,23,0,23
Giovante,M,100,0,23,23
Gradey,M,100,0,23,23
Grisham,M,100,0,23,23
Haarika,F,100,23,0,23
Hadie,F,100,23,0,23
Haki,M,100,0,23,23
Hanish,M,100,0,23,23
Hannaha,F,100,23,0,23
Harlis,M,100,0,23,23
Harveen,F,100,23,0,23
Harvir,M,100,0,23,23
Henock,M,100,0,23,23
Hridaan,M,100,0,23,23
Idiris,M,100,0,23,23
Ihab,M,100,0,23,23
Imala,F,100,23,0,23
Ireta,F,100,23,0,23
Isen,M,100,0,23,23
Israelle,F,100,23,0,23
Izaack,M,100,0,23,23
Jabrian,M,100,0,23,23
Jacinth,F,52,12,11,23
Jacobson,M,100,0,23,23
Jadayah,F,100,23,0,23
Jahmaya,F,100,23,0,23
Jahniece,F,100,23,0,23
Jajuana,F,100,23,0,23
Jalice,F,100,23,0,23
Jam,M,100,0,23,23
Jamad,M,100,0,23,23
Jamarreon,M,100,0,23,23
Jameliah,F,100,23,0,23
Jamesryan,M,100,0,23,23
Jamirrah,F,100,23,0,23
Jamiyl,M,100,0,23,23
Jamyri,F,74,17,6,23
Janill,F,100,23,0,23
Jarrold,M,100,0,23,23
Jarya,F,100,23,0,23
Jasminerose,F,100,23,0,23
Jasonna,F,100,23,0,23
Javeyah,F,100,23,0,23
Jaydun,M,100,0,23,23
Jayger,M,100,0,23,23
Jaylianis,F,100,23,0,23
Jeiel,M,100,0,23,23
Jelesia,F,100,23,0,23
Jenn,F,100,23,0,23
Jennean,F,100,23,0,23
Jeralee,F,100,23,0,23
Jermere,M,100,0,23,23
Jesska,F,100,23,0,23
Jhordy,M,100,0,23,23
Jiada,F,100,23,0,23
Jiair,M,100,0,23,23
Jimar,M,100,0,23,23
Jimbo,M,100,0,23,23
Jionny,M,100,0,23,23
Joevani,M,100,0,23,23
Joevanny,M,100,0,23,23
Johansen,M,100,0,23,23
Jometh,M,100,0,23,23
Jonecia,F,100,23,0,23
Jorgie,F,100,23,0,23
Jovey,F,100,23,0,23
Jozyah,M,100,0,23,23
Juaquina,F,100,23,0,23
Juiliana,F,100,23,0,23
Juliarose,F,100,23,0,23
Julye,F,100,23,0,23
Julyen,M,100,0,23,23
Justinryan,M,100,0,23,23
Jwaun,M,100,0,23,23
Jyheim,M,100,0,23,23
Jylene,F,100,23,0,23
Jylon,M,100,0,23,23
Kaare,M,100,0,23,23
Kadidiatou,F,100,23,0,23
Kadijha,F,100,23,0,23
Kaisan,M,100,0,23,23
Kalaina,F,100,23,0,23
Kalolaine,F,100,23,0,23
Kambrya,F,100,23,0,23
Kametria,F,100,23,0,23
Kamoree,F,100,23,0,23
Kanaria,F,100,23,0,23
Kaoru,F,74,17,6,23
Karapet,M,100,0,23,23
Karise,F,100,23,0,23
Kascha,F,100,23,0,23
Kasiem,M,100,0,23,23
Kasity,F,100,23,0,23
Kassydi,F,100,23,0,23
Kattrina,F,100,23,0,23
Kayala,F,100,23,0,23
Kayanne,F,100,23,0,23
Kaylnn,F,100,23,0,23
Keliana,F,100,23,0,23
Kelinda,F,100,23,0,23
Keltyn,M,100,0,23,23
Kemarian,M,100,0,23,23
Kendralyn,F,100,23,0,23
Kenet,M,100,0,23,23
Kentrez,M,100,0,23,23
Kerrian,F,100,23,0,23
Kestra,F,100,23,0,23
Khader,M,100,0,23,23
Khailah,F,100,23,0,23
Khiabet,F,100,23,0,23
Khrystine,F,100,23,0,23
Khup,M,100,0,23,23
Kiaura,F,100,23,0,23
Kihana,F,100,23,0,23
Kiing,M,100,0,23,23
Kimmey,F,100,23,0,23
Kirolos,M,100,0,23,23
Kolvin,M,100,0,23,23
Komalpreet,F,100,23,0,23
Kumba,F,100,23,0,23
Kurston,F,100,23,0,23
Kushana,F,100,23,0,23
Kwanesha,F,100,23,0,23
Kyell,M,100,0,23,23
Kynsey,F,100,23,0,23
Labryant,M,100,0,23,23
Labyron,M,100,0,23,23
Ladine,F,100,23,0,23
Lal,M,78,5,18,23
Lamaiya,F,100,23,0,23
Landric,M,100,0,23,23
Landun,M,100,0,23,23
Laquane,M,100,0,23,23
Lareka,F,100,23,0,23
Laronna,F,100,23,0,23
Lashad,M,100,0,23,23
Lashasta,F,100,23,0,23
Lashunna,F,100,23,0,23
Latinya,F,100,23,0,23
Lauralea,F,100,23,0,23
Laurenmarie,F,100,23,0,23
Lavaun,F,100,23,0,23
Laytin,M,100,0,23,23
Lazerrick,M,100,0,23,23
Leairah,F,100,23,0,23
Leal,F,100,23,0,23
Leayah,F,100,23,0,23
Leelend,M,100,0,23,23
Legacie,F,100,23,0,23
Lehanna,F,100,23,0,23
Leiha,F,100,23,0,23
Lekesia,F,100,23,0,23
Lenika,F,100,23,0,23
Lessia,F,100,23,0,23
Leyona,F,100,23,0,23
Lisann,F,100,23,0,23
Lismarie,F,100,23,0,23
Lital,F,100,23,0,23
Logynn,F,100,23,0,23
Loletia,F,100,23,0,23
Loritta,F,100,23,0,23
Lothar,M,100,0,23,23
Lurine,F,100,23,0,23
Lyneah,F,100,23,0,23
Lynnia,F,100,23,0,23
Mabree,F,100,23,0,23
Maddigan,F,100,23,0,23
Mahan,M,100,0,23,23
Maicon,M,100,0,23,23
Maisley,F,100,23,0,23
Makirah,F,100,23,0,23
Malaikah,F,100,23,0,23
Malkiel,M,100,0,23,23
Mama,F,100,23,0,23
Mamady,M,100,0,23,23
Mantas,M,100,0,23,23
Margarethe,F,100,23,0,23
Margeart,F,100,23,0,23
Mariacamila,F,100,23,0,23
Marianthi,F,100,23,0,23
Marleth,F,100,23,0,23
Marneisha,F,100,23,0,23
Marqel,M,100,0,23,23
Marquila,F,100,23,0,23
Marselino,M,100,0,23,23
Masashi,M,100,0,23,23
Masheka,F,100,23,0,23
Mathai,M,57,10,13,23
Matisen,F,100,23,0,23
Maxene,F,100,23,0,23
Mckaden,M,100,0,23,23
Mckalyn,F,100,23,0,23
Mckaya,F,100,23,0,23
Meryssa,F,100,23,0,23
Micahi,M,100,0,23,23
Mickaila,F,100,23,0,23
Milahn,F,100,23,0,23
Milira,F,100,23,0,23
Minde,F,100,23,0,23
Mireily,F,100,23,0,23
Moaaz,M,100,0,23,23
Mohammadali,M,100,0,23,23
Mohmad,M,100,0,23,23
Monchell,F,100,23,0,23
Moneeka,F,100,23,0,23
Moniece,F,100,23,0,23
Montessa,F,100,23,0,23
Mouad,M,100,0,23,23
Muktar,M,100,0,23,23
Mutaz,M,100,0,23,23
Mykyla,F,100,23,0,23
Myniah,F,100,23,0,23
Naavah,F,100,23,0,23
Naely,F,100,23,0,23
Najiyyah,F,100,23,0,23
Nakecia,F,100,23,0,23
Nali,F,100,23,0,23
Nardia,F,100,23,0,23
Narelle,F,100,23,0,23
Naryan,M,100,0,23,23
Nashalee,F,100,23,0,23
Nasheema,F,100,23,0,23
Natrice,F,100,23,0,23
Natyia,F,100,23,0,23
Navier,M,100,0,23,23
Naython,M,100,0,23,23
Neaven,M,100,0,23,23
Neddie,M,74,6,17,23
Neeli,F,100,23,0,23
Neizan,M,100,0,23,23
Nekaybaw,F,100,23,0,23
Nekeidra,F,100,23,0,23
Nickesha,F,100,23,0,23
Niket,M,100,0,23,23
Niralya,F,100,23,0,23
Nived,M,100,0,23,23
Nobie,F,100,23,0,23
Nolani,F,100,23,0,23
Nubaid,M,100,0,23,23
Nylie,F,100,23,0,23
Nysean,M,100,0,23,23
Octavien,M,100,0,23,23
Olajumoke,F,100,23,0,23
Olicia,F,100,23,0,23
Omarien,M,100,0,23,23
Onda,F,100,23,0,23
Oreal,F,100,23,0,23
Oreana,F,100,23,0,23
Orionna,F,100,23,0,23
Orr,M,78,5,18,23
Ossama,M,100,0,23,23
Ossian,M,100,0,23,23
Ozziel,M,100,0,23,23
Packer,M,100,0,23,23
Parthena,F,100,23,0,23
Paterica,F,100,23,0,23
Patrickjames,M,100,0,23,23
Paulet,F,100,23,0,23
Peer,M,100,0,23,23
Pella,F,100,23,0,23
Pessie,F,100,23,0,23
Piersen,M,100,0,23,23
Prithika,F,100,23,0,23
Promyce,F,100,23,0,23
Quadarrius,M,100,0,23,23
Quamain,M,100,0,23,23
Quentella,F,100,23,0,23
Qui,M,100,0,23,23
Quishawn,M,100,0,23,23
Quiyana,F,100,23,0,23
Qwanisha,F,100,23,0,23
Rachelmarie,F,100,23,0,23
Raimey,F,100,23,0,23
Rajinder,M,100,0,23,23
Rasheeta,F,100,23,0,23
Raynia,F,100,23,0,23
Rayyaan,M,100,0,23,23
Ream,F,100,23,0,23
Redena,F,100,23,0,23
Reesheda,F,100,23,0,23
Reif,M,100,0,23,23
Rekeisha,F,100,23,0,23
Reshon,M,78,5,18,23
Reston,M,100,0,23,23
Rhashad,M,100,0,23,23
Richella,F,100,23,0,23
Rikesha,F,100,23,0,23
Robertine,F,100,23,0,23
Rodeny,M,100,0,23,23
Rom,M,100,0,23,23
Romelio,M,100,0,23,23
Romil,M,100,0,23,23
Ronnah,F,100,23,0,23
Ronnelle,F,70,16,7,23
Rosamund,F,100,23,0,23
Rosebud,F,100,23,0,23
Rosemari,F,100,23,0,23
Rosemery,F,100,23,0,23
Rosse,F,100,23,0,23
Rubel,M,100,0,23,23
Rudyard,M,100,0,23,23
Ruqayah,F,100,23,0,23
Ryerson,M,100,0,23,23
Ryyan,M,100,0,23,23
Saahithi,F,100,23,0,23
Sahari,F,100,23,0,23
Sakhi,M,57,10,13,23
Sakile,F,100,23,0,23
Sakora,F,100,23,0,23
Samanthanicole,F,100,23,0,23
Sambhav,M,100,0,23,23
Sameya,F,100,23,0,23
Samica,F,100,23,0,23
Samrudh,M,100,0,23,23
Samul,M,100,0,23,23
Sansa,F,100,23,0,23
Seria,F,100,23,0,23
Serianna,F,100,23,0,23
Sesley,F,100,23,0,23
Shadaisha,F,100,23,0,23
Shaileen,F,100,23,0,23
Shakaila,F,100,23,0,23
Shakeima,F,100,23,0,23
Shakkia,F,100,23,0,23
Shamane,F,100,23,0,23
Shamarria,F,100,23,0,23
Shamelle,F,100,23,0,23
Shamirra,F,100,23,0,23
Shanekwa,F,100,23,0,23
Shanquilla,F,100,23,0,23
Shardasia,F,100,23,0,23
Sharree,F,100,23,0,23
Sharyon,F,100,23,0,23
Shawdae,F,100,23,0,23
Shawnessy,F,100,23,0,23
Shelane,F,100,23,0,23
Sheldyn,F,52,12,11,23
Shephen,M,100,0,23,23
Sheyda,F,100,23,0,23
Shotaro,M,100,0,23,23
Shureka,F,100,23,0,23
Siane,F,100,23,0,23
Silveria,F,100,23,0,23
Simyah,F,100,23,0,23
Sipriano,M,100,0,23,23
Skylea,F,100,23,0,23
Skylia,F,100,23,0,23
Soniah,F,100,23,0,23
Sovanna,F,74,17,6,23
Sravani,F,100,23,0,23
Srinithi,F,100,23,0,23
Stamatios,M,100,0,23,23
Starleigh,F,100,23,0,23
Starlisha,F,100,23,0,23
Stevenmichael,M,100,0,23,23
Sujei,F,100,23,0,23
Sukayna,F,100,23,0,23
Sumita,F,100,23,0,23
Sunjai,F,100,23,0,23
Suzet,F,100,23,0,23
Swarit,M,100,0,23,23
Tabiatha,F,100,23,0,23
Taianna,F,100,23,0,23
Taiba,F,100,23,0,23
Takendra,F,100,23,0,23
Takerria,F,100,23,0,23
Talaijah,F,100,23,0,23
Talesia,F,100,23,0,23
Tamba,F,52,12,11,23
Tambre,F,100,23,0,23
Tameesha,F,100,23,0,23
Tamron,M,78,5,18,23
Tanah,F,100,23,0,23
Tanajia,F,100,23,0,23
Tanera,F,100,23,0,23
Taniyla,F,100,23,0,23
Tannette,F,100,23,0,23
Taraj,M,100,0,23,23
Tarelle,M,100,0,23,23
Tarif,M,100,0,23,23
Tashiyah,F,100,23,0,23
Tatayanna,F,100,23,0,23
Tau,M,100,0,23,23
Tavione,M,100,0,23,23
Tayzia,F,100,23,0,23
Tazmin,F,78,18,5,23
Tejuana,F,100,23,0,23
Tekeema,F,100,23,0,23
Tekeria,F,100,23,0,23
Tenli,F,100,23,0,23
Tereatha,F,100,23,0,23
Teronica,F,100,23,0,23
Terryion,M,100,0,23,23
Tha,M,57,10,13,23
Thaliah,F,100,23,0,23
Thelton,M,100,0,23,23
Theres,F,100,23,0,23
Thida,F,100,23,0,23
Tilisa,F,100,23,0,23
Timitra,F,100,23,0,23
Timmeka,F,100,23,0,23
Timora,F,100,23,0,23
Tineke,F,100,23,0,23
Tiquana,F,100,23,0,23
Tiva,F,100,23,0,23
Traeden,M,100,0,23,23
Trayvin,M,100,0,23,23
Tress,F,100,23,0,23
Trinati,F,100,23,0,23
Troylene,F,100,23,0,23
Tryan,M,100,0,23,23
Tulia,F,100,23,0,23
Tyena,F,100,23,0,23
Tykim,M,100,0,23,23
Tyone,M,100,0,23,23
Typhani,F,100,23,0,23
Tyquann,M,100,0,23,23
Tyrence,M,100,0,23,23
Tyshira,F,100,23,0,23
Ulyess,M,100,0,23,23
Valeka,F,100,23,0,23
Valerieann,F,100,23,0,23
Vannida,F,100,23,0,23
Vassilios,M,100,0,23,23
Vaunda,F,100,23,0,23
Venba,F,100,23,0,23
Venton,M,100,0,23,23
Vibhu,M,100,0,23,23
Vidette,F,100,23,0,23
Vyshnavi,F,100,23,0,23
Vyvian,F,100,23,0,23
Waden,M,100,0,23,23
Wakita,F,100,23,0,23
Wale,M,100,0,23,23
Walesca,F,100,23,0,23
Weaver,M,100,0,23,23
Wilberta,F,100,23,0,23
Wilferd,M,100,0,23,23
Wraith,M,100,0,23,23
Wriley,M,52,11,12,23
Wwilliam,M,100,0,23,23
Wynde,F,100,23,0,23
Xaeden,M,100,0,23,23
Xina,F,100,23,0,23
Xzayden,M,100,0,23,23
Yachi,F,100,23,0,23
Yadrian,M,100,0,23,23
Yalexi,F,100,23,0,23
Yamilez,F,100,23,0,23
Yandy,M,52,11,12,23
Yasim,M,100,0,23,23
Yaxeni,F,100,23,0,23
Yeraldo,M,100,0,23,23
Yissochor,M,100,0,23,23
Yoandry,M,100,0,23,23
Yordano,M,100,0,23,23
Yowanda,F,100,23,0,23
Zahia,F,100,23,0,23
Zaiven,M,100,0,23,23
Zaylaa,F,100,23,0,23
Zeon,M,100,0,23,23
Zepplin,M,100,0,23,23
Zerion,M,100,0,23,23
Zhanee,F,100,23,0,23
Zoeylynn,F,100,23,0,23
Zyera,F,100,23,0,23
Aaliyahmarie,F,100,22,0,22
Aaqib,M,100,0,22,22
Aarick,M,100,0,22,22
Aaronn,M,100,0,22,22
Abaan,M,100,0,22,22
Abbeygale,F,100,22,0,22
Abdirashid,M,100,0,22,22
Abdulelah,M,100,0,22,22
Abdulmajeed,M,100,0,22,22
Abhilash,M,100,0,22,22
Abigeal,F,100,22,0,22
Abinadi,M,100,0,22,22
Abrah,F,100,22,0,22
Aceon,M,100,0,22,22
Adaysia,F,100,22,0,22
Addelin,F,100,22,0,22
Addileigh,F,100,22,0,22
Adrihanna,F,100,22,0,22
Adriyel,M,100,0,22,22
Adylan,F,100,22,0,22
Ahleena,F,100,22,0,22
Ajala,F,100,22,0,22
Akilan,M,100,0,22,22
Ako,M,100,0,22,22
Aldana,F,100,22,0,22
Aleha,F,100,22,0,22
Alekai,M,100,0,22,22
Alekzandr,M,100,0,22,22
Alesander,M,100,0,22,22
Alexanda,F,100,22,0,22
Alexicia,F,100,22,0,22
Aleyla,F,100,22,0,22
Alfretta,F,100,22,0,22
Algirdas,M,100,0,22,22
Alieza,F,100,22,0,22
Alilyana,F,100,22,0,22
Alivyah,F,100,22,0,22
Allanmichael,M,100,0,22,22
Alvinia,F,100,22,0,22
Alysan,F,100,22,0,22
Alyvea,F,100,22,0,22
Amariee,F,100,22,0,22
Ameiah,F,100,22,0,22
Aminatou,F,100,22,0,22
Analey,F,100,22,0,22
Anana,F,100,22,0,22
Anansa,F,100,22,0,22
Anastasi,F,100,22,0,22
Andalasia,F,100,22,0,22
Angelete,F,100,22,0,22
Angelluis,M,100,0,22,22
Anggie,F,100,22,0,22
Aniiya,F,100,22,0,22
Anir,M,100,0,22,22
Annas,M,100,0,22,22
Anndy,M,100,0,22,22
Annesley,F,100,22,0,22
Annorah,F,100,22,0,22
Anquenette,F,100,22,0,22
Antoinnette,F,100,22,0,22
Anujin,F,100,22,0,22
Anvit,M,100,0,22,22
Anyce,F,100,22,0,22
Apiphany,F,100,22,0,22
Aquanette,F,100,22,0,22
Arcely,F,100,22,0,22
Ardythe,F,100,22,0,22
Arianda,F,100,22,0,22
Ariebella,F,100,22,0,22
Ariena,F,100,22,0,22
Arinzechukwu,M,100,0,22,22
Arionah,F,100,22,0,22
Aristede,M,100,0,22,22
Arlethe,F,100,22,0,22
Armenda,F,100,22,0,22
Arnesh,M,100,0,22,22
Aseneth,F,100,22,0,22
Atasia,F,100,22,0,22
Auzhane,F,100,22,0,22
Averell,M,100,0,22,22
Averleigh,F,100,22,0,22
Awbree,F,100,22,0,22
Ayak,F,100,22,0,22
Aydric,M,100,0,22,22
Ayzlee,F,100,22,0,22
Azaylah,F,100,22,0,22
Azuredee,F,100,22,0,22
Bama,F,100,22,0,22
Barnes,M,100,0,22,22
Barrick,M,100,0,22,22
Baxley,F,55,12,10,22
Bijoux,F,100,22,0,22
Birkley,F,100,22,0,22
Bittany,F,100,22,0,22
Borys,M,100,0,22,22
Braddox,M,100,0,22,22
Brene,F,100,22,0,22
Brinya,F,100,22,0,22
Briscoe,M,100,0,22,22
Brishae,F,100,22,0,22
Britthany,F,100,22,0,22
Brittnany,F,100,22,0,22
Bronna,F,100,22,0,22
Burgandi,F,100,22,0,22
Cailynne,F,100,22,0,22
Caitlynd,F,100,22,0,22
Calisse,F,100,22,0,22
Canelo,M,100,0,22,22
Caprica,F,100,22,0,22
Caridee,F,100,22,0,22
Carlesia,F,100,22,0,22
Carryn,F,100,22,0,22
Cathren,F,100,22,0,22
Caycen,M,100,0,22,22
Cayl,M,100,0,22,22
Celio,M,100,0,22,22
Ceona,F,100,22,0,22
Champale,F,100,22,0,22
Chantice,F,100,22,0,22
Charlemagne,M,73,6,16,22
Charliann,F,100,22,0,22
Charneice,F,100,22,0,22
Charnique,F,100,22,0,22
Chasse,M,100,0,22,22
Cheisea,F,100,22,0,22
Chelene,F,100,22,0,22
Chiaki,F,100,22,0,22
Chikezie,M,100,0,22,22
Chrissette,F,100,22,0,22
Christany,F,100,22,0,22
Christianjacob,M,100,0,22,22
Christianjoseph,M,100,0,22,22
Chrostopher,M,100,0,22,22
Chryel,F,100,22,0,22
Ciyanna,F,100,22,0,22
Clairese,F,100,22,0,22
Claybon,M,100,0,22,22
Cleason,M,100,0,22,22
Coddy,M,100,0,22,22
Coel,M,100,0,22,22
Columbia,F,100,22,0,22
Constancio,M,100,0,22,22
Corabella,F,100,22,0,22
Corea,F,100,22,0,22
Corlyn,F,100,22,0,22
Corneal,M,100,0,22,22
Crystral,F,100,22,0,22
Cuitlahuac,M,100,0,22,22
Curtrina,F,100,22,0,22
Dacorion,M,100,0,22,22
Dalice,F,100,22,0,22
Dalonta,M,100,0,22,22
Dalvon,M,100,0,22,22
Damonn,M,100,0,22,22
Daniylah,F,100,22,0,22
Dantwan,M,100,0,22,22
Danyette,F,100,22,0,22
Darce,F,100,22,0,22
Darelene,F,100,22,0,22
Darrlyn,M,100,0,22,22
Darryus,M,100,0,22,22
Daryanna,F,100,22,0,22
Daureen,F,100,22,0,22
Dawnel,F,100,22,0,22
Dawone,M,100,0,22,22
Dawoud,M,100,0,22,22
Dayah,F,100,22,0,22
Dayshawna,F,100,22,0,22
Deenah,F,100,22,0,22
Deesha,F,100,22,0,22
Deiontay,M,100,0,22,22
Dejesus,M,100,0,22,22
Dekel,M,100,0,22,22
Dekevion,M,100,0,22,22
Delfred,M,100,0,22,22
Demariyah,F,100,22,0,22
Demarre,M,100,0,22,22
Demosthenes,M,100,0,22,22
Denetrice,F,100,22,0,22
Denysha,F,100,22,0,22
Deprise,F,100,22,0,22
Dequanta,M,100,0,22,22
Deris,M,100,0,22,22
Derrionna,F,100,22,0,22
Derwyn,M,100,0,22,22
Deshai,F,100,22,0,22
Deshira,F,100,22,0,22
Desmonique,F,100,22,0,22
Deuntay,M,100,0,22,22
Devren,M,100,0,22,22
Dewin,M,100,0,22,22
Dezion,M,100,0,22,22
Dezjuan,M,100,0,22,22
Dezlynn,F,100,22,0,22
Dieu,F,100,22,0,22
Dmetri,M,100,0,22,22
Dnaja,F,100,22,0,22
Dniel,M,100,0,22,22
Dollye,F,100,22,0,22
Dometrius,M,100,0,22,22
Dominek,M,77,5,17,22
Dony,M,100,0,22,22
Doreon,M,100,0,22,22
Dorothyann,F,100,22,0,22
Dorrion,M,100,0,22,22
Doruk,M,100,0,22,22
Doshie,F,100,22,0,22
Drelan,M,100,0,22,22
Drilon,M,100,0,22,22
Du,M,100,0,22,22
Dubois,M,100,0,22,22
Dwuan,M,100,0,22,22
Dynetta,F,100,22,0,22
Ebru,F,100,22,0,22
Ekamveer,M,100,0,22,22
Elay,M,100,0,22,22
Elnor,F,100,22,0,22
Elpida,F,100,22,0,22
Emilyjo,F,100,22,0,22
Emmiline,F,100,22,0,22
Emric,M,100,0,22,22
Enajah,F,100,22,0,22
Enayah,F,100,22,0,22
Enslie,F,100,22,0,22
Erioluwa,F,55,12,10,22
Escarlett,F,100,22,0,22
Etrulia,F,100,22,0,22
Euniqua,F,100,22,0,22
Eustaquio,M,100,0,22,22
Fatmah,F,100,22,0,22
Favion,M,100,0,22,22
Fayola,F,100,22,0,22
Fillip,M,100,0,22,22
Floriana,F,100,22,0,22
Fulgencio,M,100,0,22,22
Garr,M,100,0,22,22
Geneses,F,100,22,0,22
Gennett,F,100,22,0,22
Gentrie,F,100,22,0,22
Genysis,F,100,22,0,22
Gerie,F,100,22,0,22
Gerrid,M,100,0,22,22
Ghianna,F,100,22,0,22
Gin,M,68,7,15,22
Gindy,F,100,22,0,22
Glenden,M,100,0,22,22
Glenita,F,100,22,0,22
Guinivere,F,100,22,0,22
Guner,M,100,0,22,22
Gurdeep,M,100,0,22,22
Hawanya,F,100,22,0,22
Hela,F,100,22,0,22
Heladio,M,100,0,22,22
Heleen,F,100,22,0,22
Hemant,M,100,0,22,22
Henessey,F,100,22,0,22
Hennie,F,100,22,0,22
Heylin,F,100,22,0,22
Hezikiah,M,100,0,22,22
Hideki,M,100,0,22,22
Hikma,F,100,22,0,22
Hillory,F,100,22,0,22
Hopelyn,F,100,22,0,22
Hovannes,M,100,0,22,22
Hrag,M,100,0,22,22
Huynh,M,100,0,22,22
Hylan,M,100,0,22,22
Idelia,F,100,22,0,22
Ijahnae,F,100,22,0,22
Iline,F,100,22,0,22
Illeanna,F,100,22,0,22
Imagene,F,100,22,0,22
Inderjit,M,100,0,22,22
Innocent,M,100,0,22,22
Irvan,M,100,0,22,22
Isah,M,77,5,17,22
Italie,F,100,22,0,22
Izahia,M,100,0,22,22
Jaason,M,100,0,22,22
Jackelinne,F,100,22,0,22
Jacquisha,F,100,22,0,22
Jadaan,M,100,0,22,22
Jadel,M,100,0,22,22
Jaemon,M,100,0,22,22
Jaeya,F,100,22,0,22
Jahia,F,100,22,0,22
Jaimelynn,F,100,22,0,22
Jajaun,M,100,0,22,22
Jamellah,F,100,22,0,22
Jamesdean,M,100,0,22,22
Jametra,F,100,22,0,22
Janacia,F,100,22,0,22
Janeeka,F,100,22,0,22
Janellen,F,100,22,0,22
Janiecia,F,100,22,0,22
Janielys,F,100,22,0,22
Janii,F,100,22,0,22
Jaretta,F,100,22,0,22
Jarieliz,F,100,22,0,22
Jarquise,M,100,0,22,22
Javetta,F,100,22,0,22
Jayjuan,M,100,0,22,22
Jayva,F,100,22,0,22
Jeann,F,100,22,0,22
Jelon,M,100,0,22,22
Jennarose,F,100,22,0,22
Jenniyah,F,100,22,0,22
Jer,F,55,12,10,22
Jeremaiah,M,100,0,22,22
Jerison,M,100,0,22,22
Jerrah,F,100,22,0,22
Jerrye,F,100,22,0,22
Jesseray,M,100,0,22,22
Jesses,M,100,0,22,22
Jeylan,M,73,6,16,22
Jiannah,F,100,22,0,22
Jillion,F,100,22,0,22
Jimika,F,100,22,0,22
Jimm,M,100,0,22,22
Jimmel,M,100,0,22,22
Jl,M,100,0,22,22
Jnia,F,100,22,0,22
Joandra,F,100,22,0,22
Jollene,F,100,22,0,22
Jonethan,M,100,0,22,22
Jonine,F,100,22,0,22
Jonithan,M,100,0,22,22
Jonylah,F,100,22,0,22
Joskar,M,100,0,22,22
Julliet,F,100,22,0,22
Justi,F,77,17,5,22
Jwana,F,100,22,0,22
Jyah,F,100,22,0,22
Jylen,M,100,0,22,22
Jyran,M,100,0,22,22
Jyshawn,M,100,0,22,22
Kadarian,M,100,0,22,22
Kadiedra,F,100,22,0,22
Kaed,M,100,0,22,22
Kahekili,M,100,0,22,22
Kahleesi,F,100,22,0,22
Kahmora,F,100,22,0,22
Kahniya,F,100,22,0,22
Kailub,M,100,0,22,22
Kalieah,F,100,22,0,22
Kaline,F,100,22,0,22
Kaliyha,F,100,22,0,22
Kallel,M,100,0,22,22
Kamaiyah,F,100,22,0,22
Kamaren,M,100,0,22,22
Kamauria,F,100,22,0,22
Kamina,F,100,22,0,22
Karinah,F,100,22,0,22
Karsha,F,100,22,0,22
Kasady,F,100,22,0,22
Kaselyn,F,100,22,0,22
Kataliyah,F,100,22,0,22
Kawanis,F,100,22,0,22
Kayeloni,F,100,22,0,22
Kaytlinn,F,100,22,0,22
Kazlyn,F,100,22,0,22
Keagyn,F,50,11,11,22
Kealia,F,100,22,0,22
Keannah,F,100,22,0,22
Keanne,F,100,22,0,22
Kearrah,F,100,22,0,22
Kedwin,M,100,0,22,22
Keelah,F,100,22,0,22
Keishona,F,100,22,0,22
Keley,F,100,22,0,22
Kemarie,F,100,22,0,22
Kendriana,F,100,22,0,22
Kenjiro,M,100,0,22,22
Kentrice,F,100,22,0,22
Keondrae,M,100,0,22,22
Keonne,M,100,0,22,22
Kerven,M,100,0,22,22
Keshea,F,100,22,0,22
Keshondra,F,100,22,0,22
Keslynn,F,100,22,0,22
Kestutis,M,100,0,22,22
Keynen,M,100,0,22,22
Khadijat,F,100,22,0,22
Khamaya,F,100,22,0,22
Khamiah,F,100,22,0,22
Khing,M,100,0,22,22
Khristiana,F,100,22,0,22
Kiairra,F,100,22,0,22
Kiersta,F,100,22,0,22
Kilen,M,100,0,22,22
Kinsee,F,100,22,0,22
Kinyata,F,100,22,0,22
Kipley,M,100,0,22,22
Kiyaan,M,100,0,22,22
Knoelle,F,100,22,0,22
Koalii,M,100,0,22,22
Kohlten,M,100,0,22,22
Kornelia,F,100,22,0,22
Kouki,M,100,0,22,22
Kouta,M,100,0,22,22
Kouture,F,100,22,0,22
Krag,M,100,0,22,22
Krisean,M,100,0,22,22
Kristey,F,100,22,0,22
Kristijan,M,100,0,22,22
Kristn,F,100,22,0,22
Krystalee,F,100,22,0,22
Ku,M,100,0,22,22
Kwamel,M,100,0,22,22
Kyante,M,77,5,17,22
Kyiara,F,100,22,0,22
Kyly,F,100,22,0,22
Kystal,F,100,22,0,22
Lacandice,F,100,22,0,22
Lacricia,F,100,22,0,22
Laderrion,M,100,0,22,22
Ladonta,M,100,0,22,22
Laif,M,100,0,22,22
Lakida,F,100,22,0,22
Lale,F,100,22,0,22
Lamayah,F,100,22,0,22
Lameca,F,100,22,0,22
Lamecca,F,100,22,0,22
Lamecia,F,100,22,0,22
Larimar,F,100,22,0,22
Lashayna,F,100,22,0,22
Lashel,F,100,22,0,22
Latarya,F,100,22,0,22
Latigra,F,100,22,0,22
Laton,M,100,0,22,22
Latres,F,100,22,0,22
Latreva,F,100,22,0,22
Lavesha,F,100,22,0,22
Lavett,F,100,22,0,22
Lawonna,F,100,22,0,22
Leamsi,F,100,22,0,22
Leaundra,F,100,22,0,22
Leeyana,F,100,22,0,22
Lefty,M,100,0,22,22
Leighan,F,100,22,0,22
Leiyana,F,100,22,0,22
Lelsie,F,100,22,0,22
Lendsey,F,100,22,0,22
Letrisha,F,100,22,0,22
Leveah,F,100,22,0,22
Lillibeth,F,100,22,0,22
Liyu,F,100,22,0,22
Locklynn,F,100,22,0,22
Lokesh,M,100,0,22,22
Luciella,F,100,22,0,22
Luisalfredo,M,100,0,22,22
Luvinia,F,100,22,0,22
Lyllah,F,100,22,0,22
Lyndsea,F,100,22,0,22
Lynlie,F,100,22,0,22
Lynnaya,F,100,22,0,22
Lyrissa,F,100,22,0,22
Madeley,F,100,22,0,22
Madlin,F,100,22,0,22
Madoxx,M,100,0,22,22
Magdelene,F,100,22,0,22
Maitreyi,F,100,22,0,22
Maiysha,F,100,22,0,22
Majerle,F,100,22,0,22
Makei,M,100,0,22,22
Makiyha,F,100,22,0,22
Makylia,F,100,22,0,22
Malicah,M,100,0,22,22
Mamoun,M,100,0,22,22
Manik,M,100,0,22,22
Manvel,M,100,0,22,22
Maran,F,100,22,0,22
Marcangelo,M,100,0,22,22
Marcile,F,100,22,0,22
Margarida,F,100,22,0,22
Marleina,F,100,22,0,22
Marqueis,M,100,0,22,22
Maryemma,F,100,22,0,22
Marzia,F,100,22,0,22
Mashala,F,100,22,0,22
Masina,F,100,22,0,22
Mateah,F,100,22,0,22
Mavel,F,100,22,0,22
Maybrie,F,100,22,0,22
Mazee,F,100,22,0,22
Mcgarrett,M,100,0,22,22
Mckayle,F,100,22,0,22
Megh,M,100,0,22,22
Mehan,F,100,22,0,22
Memphys,M,77,5,17,22
Menda,F,100,22,0,22
Meritt,F,50,11,11,22
Meritxell,F,100,22,0,22
Micaya,F,100,22,0,22
Mich,M,100,0,22,22
Mida,F,100,22,0,22
Mie,F,100,22,0,22
Mihael,M,100,0,22,22
Minetta,F,100,22,0,22
Minsa,F,100,22,0,22
Mirae,F,100,22,0,22
Mirelys,F,100,22,0,22
Mistique,F,100,22,0,22
Momar,M,100,0,22,22
Moniyah,F,100,22,0,22
Monnette,F,100,22,0,22
Morrissey,M,77,5,17,22
Mosheh,M,100,0,22,22
Munachi,F,50,11,11,22
Murna,F,100,22,0,22
Mystikal,M,77,5,17,22
Naadir,M,100,0,22,22
Naavya,F,100,22,0,22
Naden,M,100,0,22,22
Nadjah,F,100,22,0,22
Naibe,F,100,22,0,22
Nakeyah,F,100,22,0,22
Nakie,M,64,8,14,22
Nakirah,F,100,22,0,22
Narain,M,100,0,22,22
Narayana,M,77,5,17,22
Nasiem,M,100,0,22,22
Natavion,M,100,0,22,22
Natiley,F,100,22,0,22
Natoyia,F,100,22,0,22
Nauman,M,100,0,22,22
Neiba,F,100,22,0,22
Ni,F,100,22,0,22
Nicolee,F,100,22,0,22
Nierra,F,100,22,0,22
Nineveh,F,100,22,0,22
Noomi,F,100,22,0,22
Noreli,F,100,22,0,22
Nyiema,F,100,22,0,22
Nylla,F,100,22,0,22
Nytasia,F,100,22,0,22
Obianuju,F,100,22,0,22
Olivine,F,100,22,0,22
Omera,F,100,22,0,22
Oonagh,F,100,22,0,22
Osheanna,F,100,22,0,22
Osinachi,M,100,0,22,22
Ovella,F,100,22,0,22
Ozmar,M,100,0,22,22
Pabel,M,100,0,22,22
Padee,F,100,22,0,22
Panos,M,100,0,22,22
Pansey,F,100,22,0,22
Pashen,F,100,22,0,22
Pasqualino,M,100,0,22,22
Patericia,F,100,22,0,22
Patriciann,F,100,22,0,22
Patrika,F,100,22,0,22
Pattyann,F,100,22,0,22
Paulanne,F,100,22,0,22
Paulos,M,100,0,22,22
Paxtin,M,100,0,22,22
Pearlina,F,100,22,0,22
Pelham,M,100,0,22,22
Pemberley,F,100,22,0,22
Phylecia,F,100,22,0,22
Pnina,F,100,22,0,22
Pollyanne,F,100,22,0,22
Porfiria,F,100,22,0,22
Pranaya,F,100,22,0,22
Pratt,M,100,0,22,22
Priscylla,F,100,22,0,22
Punit,M,100,0,22,22
Qasem,M,100,0,22,22
Qays,M,100,0,22,22
Quasir,M,100,0,22,22
Quaveon,M,100,0,22,22
Quiton,M,100,0,22,22
Qunita,F,100,22,0,22
Radarius,M,100,0,22,22
Radene,F,100,22,0,22
Raegene,F,100,22,0,22
Raengel,F,100,22,0,22
Raimon,M,100,0,22,22
Raishaun,M,100,0,22,22
Rajene,F,100,22,0,22
Rakhee,F,100,22,0,22
Rakyia,F,100,22,0,22
Ramelle,F,50,11,11,22
Ramero,M,100,0,22,22
Randelle,F,100,22,0,22
Randine,F,100,22,0,22
Rashona,F,100,22,0,22
Rawda,F,100,22,0,22
Raynier,M,100,0,22,22
Rayshan,M,100,0,22,22
Regeina,F,100,22,0,22
Regional,M,100,0,22,22
Renetha,F,100,22,0,22
Renotta,F,100,22,0,22
Requita,F,100,22,0,22
Revell,M,100,0,22,22
Revon,M,100,0,22,22
Richardean,F,100,22,0,22
Richi,M,100,0,22,22
Riena,F,100,22,0,22
Rinna,F,100,22,0,22
Ritaann,F,100,22,0,22
Robroy,M,100,0,22,22
Ronneka,F,100,22,0,22
Roody,M,100,0,22,22
Roshena,F,100,22,0,22
Roshod,M,100,0,22,22
Rosselin,F,100,22,0,22
Rual,M,100,0,22,22
Rubab,F,100,22,0,22
Rupesh,M,100,0,22,22
Rustina,F,100,22,0,22
Ruwaida,F,100,22,0,22
Ryleighann,F,100,22,0,22
Saavan,M,100,0,22,22
Safeer,M,100,0,22,22
Samaire,F,100,22,0,22
Sambath,M,100,0,22,22
Samvit,M,100,0,22,22
Santoya,F,100,22,0,22
Saribel,F,100,22,0,22
Sarynity,F,100,22,0,22
Saviyon,M,100,0,22,22
Savona,F,100,22,0,22
Savone,M,100,0,22,22
Scoey,M,100,0,22,22
Scotte,M,100,0,22,22
Selamawit,F,100,22,0,22
Sen,M,100,0,22,22
Shaban,M,100,0,22,22
Shadreka,F,100,22,0,22
Shaker,M,100,0,22,22
Shakiela,F,100,22,0,22
Shamire,F,55,12,10,22
Shaneqwa,F,100,22,0,22
Shaniesha,F,100,22,0,22
Shantaria,F,100,22,0,22
Share,F,100,22,0,22
Shareema,F,100,22,0,22
Sharette,F,100,22,0,22
Sharlita,F,100,22,0,22
Sharrion,F,100,22,0,22
Shatorria,F,100,22,0,22
Shawndre,M,100,0,22,22
Shawndrika,F,100,22,0,22
Shaynia,F,100,22,0,22
Sheldan,M,100,0,22,22
Shelicia,F,100,22,0,22
Shelma,F,100,22,0,22
Sheniyah,F,100,22,0,22
Sheriyah,F,100,22,0,22
Shernice,F,100,22,0,22
Sherona,F,100,22,0,22
Shlanda,F,100,22,0,22
Shondi,F,100,22,0,22
Shonelle,F,100,22,0,22
Shontal,F,100,22,0,22
Shontrice,F,100,22,0,22
Shunteria,F,100,22,0,22
Siclaly,F,100,22,0,22
Siiri,F,100,22,0,22
Sing,M,77,5,17,22
Siobhain,F,100,22,0,22
Skylla,F,100,22,0,22
Slaten,M,100,0,22,22
Sofiana,F,100,22,0,22
Soliman,M,100,0,22,22
Solomone,M,100,0,22,22
Sophat,M,100,0,22,22
Sreeram,M,100,0,22,22
Sreyas,M,100,0,22,22
Stanna,F,100,22,0,22
Stavro,M,100,0,22,22
Steban,M,100,0,22,22
Steffie,F,100,22,0,22
Stosh,M,100,0,22,22
Suah,F,100,22,0,22
Suanna,F,100,22,0,22
Sujit,M,100,0,22,22
Sumera,F,100,22,0,22
Sunda,F,100,22,0,22
Surbhi,F,100,22,0,22
Sureya,F,100,22,0,22
Symmone,F,100,22,0,22
Syrae,F,100,22,0,22
Taio,M,100,0,22,22
Taiwanna,F,100,22,0,22
Tajaun,M,100,0,22,22
Takhi,M,100,0,22,22
Taleesa,F,100,22,0,22
Talhah,M,100,0,22,22
Talisia,F,100,22,0,22
Tamare,M,55,10,12,22
Tamatoa,M,100,0,22,22
Tamiqua,F,100,22,0,22
Tammer,M,100,0,22,22
Tamzin,F,100,22,0,22
Tanaiyah,F,100,22,0,22
Tangella,F,100,22,0,22
Tangila,F,100,22,0,22
Tarak,M,100,0,22,22
Tashekia,F,100,22,0,22
Tavarez,M,100,0,22,22
Taviona,F,100,22,0,22
Tawnni,F,100,22,0,22
Taydin,M,100,0,22,22
Taylorrae,F,100,22,0,22
Teisa,F,100,22,0,22
Tekara,F,100,22,0,22
Telana,F,100,22,0,22
Temarion,M,100,0,22,22
Tessalyn,F,100,22,0,22
Texanna,F,100,22,0,22
Thasha,F,100,22,0,22
Thelda,F,100,22,0,22
Theodric,M,100,0,22,22
Thornell,M,100,0,22,22
Threase,F,100,22,0,22
Tiawna,F,100,22,0,22
Tikki,F,100,22,0,22
Tiosha,F,100,22,0,22
Tirek,M,100,0,22,22
Tomeki,F,100,22,0,22
Tomico,F,100,22,0,22
Toprak,M,100,0,22,22
Toyya,F,100,22,0,22
Traiton,M,100,0,22,22
Traneisha,F,100,22,0,22
Tranita,F,100,22,0,22
Trauis,M,100,0,22,22
Trelynn,M,55,10,12,22
Trennis,M,100,0,22,22
Trevi,F,100,22,0,22
Trevond,M,100,0,22,22
Trevoris,M,100,0,22,22
Triona,F,100,22,0,22
Trishawn,F,55,12,10,22
Trison,M,100,0,22,22
Tristaca,F,100,22,0,22
Tunja,F,100,22,0,22
Tylaya,F,100,22,0,22
Tymaine,M,100,0,22,22
Tyrane,M,100,0,22,22
Tyranny,F,100,22,0,22
Tyrei,M,100,0,22,22
Tyrico,M,100,0,22,22
Ulrike,F,100,22,0,22
Ulysis,M,100,0,22,22
Vahid,M,100,0,22,22
Valenica,F,100,22,0,22
Valesha,F,100,22,0,22
Vardan,M,100,0,22,22
Veeda,F,100,22,0,22
Veniece,F,100,22,0,22
Verenisse,F,100,22,0,22
Vernest,M,100,0,22,22
Vicotria,F,100,22,0,22
Victorialynn,F,100,22,0,22
Vindhya,F,100,22,0,22
Wafi,M,100,0,22,22
Wanye,M,100,0,22,22
Wesely,M,100,0,22,22
Wilborn,M,100,0,22,22
Willesha,F,100,22,0,22
Willilam,M,100,0,22,22
Winette,F,100,22,0,22
Wong,M,100,0,22,22
Wwlliam,M,100,0,22,22
Wyetta,F,100,22,0,22
Xymena,F,100,22,0,22
Yadon,M,100,0,22,22
Yaitza,F,100,22,0,22
Yanika,F,100,22,0,22
Yanill,F,100,22,0,22
Yasmeena,F,100,22,0,22
Yasmim,F,100,22,0,22
Yeniel,M,100,0,22,22
Yesenya,F,100,22,0,22
Ylana,F,100,22,0,22
Ylenia,F,100,22,0,22
Ymelda,F,100,22,0,22
Yorman,M,100,0,22,22
Yoshiki,M,100,0,22,22
Yosvani,M,100,0,22,22
Yuly,F,100,22,0,22
Yunalesca,F,100,22,0,22
Yuraima,F,100,22,0,22
Zacharry,M,100,0,22,22
Zaileigh,F,100,22,0,22
Zameir,M,100,0,22,22
Zariha,F,100,22,0,22
Ze,M,100,0,22,22
Zeddicus,M,100,0,22,22
Zevi,M,100,0,22,22
Zeyda,F,100,22,0,22
Zhia,F,100,22,0,22
Zinna,F,100,22,0,22
Zoeh,F,100,22,0,22
Zyniya,F,100,22,0,22
Zyrielle,F,100,22,0,22
Aabha,F,100,21,0,21
Aaima,F,100,21,0,21
Aalanah,F,100,21,0,21
Aaliyaha,F,100,21,0,21
Aaronjohn,M,100,0,21,21
Abdikarim,M,100,0,21,21
Abiah,F,100,21,0,21
Abigayil,F,100,21,0,21
Abubakarr,M,100,0,21,21
Achsah,F,100,21,0,21
Addan,M,100,0,21,21
Aderinsola,F,100,21,0,21
Adilena,F,100,21,0,21
Adlemi,F,100,21,0,21
Adoniram,M,100,0,21,21
Adorabella,F,100,21,0,21
Adree,F,100,21,0,21
Adreian,M,100,0,21,21
Advita,F,100,21,0,21
Agathe,F,100,21,0,21
Agigail,F,100,21,0,21
Ahzir,M,100,0,21,21
Aichatou,F,100,21,0,21
Airalynn,F,100,21,0,21
Airick,M,100,0,21,21
Akara,F,100,21,0,21
Alaizah,F,100,21,0,21
Alaxandra,F,100,21,0,21
Alaza,F,100,21,0,21
Alema,M,100,0,21,21
Alexandriah,F,100,21,0,21
Alhia,F,100,21,0,21
Aliciah,F,100,21,0,21
Alilia,F,100,21,0,21
Allaire,F,100,21,0,21
Allianah,F,100,21,0,21
Alvyn,M,100,0,21,21
Amarely,F,100,21,0,21
Americas,F,100,21,0,21
Ameriya,F,100,21,0,21
Amissa,F,100,21,0,21
Anaili,F,100,21,0,21
Anastaysia,F,100,21,0,21
Andhy,M,100,0,21,21
Andrejs,M,100,0,21,21
Angline,F,100,21,0,21
Anielka,F,100,21,0,21
Anirah,F,100,21,0,21
Anirvin,M,100,0,21,21
Annaleece,F,100,21,0,21
Annam,F,100,21,0,21
Annastin,F,100,21,0,21
Annesia,F,100,21,0,21
Annettie,F,100,21,0,21
Annum,F,100,21,0,21
Anoush,F,100,21,0,21
Anrew,M,100,0,21,21
Ansa,F,100,21,0,21
Anyha,F,100,21,0,21
Arcenia,F,100,21,0,21
Aree,F,76,16,5,21
Areisy,F,100,21,0,21
Areyona,F,100,21,0,21
Arnaz,M,100,0,21,21
Arreanna,F,100,21,0,21
Aryhanna,F,100,21,0,21
Ashai,F,71,15,6,21
Ashantii,F,100,21,0,21
Ashwaq,F,100,21,0,21
Asyiah,F,100,21,0,21
Atavion,M,100,0,21,21
Aubreonna,F,100,21,0,21
Avanell,F,100,21,0,21
Avenleigh,F,100,21,0,21
Aveona,F,100,21,0,21
Aveonna,F,100,21,0,21
Avianne,F,100,21,0,21
Azirah,F,100,21,0,21
Azyla,F,100,21,0,21
Babe,M,100,0,21,21
Balke,M,100,0,21,21
Bamidele,M,100,0,21,21
Baudelia,F,100,21,0,21
Benjamim,M,100,0,21,21
Berenisse,F,100,21,0,21
Berma,F,100,21,0,21
Berra,F,100,21,0,21
Bethsy,F,100,21,0,21
Biatriz,F,100,21,0,21
Blease,M,100,0,21,21
Bonnell,F,100,21,0,21
Braijon,M,100,0,21,21
Branddon,M,100,0,21,21
Brandonjames,M,100,0,21,21
Breajah,F,100,21,0,21
Breaun,F,76,16,5,21
Bretten,M,100,0,21,21
Brichelle,F,100,21,0,21
Briela,F,100,21,0,21
Bronze,M,100,0,21,21
Cabrielle,F,100,21,0,21
Cadrian,M,52,10,11,21
Caetlyn,F,100,21,0,21
Caitin,F,100,21,0,21
Calex,M,100,0,21,21
Calvion,M,100,0,21,21
Camerino,M,100,0,21,21
Campbelle,F,100,21,0,21
Cariyah,F,100,21,0,21
Carloseduardo,M,100,0,21,21
Carris,F,76,16,5,21
Cashon,M,100,0,21,21
Cathalene,F,100,21,0,21
Cathrin,F,100,21,0,21
Chalres,M,100,0,21,21
Chantasia,F,100,21,0,21
Charlston,M,100,0,21,21
Charone,F,76,16,5,21
Chasidi,F,100,21,0,21
Chelseamarie,F,100,21,0,21
Chelynne,F,100,21,0,21
Cheryse,F,100,21,0,21
Chevell,F,100,21,0,21
Cheznie,F,100,21,0,21
Chiam,M,100,0,21,21
Chin,M,100,0,21,21
Chloye,F,100,21,0,21
Chona,F,100,21,0,21
Chryssa,F,100,21,0,21
Ciya,F,100,21,0,21
Clestine,F,100,21,0,21
Connye,F,100,21,0,21
Coralei,F,100,21,0,21
Cortes,M,100,0,21,21
Cristien,M,100,0,21,21
Crusita,F,100,21,0,21
Cyrine,F,100,21,0,21
Daddy,M,100,0,21,21
Dahn,F,76,16,5,21
Damato,M,100,0,21,21
Danajha,F,100,21,0,21
Danesia,F,100,21,0,21
Danieljoseph,M,100,0,21,21
Danley,M,100,0,21,21
Daquin,M,100,0,21,21
Daralynn,F,100,21,0,21
Darein,M,76,5,16,21
Darmon,M,100,0,21,21
Dashaya,F,100,21,0,21
Davasia,F,100,21,0,21
Davee,M,52,10,11,21
Dawni,F,100,21,0,21
Dayeli,F,100,21,0,21
Dazah,F,100,21,0,21
Deamontae,M,100,0,21,21
Dearon,M,100,0,21,21
Debrianna,F,100,21,0,21
Decora,F,100,21,0,21
Dejanelle,F,100,21,0,21
Dejoun,M,100,0,21,21
Dekira,F,100,21,0,21
Dekon,M,100,0,21,21
Deliza,F,100,21,0,21
Dellena,F,100,21,0,21
Demerick,M,100,0,21,21
Demorrio,M,100,0,21,21
Denaija,F,100,21,0,21
Denequa,F,100,21,0,21
Denize,F,100,21,0,21
Deonni,F,100,21,0,21
Derex,M,100,0,21,21
Deshaundra,F,100,21,0,21
Destinymarie,F,100,21,0,21
Dewayna,F,100,21,0,21
Dewyane,M,100,0,21,21
Dezhon,M,100,0,21,21
Dezmyn,M,76,5,16,21
Dharius,M,100,0,21,21
Diabolique,F,67,14,7,21
Diamani,F,100,21,0,21
Diedrich,M,100,0,21,21
Dinnie,M,76,5,16,21
Diomedes,M,100,0,21,21
Dmon,M,100,0,21,21
Donesia,F,100,21,0,21
Donza,F,100,21,0,21
Dorothe,F,100,21,0,21
Doryce,F,100,21,0,21
Dover,M,100,0,21,21
Doyla,F,100,21,0,21
Dracy,M,100,0,21,21
Drean,M,100,0,21,21
Dustn,M,100,0,21,21
Eadie,F,100,21,0,21
Elisebeth,F,100,21,0,21
Elliza,F,100,21,0,21
Ellsa,F,100,21,0,21
Elsee,F,100,21,0,21
Elzbieta,F,100,21,0,21
Emanee,F,100,21,0,21
Emanuelly,F,100,21,0,21
Emelyne,F,100,21,0,21
Emmrie,F,100,21,0,21
Emuna,F,100,21,0,21
Engrid,F,100,21,0,21
Erineo,M,100,0,21,21
Eriyon,M,52,10,11,21
Eshaun,M,100,0,21,21
Eton,M,100,0,21,21
Eveleigh,F,100,21,0,21
Fadra,F,100,21,0,21
Fain,M,71,6,15,21
Faithful,F,100,21,0,21
Fatmeh,F,100,21,0,21
Filza,F,100,21,0,21
Firdaus,F,100,21,0,21
Freddick,M,100,0,21,21
Fynleigh,F,100,21,0,21
Gajuan,M,100,0,21,21
Gavril,M,100,0,21,21
Geancarlo,M,100,0,21,21
Geannine,F,100,21,0,21
Genavee,F,100,21,0,21
Geneveive,F,100,21,0,21
Geof,M,100,0,21,21
Geremias,M,100,0,21,21
Gerrel,M,100,0,21,21
Gervon,M,100,0,21,21
Ginessa,F,100,21,0,21
Giovonna,F,100,21,0,21
Giselda,F,100,21,0,21
Giuliani,M,100,0,21,21
Graice,F,100,21,0,21
Grindle,F,100,21,0,21
Grissom,M,100,0,21,21
Haddi,F,100,21,0,21
Hadlyn,F,100,21,0,21
Hannahmae,F,100,21,0,21
Hannaley,F,100,21,0,21
Hariklia,F,100,21,0,21
Harshdeep,M,100,0,21,21
Havan,F,100,21,0,21
Hee,F,100,21,0,21
Hemanth,M,100,0,21,21
Hemma,F,100,21,0,21
Henlie,F,100,21,0,21
Hermoine,F,100,21,0,21
Herry,M,100,0,21,21
Heyley,F,100,21,0,21
Himmat,M,100,0,21,21
Honoka,F,100,21,0,21
Iayana,F,100,21,0,21
Ibin,M,100,0,21,21
Icarus,M,100,0,21,21
Ija,F,100,21,0,21
Ileyah,F,100,21,0,21
Iliah,F,100,21,0,21
In,F,76,16,5,21
Ingemar,M,100,0,21,21
Irany,F,100,21,0,21
Iric,M,100,0,21,21
Isma,F,100,21,0,21
Ives,M,100,0,21,21
Iyiana,F,100,21,0,21
Iyunna,F,100,21,0,21
Izziah,M,100,0,21,21
Jacaree,M,100,0,21,21
Jacary,M,100,0,21,21
Jackaline,F,100,21,0,21
Jacorien,M,100,0,21,21
Jacquon,M,100,0,21,21
Jadarrian,M,100,0,21,21
Jadyel,M,100,0,21,21
Jagen,M,100,0,21,21
Jagjit,M,100,0,21,21
Jahnelle,F,100,21,0,21
Jaici,F,100,21,0,21
Jaimar,M,100,0,21,21
Jainaba,F,100,21,0,21
Jaiver,M,100,0,21,21
Jakelyne,F,100,21,0,21
Jakil,M,100,0,21,21
Jakyrie,M,100,0,21,21
Jalontae,M,100,0,21,21
Jamalia,F,100,21,0,21
Jamesandrew,M,100,0,21,21
Jamesmatthew,M,100,0,21,21
Jamessa,F,100,21,0,21
Jametrius,M,100,0,21,21
Janelda,F,100,21,0,21
Janiha,F,100,21,0,21
Janilyn,F,100,21,0,21
Janyne,F,100,21,0,21
Japera,F,100,21,0,21
Jaqai,M,100,0,21,21
Jarrion,M,100,0,21,21
Jassidy,F,100,21,0,21
Javahn,M,100,0,21,21
Jawone,M,100,0,21,21
Jaydel,M,100,0,21,21
Jaylein,F,76,16,5,21
Jazzelyn,F,100,21,0,21
Jealousy,F,100,21,0,21
Jefre,M,100,0,21,21
Jehovah,M,100,0,21,21
Jelecia,F,100,21,0,21
Jelyssa,F,100,21,0,21
Jennaveve,F,100,21,0,21
Jermicheal,M,100,0,21,21
Jewlian,M,100,0,21,21
Jhaylen,M,100,0,21,21
Joele,F,100,21,0,21
Johntavis,M,100,0,21,21
Jonadab,M,100,0,21,21
Joneen,F,100,21,0,21
Jonikka,F,100,21,0,21
Joquita,F,100,21,0,21
Josecruz,M,100,0,21,21
Joston,M,100,0,21,21
Juhee,F,100,21,0,21
Jumarion,M,100,0,21,21
Juvia,F,100,21,0,21
Jynia,F,100,21,0,21
Kaashvi,F,100,21,0,21
Kadeidre,F,100,21,0,21
Kadidja,F,100,21,0,21
Kaedynn,F,76,16,5,21
Kaesin,M,100,0,21,21
Kahleil,M,100,0,21,21
Kailina,F,100,21,0,21
Kailye,F,100,21,0,21
Kaleeb,M,100,0,21,21
Kamarin,F,100,21,0,21
Karlesha,F,100,21,0,21
Karmell,M,100,0,21,21
Karriann,F,100,21,0,21
Kaselynn,F,100,21,0,21
Kashad,M,100,0,21,21
Kaspian,M,100,0,21,21
Kat,F,100,21,0,21
Kathyria,F,100,21,0,21
Kayliyah,F,100,21,0,21
Kaylup,M,100,0,21,21
Kehly,F,100,21,0,21
Kelanie,F,100,21,0,21
Kemely,F,100,21,0,21
Kennyth,M,100,0,21,21
Kenteria,F,100,21,0,21
Kentre,M,100,0,21,21
Kenye,M,100,0,21,21
Kerrah,F,100,21,0,21
Keshone,M,100,0,21,21
Ketch,M,100,0,21,21
Kevi,F,52,11,10,21
Kevins,M,100,0,21,21
Kevondre,M,100,0,21,21
Keyley,F,100,21,0,21
Keyone,M,100,0,21,21
Keyur,M,100,0,21,21
Khilan,M,100,0,21,21
Kiesa,F,100,21,0,21
Kijani,M,100,0,21,21
Koli,M,62,8,13,21
Kolsyn,M,100,0,21,21
Konye,M,100,0,21,21
Kornell,M,100,0,21,21
Krishika,F,100,21,0,21
Kristella,F,100,21,0,21
Kristoper,M,100,0,21,21
Kvaughn,M,100,0,21,21
Kyeon,M,100,0,21,21
Kymberleigh,F,100,21,0,21
Kyven,M,100,0,21,21
Ladedra,F,100,21,0,21
Ladelle,F,100,21,0,21
Ladrina,F,100,21,0,21
Lagregory,M,100,0,21,21
Laighla,F,100,21,0,21
Lajeanna,F,100,21,0,21
Lakeyda,F,100,21,0,21
Lakicia,F,100,21,0,21
Lamariya,F,100,21,0,21
Lanet,F,100,21,0,21
Lansana,M,100,0,21,21
Laporshe,F,100,21,0,21
Laqueda,F,100,21,0,21
Lareese,F,100,21,0,21
Laroderick,M,100,0,21,21
Lasharra,F,100,21,0,21
Lashaunte,F,100,21,0,21
Lassandra,F,100,21,0,21
Latece,F,100,21,0,21
Latosia,F,100,21,0,21
Latrevious,M,100,0,21,21
Latya,F,100,21,0,21
Laurn,F,100,21,0,21
Lavaria,F,100,21,0,21
Laython,M,100,0,21,21
Leiden,M,100,0,21,21
Leilanii,F,100,21,0,21
Lekeesha,F,100,21,0,21
Lennan,F,100,21,0,21
Leorah,F,100,21,0,21
Lewana,F,100,21,0,21
Lillan,F,100,21,0,21
Lilyani,F,100,21,0,21
Litsa,F,100,21,0,21
Lochlynn,F,100,21,0,21
Loralynn,F,100,21,0,21
Lotta,F,100,21,0,21
Loula,F,100,21,0,21
Lovelynn,F,100,21,0,21
Loyalti,F,100,21,0,21
Lukesha,F,100,21,0,21
Lumina,F,100,21,0,21
Lurlean,F,100,21,0,21
Lyndol,M,100,0,21,21
Maasai,M,100,0,21,21
Macye,F,100,21,0,21
Madra,F,100,21,0,21
Mahendra,M,100,0,21,21
Maianh,F,100,21,0,21
Maithili,F,100,21,0,21
Majdi,M,100,0,21,21
Makensley,F,100,21,0,21
Malieka,F,100,21,0,21
Mallari,F,100,21,0,21
Manaswini,F,100,21,0,21
Maraiah,F,100,21,0,21
Marcenia,F,100,21,0,21
Marciela,F,100,21,0,21
Mariaisabella,F,100,21,0,21
Marieo,M,100,0,21,21
Marim,F,100,21,0,21
Markon,M,100,0,21,21
Marlenie,F,100,21,0,21
Marlese,F,100,21,0,21
Maryjoan,F,100,21,0,21
Mattheau,M,100,0,21,21
Maxtyn,M,100,0,21,21
Maxxim,M,100,0,21,21
Maylasia,F,100,21,0,21
Mckaley,F,100,21,0,21
Mcneil,M,100,0,21,21
Mecia,F,100,21,0,21
Meguel,M,100,0,21,21
Meilynn,F,100,21,0,21
Meirav,F,100,21,0,21
Melandie,F,100,21,0,21
Meliek,M,100,0,21,21
Melike,F,100,21,0,21
Melynie,F,100,21,0,21
Mercedee,F,100,21,0,21
Merlynn,F,100,21,0,21
Metthew,M,100,0,21,21
Mianicole,F,100,21,0,21
Micale,M,71,6,15,21
Michaellee,M,100,0,21,21
Micheaux,M,100,0,21,21
Migna,F,100,21,0,21
Mikalee,F,100,21,0,21
Mikkos,M,100,0,21,21
Milove,F,100,21,0,21
Milt,M,100,0,21,21
Miquelle,F,100,21,0,21
Mircle,F,100,21,0,21
Mirena,F,100,21,0,21
Mital,F,76,16,5,21
Moath,M,100,0,21,21
Mobeen,M,100,0,21,21
Mondale,M,100,0,21,21
Morea,F,100,21,0,21
Motunrayo,F,100,21,0,21
Muiz,M,100,0,21,21
Musaab,M,100,0,21,21
Myaire,M,76,5,16,21
Myara,F,100,21,0,21
Myke,M,100,0,21,21
Myndee,F,100,21,0,21
Nadeline,F,100,21,0,21
Najaya,F,100,21,0,21
Najayah,F,100,21,0,21
Narges,F,100,21,0,21
Nashai,F,100,21,0,21
Nashana,F,100,21,0,21
Natalle,F,100,21,0,21
Natas,M,100,0,21,21
Nayima,F,100,21,0,21
Nebraska,F,76,16,5,21
Nechy,F,100,21,0,21
Nehorai,M,100,0,21,21
Neia,F,100,21,0,21
Nephateria,F,100,21,0,21
Nereo,M,100,0,21,21
Neshell,F,100,21,0,21
Nielah,F,100,21,0,21
Niesa,F,100,21,0,21
Nikaila,F,100,21,0,21
Nikishia,F,100,21,0,21
Nikkii,F,100,21,0,21
Niyam,M,100,0,21,21
Nohe,M,100,0,21,21
Noon,F,100,21,0,21
Noraida,F,100,21,0,21
Noralba,F,100,21,0,21
Notasha,F,100,21,0,21
Nouman,M,100,0,21,21
Nyeasha,F,100,21,0,21
Nyrobi,F,100,21,0,21
Olinka,F,100,21,0,21
Olla,F,100,21,0,21
Olufunke,F,100,21,0,21
Olukayode,M,100,0,21,21
Onye,F,100,21,0,21
Ortensia,F,100,21,0,21
Otavio,M,100,0,21,21
Oumy,F,100,21,0,21
Ovida,F,100,21,0,21
Pablito,M,100,0,21,21
Paizli,F,100,21,0,21
Pamilla,F,100,21,0,21
Pamm,F,100,21,0,21
Parmida,F,100,21,0,21
Pauli,F,100,21,0,21
Penelopy,F,100,21,0,21
Peregrin,M,100,0,21,21
Petronia,F,100,21,0,21
Peyden,F,76,16,5,21
Phatima,F,100,21,0,21
Philliph,M,100,0,21,21
Pong,M,100,0,21,21
Prayan,M,100,0,21,21
Priyansh,M,100,0,21,21
Quadirah,F,100,21,0,21
Quantaya,F,100,21,0,21
Quashonda,F,100,21,0,21
Quenia,F,100,21,0,21
Quevin,M,100,0,21,21
Quian,M,52,10,11,21
Qwinton,M,100,0,21,21
Rabiya,F,100,21,0,21
Radia,F,100,21,0,21
Raedawn,F,100,21,0,21
Ragini,F,100,21,0,21
Raheema,F,100,21,0,21
Rakelle,F,100,21,0,21
Rakem,M,100,0,21,21
Ralisha,F,100,21,0,21
Rannah,F,100,21,0,21
Rannon,M,100,0,21,21
Rashundra,F,100,21,0,21
Rashya,F,100,21,0,21
Raybon,M,100,0,21,21
Rayshaud,M,100,0,21,21
Rayshawna,F,100,21,0,21
Reachel,F,100,21,0,21
Realynn,F,100,21,0,21
Reighn,F,100,21,0,21
Reilee,F,100,21,0,21
Reinier,M,100,0,21,21
Remone,M,100,0,21,21
Renier,M,100,0,21,21
Rhoan,M,100,0,21,21
Rieanna,F,100,21,0,21
Rocelia,F,100,21,0,21
Roha,F,100,21,0,21
Romuald,M,100,0,21,21
Rondie,M,76,5,16,21
Roniah,F,100,21,0,21
Roquan,M,100,0,21,21
Rorry,M,100,0,21,21
Roudy,M,100,0,21,21
Ruzgar,M,100,0,21,21
Ryel,M,71,6,15,21
Ryilee,F,100,21,0,21
Saaid,M,100,0,21,21
Sadiemae,F,100,21,0,21
Saharrah,F,100,21,0,21
Sahibjot,M,100,0,21,21
Saija,F,100,21,0,21
Salsabil,F,100,21,0,21
Samanntha,F,100,21,0,21
Samridhi,F,100,21,0,21
Santonia,M,52,10,11,21
Santwan,M,100,0,21,21
Saraanne,F,100,21,0,21
Sargun,F,100,21,0,21
Saveena,F,100,21,0,21
Sea,M,52,10,11,21
Seniqua,F,100,21,0,21
Serafino,M,100,0,21,21
Seraph,M,71,6,15,21
Sevanah,F,100,21,0,21
Shaedon,M,100,0,21,21
Shahriar,M,100,0,21,21
Shakiea,F,100,21,0,21
Shamair,F,76,16,5,21
Shameya,F,100,21,0,21
Shamont,M,100,0,21,21
Shanada,F,100,21,0,21
Shannikia,F,100,21,0,21
Shanquia,F,100,21,0,21
Shaquania,F,100,21,0,21
Shaquise,F,100,21,0,21
Shaquonda,F,100,21,0,21
Shaqville,M,100,0,21,21
Sharrah,F,100,21,0,21
Shartavia,F,100,21,0,21
Shatonga,F,100,21,0,21
Shawnisha,F,100,21,0,21
Shecid,F,100,21,0,21
Sheenia,F,100,21,0,21
Shelbylyn,F,100,21,0,21
Sheneta,F,100,21,0,21
Sheny,F,100,21,0,21
Sherlean,F,100,21,0,21
Sherna,F,100,21,0,21
Shivesh,M,100,0,21,21
Shondia,F,100,21,0,21
Shukura,F,100,21,0,21
Shulanda,F,100,21,0,21
Shwana,F,100,21,0,21
Shyera,F,100,21,0,21
Shyesha,F,100,21,0,21
Shykia,F,100,21,0,21
Silah,F,100,21,0,21
Simryn,F,100,21,0,21
Sinea,F,100,21,0,21
Sirah,F,100,21,0,21
Sissie,F,100,21,0,21
Sivana,F,100,21,0,21
Solmarie,F,100,21,0,21
Somia,F,100,21,0,21
Sophialynn,F,100,21,0,21
Sophieann,F,100,21,0,21
Srihita,F,100,21,0,21
Sristi,F,100,21,0,21
Standly,M,100,0,21,21
Starley,F,76,16,5,21
Stepfan,M,100,0,21,21
Stephiane,F,100,21,0,21
Steveland,M,100,0,21,21
Sukhjit,M,52,10,11,21
Sunniva,F,100,21,0,21
Svana,F,100,21,0,21
Swen,M,100,0,21,21
Tadeh,M,100,0,21,21
Taevian,M,100,0,21,21
Taeylor,F,100,21,0,21
Tajmir,M,100,0,21,21
Takoma,M,100,0,21,21
Tamariah,F,100,21,0,21
Tannika,F,100,21,0,21
Tansey,F,100,21,0,21
Tanyra,F,100,21,0,21
Taquon,M,100,0,21,21
Taranika,F,100,21,0,21
Taree,F,76,16,5,21
Tarneshia,F,100,21,0,21
Tasheia,F,100,21,0,21
Tatina,F,100,21,0,21
Tavonne,M,76,5,16,21
Tekeyla,F,100,21,0,21
Telvis,M,100,0,21,21
Tember,F,100,21,0,21
Terrio,M,100,0,21,21
Teruko,F,100,21,0,21
Tervon,M,100,0,21,21
Teshauna,F,100,21,0,21
Thearsa,F,100,21,0,21
Thelonius,M,100,0,21,21
Thereas,F,100,21,0,21
Theresita,F,100,21,0,21
Tiante,F,76,16,5,21
Tikeisha,F,100,21,0,21
Tnisha,F,100,21,0,21
Tobius,M,100,0,21,21
Tomeco,F,100,21,0,21
Toshiana,F,100,21,0,21
Toshina,F,100,21,0,21
Travan,M,100,0,21,21
Trayshaun,M,100,0,21,21
Treaver,M,100,0,21,21
Treca,F,100,21,0,21
Trechelle,F,100,21,0,21
Tremia,F,100,21,0,21
Treron,M,100,0,21,21
Trotter,M,100,0,21,21
Tryg,M,100,0,21,21
Turkesha,F,100,21,0,21
Tydell,M,100,0,21,21
Tyga,M,100,0,21,21
Tylecia,F,100,21,0,21
Tymeek,M,100,0,21,21
Uryah,M,100,0,21,21
Uwais,M,100,0,21,21
Valanda,F,100,21,0,21
Valeriy,M,100,0,21,21
Veeksha,F,100,21,0,21
Verginia,F,100,21,0,21
Verniece,F,100,21,0,21
Vicken,M,100,0,21,21
Vickilynn,F,100,21,0,21
Victorea,F,100,21,0,21
Vinda,F,100,21,0,21
Vinit,M,100,0,21,21
Virjinia,F,100,21,0,21
Willoh,F,100,21,0,21
Wrenley,F,100,21,0,21
Wylliam,M,100,0,21,21
Wynesha,F,100,21,0,21
Xienna,F,100,21,0,21
Xochi,F,100,21,0,21
Xong,F,76,16,5,21
Yanielis,F,100,21,0,21
Yanieliz,F,100,21,0,21
Yasline,F,100,21,0,21
Yeshayahu,M,100,0,21,21
Yoli,F,100,21,0,21
Yoshigei,F,100,21,0,21
Youssif,M,100,0,21,21
Yuhan,F,100,21,0,21
Yuneisy,F,100,21,0,21
Yvonnda,F,100,21,0,21
Zabien,M,100,0,21,21
Zacheri,M,100,0,21,21
Zaedin,M,100,0,21,21
Zahmya,F,100,21,0,21
Zaidah,F,100,21,0,21
Zakarias,M,100,0,21,21
Zakera,F,100,21,0,21
Zalena,F,100,21,0,21
Zamyriah,F,100,21,0,21
Zanique,F,100,21,0,21
Zaviyar,M,100,0,21,21
Zayid,M,100,0,21,21
Zellie,F,100,21,0,21
Ziporah,F,100,21,0,21
Zobia,F,100,21,0,21
Zuleimy,F,100,21,0,21
Zykeia,F,100,21,0,21
Aajaylah,F,100,20,0,20
Aalexis,F,100,20,0,20
Abdiqani,M,100,0,20,20
Abdulloh,M,100,0,20,20
Abdulsalam,M,100,0,20,20
Aberham,M,100,0,20,20
Abriona,F,100,20,0,20
Adamina,F,100,20,0,20
Adashia,F,100,20,0,20
Addylyn,F,100,20,0,20
Adeniyi,M,100,0,20,20
Adilia,F,100,20,0,20
Adiv,M,100,0,20,20
Adiyan,M,100,0,20,20
Adlih,F,100,20,0,20
Aftab,M,100,0,20,20
Ahmond,M,100,0,20,20
Aidaliz,F,100,20,0,20
Aidrik,M,100,0,20,20
Aidy,F,100,20,0,20
Ailaina,F,100,20,0,20
Airial,F,100,20,0,20
Aisosa,F,100,20,0,20
Ajavion,M,100,0,20,20
Akeera,F,100,20,0,20
Akshadha,F,100,20,0,20
Akshit,M,100,0,20,20
Alaeyah,F,100,20,0,20
Alastor,M,100,0,20,20
Alaxander,M,100,0,20,20
Albanie,F,100,20,0,20
Alber,M,100,0,20,20
Aldred,M,100,0,20,20
Alectra,F,100,20,0,20
Alektra,F,100,20,0,20
Alenis,F,100,20,0,20
Aleska,F,100,20,0,20
Alessi,F,100,20,0,20
Alhana,F,100,20,0,20
Alicai,F,100,20,0,20
Aliciya,F,100,20,0,20
Allice,F,100,20,0,20
Allishia,F,100,20,0,20
Alusine,M,100,0,20,20
Amaliah,F,100,20,0,20
Amariea,F,100,20,0,20
Amiira,F,100,20,0,20
Amilli,F,100,20,0,20
Amilyn,F,100,20,0,20
Anailah,F,100,20,0,20
Anarah,F,100,20,0,20
Anastin,F,100,20,0,20
Anayanci,F,100,20,0,20
Aneeq,M,100,0,20,20
Anike,F,100,20,0,20
Annaelizabeth,F,100,20,0,20
Annalisha,F,100,20,0,20
Annazette,F,100,20,0,20
Anneisha,F,100,20,0,20
Anneliz,F,100,20,0,20
Anousha,F,100,20,0,20
Arawyn,F,100,20,0,20
Ariss,F,100,20,0,20
Arrihanna,F,100,20,0,20
Arrissa,F,100,20,0,20
Arriya,F,100,20,0,20
Articia,F,100,20,0,20
Aryss,F,100,20,0,20
Ashston,M,100,0,20,20
Atreya,M,70,6,14,20
Aubreeanna,F,100,20,0,20
Aureliana,F,100,20,0,20
Aurick,M,100,0,20,20
Austi,F,100,20,0,20
Avenley,F,100,20,0,20
Averii,F,100,20,0,20
Azaia,F,100,20,0,20
Azaila,F,100,20,0,20
Azelie,F,100,20,0,20
Bailly,F,100,20,0,20
Bellaann,F,100,20,0,20
Berina,F,100,20,0,20
Bernon,M,100,0,20,20
Bethina,F,100,20,0,20
Blakeney,F,100,20,0,20
Bostynn,F,100,20,0,20
Bradynn,M,75,5,15,20
Brainna,F,100,20,0,20
Brandal,M,100,0,20,20
Bredan,M,100,0,20,20
Breshey,F,100,20,0,20
Brex,M,100,0,20,20
Britannica,F,100,20,0,20
Brittant,F,100,20,0,20
Britteni,F,100,20,0,20
Brosnan,M,100,0,20,20
Bryhanna,F,100,20,0,20
Bunita,F,100,20,0,20
Cadeja,F,100,20,0,20
Caithlin,F,100,20,0,20
Callon,M,100,0,20,20
Cardella,F,100,20,0,20
Caribe,M,100,0,20,20
Carmya,F,100,20,0,20
Carwin,M,100,0,20,20
Caseyann,F,100,20,0,20
Cashmir,M,70,6,14,20
Catoya,F,100,20,0,20
Catrenia,F,100,20,0,20
Caulder,M,100,0,20,20
Caylene,F,100,20,0,20
Cellina,F,100,20,0,20
Chardon,F,100,20,0,20
Charlianne,F,100,20,0,20
Charlice,F,100,20,0,20
Charlon,F,100,20,0,20
Charmae,F,100,20,0,20
Chasitiy,F,100,20,0,20
Chedrick,M,100,0,20,20
Chelcia,F,100,20,0,20
Chezare,M,75,5,15,20
Chimeng,M,100,0,20,20
Chinetta,F,100,20,0,20
Clairice,F,100,20,0,20
Claren,F,100,20,0,20
Clate,M,100,0,20,20
Claudelle,F,100,20,0,20
Clayt,M,100,0,20,20
Cobra,M,100,0,20,20
Coney,M,100,0,20,20
Consetta,F,100,20,0,20
Cornelis,M,100,0,20,20
Cossandra,F,100,20,0,20
Crissey,F,100,20,0,20
Cushena,F,100,20,0,20
Cyasia,F,100,20,0,20
Daejanay,F,100,20,0,20
Daeshawna,F,100,20,0,20
Daeshia,F,100,20,0,20
Daeshun,M,100,0,20,20
Daijuan,M,100,0,20,20
Daimyan,M,100,0,20,20
Dairo,M,100,0,20,20
Daizhane,F,100,20,0,20
Damarii,M,100,0,20,20
Danard,M,100,0,20,20
Dannapaola,F,100,20,0,20
Dannesha,F,100,20,0,20
Darionte,M,100,0,20,20
Darrisha,F,100,20,0,20
Dashawnna,F,100,20,0,20
Davaeh,F,100,20,0,20
Davilyn,F,100,20,0,20
Davionn,M,100,0,20,20
Dawane,M,100,0,20,20
Dayanera,F,100,20,0,20
Daysun,M,100,0,20,20
Dayzie,F,100,20,0,20
Dazmon,M,100,0,20,20
Dcarlos,M,100,0,20,20
Deaysha,F,100,20,0,20
Debhra,F,100,20,0,20
Debrann,F,100,20,0,20
Dejanea,F,100,20,0,20
Dekesha,F,100,20,0,20
Delacy,F,100,20,0,20
Delaiah,F,100,20,0,20
Delandra,F,100,20,0,20
Delle,F,100,20,0,20
Demauria,F,55,11,9,20
Demy,F,100,20,0,20
Denaijah,F,100,20,0,20
Denman,M,100,0,20,20
Dennia,F,100,20,0,20
Dennielle,F,100,20,0,20
Dequarious,M,100,0,20,20
Dequinn,M,100,0,20,20
Dermott,M,100,0,20,20
Destannie,F,100,20,0,20
Devar,M,100,0,20,20
Devontee,M,100,0,20,20
Deyanne,F,100,20,0,20
Dhiraj,M,100,0,20,20
Dhyani,F,100,20,0,20
Dimetra,F,100,20,0,20
Dinahlee,F,100,20,0,20
Djavan,M,100,0,20,20
Dnyah,F,100,20,0,20
Doel,M,100,0,20,20
Dondee,F,100,20,0,20
Dondrick,M,100,0,20,20
Donishia,F,100,20,0,20
Dontravius,M,100,0,20,20
Dovey,F,100,20,0,20
Drewcilla,F,100,20,0,20
Drummond,M,100,0,20,20
Dwaylon,M,100,0,20,20
Dyuthi,F,100,20,0,20
Echelle,F,100,20,0,20
Edjuan,M,100,0,20,20
Effy,F,100,20,0,20
Efia,F,100,20,0,20
Elisio,M,100,0,20,20
Elizabeta,F,100,20,0,20
Elkanah,M,100,0,20,20
Elynor,F,100,20,0,20
Embyr,F,100,20,0,20
Erdi,M,100,0,20,20
Erini,F,100,20,0,20
Esbeidi,F,100,20,0,20
Euclides,M,100,0,20,20
Evet,F,100,20,0,20
Evilyn,F,100,20,0,20
Evlynn,F,100,20,0,20
Eymen,M,100,0,20,20
Faiyaz,M,100,0,20,20
Faleshia,F,100,20,0,20
Farzan,M,100,0,20,20
Feliks,M,100,0,20,20
Fenris,M,100,0,20,20
Fidelis,M,100,0,20,20
Finna,F,100,20,0,20
Gai,F,100,20,0,20
Garang,M,100,0,20,20
Garlene,F,100,20,0,20
Gaudy,F,100,20,0,20
Gejuan,M,100,0,20,20
Geleah,F,100,20,0,20
Geneveve,F,100,20,0,20
Gennesys,F,100,20,0,20
Genya,F,100,20,0,20
Geraldyn,F,100,20,0,20
Gevonte,M,100,0,20,20
Givanna,F,100,20,0,20
Greysyn,M,100,0,20,20
Guinnevere,F,100,20,0,20
Haby,F,100,20,0,20
Hadil,F,100,20,0,20
Hakob,M,100,0,20,20
Harkiran,F,100,20,0,20
Heiden,M,100,0,20,20
Heleana,F,100,20,0,20
Helton,M,100,0,20,20
Henryetta,F,100,20,0,20
Hermalinda,F,100,20,0,20
Heyab,F,100,20,0,20
Hifza,F,100,20,0,20
Hildreth,F,100,20,0,20
Hiroaki,M,100,0,20,20
Hobbes,M,100,0,20,20
Homas,M,100,0,20,20
Hoor,F,100,20,0,20
Iason,M,100,0,20,20
Icey,F,100,20,0,20
Idesha,F,100,20,0,20
Illyssa,F,100,20,0,20
Inbar,F,100,20,0,20
Ireon,F,75,15,5,20
Iroh,M,100,0,20,20
Issic,M,100,0,20,20
Itzanami,F,100,20,0,20
Itzayani,F,100,20,0,20
Ixcel,F,100,20,0,20
Izuchukwu,M,100,0,20,20
Jadean,F,75,15,5,20
Jadeen,F,75,15,5,20
Jaharie,M,100,0,20,20
Jaimelee,F,100,20,0,20
Jaimison,M,75,5,15,20
Jalishia,F,100,20,0,20
Jamarrian,M,100,0,20,20
Jameerah,F,100,20,0,20
Jamerio,M,100,0,20,20
Jamesthomas,M,100,0,20,20
Janala,F,100,20,0,20
Jandra,F,100,20,0,20
Janear,F,100,20,0,20
Janesse,F,100,20,0,20
Jaqueze,M,100,0,20,20
Jashyra,F,100,20,0,20
Jaydia,F,100,20,0,20
Jayvn,M,100,0,20,20
Jaywana,F,100,20,0,20
Jeimmy,F,100,20,0,20
Jenesia,F,100,20,0,20
Jennis,F,100,20,0,20
Jerimya,M,100,0,20,20
Jersiah,M,100,0,20,20
Jessabelle,F,100,20,0,20
Jhari,M,100,0,20,20
Jihanna,F,100,20,0,20
Jiten,M,100,0,20,20
Jiwon,F,100,20,0,20
Jodianne,F,100,20,0,20
Johnallen,M,100,0,20,20
Johnea,F,100,20,0,20
Johnse,M,100,0,20,20
Jonaye,F,100,20,0,20
Jonbenet,F,100,20,0,20
Jondarius,M,100,0,20,20
Josiphine,F,100,20,0,20
Joumana,F,100,20,0,20
Jozilyn,F,100,20,0,20
Jua,M,100,0,20,20
Junae,F,100,20,0,20
Juniyah,F,100,20,0,20
Jurrien,M,100,0,20,20
Kabel,M,100,0,20,20
Kader,M,100,0,20,20
Kadesh,M,100,0,20,20
Kadrien,M,100,0,20,20
Kaethe,F,100,20,0,20
Kaheim,M,100,0,20,20
Kahmiyah,F,100,20,0,20
Kaiwen,M,100,0,20,20
Kaliannah,F,100,20,0,20
Kalleb,M,100,0,20,20
Kamily,F,100,20,0,20
Kamorion,M,100,0,20,20
Kandia,F,75,15,5,20
Kaniqua,F,100,20,0,20
Kantina,F,100,20,0,20
Kaomi,F,100,20,0,20
Kaory,F,100,20,0,20
Karenn,F,100,20,0,20
Karlito,M,100,0,20,20
Kathaline,F,100,20,0,20
Kaveah,F,100,20,0,20
Kaycia,F,100,20,0,20
Kaytin,F,100,20,0,20
Keantae,M,100,0,20,20
Keileen,F,100,20,0,20
Keirnan,M,100,0,20,20
Keishanna,F,100,20,0,20
Kelian,M,100,0,20,20
Keristen,F,100,20,0,20
Kevn,M,100,0,20,20
Kevone,M,100,0,20,20
Keydan,M,100,0,20,20
Keymonte,M,100,0,20,20
Keyrin,F,100,20,0,20
Khalifah,M,100,0,20,20
Khelan,M,100,0,20,20
Khol,M,100,0,20,20
Kial,M,100,0,20,20
Kilei,F,100,20,0,20
Kimeko,F,100,20,0,20
Kimily,F,100,20,0,20
Kinny,M,100,0,20,20
Kirollos,M,100,0,20,20
Kirstian,F,100,20,0,20
Kiry,M,100,0,20,20
Kish,F,75,15,5,20
Kivin,M,100,0,20,20
Kiyari,F,100,20,0,20
Kiziah,F,100,20,0,20
Kolya,M,70,6,14,20
Kordarius,M,100,0,20,20
Kordero,M,100,0,20,20
Kotina,F,100,20,0,20
Kowana,F,100,20,0,20
Krisztian,M,100,0,20,20
Kryslin,F,100,20,0,20
Kylenn,F,60,12,8,20
Kylik,M,100,0,20,20
Kymberlynn,F,100,20,0,20
Kyrone,M,100,0,20,20
Kyrston,F,100,20,0,20
Lacory,M,100,0,20,20
Lacresa,F,100,20,0,20
Laderek,M,100,0,20,20
Laionna,F,100,20,0,20
Lakeland,M,75,5,15,20
Lakeyla,F,100,20,0,20
Lakitta,F,100,20,0,20
Lamier,M,100,0,20,20
Lanayia,F,100,20,0,20
Laquez,M,100,0,20,20
Lashyia,F,100,20,0,20
Laterrika,F,100,20,0,20
Laterrius,M,100,0,20,20
Laurelee,F,100,20,0,20
Lavant,M,100,0,20,20
Lavarus,M,100,0,20,20
Leathia,F,100,20,0,20
Lecresha,F,100,20,0,20
Leighna,F,100,20,0,20
Lemark,M,100,0,20,20
Leverett,M,100,0,20,20
Lilan,F,100,20,0,20
Lilani,F,100,20,0,20
Lilyin,F,100,20,0,20
Liylah,F,100,20,0,20
Loriene,F,100,20,0,20
Ludovic,M,100,0,20,20
Lynken,M,100,0,20,20
Mackinzy,F,100,20,0,20
Madeson,F,100,20,0,20
Madoka,F,100,20,0,20
Maecee,F,100,20,0,20
Magean,F,100,20,0,20
Mahkel,M,100,0,20,20
Mailei,F,100,20,0,20
Makoy,M,100,0,20,20
Malala,F,100,20,0,20
Malette,F,100,20,0,20
Malila,F,100,20,0,20
Malora,F,100,20,0,20
Marcua,M,100,0,20,20
Marcum,M,100,0,20,20
Mareta,F,100,20,0,20
Margia,F,100,20,0,20
Marieka,F,100,20,0,20
Maritha,F,100,20,0,20
Mariyon,M,100,0,20,20
Markira,F,100,20,0,20
Marloe,F,100,20,0,20
Marquilla,F,100,20,0,20
Marriann,F,100,20,0,20
Marrianna,F,100,20,0,20
Martir,M,100,0,20,20
Marvalene,F,100,20,0,20
Maryluz,F,100,20,0,20
Marysusan,F,100,20,0,20
Matviy,M,100,0,20,20
Mayella,F,100,20,0,20
Mayka,F,100,20,0,20
Mayleah,F,100,20,0,20
Mccaela,F,100,20,0,20
Meeko,M,100,0,20,20
Meike,F,100,20,0,20
Meilee,F,100,20,0,20
Mercedeez,F,100,20,0,20
Meril,F,50,10,10,20
Merv,M,100,0,20,20
Michaee,M,100,0,20,20
Michelin,F,100,20,0,20
Michiya,F,100,20,0,20
Mikara,F,100,20,0,20
Mikaylia,F,100,20,0,20
Mikyia,F,100,20,0,20
Mililani,F,100,20,0,20
Millana,F,100,20,0,20
Millen,M,100,0,20,20
Mison,M,100,0,20,20
Mithran,M,100,0,20,20
Mohamadali,M,100,0,20,20
Montaque,M,100,0,20,20
Morice,M,100,0,20,20
Murdoch,M,100,0,20,20
Mycayla,F,100,20,0,20
Mychel,F,50,10,10,20
Myja,F,100,20,0,20
Mylina,F,100,20,0,20
Myrion,M,100,0,20,20
Myshell,F,100,20,0,20
Nadera,F,100,20,0,20
Nagely,F,100,20,0,20
Nakeba,F,100,20,0,20
Nashell,F,100,20,0,20
Natassha,F,100,20,0,20
Natavious,M,100,0,20,20
Naweed,M,100,0,20,20
Nayani,F,100,20,0,20
Nekea,F,100,20,0,20
Nekiyah,F,100,20,0,20
Nelsi,F,100,20,0,20
Nemecio,M,100,0,20,20
Nera,F,100,20,0,20
Neydelin,F,100,20,0,20
Ngun,F,100,20,0,20
Nicholaas,M,100,0,20,20
Nikina,F,100,20,0,20
Nilynn,F,100,20,0,20
Nish,M,100,0,20,20
Niviah,F,100,20,0,20
Noria,F,100,20,0,20
Nusaibah,F,100,20,0,20
Nyveah,F,100,20,0,20
Oletta,F,100,20,0,20
Olvia,F,100,20,0,20
Paishence,F,100,20,0,20
Palestine,F,100,20,0,20
Poyraz,M,100,0,20,20
Prit,M,100,0,20,20
Qirat,F,100,20,0,20
Qualik,M,100,0,20,20
Quienton,M,100,0,20,20
Quintrel,M,100,0,20,20
Quontavious,M,100,0,20,20
Qushawn,M,100,0,20,20
Raam,M,100,0,20,20
Radwa,F,100,20,0,20
Raelinn,F,100,20,0,20
Raenesha,F,100,20,0,20
Raenisha,F,100,20,0,20
Raghib,M,100,0,20,20
Raianne,F,100,20,0,20
Rajuan,M,100,0,20,20
Rakshan,M,100,0,20,20
Ralanda,F,100,20,0,20
Ralen,M,100,0,20,20
Renlee,F,100,20,0,20
Reynardo,M,100,0,20,20
Rhodora,F,100,20,0,20
Riahnna,F,100,20,0,20
Richer,M,100,0,20,20
Rihannah,F,100,20,0,20
Rijul,M,100,0,20,20
Rikkie,F,100,20,0,20
Roanld,M,100,0,20,20
Robia,F,100,20,0,20
Ronea,F,100,20,0,20
Roselene,F,100,20,0,20
Roynell,M,100,0,20,20
Rubisela,F,100,20,0,20
Ruthell,F,100,20,0,20
Ruya,F,100,20,0,20
Ryanlee,M,100,0,20,20
Ryneisha,F,100,20,0,20
Saani,F,100,20,0,20
Sabira,F,100,20,0,20
Saddiq,M,100,0,20,20
Sahal,M,100,0,20,20
Sailesh,M,100,0,20,20
Saish,M,100,0,20,20
Sakurako,F,100,20,0,20
Saleta,F,100,20,0,20
Samerah,F,100,20,0,20
Sanieya,F,100,20,0,20
Santario,M,100,0,20,20
Santrell,F,50,10,10,20
Saraelizabeth,F,100,20,0,20
Saraii,F,100,20,0,20
Sebashtian,M,100,0,20,20
Sebastyn,M,100,0,20,20
Selana,F,100,20,0,20
Selman,M,100,0,20,20
Sesen,F,100,20,0,20
Sesily,F,100,20,0,20
Shadasha,F,100,20,0,20
Shamella,F,100,20,0,20
Shariyf,M,100,0,20,20
Sharlot,F,100,20,0,20
Shavella,F,100,20,0,20
Shelika,F,100,20,0,20
Shelon,F,100,20,0,20
Sheraya,F,100,20,0,20
Sherren,F,100,20,0,20
Sherriel,F,100,20,0,20
Shrihaan,M,100,0,20,20
Shumeka,F,100,20,0,20
Shwanna,F,100,20,0,20
Shydae,F,100,20,0,20
Sidak,M,100,0,20,20
Sieda,F,100,20,0,20
Silis,M,100,0,20,20
Soe,M,75,5,15,20
Somaiya,F,100,20,0,20
Sophiyah,F,100,20,0,20
Sorena,F,100,20,0,20
Sotheary,F,100,20,0,20
Srithik,M,100,0,20,20
Steffano,M,100,0,20,20
Stepehen,M,100,0,20,20
Stevieray,M,100,0,20,20
Subhana,F,100,20,0,20
Summerrose,F,100,20,0,20
Suna,F,100,20,0,20
Suriana,F,100,20,0,20
Suzelle,F,100,20,0,20
Suzzanna,F,100,20,0,20
Sylah,F,100,20,0,20
Taeron,M,100,0,20,20
Tailar,F,100,20,0,20
Takiara,F,100,20,0,20
Talayshia,F,100,20,0,20
Talysa,F,100,20,0,20
Tamarin,F,100,20,0,20
Tamikah,F,100,20,0,20
Tamiracle,F,100,20,0,20
Tanger,F,100,20,0,20
Tanzia,F,100,20,0,20
Tarie,F,100,20,0,20
Tarvarus,M,100,0,20,20
Tatyonna,F,100,20,0,20
Tauriel,F,100,20,0,20
Tayzha,F,100,20,0,20
Temani,F,50,10,10,20
Tenor,M,100,0,20,20
Tereas,F,100,20,0,20
Terionna,F,100,20,0,20
Teyha,F,100,20,0,20
Theophile,M,100,0,20,20
Timbre,F,100,20,0,20
Tinker,F,50,10,10,20
Tisya,F,100,20,0,20
Tkeyha,F,100,20,0,20
Tomasi,M,100,0,20,20
Torivio,M,100,0,20,20
Tousha,F,100,20,0,20
Tramesha,F,100,20,0,20
Traniqua,F,100,20,0,20
Trayanna,F,100,20,0,20
Treanthony,M,100,0,20,20
Treba,F,100,20,0,20
Treigh,M,100,0,20,20
Trejohn,M,100,0,20,20
Tremonte,M,100,0,20,20
Trendyn,M,100,0,20,20
Treydan,M,100,0,20,20
Trynton,M,100,0,20,20
Tyas,M,100,0,20,20
Tynaisha,F,100,20,0,20
Tyreion,M,100,0,20,20
Tyten,M,100,0,20,20
Tyteonna,F,100,20,0,20
Tyzhane,F,100,20,0,20
Upton,M,100,0,20,20
Vanson,M,100,0,20,20
Vedra,F,100,20,0,20
Vernor,M,100,0,20,20
Victoriarose,F,100,20,0,20
Vinesh,M,100,0,20,20
Viyaan,M,100,0,20,20
Vola,F,100,20,0,20
Wajeeha,F,100,20,0,20
Wakana,F,100,20,0,20
Wanell,F,100,20,0,20
Wilnesha,F,100,20,0,20
Wuendy,F,100,20,0,20
Wyette,M,100,0,20,20
Wykeisha,F,100,20,0,20
Wyler,M,100,0,20,20
Xola,F,100,20,0,20
Xzadrian,M,100,0,20,20
Yaila,F,100,20,0,20
Yalisa,F,100,20,0,20
Yaneris,F,100,20,0,20
Yashwanth,M,100,0,20,20
Yasmaine,F,100,20,0,20
Yenis,F,100,20,0,20
Ylanda,F,100,20,0,20
Yonnie,F,100,20,0,20
Yorlei,F,100,20,0,20
Yoshihiro,M,100,0,20,20
Yuleimy,F,100,20,0,20
Yuleisy,F,100,20,0,20
Yumika,F,100,20,0,20
Yusha,M,100,0,20,20
Zaccari,M,100,0,20,20
Zackariya,M,100,0,20,20
Zadiel,M,100,0,20,20
Zaedon,M,100,0,20,20
Zahnya,F,100,20,0,20
Zaniylah,F,100,20,0,20
Zarien,M,100,0,20,20
Zarihanna,F,100,20,0,20
Zaydie,F,100,20,0,20
Zendra,F,100,20,0,20
Zhayden,M,100,0,20,20
Zoeey,F,100,20,0,20
Zykeith,M,100,0,20,20
Zyquavious,M,100,0,20,20
Zyran,M,100,0,20,20
Aadhavan,M,100,0,19,19
Aalyha,F,100,19,0,19
Abdiwahab,M,100,0,19,19
Abiona,F,100,19,0,19
Acari,M,100,0,19,19
Achyuth,M,100,0,19,19
Adalynd,F,100,19,0,19
Adayshia,F,100,19,0,19
Adebowale,M,100,0,19,19
Adelind,F,100,19,0,19
Adhrith,M,100,0,19,19
Adly,F,100,19,0,19
Advit,M,100,0,19,19
Adylen,F,100,19,0,19
Agapita,F,100,19,0,19
Ahmiracle,F,100,19,0,19
Aisaiah,M,100,0,19,19
Ajalon,F,63,12,7,19
Akashia,F,100,19,0,19
Alaini,F,100,19,0,19
Aliva,F,100,19,0,19
Aliyannah,F,100,19,0,19
Allieanna,F,100,19,0,19
Altay,M,100,0,19,19
Alyaan,M,100,0,19,19
Alyena,F,100,19,0,19
Alyiana,F,100,19,0,19
Amande,F,100,19,0,19
Amareya,F,100,19,0,19
Amileah,F,100,19,0,19
Amitoj,M,100,0,19,19
Amonni,F,100,19,0,19
Amontay,M,100,0,19,19
Amouri,M,74,5,14,19
Anajia,F,100,19,0,19
Anaveah,F,100,19,0,19
Andreo,M,100,0,19,19
Anelyse,F,100,19,0,19
Anganette,F,100,19,0,19
Anikait,M,100,0,19,19
Anjelia,F,100,19,0,19
Annajane,F,100,19,0,19
Aprell,F,100,19,0,19
Aquetzalli,F,100,19,0,19
Aquilino,M,100,0,19,19
Arbin,M,100,0,19,19
Areianna,F,100,19,0,19
Arellys,F,100,19,0,19
Aro,M,100,0,19,19
Arrika,F,100,19,0,19
Asadullah,M,100,0,19,19
Asbel,M,100,0,19,19
Aseelah,F,100,19,0,19
Asees,F,100,19,0,19
Assane,M,100,0,19,19
Atiim,M,100,0,19,19
Attalie,F,100,19,0,19
Attoria,F,100,19,0,19
Audrienna,F,100,19,0,19
Augustas,M,100,0,19,19
Avionne,F,100,19,0,19
Avont,M,100,0,19,19
Aybrie,F,100,19,0,19
Aydah,F,100,19,0,19
Aydren,M,100,0,19,19
Aylina,F,100,19,0,19
Azaleia,F,100,19,0,19
Azayvion,M,100,0,19,19
Azon,M,100,0,19,19
Bankston,M,100,0,19,19
Beaver,M,100,0,19,19
Benika,F,100,19,0,19
Berkli,F,100,19,0,19
Berley,M,100,0,19,19
Bettsy,F,100,19,0,19
Biak,F,68,13,6,19
Bisa,F,100,19,0,19
Brandia,F,100,19,0,19
Breania,F,100,19,0,19
Brehon,M,100,0,19,19
Brenham,M,100,0,19,19
Breydin,M,100,0,19,19
Brijae,F,100,19,0,19
Brilan,M,100,0,19,19
Brisayda,F,100,19,0,19
Brystin,M,100,0,19,19
Bryttanie,F,100,19,0,19
Caiyah,F,100,19,0,19
Calamity,F,100,19,0,19
Callieann,F,100,19,0,19
Camare,M,100,0,19,19
Candess,F,100,19,0,19
Careese,F,100,19,0,19
Carliana,F,100,19,0,19
Carressa,F,100,19,0,19
Cartell,M,100,0,19,19
Cateena,F,100,19,0,19
Cawanda,F,100,19,0,19
Chailey,F,100,19,0,19
Chaneice,F,100,19,0,19
Charrell,F,100,19,0,19
Chatia,F,100,19,0,19
Chatoya,F,100,19,0,19
Chavonda,F,100,19,0,19
Chawana,F,100,19,0,19
Chigozirim,M,68,6,13,19
Chinh,M,100,0,19,19
Chinika,F,100,19,0,19
Ciannah,F,100,19,0,19
Clarkson,M,100,0,19,19
Cleland,M,100,0,19,19
Clowey,F,100,19,0,19
Colyer,M,100,0,19,19
Corda,M,63,7,12,19
Corden,M,100,0,19,19
Corderal,M,100,0,19,19
Cortavion,M,100,0,19,19
Cynae,F,100,19,0,19
Dailene,F,100,19,0,19
Daizia,F,100,19,0,19
Damarria,F,100,19,0,19
Daneida,F,100,19,0,19
Danelys,F,100,19,0,19
Dantrel,M,100,0,19,19
Darence,M,100,0,19,19
Darvel,M,100,0,19,19
Darylann,F,100,19,0,19
Daviah,F,100,19,0,19
Dawlton,M,100,0,19,19
Deavionne,F,100,19,0,19
Delali,F,100,19,0,19
Deliylah,F,100,19,0,19
Delorice,F,100,19,0,19
Demare,M,100,0,19,19
Deniko,M,100,0,19,19
Densie,F,100,19,0,19
Dequinton,M,100,0,19,19
Deshaune,M,100,0,19,19
Dessarae,F,100,19,0,19
Detarius,M,100,0,19,19
Dezlyn,F,100,19,0,19
Dhvani,F,100,19,0,19
Diavonte,M,100,0,19,19
Dijonnae,F,100,19,0,19
Dionni,F,100,19,0,19
Dipesh,M,100,0,19,19
Domnik,M,100,0,19,19
Dorance,M,100,0,19,19
Earnesteen,F,100,19,0,19
Edriel,M,100,0,19,19
Eirinn,F,100,19,0,19
Elaney,F,100,19,0,19
Elfredia,F,100,19,0,19
Eliahna,F,100,19,0,19
Elisee,M,100,0,19,19
Ellaree,F,100,19,0,19
Elliemay,F,100,19,0,19
Elward,M,100,0,19,19
Elyzah,F,100,19,0,19
Emmalyse,F,100,19,0,19
Emmelin,F,100,19,0,19
Emyrson,F,100,19,0,19
Eponine,F,100,19,0,19
Eray,M,100,0,19,19
Erissa,F,100,19,0,19
Essiah,M,100,0,19,19
Evalet,F,100,19,0,19
Ezella,F,100,19,0,19
Falona,F,100,19,0,19
Fatimatou,F,100,19,0,19
Felipedejesus,M,100,0,19,19
Felycia,F,100,19,0,19
Finnly,F,53,10,9,19
Floresita,F,100,19,0,19
Frania,F,100,19,0,19
Gannen,M,100,0,19,19
Garit,M,100,0,19,19
Garrion,M,100,0,19,19
Gelene,F,100,19,0,19
Gianpaul,M,100,0,19,19
Gicel,F,100,19,0,19
Gizem,F,100,19,0,19
Gladstone,M,100,0,19,19
Grandville,M,100,0,19,19
Gyla,F,100,19,0,19
Hadly,F,100,19,0,19
Haviland,F,100,19,0,19
Hazzel,F,100,19,0,19
Henrie,M,74,5,14,19
Hermen,M,100,0,19,19
Hilaire,F,100,19,0,19
Hillaree,F,100,19,0,19
Holyn,F,100,19,0,19
Hristo,M,100,0,19,19
Hurtis,M,100,0,19,19
Hutchison,M,100,0,19,19
Icelyn,F,100,19,0,19
Icole,F,100,19,0,19
Idalee,F,100,19,0,19
Idhant,M,100,0,19,19
Ifetayo,F,100,19,0,19
Imam,M,100,0,19,19
Irlene,F,100,19,0,19
Iselle,F,100,19,0,19
Ishmil,M,100,0,19,19
Isioma,F,100,19,0,19
Italee,F,100,19,0,19
Itzhel,F,100,19,0,19
Iziaha,M,100,0,19,19
Jacin,M,100,0,19,19
Jacorrian,M,100,0,19,19
Jacquilynn,F,100,19,0,19
Jadai,F,100,19,0,19
Jaded,F,100,19,0,19
Jaelianna,F,100,19,0,19
Jahier,M,100,0,19,19
Jahiro,M,100,0,19,19
Jahnell,F,100,19,0,19
Jahsi,M,100,0,19,19
Jaksyn,M,100,0,19,19
Jakylon,M,100,0,19,19
Jaleb,M,100,0,19,19
Jalivia,F,100,19,0,19
Jalonte,M,100,0,19,19
Jamius,M,100,0,19,19
Janaii,F,100,19,0,19
Jarden,M,100,0,19,19
Jarif,M,100,0,19,19
Jasenya,F,100,19,0,19
Jasreet,F,100,19,0,19
Jaydelynn,F,100,19,0,19
Jayia,F,100,19,0,19
Jaylana,F,100,19,0,19
Jaylond,M,100,0,19,19
Jayriel,M,100,0,19,19
Jazabel,F,100,19,0,19
Jazariya,F,100,19,0,19
Jceion,M,100,0,19,19
Jedrik,M,100,0,19,19
Jennylynn,F,100,19,0,19
Jeretta,F,100,19,0,19
Jerine,F,100,19,0,19
Jesu,M,100,0,19,19
Jesusangel,M,100,0,19,19
Jesusjr,M,100,0,19,19
Jhani,F,100,19,0,19
Jiaqi,F,100,19,0,19
Jigna,F,100,19,0,19
Jinal,F,100,19,0,19
Jizell,F,100,19,0,19
Joben,M,100,0,19,19
Jofiel,M,100,0,19,19
Johansel,M,100,0,19,19
Johnnesha,F,100,19,0,19
Johnvictor,M,100,0,19,19
Jondrea,F,100,19,0,19
Jonier,F,100,19,0,19
Jontasia,F,100,19,0,19
Jontavion,M,100,0,19,19
Josellyn,F,100,19,0,19
Joseroberto,M,100,0,19,19
Josheph,M,100,0,19,19
Jossiel,M,100,0,19,19
Jovantae,M,100,0,19,19
Jovianna,F,100,19,0,19
Joyah,F,100,19,0,19
Joyal,F,100,19,0,19
Joyl,F,100,19,0,19
Jron,M,100,0,19,19
Julani,M,74,5,14,19
Juleus,M,100,0,19,19
Julianie,F,100,19,0,19
Julianys,F,100,19,0,19
Jumel,M,100,0,19,19
Kaislyn,F,100,19,0,19
Kaleob,M,100,0,19,19
Kaloyan,M,100,0,19,19
Kamella,F,100,19,0,19
Kamiera,F,100,19,0,19
Kashya,F,100,19,0,19
Kasonya,F,100,19,0,19
Kassen,M,100,0,19,19
Kavika,M,100,0,19,19
Kavyn,M,100,0,19,19
Kaydien,M,100,0,19,19
Kaylonie,F,100,19,0,19
Kayri,F,100,19,0,19
Keiani,F,100,19,0,19
Keimyah,F,100,19,0,19
Keishara,F,100,19,0,19
Keivin,M,100,0,19,19
Kemira,F,100,19,0,19
Kenethia,F,100,19,0,19
Kennise,F,100,19,0,19
Kenyari,F,53,10,9,19
Kewin,M,100,0,19,19
Kewuan,M,100,0,19,19
Khadidiatou,F,100,19,0,19
Khaleal,M,100,0,19,19
Kharli,F,100,19,0,19
Khennedi,F,100,19,0,19
Khloeann,F,100,19,0,19
Khobe,M,100,0,19,19
Khyir,M,100,0,19,19
Kibwe,M,100,0,19,19
Kimayah,F,100,19,0,19
Kimberlina,F,100,19,0,19
Kimetra,F,100,19,0,19
Kirat,F,100,19,0,19
Kiria,F,100,19,0,19
Kirianna,F,100,19,0,19
Kishina,F,100,19,0,19
Kiwanis,F,100,19,0,19
Knoxton,M,100,0,19,19
Krishma,F,100,19,0,19
Kursty,F,100,19,0,19
Kwamain,M,100,0,19,19
Kydin,M,100,0,19,19
Kyleanthony,M,100,0,19,19
Kyton,M,100,0,19,19
Lacrista,F,100,19,0,19
Ladaris,M,100,0,19,19
Ladessa,F,100,19,0,19
Lakila,F,100,19,0,19
Lakimberly,F,100,19,0,19
Laquaysha,F,100,19,0,19
Lashenna,F,100,19,0,19
Latress,F,100,19,0,19
Lavares,M,100,0,19,19
Laylanni,F,100,19,0,19
Laylla,F,100,19,0,19
Laynah,F,100,19,0,19
Leamber,F,100,19,0,19
Learah,F,100,19,0,19
Leartis,M,100,0,19,19
Lennetta,F,100,19,0,19
Lerhonda,F,100,19,0,19
Lesi,F,100,19,0,19
Less,M,100,0,19,19
Leveda,F,100,19,0,19
Levonta,M,100,0,19,19
Leyden,M,100,0,19,19
Linsdey,F,100,19,0,19
Linward,M,100,0,19,19
Lisabella,F,100,19,0,19
Lisander,M,100,0,19,19
Lucecita,F,100,19,0,19
Lusiano,M,100,0,19,19
Lynkon,M,100,0,19,19
Lynli,F,100,19,0,19
Lynmarie,F,100,19,0,19
Lyzeth,F,100,19,0,19
Madajah,F,100,19,0,19
Madasen,F,100,19,0,19
Madee,F,100,19,0,19
Mads,M,100,0,19,19
Mahee,F,100,19,0,19
Maimoona,F,100,19,0,19
Maive,F,100,19,0,19
Maka,F,100,19,0,19
Makhyia,F,100,19,0,19
Mallely,F,100,19,0,19
Mallik,M,100,0,19,19
Mandria,F,100,19,0,19
Marbely,F,100,19,0,19
Marchita,F,100,19,0,19
Marcuz,M,100,0,19,19
Mardeen,F,100,19,0,19
Maridith,F,100,19,0,19
Marilene,F,100,19,0,19
Markece,M,100,0,19,19
Markley,M,100,0,19,19
Marlett,F,100,19,0,19
Martisa,F,100,19,0,19
Maryalyce,F,100,19,0,19
Mashia,F,100,19,0,19
Maxsen,M,100,0,19,19
Mayfield,M,100,0,19,19
Mckylee,F,100,19,0,19
Melroy,M,100,0,19,19
Merli,F,100,19,0,19
Merridy,F,100,19,0,19
Michia,F,100,19,0,19
Milaun,F,100,19,0,19
Milenka,F,100,19,0,19
Mirlande,F,100,19,0,19
Mithil,M,100,0,19,19
Muzzammil,M,100,0,19,19
Nadeige,F,100,19,0,19
Naeshawn,M,100,0,19,19
Najea,F,100,19,0,19
Namia,F,100,19,0,19
Namitha,F,100,19,0,19
Naquana,F,100,19,0,19
Nasheena,F,100,19,0,19
Nashiem,M,100,0,19,19
Natae,F,100,19,0,19
Nayli,F,100,19,0,19
Netty,F,100,19,0,19
Nevaehmarie,F,100,19,0,19
Nickea,F,100,19,0,19
Niclole,F,100,19,0,19
Nikerria,F,100,19,0,19
Nikyia,F,100,19,0,19
Ninja,F,100,19,0,19
Nitai,M,100,0,19,19
Noelan,M,100,0,19,19
Nolynn,F,100,19,0,19
Nylayah,F,100,19,0,19
Nyllah,F,100,19,0,19
Ojay,M,100,0,19,19
Olajawon,M,100,0,19,19
Olatunde,M,100,0,19,19
Omaid,M,100,0,19,19
Omaida,F,100,19,0,19
Osa,F,100,19,0,19
Osby,M,100,0,19,19
Ottilie,F,100,19,0,19
Patrinia,F,100,19,0,19
Petrita,F,100,19,0,19
Phenyx,F,100,19,0,19
Philina,F,100,19,0,19
Phoebee,F,100,19,0,19
Qaasim,M,100,0,19,19
Quadarious,M,100,0,19,19
Qualon,M,100,0,19,19
Quantrel,M,100,0,19,19
Rade,M,100,0,19,19
Raegin,F,100,19,0,19
Raeisha,F,100,19,0,19
Raelei,F,100,19,0,19
Ramsses,M,100,0,19,19
Raneesha,F,100,19,0,19
Raniel,M,100,0,19,19
Ranim,F,100,19,0,19
Raphaelle,F,100,19,0,19
Rathanak,M,100,0,19,19
Rayjohn,M,100,0,19,19
Reggina,F,100,19,0,19
Rejon,M,100,0,19,19
Reshawnda,F,100,19,0,19
Reynah,F,100,19,0,19
Reyniel,M,100,0,19,19
Riqui,F,100,19,0,19
Ritchey,M,100,0,19,19
Riyon,M,100,0,19,19
Roald,M,100,0,19,19
Rockeem,M,100,0,19,19
Rodin,M,100,0,19,19
Romeesa,F,100,19,0,19
Romiyah,F,100,19,0,19
Rondelle,F,68,13,6,19
Ronnia,F,100,19,0,19
Rpbert,M,100,0,19,19
Rubit,F,100,19,0,19
Ruchoma,F,100,19,0,19
Sacoria,F,100,19,0,19
Sadiee,F,100,19,0,19
Saila,F,100,19,0,19
Saiveon,M,100,0,19,19
Sajani,F,100,19,0,19
Samarri,F,100,19,0,19
Samel,M,100,0,19,19
Sanjita,F,100,19,0,19
Sareth,M,63,7,12,19
Sarvin,M,100,0,19,19
Sashe,F,100,19,0,19
Scarlettrose,F,100,19,0,19
Seely,F,74,14,5,19
Semantha,F,100,19,0,19
Serayah,F,100,19,0,19
Seslie,F,100,19,0,19
Severina,F,100,19,0,19
Shaddix,M,100,0,19,19
Shafonda,F,100,19,0,19
Shaghayegh,F,100,19,0,19
Shalai,F,100,19,0,19
Shampayne,F,100,19,0,19
Shande,M,63,7,12,19
Sharaye,F,100,19,0,19
Shasmeen,F,100,19,0,19
Shauniqua,F,100,19,0,19
Shawndreka,F,100,19,0,19
Shawneice,F,100,19,0,19
Shayenne,F,100,19,0,19
Shelcy,F,100,19,0,19
Shenai,F,100,19,0,19
Sheronne,F,100,19,0,19
Sherrylyn,F,100,19,0,19
Sheryce,F,100,19,0,19
Shewana,F,100,19,0,19
Shiffy,F,100,19,0,19
Shimya,F,100,19,0,19
Shinead,F,100,19,0,19
Shiomara,F,100,19,0,19
Shiyanne,F,100,19,0,19
Shundrika,F,100,19,0,19
Sidalee,F,100,19,0,19
Simmon,M,100,0,19,19
Sirat,F,100,19,0,19
Somiyah,F,100,19,0,19
Sophana,M,74,5,14,19
Sopheya,F,100,19,0,19
Sosuke,M,100,0,19,19
Srushti,F,100,19,0,19
Stefaney,F,100,19,0,19
Suset,F,100,19,0,19
Sushmita,F,100,19,0,19
Tahliah,F,100,19,0,19
Taidyn,M,100,0,19,19
Taijha,F,100,19,0,19
Taimak,M,100,0,19,19
Takecia,F,100,19,0,19
Tamaika,F,100,19,0,19
Tashaunda,F,100,19,0,19
Tasiah,F,100,19,0,19
Tayzlee,F,100,19,0,19
Teija,F,100,19,0,19
Tekera,F,100,19,0,19
Temicka,F,100,19,0,19
Teneika,F,100,19,0,19
Tenisa,F,100,19,0,19
Teronda,F,100,19,0,19
Texie,F,100,19,0,19
Teyvon,M,100,0,19,19
Thailia,F,100,19,0,19
Thaleia,F,100,19,0,19
Thaman,M,100,0,19,19
Thawng,M,100,0,19,19
Thyda,F,100,19,0,19
Tijan,M,100,0,19,19
Timberlynn,F,100,19,0,19
Timekia,F,100,19,0,19
Tityanna,F,100,19,0,19
Tonecia,F,100,19,0,19
Traciann,F,100,19,0,19
Tramarion,M,100,0,19,19
Travionna,F,100,19,0,19
Trax,M,100,0,19,19
Treyvond,M,100,0,19,19
Trezdon,M,100,0,19,19
Trinyti,F,100,19,0,19
Triscia,F,100,19,0,19
Trone,M,100,0,19,19
Turina,F,100,19,0,19
Turkesa,F,100,19,0,19
Tyheed,M,100,0,19,19
Tymera,F,100,19,0,19
Tymiere,M,100,0,19,19
Tynajah,F,100,19,0,19
Tynashia,F,100,19,0,19
Tyquane,M,100,0,19,19
Tyreem,M,100,0,19,19
Tzipa,F,100,19,0,19
Uniquea,F,100,19,0,19
Urica,F,100,19,0,19
Venitta,F,100,19,0,19
Verdelle,F,100,19,0,19
Veronic,F,100,19,0,19
Wakely,F,100,19,0,19
Walta,F,100,19,0,19
Weyland,M,100,0,19,19
Williamjoseph,M,100,0,19,19
Winnona,F,100,19,0,19
Wise,M,100,0,19,19
Wynnie,F,100,19,0,19
Xya,F,100,19,0,19
Yamia,F,100,19,0,19
Yander,M,100,0,19,19
Yaslynn,F,100,19,0,19
Yasna,F,100,19,0,19
Yero,M,100,0,19,19
Yojana,F,100,19,0,19
Yosniel,M,100,0,19,19
Yume,F,100,19,0,19
Zaelee,F,100,19,0,19
Zahna,F,100,19,0,19
Zamuel,M,100,0,19,19
Zarik,M,100,0,19,19
Zariyana,F,100,19,0,19
Zavanna,F,100,19,0,19
Zaviar,M,100,0,19,19
Zayen,M,100,0,19,19
Zaylor,M,100,0,19,19
Zema,F,100,19,0,19
Ziarra,F,100,19,0,19
Ziqi,F,100,19,0,19
Zorawar,M,100,0,19,19
Zuberi,M,100,0,19,19
Zyarah,F,100,19,0,19
Zykeira,F,100,19,0,19
Zyleigh,F,100,19,0,19
Zynae,F,100,19,0,19
Zyshon,M,100,0,19,19
Aaila,F,100,18,0,18
Aaishah,F,100,18,0,18
Aakilah,F,100,18,0,18
Aaziyah,F,100,18,0,18
Abbiegayle,F,100,18,0,18
Abbylynn,F,100,18,0,18
Abdisamad,M,100,0,18,18
Abdourahmane,M,100,0,18,18
Abiodun,M,100,0,18,18
Abubaker,M,100,0,18,18
Abyssinia,F,100,18,0,18
Adalinn,F,100,18,0,18
Adallyn,F,100,18,0,18
Adassa,F,100,18,0,18
Addesyn,F,100,18,0,18
Adiam,F,100,18,0,18
Adriean,M,100,0,18,18
Adrius,M,100,0,18,18
Advaita,F,100,18,0,18
Aeryanna,F,100,18,0,18
Agripina,F,100,18,0,18
Ahmiah,F,100,18,0,18
Ahmirah,F,100,18,0,18
Ahmire,M,100,0,18,18
Ahonesti,F,100,18,0,18
Aiah,F,100,18,0,18
Aimsley,F,100,18,0,18
Ain,F,100,18,0,18
Airion,M,100,0,18,18
Akaria,F,100,18,0,18
Akiesha,F,100,18,0,18
Alandre,M,100,0,18,18
Alax,M,100,0,18,18
Aldolfo,M,100,0,18,18
Aleanah,F,100,18,0,18
Alecxa,F,100,18,0,18
Alexan,M,100,0,18,18
Aleysa,F,100,18,0,18
Alishya,F,100,18,0,18
Alisiana,F,100,18,0,18
Allicen,F,100,18,0,18
Allisun,F,100,18,0,18
Allysan,F,100,18,0,18
Almonzo,M,100,0,18,18
Alonta,M,100,0,18,18
Alyster,M,100,0,18,18
Amairah,F,100,18,0,18
Amaure,M,100,0,18,18
Amayla,F,100,18,0,18
Ambrocio,M,100,0,18,18
Amdanda,F,100,18,0,18
Amelyah,F,100,18,0,18
Amuel,M,100,0,18,18
Amysue,F,100,18,0,18
Anastatia,F,100,18,0,18
Andalynn,F,100,18,0,18
Andreau,M,100,0,18,18
Anferny,M,100,0,18,18
Angeleana,F,100,18,0,18
Angilique,F,100,18,0,18
Aniyyah,F,100,18,0,18
Anjonette,F,100,18,0,18
Annacatherine,F,100,18,0,18
Annalys,F,100,18,0,18
Annasia,F,100,18,0,18
Anniemae,F,100,18,0,18
Antonnette,F,100,18,0,18
Anyja,F,100,18,0,18
Anyston,F,100,18,0,18
Apsara,F,100,18,0,18
Arabellah,F,100,18,0,18
Arbi,M,100,0,18,18
Ardin,M,100,0,18,18
Ardon,M,100,0,18,18
Aricella,F,100,18,0,18
Arieli,F,100,18,0,18
Arihan,M,100,0,18,18
Arijah,F,100,18,0,18
Ariyani,F,100,18,0,18
Arjit,M,100,0,18,18
Armard,M,100,0,18,18
Armella,F,100,18,0,18
Arniyah,F,100,18,0,18
Arquimides,M,100,0,18,18
Asako,F,100,18,0,18
Asaun,M,100,0,18,18
Ashleey,F,100,18,0,18
Atonia,F,100,18,0,18
Attalia,F,100,18,0,18
Aubray,F,100,18,0,18
Aubreeana,F,100,18,0,18
Audrei,F,100,18,0,18
Audresha,F,100,18,0,18
Aulelei,F,100,18,0,18
Avabelle,F,100,18,0,18
Avariella,F,100,18,0,18
Avasophia,F,100,18,0,18
Avlyn,F,100,18,0,18
Aylanie,F,100,18,0,18
Ayneka,F,100,18,0,18
Ayreonna,F,100,18,0,18
Azailya,F,100,18,0,18
Azikiwe,M,100,0,18,18
Azora,F,100,18,0,18
Azyra,F,100,18,0,18
Belize,F,100,18,0,18
Benedikt,M,100,0,18,18
Benhamin,M,100,0,18,18
Berdia,F,100,18,0,18
Bernave,M,100,0,18,18
Bethony,F,100,18,0,18
Bethzi,F,100,18,0,18
Blandina,F,100,18,0,18
Bleona,F,100,18,0,18
Bol,M,100,0,18,18
Braeli,F,100,18,0,18
Brandtley,M,100,0,18,18
Brania,F,100,18,0,18
Braxdyn,M,100,0,18,18
Breeleigh,F,100,18,0,18
Breiann,F,100,18,0,18
Brein,F,100,18,0,18
Breyonce,F,100,18,0,18
Britte,F,100,18,0,18
Brittlynn,F,100,18,0,18
Bruke,M,100,0,18,18
Cadeshia,F,100,18,0,18
Camyiah,F,100,18,0,18
Carmeisha,F,100,18,0,18
Carolie,F,100,18,0,18
Cashden,M,100,0,18,18
Cashea,F,100,18,0,18
Catch,M,100,0,18,18
Catey,F,100,18,0,18
Cathelene,F,100,18,0,18
Caullin,M,100,0,18,18
Cayetana,F,100,18,0,18
Cayliana,F,100,18,0,18
Cee,F,100,18,0,18
Celeena,F,100,18,0,18
Chaelynn,F,100,18,0,18
Chaila,F,100,18,0,18
Chalia,F,100,18,0,18
Chancler,M,100,0,18,18
Chantol,F,100,18,0,18
Charay,F,100,18,0,18
Chardee,F,100,18,0,18
Charmarie,F,100,18,0,18
Charmonique,F,100,18,0,18
Charny,F,100,18,0,18
Charro,F,100,18,0,18
Chaslynn,F,100,18,0,18
Chassy,F,100,18,0,18
Chauncie,F,100,18,0,18
Chealse,F,100,18,0,18
Chelley,F,100,18,0,18
Cherena,F,100,18,0,18
Chiquila,F,100,18,0,18
Chiya,F,100,18,0,18
Cleston,M,100,0,18,18
Cobee,M,100,0,18,18
Colley,M,100,0,18,18
Commodore,M,100,0,18,18
Coralyne,F,100,18,0,18
Coreyana,F,100,18,0,18
Coya,F,100,18,0,18
Creeden,M,100,0,18,18
Crichton,M,100,0,18,18
Cristena,F,100,18,0,18
Cyniya,F,100,18,0,18
Daania,F,100,18,0,18
Dacarri,M,100,0,18,18
Dacion,M,100,0,18,18
Daebreon,F,72,13,5,18
Daejhun,M,100,0,18,18
Dairius,M,100,0,18,18
Dakeisha,F,100,18,0,18
Dalaila,F,100,18,0,18
Daleth,F,100,18,0,18
Damaury,M,100,0,18,18
Dannely,F,100,18,0,18
Dannion,M,100,0,18,18
Daonna,F,100,18,0,18
Daquanna,F,100,18,0,18
Daquasha,F,100,18,0,18
Darae,F,67,12,6,18
Darena,F,100,18,0,18
Darieus,M,100,0,18,18
Darise,F,100,18,0,18
Darlenne,F,100,18,0,18
Darneil,M,100,0,18,18
Daryal,M,100,0,18,18
Dashal,M,100,0,18,18
Dasir,M,100,0,18,18
Daviante,M,100,0,18,18
Davud,M,100,0,18,18
Davyion,M,100,0,18,18
Daydra,F,100,18,0,18
Dazmine,F,100,18,0,18
Deakyn,M,100,0,18,18
Deantay,M,100,0,18,18
Deavan,M,100,0,18,18
Deba,F,100,18,0,18
Debaroh,F,100,18,0,18
Dehlila,F,100,18,0,18
Deidria,F,100,18,0,18
Dejhon,M,100,0,18,18
Dejona,F,100,18,0,18
Dekan,M,100,0,18,18
Delaylah,F,100,18,0,18
Denziel,M,100,0,18,18
Deondrey,M,100,0,18,18
Derice,M,100,0,18,18
Deshad,M,100,0,18,18
Desheila,F,100,18,0,18
Deshera,F,100,18,0,18
Desyrae,F,100,18,0,18
Devionne,M,100,0,18,18
Devoney,F,100,18,0,18
Devonti,M,100,0,18,18
Devontray,M,100,0,18,18
Deylon,M,100,0,18,18
Dhruvan,M,100,0,18,18
Dianaliz,F,100,18,0,18
Dibanhi,F,100,18,0,18
Dichelle,F,100,18,0,18
Diland,M,100,0,18,18
Dimitre,M,100,0,18,18
Dimitrie,M,100,0,18,18
Dionnie,F,100,18,0,18
Dipa,F,100,18,0,18
Divany,F,100,18,0,18
Diyar,M,100,0,18,18
Djenne,F,100,18,0,18
Dolline,F,100,18,0,18
Donaji,F,100,18,0,18
Dorisann,F,100,18,0,18
Dorne,M,100,0,18,18
Draeson,M,100,0,18,18
Dreysen,M,100,0,18,18
Dylilah,F,100,18,0,18
Dyral,M,100,0,18,18
Ebb,M,100,0,18,18
Ebbony,F,100,18,0,18
Eddiel,M,100,0,18,18
Edwuin,M,100,0,18,18
Edwynn,M,100,0,18,18
Eire,F,100,18,0,18
Eldric,M,100,0,18,18
Eliezar,M,100,0,18,18
Elijahwon,M,100,0,18,18
Eliset,F,100,18,0,18
Ellenora,F,100,18,0,18
Ellyott,F,100,18,0,18
Elvan,M,100,0,18,18
Elvena,F,100,18,0,18
Elyes,M,100,0,18,18
Emerey,F,100,18,0,18
Emirah,F,100,18,0,18
Emlynn,F,100,18,0,18
Eneyda,F,100,18,0,18
Ervie,M,100,0,18,18
Esi,F,100,18,0,18
Ethanmatthew,M,100,0,18,18
Eulice,M,100,0,18,18
Evaya,F,100,18,0,18
Evodio,M,100,0,18,18
Ewaoluwa,F,100,18,0,18
Fama,F,100,18,0,18
Faraj,M,100,0,18,18
Fatmir,M,100,0,18,18
Felisity,F,100,18,0,18
Fiamma,F,100,18,0,18
Franchesska,F,100,18,0,18
Frani,F,100,18,0,18
Franklen,M,100,0,18,18
Freada,F,100,18,0,18
Galisa,F,100,18,0,18
Geidy,F,100,18,0,18
Geneal,F,100,18,0,18
Genika,F,100,18,0,18
Geovoni,M,100,0,18,18
Ghaith,M,100,0,18,18
Gilchrist,M,100,0,18,18
Giselly,F,100,18,0,18
Gloretta,F,100,18,0,18
Gretell,F,100,18,0,18
Gwendylon,F,100,18,0,18
Hamir,M,100,0,18,18
Havynn,F,100,18,0,18
Hayoung,F,100,18,0,18
Hevan,F,100,18,0,18
Hezron,M,100,0,18,18
Horlando,M,100,0,18,18
Husnain,M,100,0,18,18
Icsis,F,100,18,0,18
Ilysa,F,100,18,0,18
Imere,M,100,0,18,18
Immani,F,100,18,0,18
Ingred,F,100,18,0,18
Inta,F,100,18,0,18
Ionia,F,100,18,0,18
Irmgard,F,100,18,0,18
Isenia,F,100,18,0,18
Isileli,M,100,0,18,18
Israh,F,100,18,0,18
Issaias,M,100,0,18,18
Iylee,F,100,18,0,18
Izaiya,M,100,0,18,18
Izzibella,F,100,18,0,18
Jabryan,M,100,0,18,18
Jadavian,M,100,0,18,18
Jadein,M,100,0,18,18
Jaderion,M,100,0,18,18
Jaeyla,F,100,18,0,18
Jahcari,M,100,0,18,18
Jahirah,F,100,18,0,18
Jahiyah,F,100,18,0,18
Jahsun,M,100,0,18,18
Jahziyah,F,100,18,0,18
Jaileah,F,100,18,0,18
Jaini,F,100,18,0,18
Jakailyn,F,100,18,0,18
Jakeil,M,100,0,18,18
Jaleana,F,100,18,0,18
Jaleo,M,100,0,18,18
Jaliesa,F,100,18,0,18
Jamaca,F,100,18,0,18
Jamely,F,100,18,0,18
Jamerian,M,100,0,18,18
Jameslee,M,100,0,18,18
Janelise,F,100,18,0,18
Janeria,F,100,18,0,18
Janilee,F,100,18,0,18
Jaqualine,F,100,18,0,18
Jaramy,M,100,0,18,18
Jarmain,M,100,0,18,18
Jarmell,M,100,0,18,18
Jaseon,M,100,0,18,18
Jasmone,F,100,18,0,18
Jaterrious,M,100,0,18,18
Javiona,F,100,18,0,18
Jaycean,M,100,0,18,18
Jaycieon,M,100,0,18,18
Jayeden,M,100,0,18,18
Jaymel,M,100,0,18,18
Jazmari,F,100,18,0,18
Jediael,M,100,0,18,18
Jelen,M,100,0,18,18
Jeneca,F,100,18,0,18
Jennee,F,100,18,0,18
Jenova,F,100,18,0,18
Jentezen,M,100,0,18,18
Jerrill,M,100,0,18,18
Jersain,M,100,0,18,18
Jeryd,M,100,0,18,18
Jesikah,F,100,18,0,18
Jeslene,F,100,18,0,18
Jessalee,F,100,18,0,18
Jessiana,F,100,18,0,18
Jesstina,F,100,18,0,18
Jessuly,F,100,18,0,18
Jevyn,M,100,0,18,18
Jexiel,M,100,0,18,18
Jhadiel,M,100,0,18,18
Jiancarlos,M,100,0,18,18
Jieun,F,100,18,0,18
Jinu,M,100,0,18,18
Jnyla,F,100,18,0,18
Jocalynn,F,100,18,0,18
Joesette,F,100,18,0,18
Joesha,F,100,18,0,18
Johnaya,F,100,18,0,18
Johnrichard,M,100,0,18,18
Joneka,F,100,18,0,18
Joory,F,100,18,0,18
Jordanlee,M,100,0,18,18
Jovanda,F,100,18,0,18
Jovawn,M,100,0,18,18
Julienna,F,100,18,0,18
Junichi,M,100,0,18,18
Justinray,M,100,0,18,18
Jymme,F,100,18,0,18
Jyselle,F,100,18,0,18
Kachiri,F,100,18,0,18
Kaidy,F,100,18,0,18
Kaigan,F,67,12,6,18
Kalet,M,100,0,18,18
Kalo,M,100,0,18,18
Kameel,M,100,0,18,18
Kamiron,M,100,0,18,18
Kamore,F,100,18,0,18
Kanilah,F,100,18,0,18
Kanyae,M,100,0,18,18
Karesse,F,100,18,0,18
Kassee,F,100,18,0,18
Katalayah,F,100,18,0,18
Katharyne,F,100,18,0,18
Kathllen,F,100,18,0,18
Katilaya,F,100,18,0,18
Kayedence,F,100,18,0,18
Kayel,M,100,0,18,18
Kaysar,M,100,0,18,18
Kealin,M,100,0,18,18
Keaunte,M,100,0,18,18
Keavion,M,100,0,18,18
Kederick,M,100,0,18,18
Keithrick,M,100,0,18,18
Kellsi,F,100,18,0,18
Keragan,F,100,18,0,18
Kerbie,F,100,18,0,18
Kessandra,F,100,18,0,18
Ketha,F,100,18,0,18
Kexin,F,100,18,0,18
Keyonnie,F,100,18,0,18
Keyshauna,F,100,18,0,18
Khaina,F,100,18,0,18
Khaliyl,M,100,0,18,18
Khamara,F,100,18,0,18
Kharmen,F,100,18,0,18
Kiandrea,F,100,18,0,18
Kiawana,F,100,18,0,18
Kieayla,F,100,18,0,18
Kieyana,F,100,18,0,18
Kimann,F,100,18,0,18
Kimary,F,100,18,0,18
Kimberlei,F,100,18,0,18
Kinberlin,F,100,18,0,18
Kiniyah,F,100,18,0,18
Kinlynn,F,100,18,0,18
Klarity,F,100,18,0,18
Kongcheng,M,100,0,18,18
Krishanda,F,100,18,0,18
Kryston,F,100,18,0,18
Kumasi,M,100,0,18,18
Kurdt,M,100,0,18,18
Kwante,M,100,0,18,18
Kyaria,F,100,18,0,18
Kyeria,F,100,18,0,18
Kyndrick,M,100,0,18,18
Kynna,F,100,18,0,18
Kyrrah,F,100,18,0,18
Labrittney,F,100,18,0,18
Lachante,F,100,18,0,18
Laicey,F,100,18,0,18
Lailanee,F,100,18,0,18
Lajae,F,100,18,0,18
Lanney,M,100,0,18,18
Laquitia,F,100,18,0,18
Lashaina,F,100,18,0,18
Lashieka,F,100,18,0,18
Latachia,F,100,18,0,18
Latarus,M,100,0,18,18
Latecha,F,100,18,0,18
Lathe,M,100,0,18,18
Lawanza,F,100,18,0,18
Lazetta,F,100,18,0,18
Leabella,F,100,18,0,18
Leatta,F,100,18,0,18
Leilahni,F,100,18,0,18
Lejend,M,100,0,18,18
Lekeitha,F,100,18,0,18
Lenden,M,100,0,18,18
Lenville,M,100,0,18,18
Leteisha,F,100,18,0,18
Leteshia,F,100,18,0,18
Leveta,F,100,18,0,18
Lilliemae,F,100,18,0,18
Lomont,M,100,0,18,18
Loressa,F,100,18,0,18
Louvella,F,100,18,0,18
Lukka,M,100,0,18,18
Lupie,F,100,18,0,18
Lurie,F,67,12,6,18
Luul,F,100,18,0,18
Lynice,F,100,18,0,18
Lyniyah,F,100,18,0,18
Maaya,F,100,18,0,18
Macks,M,100,0,18,18
Macolm,M,100,0,18,18
Madysan,F,100,18,0,18
Mahdee,M,100,0,18,18
Mahia,F,100,18,0,18
Mahliyah,F,100,18,0,18
Mairah,F,100,18,0,18
Majayla,F,100,18,0,18
Makiylah,F,100,18,0,18
Malaila,F,100,18,0,18
Malazia,F,100,18,0,18
Maleehah,F,100,18,0,18
Maleina,F,100,18,0,18
Mallaki,M,100,0,18,18
Mamoon,M,100,0,18,18
Mania,F,100,18,0,18
Mano,M,100,0,18,18
Manolis,M,100,0,18,18
Maquela,F,100,18,0,18
Marcale,M,100,0,18,18
Marcjacob,M,100,0,18,18
Mariajulia,F,100,18,0,18
Marialisa,F,100,18,0,18
Mariquita,F,100,18,0,18
Markhia,F,100,18,0,18
Markuz,M,100,0,18,18
Marquess,M,100,0,18,18
Marquessa,F,100,18,0,18
Marylan,F,100,18,0,18
Marylen,F,100,18,0,18
Maryorie,F,100,18,0,18
Marzena,F,100,18,0,18
Matthewjoseph,M,100,0,18,18
Matthw,M,100,0,18,18
Maxeen,F,100,18,0,18
Maxiel,F,100,18,0,18
Maylana,F,100,18,0,18
Maylena,F,100,18,0,18
Maylis,F,100,18,0,18
Medinah,F,100,18,0,18
Melanne,F,100,18,0,18
Melesha,F,100,18,0,18
Merav,F,100,18,0,18
Metin,M,100,0,18,18
Mevelyn,F,100,18,0,18
Meyana,F,100,18,0,18
Michalyn,F,100,18,0,18
Michelli,F,100,18,0,18
Mihajlo,M,100,0,18,18
Mikhel,M,100,0,18,18
Minika,F,100,18,0,18
Montelle,M,100,0,18,18
Monterrious,M,100,0,18,18
Mosha,M,100,0,18,18
Mosie,M,100,0,18,18
Mossie,F,100,18,0,18
Mourice,M,100,0,18,18
Movita,F,100,18,0,18
Munasar,M,100,0,18,18
Murdoc,M,100,0,18,18
Myazia,F,100,18,0,18
Mycha,F,100,18,0,18
Myleigha,F,100,18,0,18
Mytia,F,100,18,0,18
Naail,M,100,0,18,18
Naairah,F,100,18,0,18
Naeli,F,100,18,0,18
Nahyeli,F,100,18,0,18
Nakara,F,100,18,0,18
Nakhya,F,100,18,0,18
Nassiah,F,67,12,6,18
Nealon,M,100,0,18,18
Nekiya,F,100,18,0,18
Neldon,M,100,0,18,18
Neleigh,F,100,18,0,18
Nelina,F,100,18,0,18
Nevaiah,F,100,18,0,18
Neylin,F,100,18,0,18
Nicala,F,100,18,0,18
Nichaela,F,100,18,0,18
Nichel,F,100,18,0,18
Nicodemo,M,100,0,18,18
Nicolia,F,100,18,0,18
Nijai,F,100,18,0,18
Nimsy,F,100,18,0,18
Nishal,M,100,0,18,18
No,F,67,12,6,18
Noellia,F,100,18,0,18
Nohl,M,100,0,18,18
Novel,M,100,0,18,18
Nyteria,F,100,18,0,18
Oday,M,100,0,18,18
Ollivia,F,100,18,0,18
Oluwafunmilayo,F,100,18,0,18
Olyve,F,100,18,0,18
Omariyon,M,100,0,18,18
Omelia,F,100,18,0,18
Omi,M,100,0,18,18
Onassis,M,100,0,18,18
Onetha,F,100,18,0,18
Orah,F,100,18,0,18
Orell,M,100,0,18,18
Orlen,M,100,0,18,18
Osbourne,M,100,0,18,18
Pala,F,100,18,0,18
Paricia,F,100,18,0,18
Patricka,F,100,18,0,18
Paule,F,100,18,0,18
Paysli,F,100,18,0,18
Pei,F,100,18,0,18
Peiton,F,100,18,0,18
Peppi,F,72,13,5,18
Perlie,F,100,18,0,18
Persaius,F,100,18,0,18
Phallyn,F,100,18,0,18
Poleth,F,100,18,0,18
Prabhdeep,M,100,0,18,18
Prynceton,M,100,0,18,18
Ptolemy,M,100,0,18,18
Qi,M,100,0,18,18
Quamarion,M,100,0,18,18
Rachae,F,100,18,0,18
Radiya,F,100,18,0,18
Rahshad,M,100,0,18,18
Rahshon,M,100,0,18,18
Ralee,F,100,18,0,18
Randolyn,F,100,18,0,18
Rashayla,F,100,18,0,18
Rashmika,F,100,18,0,18
Rayvan,F,100,18,0,18
Reca,F,100,18,0,18
Remell,F,100,18,0,18
Reminisce,F,100,18,0,18
Remiyah,F,100,18,0,18
Renz,M,100,0,18,18
Rethia,F,100,18,0,18
Reylin,F,72,13,5,18
Rhiannah,F,100,18,0,18
Rickeshia,F,100,18,0,18
Rickford,M,100,0,18,18
Rietta,F,100,18,0,18
Robart,M,100,0,18,18
Rodrique,M,100,0,18,18
Rolisha,F,100,18,0,18
Roxey,F,100,18,0,18
Rozita,F,100,18,0,18
Rueger,M,100,0,18,18
Ruthi,F,100,18,0,18
Ryelyn,F,100,18,0,18
Rylund,M,100,0,18,18
Rynda,F,100,18,0,18
Saarth,M,100,0,18,18
Sadieann,F,100,18,0,18
Sahanna,F,100,18,0,18
Sahit,M,100,0,18,18
Sahnnon,F,100,18,0,18
Samajay,M,100,0,18,18
Samario,M,100,0,18,18
Samrath,M,100,0,18,18
Saniia,F,100,18,0,18
Sanija,F,100,18,0,18
Sanisha,F,100,18,0,18
Saniy,F,100,18,0,18
Sanvitha,F,100,18,0,18
Sarene,F,100,18,0,18
Sayeh,F,100,18,0,18
Saynab,F,100,18,0,18
Schaeffer,M,100,0,18,18
Scharlotte,F,100,18,0,18
Schlonda,F,100,18,0,18
Se,F,67,12,6,18
Seabron,M,100,0,18,18
Seam,M,100,0,18,18
Seanan,M,100,0,18,18
Seante,F,100,18,0,18
Selica,F,100,18,0,18
Serbando,M,100,0,18,18
Seryn,F,100,18,0,18
Shaconna,F,100,18,0,18
Shadwick,M,100,0,18,18
Shael,M,100,0,18,18
Shahera,F,100,18,0,18
Shallah,M,100,0,18,18
Shalma,F,100,18,0,18
Shalome,F,100,18,0,18
Shamare,M,100,0,18,18
Shanerica,F,100,18,0,18
Shaneva,F,100,18,0,18
Shanijah,F,100,18,0,18
Shavita,F,100,18,0,18
Shawnece,F,100,18,0,18
Shaymaa,F,100,18,0,18
Sheletta,F,100,18,0,18
Shemira,F,100,18,0,18
Shenequia,F,100,18,0,18
Sheradyn,F,100,18,0,18
Sherrese,F,100,18,0,18
Sherritta,F,100,18,0,18
Sherryn,F,100,18,0,18
Shiffon,F,100,18,0,18
Shikina,F,100,18,0,18
Shinia,F,100,18,0,18
Shoshawna,F,100,18,0,18
Shriram,M,100,0,18,18
Shundrea,F,100,18,0,18
Shykila,F,100,18,0,18
Sibella,F,100,18,0,18
Siddeeqah,F,100,18,0,18
Silia,F,100,18,0,18
Simonetta,F,100,18,0,18
Sinatra,M,100,0,18,18
Siu,F,72,13,5,18
Sivad,M,100,0,18,18
Skyland,M,100,0,18,18
Snithik,M,100,0,18,18
Sniya,F,100,18,0,18
Sochil,F,100,18,0,18
Soon,F,100,18,0,18
Sophear,M,56,8,10,18
Soroush,M,100,0,18,18
Sovanny,F,100,18,0,18
Spandana,F,100,18,0,18
Spruha,F,100,18,0,18
Subrenia,F,100,18,0,18
Suchita,F,100,18,0,18
Sumukh,M,100,0,18,18
Sundown,F,67,12,6,18
Sybilla,F,100,18,0,18
Sylester,M,100,0,18,18
Taahirah,F,100,18,0,18
Tahera,F,100,18,0,18
Tahiem,M,100,0,18,18
Taion,M,100,0,18,18
Tajanea,F,100,18,0,18
Tajauna,F,100,18,0,18
Takierra,F,100,18,0,18
Talethia,F,100,18,0,18
Talhia,F,100,18,0,18
Tamarious,M,100,0,18,18
Tamblyn,F,100,18,0,18
Tameer,M,100,0,18,18
Tamijah,F,100,18,0,18
Tanaejah,F,100,18,0,18
Taniel,F,100,18,0,18
Tanikqua,F,100,18,0,18
Taqueria,F,100,18,0,18
Tarajee,F,100,18,0,18
Tarel,M,100,0,18,18
Tatiauna,F,100,18,0,18
Tavishi,F,100,18,0,18
Teaghen,F,100,18,0,18
Teairah,F,100,18,0,18
Teaona,F,100,18,0,18
Teaundra,F,100,18,0,18
Teel,F,100,18,0,18
Telethia,F,100,18,0,18
Tempress,F,100,18,0,18
Tennell,F,72,13,5,18
Tevante,M,100,0,18,18
Teyler,F,100,18,0,18
Thedford,M,100,0,18,18
Thrisha,F,100,18,0,18
Tieka,F,100,18,0,18
Tijwana,F,100,18,0,18
Tikara,F,100,18,0,18
Tileah,F,100,18,0,18
Timthoy,M,100,0,18,18
Tiniyah,F,100,18,0,18
Tishona,F,100,18,0,18
Toinetta,F,100,18,0,18
Tonysha,F,100,18,0,18
Torrye,F,100,18,0,18
Toyin,F,100,18,0,18
Traedyn,M,100,0,18,18
Traice,F,72,13,5,18
Tralana,F,100,18,0,18
Tralyn,M,100,0,18,18
Tranya,F,100,18,0,18
Traviona,F,100,18,0,18
Trejean,M,100,0,18,18
Treka,F,100,18,0,18
Trinatee,F,100,18,0,18
Trona,F,100,18,0,18
Tuf,M,100,0,18,18
Twilight,F,100,18,0,18
Tyania,F,100,18,0,18
Tyffanie,F,100,18,0,18
Tykara,F,100,18,0,18
Tyleshia,F,100,18,0,18
Tynsley,F,100,18,0,18
Tysie,F,100,18,0,18
Tzurty,F,100,18,0,18
Ulana,F,100,18,0,18
Umut,M,100,0,18,18
Ursla,F,100,18,0,18
Vaelyn,F,100,18,0,18
Valgene,M,100,0,18,18
Vanesta,F,100,18,0,18
Vanness,M,72,5,13,18
Varinia,F,100,18,0,18
Velna,F,100,18,0,18
Vermelle,F,100,18,0,18
Vernika,F,100,18,0,18
Victoriamarie,F,100,18,0,18
Vinesha,F,100,18,0,18
Viney,F,100,18,0,18
Vyas,M,100,0,18,18
Waad,F,100,18,0,18
Wakinyan,M,100,0,18,18
Waylynn,F,72,13,5,18
Webber,M,100,0,18,18
Wilbon,M,100,0,18,18
Wirt,M,100,0,18,18
Wood,M,100,0,18,18
Wryder,M,100,0,18,18
Wykisha,F,100,18,0,18
Xzayvian,M,100,0,18,18
Yaasmeen,F,100,18,0,18
Yacqueline,F,100,18,0,18
Yaelle,F,100,18,0,18
Yameka,F,100,18,0,18
Yandi,F,72,13,5,18
Yaniece,F,100,18,0,18
Yaqoob,M,100,0,18,18
Yazzmine,F,100,18,0,18
Yeiri,F,100,18,0,18
Yesnia,F,100,18,0,18
Yian,M,100,0,18,18
Yoann,M,100,0,18,18
Yolandia,F,100,18,0,18
Yonael,M,100,0,18,18
Yordany,M,100,0,18,18
Yukino,F,100,18,0,18
Yuxuan,M,72,5,13,18
Zacai,M,100,0,18,18
Zadaya,F,100,18,0,18
Zaeleigh,F,100,18,0,18
Zaniyyah,F,100,18,0,18
Zaphira,F,100,18,0,18
Zaybree,F,100,18,0,18
Zelaya,F,100,18,0,18
Zeplin,M,100,0,18,18
Zhariya,F,100,18,0,18
Ziera,F,100,18,0,18
Ziion,M,100,0,18,18
Zinachidi,F,100,18,0,18
Zoelie,F,100,18,0,18
Zoli,F,100,18,0,18
Zonna,F,100,18,0,18
Zuko,M,100,0,18,18
Zuzana,F,100,18,0,18
Zykiah,F,100,18,0,18
Aadish,M,100,0,17,17
Aalaysha,F,100,17,0,17
Aamil,M,100,0,17,17
Aaradhana,F,100,17,0,17
Aarn,M,100,0,17,17
Aason,M,100,0,17,17
Aavion,M,100,0,17,17
Abd,M,100,0,17,17
Abdellah,M,100,0,17,17
Abdual,M,100,0,17,17
Abdurraheem,M,100,0,17,17
Aben,M,100,0,17,17
Abish,F,100,17,0,17
Abraheem,M,100,0,17,17
Absidy,F,100,17,0,17
Adai,F,100,17,0,17
Adraya,F,100,17,0,17
Aeowyn,F,100,17,0,17
Afiyah,F,100,17,0,17
Afsaneh,F,100,17,0,17
Agostina,F,100,17,0,17
Ahjanay,F,100,17,0,17
Ahlaam,F,100,17,0,17
Aiddan,M,100,0,17,17
Ajan,M,100,0,17,17
Ajiana,F,100,17,0,17
Akeyia,F,100,17,0,17
Alaki,M,100,0,17,17
Alayjha,F,100,17,0,17
Aleata,F,100,17,0,17
Alekza,F,100,17,0,17
Alexandia,F,100,17,0,17
Aliceann,F,100,17,0,17
Aliesa,F,100,17,0,17
Alinson,F,100,17,0,17
Allandra,F,100,17,0,17
Allyannah,F,100,17,0,17
Almanzo,M,100,0,17,17
Alonya,F,100,17,0,17
Alonzia,F,100,17,0,17
Alprentice,M,100,0,17,17
Alsatia,F,100,17,0,17
Alsion,F,100,17,0,17
Altouise,F,100,17,0,17
Alyaa,F,100,17,0,17
Amardeep,M,100,0,17,17
Amaryia,F,100,17,0,17
Ambriehl,F,100,17,0,17
Amelle,F,100,17,0,17
Amoz,M,100,0,17,17
Amriel,F,100,17,0,17
Anazia,F,100,17,0,17
Andreq,M,100,0,17,17
Angellyn,F,100,17,0,17
Angelyka,F,100,17,0,17
Angelyssa,F,100,17,0,17
Angia,F,100,17,0,17
Angleica,F,100,17,0,17
Animesh,M,100,0,17,17
Anistynn,F,100,17,0,17
Aniyan,F,100,17,0,17
Annalecia,F,100,17,0,17
Annecy,F,100,17,0,17
Antanay,F,100,17,0,17
Antha,F,100,17,0,17
Anthuan,M,100,0,17,17
Antonasia,F,100,17,0,17
Antonita,F,100,17,0,17
Antwanisha,F,100,17,0,17
Anvesha,F,100,17,0,17
Anyri,F,100,17,0,17
Apolline,F,100,17,0,17
Aquille,M,100,0,17,17
Aralynne,F,100,17,0,17
Aranya,F,100,17,0,17
Aranzazu,F,100,17,0,17
Aremy,F,100,17,0,17
Ariagna,F,100,17,0,17
Arinna,F,100,17,0,17
Armelinda,F,100,17,0,17
Arney,M,100,0,17,17
Arnis,M,100,0,17,17
Arpad,M,100,0,17,17
Arson,M,100,0,17,17
Arunas,M,100,0,17,17
Aryell,F,100,17,0,17
Arysa,F,100,17,0,17
Asalah,F,100,17,0,17
Ashanique,F,100,17,0,17
Ashkii,M,100,0,17,17
Ashonna,F,100,17,0,17
Aszia,F,100,17,0,17
Atheana,F,100,17,0,17
Atosha,F,100,17,0,17
Aubreylynn,F,100,17,0,17
Aubreyona,F,100,17,0,17
Aubreyonna,F,100,17,0,17
Audrinah,F,100,17,0,17
Auralia,F,100,17,0,17
Austria,F,100,17,0,17
Auturo,M,100,0,17,17
Avantay,M,100,0,17,17
Avee,F,100,17,0,17
Averlee,F,100,17,0,17
Averylynn,F,100,17,0,17
Avionce,F,100,17,0,17
Avonelle,F,100,17,0,17
Avrom,M,100,0,17,17
Axa,F,100,17,0,17
Aylinne,F,100,17,0,17
Ayreanna,F,100,17,0,17
Ayreona,F,100,17,0,17
Ayusha,F,100,17,0,17
Bachir,M,100,0,17,17
Baeley,F,100,17,0,17
Bahia,F,100,17,0,17
Balal,M,100,0,17,17
Balentin,M,100,0,17,17
Bansari,F,100,17,0,17
Banx,M,100,0,17,17
Barnette,F,100,17,0,17
Basile,M,100,0,17,17
Bearl,M,100,0,17,17
Benigna,F,100,17,0,17
Beri,F,100,17,0,17
Bernadino,M,100,0,17,17
Bernida,F,100,17,0,17
Bernnadette,F,100,17,0,17
Betanya,F,100,17,0,17
Bethia,F,100,17,0,17
Beunca,F,100,17,0,17
Bevon,M,100,0,17,17
Bexton,M,100,0,17,17
Bezalel,M,100,0,17,17
Biatris,F,100,17,0,17
Biju,M,100,0,17,17
Bixby,F,71,12,5,17
Blaiklee,F,100,17,0,17
Blakelie,F,100,17,0,17
Boban,M,100,0,17,17
Bostin,M,100,0,17,17
Braela,F,100,17,0,17
Brancy,F,100,17,0,17
Brandasia,F,100,17,0,17
Bravin,M,100,0,17,17
Breezi,F,100,17,0,17
Breshaun,M,100,0,17,17
Breyanne,F,100,17,0,17
Breylynn,F,100,17,0,17
Briance,F,100,17,0,17
Brigita,F,100,17,0,17
Bristin,F,71,12,5,17
Brittneyann,F,100,17,0,17
Bronner,M,100,0,17,17
Brookston,M,100,0,17,17
Brynnen,F,59,10,7,17
Brynnli,F,100,17,0,17
Brynt,M,100,0,17,17
Bukhari,M,100,0,17,17
Burklee,F,100,17,0,17
Byrce,M,100,0,17,17
Cabell,M,100,0,17,17
Cadijah,F,100,17,0,17
Caisley,F,100,17,0,17
Caleesha,F,100,17,0,17
Cambrielle,F,100,17,0,17
Camerion,M,100,0,17,17
Camreon,M,100,0,17,17
Caraleigh,F,100,17,0,17
Caril,F,100,17,0,17
Carion,M,100,0,17,17
Caritina,F,100,17,0,17
Carliegh,F,100,17,0,17
Carmenita,F,100,17,0,17
Caros,M,100,0,17,17
Carsandra,F,100,17,0,17
Caselyn,F,100,17,0,17
Caslyn,F,100,17,0,17
Cathay,F,100,17,0,17
Cathee,F,100,17,0,17
Catinia,F,100,17,0,17
Catrese,F,100,17,0,17
Caydenn,M,100,0,17,17
Caysee,F,100,17,0,17
Cazzie,M,100,0,17,17
Cecilly,F,100,17,0,17
Celton,M,100,0,17,17
Cemone,F,100,17,0,17
Ceyonna,F,100,17,0,17
Chaketa,F,100,17,0,17
Chakiya,F,100,17,0,17
Chaniel,F,100,17,0,17
Channer,M,100,0,17,17
Charece,F,100,17,0,17
Charemon,F,100,17,0,17
Charessa,F,100,17,0,17
Charielle,F,100,17,0,17
Charlsea,F,100,17,0,17
Charolet,F,100,17,0,17
Chaveli,F,100,17,0,17
Chawanda,F,100,17,0,17
Chayten,M,100,0,17,17
Chemene,F,100,17,0,17
Cherea,F,100,17,0,17
Cherif,M,100,0,17,17
Cherol,F,100,17,0,17
Cherra,F,100,17,0,17
Chiedozie,M,100,0,17,17
Chira,F,100,17,0,17
Chol,M,100,0,17,17
Chontae,F,100,17,0,17
Chrisanthony,M,100,0,17,17
Chriselle,F,100,17,0,17
Christalle,F,100,17,0,17
Christianjohn,M,100,0,17,17
Christiyana,F,100,17,0,17
Christopherjose,M,100,0,17,17
Clabe,M,100,0,17,17
Clarisha,F,100,17,0,17
Colina,F,100,17,0,17
Comeka,F,100,17,0,17
Corbie,F,71,12,5,17
Corson,M,100,0,17,17
Coryna,F,100,17,0,17
Cretia,F,100,17,0,17
Crisoforo,M,100,0,17,17
Cynteria,F,100,17,0,17
Cyriana,F,100,17,0,17
Cyrille,M,65,6,11,17
Daaimah,F,100,17,0,17
Dainen,M,100,0,17,17
Dakarie,M,100,0,17,17
Dakim,M,100,0,17,17
Dalano,M,100,0,17,17
Damajah,M,100,0,17,17
Damariya,F,100,17,0,17
Damecia,F,100,17,0,17
Danik,M,100,0,17,17
Danyaal,M,100,0,17,17
Dariun,M,100,0,17,17
Darle,M,100,0,17,17
Darnez,M,100,0,17,17
Darrionna,F,100,17,0,17
Darryell,M,100,0,17,17
Dartavius,M,100,0,17,17
Daryian,F,65,11,6,17
Dashad,M,100,0,17,17
Dashanda,F,100,17,0,17
Dathen,M,100,0,17,17
Dathon,M,100,0,17,17
Daury,M,100,0,17,17
Davayah,F,100,17,0,17
Davel,M,100,0,17,17
Daveney,F,100,17,0,17
Davidjohn,M,100,0,17,17
Davontai,M,100,0,17,17
Daycia,F,100,17,0,17
Daylie,F,100,17,0,17
Daynisha,F,100,17,0,17
Deajanae,F,100,17,0,17
Deannia,F,100,17,0,17
Deantwan,M,100,0,17,17
Deaundrey,M,100,0,17,17
Debborrah,F,100,17,0,17
Debooah,F,100,17,0,17
Dechlan,M,100,0,17,17
Deenie,F,100,17,0,17
Deivin,M,100,0,17,17
Deivion,M,59,7,10,17
Deleena,F,100,17,0,17
Dellar,F,100,17,0,17
Delmore,M,100,0,17,17
Delorese,F,100,17,0,17
Delrita,F,100,17,0,17
Delyssa,F,100,17,0,17
Demacio,M,100,0,17,17
Demariyon,M,100,0,17,17
Demea,M,71,5,12,17
Denardo,M,100,0,17,17
Denie,F,100,17,0,17
Denira,F,100,17,0,17
Deonate,M,100,0,17,17
Depree,M,100,0,17,17
Dequindre,M,100,0,17,17
Dessiah,F,100,17,0,17
Destinay,F,100,17,0,17
Devahn,M,100,0,17,17
Devien,M,100,0,17,17
Devonee,F,100,17,0,17
Devraj,M,100,0,17,17
Dewann,M,100,0,17,17
Dila,F,100,17,0,17
Dominyc,M,100,0,17,17
Domminick,M,100,0,17,17
Donnasia,F,100,17,0,17
Dontate,M,100,0,17,17
Dottye,F,100,17,0,17
Down,F,100,17,0,17
Driss,M,100,0,17,17
Dystinee,F,100,17,0,17
Ebby,F,100,17,0,17
Ede,F,100,17,0,17
Edmanuel,M,100,0,17,17
Edwyna,F,100,17,0,17
Ehaan,M,100,0,17,17
Eiji,M,100,0,17,17
Eimmy,F,100,17,0,17
Eirc,M,100,0,17,17
Ekko,F,100,17,0,17
Elenny,F,100,17,0,17
Eliscia,F,100,17,0,17
Ellar,F,100,17,0,17
Ellard,M,100,0,17,17
Ellawyn,F,100,17,0,17
Elleri,F,100,17,0,17
Ellexus,F,100,17,0,17
Ellieann,F,100,17,0,17
Ellisia,F,100,17,0,17
Ellyonna,F,100,17,0,17
Elnatan,M,100,0,17,17
Eloi,M,100,0,17,17
Elvenia,F,100,17,0,17
Elveria,F,100,17,0,17
Elway,M,100,0,17,17
Elyja,M,100,0,17,17
Emauni,F,100,17,0,17
Emilson,M,100,0,17,17
Enry,M,100,0,17,17
Enyce,F,100,17,0,17
Eralyn,F,100,17,0,17
Erneshia,F,100,17,0,17
Ervina,F,100,17,0,17
Eseosa,F,100,17,0,17
Estacia,F,100,17,0,17
Esthefania,F,100,17,0,17
Evangeleen,F,100,17,0,17
Evonny,F,100,17,0,17
Eyuel,M,100,0,17,17
Ezgi,F,100,17,0,17
Eziel,M,100,0,17,17
Fadwa,F,100,17,0,17
Farmer,M,100,0,17,17
Farshad,M,100,0,17,17
Fatouma,F,100,17,0,17
Fawnia,F,100,17,0,17
Felicea,F,100,17,0,17
Fenn,M,100,0,17,17
Fenna,F,100,17,0,17
Filmon,M,100,0,17,17
Flori,F,100,17,0,17
Flory,F,100,17,0,17
Fotis,M,100,0,17,17
Franka,F,100,17,0,17
Fredreick,M,100,0,17,17
Gaal,F,100,17,0,17
Gabel,M,100,0,17,17
Ganna,F,100,17,0,17
Garwin,M,100,0,17,17
Gea,F,100,17,0,17
Generoso,M,100,0,17,17
Gennine,F,100,17,0,17
Gentiana,F,100,17,0,17
Geordyn,F,100,17,0,17
Georgemichael,M,100,0,17,17
Geramie,M,100,0,17,17
Gere,M,65,6,11,17
Geric,M,100,0,17,17
Gerise,F,100,17,0,17
Gernard,M,100,0,17,17
Gertrudis,F,100,17,0,17
Gianmichael,M,100,0,17,17
Gig,M,100,0,17,17
Giscard,M,100,0,17,17
Glean,M,100,0,17,17
Glendaliz,F,100,17,0,17
Glenyce,F,100,17,0,17
Gloriane,F,100,17,0,17
Greko,M,100,0,17,17
Grove,M,100,0,17,17
Gurvinder,M,100,0,17,17
Gwenavere,F,100,17,0,17
Gwendol,F,100,17,0,17
Gyana,F,100,17,0,17
Hades,M,100,0,17,17
Hafeez,M,100,0,17,17
Halford,M,100,0,17,17
Hamsika,F,100,17,0,17
Hargis,M,100,0,17,17
Harkaran,M,100,0,17,17
Harmeet,F,65,11,6,17
Harmonei,F,100,17,0,17
Hasley,F,100,17,0,17
Havisha,F,100,17,0,17
Haydar,M,100,0,17,17
Hazelee,F,100,17,0,17
Heathermarie,F,100,17,0,17
Heleyna,F,100,17,0,17
Hemali,F,100,17,0,17
Herik,M,100,0,17,17
Hershall,M,100,0,17,17
Heyam,F,100,17,0,17
Hiwot,F,100,17,0,17
Hypatia,F,100,17,0,17
Ilesha,F,100,17,0,17
Ilyjah,M,100,0,17,17
Indee,F,100,17,0,17
Infantboy,M,100,0,17,17
Irvyn,M,100,0,17,17
Ishak,M,100,0,17,17
Issey,M,100,0,17,17
Izear,M,100,0,17,17
Jabdiel,M,100,0,17,17
Jacorri,M,100,0,17,17
Jacquelline,F,100,17,0,17
Jacyon,M,100,0,17,17
Jadeann,F,100,17,0,17
Jadell,M,100,0,17,17
Jaeci,F,100,17,0,17
Jahrod,M,100,0,17,17
Jahsan,M,100,0,17,17
Jahsim,M,100,0,17,17
Jahya,F,100,17,0,17
Jaicie,F,100,17,0,17
Jairah,F,100,17,0,17
Jairdan,M,100,0,17,17
Jaiza,F,100,17,0,17
Jaizen,M,100,0,17,17
Jakaela,F,100,17,0,17
Jakale,M,100,0,17,17
Jakilah,F,100,17,0,17
Jal,M,100,0,17,17
Jaleesia,F,100,17,0,17
Jaliayah,F,100,17,0,17
Jamaun,M,100,0,17,17
Jamesley,M,100,0,17,17
Jamileh,F,100,17,0,17
Janavi,F,100,17,0,17
Janelee,F,100,17,0,17
Janeta,F,100,17,0,17
Janyth,F,100,17,0,17
Jaqual,M,100,0,17,17
Jaquella,F,100,17,0,17
Jarez,M,100,0,17,17
Jarie,F,65,11,6,17
Jarmall,M,100,0,17,17
Jaroslaw,M,100,0,17,17
Jataun,F,100,17,0,17
Jathziry,F,100,17,0,17
Javant,M,100,0,17,17
Javario,M,100,0,17,17
Javarrius,M,100,0,17,17
Javianna,F,100,17,0,17
Jaxom,M,100,0,17,17
Jayannah,F,100,17,0,17
Jayciana,F,100,17,0,17
Jaylis,F,100,17,0,17
Jayms,M,100,0,17,17
Jaynesha,F,100,17,0,17
Jaynette,F,100,17,0,17
Jazavier,M,100,0,17,17
Jazmariah,F,100,17,0,17
Jazzabella,F,100,17,0,17
Jeanessa,F,100,17,0,17
Jehna,F,100,17,0,17
Jeiren,M,100,0,17,17
Jemmah,F,100,17,0,17
Jenece,F,100,17,0,17
Jeneene,F,100,17,0,17
Jeneil,F,100,17,0,17
Jerjuan,M,100,0,17,17
Jerray,M,100,0,17,17
Jerril,M,100,0,17,17
Jerrimy,M,100,0,17,17
Jerrisha,F,100,17,0,17
Jewan,M,100,0,17,17
Jeylen,F,71,12,5,17
Jeyline,F,100,17,0,17
Jhourni,F,100,17,0,17
Jibrail,M,100,0,17,17
Jineane,F,100,17,0,17
Jion,M,100,0,17,17
Jionna,F,100,17,0,17
Jiovonni,M,100,0,17,17
Jizzel,F,100,17,0,17
Jlin,M,100,0,17,17
Jmauri,M,100,0,17,17
Jmaya,F,100,17,0,17
Jnyia,F,100,17,0,17
Jocylin,F,100,17,0,17
Joelliane,F,100,17,0,17
Johnavin,M,100,0,17,17
Johntez,M,100,0,17,17
Jomal,M,100,0,17,17
Joniesha,F,100,17,0,17
Josabeth,F,100,17,0,17
Joshuaryan,M,100,0,17,17
Josiana,F,100,17,0,17
Josielyn,F,100,17,0,17
Jovonie,M,100,0,17,17
Jozzlynn,F,100,17,0,17
Juawan,M,100,0,17,17
Juile,F,100,17,0,17
Justess,F,100,17,0,17
Jyshaun,M,100,0,17,17
Kaarina,F,100,17,0,17
Kacelynn,F,100,17,0,17
Kadidra,F,100,17,0,17
Kaeliegh,F,100,17,0,17
Kaeyla,F,100,17,0,17
Kahl,M,100,0,17,17
Kailaya,F,100,17,0,17
Kailo,M,100,0,17,17
Kaion,M,100,0,17,17
Kairan,M,100,0,17,17
Kaitie,F,100,17,0,17
Kaityn,F,100,17,0,17
Kakisha,F,100,17,0,17
Kalae,F,71,12,5,17
Kalaiah,F,100,17,0,17
Kalayshia,F,100,17,0,17
Kalell,M,100,0,17,17
Kalpesh,M,100,0,17,17
Kamakana,M,100,0,17,17
Kamell,M,100,0,17,17
Kamiesha,F,100,17,0,17
Kamiylah,F,100,17,0,17
Kammron,M,100,0,17,17
Kamyar,M,100,0,17,17
Kanah,F,100,17,0,17
Kaniela,M,100,0,17,17
Kapiolani,F,100,17,0,17
Karalynne,F,100,17,0,17
Karneshia,F,100,17,0,17
Karysma,F,100,17,0,17
Kashyia,F,100,17,0,17
Kathiana,F,100,17,0,17
Katinka,F,100,17,0,17
Katrica,F,100,17,0,17
Kawailani,F,100,17,0,17
Kawaun,M,100,0,17,17
Kaydrian,M,100,0,17,17
Kayjah,F,100,17,0,17
Kaylii,F,100,17,0,17
Kaylonnie,F,100,17,0,17
Kazariah,F,100,17,0,17
Kealen,M,100,0,17,17
Keanda,F,100,17,0,17
Keatan,M,100,0,17,17
Keating,M,65,6,11,17
Keausha,F,100,17,0,17
Kedesha,F,100,17,0,17
Keeba,F,100,17,0,17
Keegon,M,100,0,17,17
Keenyah,F,100,17,0,17
Kelsia,F,100,17,0,17
Kemareon,M,100,0,17,17
Kenderius,M,100,0,17,17
Kendylle,F,100,17,0,17
Kenetta,F,100,17,0,17
Kenndy,F,59,10,7,17
Kentin,M,100,0,17,17
Kenyin,M,100,0,17,17
Keresa,F,100,17,0,17
Kerlyn,F,100,17,0,17
Kerr,M,100,0,17,17
Kerwyn,M,100,0,17,17
Keshunna,F,100,17,0,17
Kevana,F,100,17,0,17
Keystal,F,100,17,0,17
Khadin,M,100,0,17,17
Khaleigh,F,100,17,0,17
Khaley,F,100,17,0,17
Khalina,F,100,17,0,17
Khyara,F,100,17,0,17
Khylil,M,100,0,17,17
Kimlee,F,100,17,0,17
Kingsolomon,M,100,0,17,17
Kinkade,M,100,0,17,17
Kionah,F,100,17,0,17
Kisara,F,100,17,0,17
Kishauna,F,100,17,0,17
Kmarie,F,100,17,0,17
Knixon,M,100,0,17,17
Korian,M,100,0,17,17
Kourteney,F,100,17,0,17
Kriselle,F,100,17,0,17
Krisia,F,100,17,0,17
Kristinna,F,100,17,0,17
Kyashia,F,100,17,0,17
Kylara,F,100,17,0,17
Kymier,M,100,0,17,17
Kyril,M,100,0,17,17
Kyrique,M,100,0,17,17
Ladaya,F,100,17,0,17
Lafarrah,F,100,17,0,17
Lagreta,F,100,17,0,17
Laili,F,100,17,0,17
Lajaya,F,100,17,0,17
Lajla,F,100,17,0,17
Lakaia,F,100,17,0,17
Lakenia,F,100,17,0,17
Laliah,F,100,17,0,17
Lamariah,F,100,17,0,17
Langford,M,100,0,17,17
Langstyn,F,100,17,0,17
Laquanza,F,100,17,0,17
Laquay,F,71,12,5,17
Laqwanda,F,100,17,0,17
Larresha,F,100,17,0,17
Lashanya,F,100,17,0,17
Lashaundria,F,100,17,0,17
Lashondia,F,100,17,0,17
Latay,F,100,17,0,17
Latimer,M,100,0,17,17
Latousha,F,100,17,0,17
Latoyria,F,100,17,0,17
Latoyta,F,100,17,0,17
Latrey,M,100,0,17,17
Latrone,M,100,0,17,17
Latunia,F,100,17,0,17
Laundyn,F,100,17,0,17
Laurea,F,100,17,0,17
Lavinda,F,100,17,0,17
Laylaann,F,100,17,0,17
Layle,F,100,17,0,17
Laynette,F,100,17,0,17
Layra,F,100,17,0,17
Lazavion,M,100,0,17,17
Laziya,F,100,17,0,17
Leanie,F,100,17,0,17
Ledarion,M,100,0,17,17
Leesly,F,100,17,0,17
Leihla,F,100,17,0,17
Leilia,F,100,17,0,17
Lelyn,M,100,0,17,17
Leshelle,F,100,17,0,17
Leti,F,100,17,0,17
Liahona,F,100,17,0,17
Liamjames,M,100,0,17,17
Licette,F,100,17,0,17
Liko,M,100,0,17,17
Lilea,F,100,17,0,17
Lindsae,F,100,17,0,17
Linleigh,F,100,17,0,17
Linnzi,F,100,17,0,17
Linze,F,100,17,0,17
Lionela,F,100,17,0,17
Lisamaria,F,100,17,0,17
Lisbel,F,100,17,0,17
Lochlain,M,100,0,17,17
Loey,F,100,17,0,17
Lomar,M,100,0,17,17
Louria,F,100,17,0,17
Lousie,F,100,17,0,17
Lucias,M,100,0,17,17
Luisgustavo,M,100,0,17,17
Lurana,F,100,17,0,17
Lutece,F,100,17,0,17
Luzia,F,100,17,0,17
Lyndan,F,71,12,5,17
Lyndley,F,100,17,0,17
Lynward,M,100,0,17,17
Maari,F,100,17,0,17
Macel,F,100,17,0,17
Maclayne,F,100,17,0,17
Madchen,F,100,17,0,17
Madria,F,100,17,0,17
Madrid,F,71,12,5,17
Madux,M,100,0,17,17
Maged,M,100,0,17,17
Magno,M,100,0,17,17
Mahawa,F,100,17,0,17
Mahliya,F,100,17,0,17
Mahveen,F,100,17,0,17
Mailah,F,100,17,0,17
Mailie,F,100,17,0,17
Mainhia,F,100,17,0,17
Maisah,F,100,17,0,17
Malisia,F,100,17,0,17
Malkah,F,100,17,0,17
Malliyah,F,100,17,0,17
Malyke,M,100,0,17,17
Mamediarra,F,100,17,0,17
Manbir,M,100,0,17,17
Maninder,M,100,0,17,17
Marcasia,F,100,17,0,17
Marelie,F,100,17,0,17
Marette,F,100,17,0,17
Marfil,F,100,17,0,17
Mariadelourdes,F,100,17,0,17
Marida,F,100,17,0,17
Mariliz,F,100,17,0,17
Marlayne,F,100,17,0,17
Marris,M,65,6,11,17
Martena,F,100,17,0,17
Marvita,F,100,17,0,17
Marymichael,F,100,17,0,17
Maryrita,F,100,17,0,17
Marz,M,100,0,17,17
Masako,F,100,17,0,17
Masaya,M,100,0,17,17
Mathyus,M,100,0,17,17
Matyson,F,100,17,0,17
Mayvis,F,100,17,0,17
Mazell,F,100,17,0,17
Mcayla,F,100,17,0,17
Mcclellan,M,100,0,17,17
Mckane,M,100,0,17,17
Mckenlie,F,100,17,0,17
Mckynley,F,100,17,0,17
Meagin,F,100,17,0,17
Medeline,F,100,17,0,17
Medrick,M,100,0,17,17
Mehvish,F,100,17,0,17
Meilan,F,100,17,0,17
Mekal,M,100,0,17,17
Melissasue,F,100,17,0,17
Melvon,M,100,0,17,17
Memarie,F,100,17,0,17
Merima,F,100,17,0,17
Mesiyah,F,71,12,5,17
Micaelah,F,100,17,0,17
Michellene,F,100,17,0,17
Mieasha,F,100,17,0,17
Mikial,M,100,0,17,17
Mikiyas,M,100,0,17,17
Mikye,M,100,0,17,17
Milette,F,100,17,0,17
Minwoo,M,100,0,17,17
Mirola,F,100,17,0,17
Miryan,F,100,17,0,17
Mithun,M,100,0,17,17
Miylah,F,100,17,0,17
Miyon,M,100,0,17,17
Moad,M,100,0,17,17
Moctezuma,M,100,0,17,17
Mohagany,F,100,17,0,17
Moncerath,F,100,17,0,17
Monchelle,F,100,17,0,17
Monquez,M,100,0,17,17
Montra,M,65,6,11,17
Mor,F,71,12,5,17
Moukthika,F,100,17,0,17
Myauna,F,100,17,0,17
Mykailah,F,100,17,0,17
Mylesha,F,100,17,0,17
Myresha,F,100,17,0,17
Naailah,F,100,17,0,17
Naariah,F,100,17,0,17
Nacola,F,100,17,0,17
Nadaly,F,100,17,0,17
Nadalynn,F,100,17,0,17
Naelson,M,100,0,17,17
Naihla,F,100,17,0,17
Naiovy,F,100,17,0,17
Nakieta,F,100,17,0,17
Nallah,F,100,17,0,17
Nameera,F,100,17,0,17
Nanett,F,100,17,0,17
Nannetta,F,100,17,0,17
Naoya,M,100,0,17,17
Naquon,M,100,0,17,17
Narita,F,100,17,0,17
Nashyia,F,100,17,0,17
Nashyra,F,100,17,0,17
Nasiha,F,100,17,0,17
Nasteha,F,100,17,0,17
Nataliz,F,100,17,0,17
Nathias,M,100,0,17,17
Natilynn,F,100,17,0,17
Natylie,F,100,17,0,17
Naudica,F,100,17,0,17
Nausheen,F,100,17,0,17
Navell,M,100,0,17,17
Nayaliz,F,100,17,0,17
Naylen,M,71,5,12,17
Nayvie,F,100,17,0,17
Nazaneen,F,100,17,0,17
Nazere,M,100,0,17,17
Neina,F,100,17,0,17
Nenah,F,100,17,0,17
Nevaehly,F,100,17,0,17
Nevo,M,100,0,17,17
Niarah,F,100,17,0,17
Nickales,M,100,0,17,17
Nicolos,M,100,0,17,17
Nieya,F,100,17,0,17
Nihitha,F,100,17,0,17
Nikeesha,F,100,17,0,17
Nikila,F,100,17,0,17
Niral,M,100,0,17,17
Nishitha,F,100,17,0,17
Niveyah,F,100,17,0,17
Nocona,M,65,6,11,17
Noralynn,F,100,17,0,17
Norean,F,100,17,0,17
Nouran,F,100,17,0,17
Noy,F,100,17,0,17
Nsombi,F,100,17,0,17
Nubian,F,100,17,0,17
Nyjuan,M,100,0,17,17
Nykeia,F,100,17,0,17
Nyseem,M,100,0,17,17
Nyxon,M,100,0,17,17
Nyzeria,F,100,17,0,17
Odalyz,F,100,17,0,17
Ody,M,71,5,12,17
Ofek,M,100,0,17,17
Olalekan,M,100,0,17,17
Olujimi,M,100,0,17,17
Oluwasegun,M,100,0,17,17
Onawa,F,100,17,0,17
Oshawn,M,100,0,17,17
Otavia,F,100,17,0,17
Ottavio,M,100,0,17,17
Ottoniel,M,100,0,17,17
Pader,F,100,17,0,17
Paley,F,100,17,0,17
Panav,M,100,0,17,17
Parvin,M,100,0,17,17
Pater,M,100,0,17,17
Patricik,M,100,0,17,17
Pearlette,F,100,17,0,17
Pharez,M,100,0,17,17
Pheadra,F,100,17,0,17
Philisa,F,100,17,0,17
Pinches,M,100,0,17,17
Prayag,M,100,0,17,17
Prissila,F,100,17,0,17
Priyasha,F,100,17,0,17
Quateria,F,100,17,0,17
Quatrell,M,100,0,17,17
Quillen,M,100,0,17,17
Quindara,F,100,17,0,17
Quionna,F,100,17,0,17
Rahmeir,M,100,0,17,17
Rahniyah,F,100,17,0,17
Rajaa,F,100,17,0,17
Rajaun,M,100,0,17,17
Rajeeni,F,100,17,0,17
Rajni,F,100,17,0,17
Ralena,F,100,17,0,17
Ramielle,F,100,17,0,17
Ramzee,M,71,5,12,17
Rances,M,100,0,17,17
Randisha,F,100,17,0,17
Raniqua,F,100,17,0,17
Ratzy,F,100,17,0,17
Raycen,M,100,0,17,17
Redgie,M,100,0,17,17
Rekesha,F,100,17,0,17
Relina,F,100,17,0,17
Reme,M,100,0,17,17
Renezmee,F,100,17,0,17
Reny,M,65,6,11,17
Rhoni,F,100,17,0,17
Rhonisha,F,100,17,0,17
Rielee,F,100,17,0,17
Rikardo,M,100,0,17,17
Rikisha,F,100,17,0,17
Rikuto,M,100,0,17,17
Riylee,F,100,17,0,17
Robertmichael,M,100,0,17,17
Robinann,F,100,17,0,17
Rohana,F,100,17,0,17
Rokaya,F,100,17,0,17
Rokesha,F,100,17,0,17
Romilda,F,100,17,0,17
Ronld,M,100,0,17,17
Ronyae,F,100,17,0,17
Rosaida,F,100,17,0,17
Rosebella,F,100,17,0,17
Rossella,F,100,17,0,17
Rosser,M,100,0,17,17
Rossibell,F,100,17,0,17
Rozalie,F,100,17,0,17
Rudee,F,100,17,0,17
Ryhan,M,100,0,17,17
Rykeem,M,100,0,17,17
Rylenn,F,100,17,0,17
Rylind,M,100,0,17,17
Ryunosuke,M,100,0,17,17
Saanika,F,100,17,0,17
Sabelle,F,100,17,0,17
Sabriyya,F,100,17,0,17
Sadiga,F,100,17,0,17
Saevon,M,100,0,17,17
Saffiya,F,100,17,0,17
Safin,M,100,0,17,17
Sagarika,F,100,17,0,17
Sailyn,F,100,17,0,17
Sajah,F,100,17,0,17
Salamasina,F,100,17,0,17
Salamon,M,100,0,17,17
Samanthagrace,F,100,17,0,17
Sarahlyn,F,100,17,0,17
Sareli,F,100,17,0,17
Sateria,F,100,17,0,17
Sati,F,100,17,0,17
Satoko,F,100,17,0,17
Sauda,F,100,17,0,17
Saundria,F,100,17,0,17
Savante,M,100,0,17,17
Scyler,M,71,5,12,17
Seanice,F,100,17,0,17
Seidi,F,100,17,0,17
Seiry,F,100,17,0,17
Selestino,M,100,0,17,17
Semaiah,F,100,17,0,17
Semyah,F,100,17,0,17
Senoria,F,100,17,0,17
Sequoria,F,100,17,0,17
Seriana,F,100,17,0,17
Setayesh,F,100,17,0,17
Sevaughn,M,100,0,17,17
Sewell,M,100,0,17,17
Seyon,M,100,0,17,17
Shabab,M,100,0,17,17
Shakeithia,F,100,17,0,17
Shakib,M,100,0,17,17
Shakor,M,100,0,17,17
Shaleesa,F,100,17,0,17
Shalone,F,100,17,0,17
Shalynda,F,100,17,0,17
Shami,F,100,17,0,17
Shamikka,F,100,17,0,17
Shanari,F,100,17,0,17
Shanida,F,100,17,0,17
Shanike,F,100,17,0,17
Shanreka,F,100,17,0,17
Shaquawn,M,100,0,17,17
Shardaye,F,100,17,0,17
Sharmonique,F,100,17,0,17
Sharnece,F,100,17,0,17
Sharyce,F,100,17,0,17
Shaunese,F,100,17,0,17
Shawann,F,100,17,0,17
Sheilly,F,100,17,0,17
Shequan,M,100,0,17,17
Shequetta,F,100,17,0,17
Sherrion,F,100,17,0,17
Sherrl,F,100,17,0,17
Shervonne,F,100,17,0,17
Sheryal,F,100,17,0,17
Shindana,F,100,17,0,17
Shinea,F,100,17,0,17
Shinell,F,100,17,0,17
Shirika,F,100,17,0,17
Shontai,F,100,17,0,17
Shontea,F,100,17,0,17
Shontella,F,100,17,0,17
Shreyes,M,100,0,17,17
Shundreka,F,100,17,0,17
Shurla,F,100,17,0,17
Shyheed,M,100,0,17,17
Sidarth,M,100,0,17,17
Sidy,M,100,0,17,17
Sinem,F,100,17,0,17
Sinya,F,100,17,0,17
Sireena,F,100,17,0,17
Sirley,F,100,17,0,17
Sismai,F,100,17,0,17
Sofiagrace,F,100,17,0,17
Sonai,F,100,17,0,17
Sophanna,F,59,10,7,17
Sophiaann,F,100,17,0,17
Southern,F,100,17,0,17
Stancil,M,100,0,17,17
Starlight,F,100,17,0,17
Stellamarie,F,100,17,0,17
Steveson,M,100,0,17,17
Sthephanie,F,100,17,0,17
Stig,M,100,0,17,17
Strange,F,100,17,0,17
Sueling,F,100,17,0,17
Suhavi,F,100,17,0,17
Sulaf,F,100,17,0,17
Sumaia,F,100,17,0,17
Sunem,F,100,17,0,17
Suryansh,M,100,0,17,17
Sutten,F,100,17,0,17
Suzon,F,100,17,0,17
Taara,F,100,17,0,17
Taavon,M,100,0,17,17
Tabrea,F,100,17,0,17
Tadzia,F,100,17,0,17
Tahleah,F,100,17,0,17
Tahlil,M,100,0,17,17
Tahron,M,100,0,17,17
Tairon,M,100,0,17,17
Talarisha,F,100,17,0,17
Talei,F,100,17,0,17
Talique,M,100,0,17,17
Tamarian,M,100,0,17,17
Tamarr,M,71,5,12,17
Tamboura,M,71,5,12,17
Tamiesha,F,100,17,0,17
Tamilla,F,100,17,0,17
Tamiria,F,100,17,0,17
Tammitha,F,100,17,0,17
Tanaria,F,100,17,0,17
Taniece,F,100,17,0,17
Tanyel,F,100,17,0,17
Taquarius,M,100,0,17,17
Taraus,M,100,0,17,17
Tarcha,F,100,17,0,17
Tariek,M,100,0,17,17
Tasiyah,F,100,17,0,17
Tatiania,F,100,17,0,17
Taylur,F,100,17,0,17
Taysir,M,100,0,17,17
Tazmeen,F,100,17,0,17
Teani,F,100,17,0,17
Tearle,M,100,0,17,17
Teegen,M,100,0,17,17
Teilor,F,100,17,0,17
Temiko,F,100,17,0,17
Tennison,M,100,0,17,17
Tequesta,F,100,17,0,17
Teray,M,100,0,17,17
Tereska,F,100,17,0,17
Terrielle,F,100,17,0,17
Terryonna,F,100,17,0,17
Teshana,F,100,17,0,17
Thadeous,M,100,0,17,17
Thavy,F,100,17,0,17
Theonita,F,100,17,0,17
Theresamarie,F,100,17,0,17
Thommy,M,100,0,17,17
Thristian,M,100,0,17,17
Tiam,M,100,0,17,17
Tiamara,F,100,17,0,17
Tiffni,F,100,17,0,17
Tilesha,F,100,17,0,17
Tiliyah,F,100,17,0,17
Timothie,M,100,0,17,17
Tnyah,F,100,17,0,17
Toluwalase,F,65,11,6,17
Tondelayo,F,100,17,0,17
Traeveon,M,100,0,17,17
Tranette,F,100,17,0,17
Traun,M,100,0,17,17
Treagan,M,100,0,17,17
Trelin,M,100,0,17,17
Trenicia,F,100,17,0,17
Trinise,F,100,17,0,17
Tromaine,M,100,0,17,17
Tunisa,F,100,17,0,17
Tupou,F,71,12,5,17
Turan,M,100,0,17,17
Twylah,F,100,17,0,17
Tybee,F,100,17,0,17
Tydarious,M,100,0,17,17
Tyeast,F,100,17,0,17
Tyhessia,F,100,17,0,17
Tyhisha,F,100,17,0,17
Tymya,F,100,17,0,17
Tynea,F,100,17,0,17
Tyquawn,M,100,0,17,17
Tyquil,M,100,0,17,17
Tyshiana,F,100,17,0,17
Tytiauna,F,100,17,0,17
Udy,F,100,17,0,17
Ulis,M,100,0,17,17
Ulisa,F,100,17,0,17
Umeki,F,100,17,0,17
Umika,F,100,17,0,17
Uneeda,F,100,17,0,17
Uniqueka,F,100,17,0,17
Uriana,F,100,17,0,17
Usvaldo,M,100,0,17,17
Valicity,F,100,17,0,17
Vaylen,M,100,0,17,17
Velvie,F,100,17,0,17
Venelope,F,100,17,0,17
Venessia,F,100,17,0,17
Veonica,F,100,17,0,17
Veralee,F,100,17,0,17
Verenda,F,100,17,0,17
Veridiana,F,100,17,0,17
Verneta,F,100,17,0,17
Verron,M,100,0,17,17
Vitorio,M,100,0,17,17
Vivana,F,100,17,0,17
Vondre,M,100,0,17,17
Vonzetta,F,100,17,0,17
Vyan,M,100,0,17,17
Waldy,M,100,0,17,17
Warith,M,100,0,17,17
Wessam,M,100,0,17,17
Wills,M,100,0,17,17
Wisteria,F,100,17,0,17
Woodruff,M,100,0,17,17
Wulfric,M,100,0,17,17
Yahweh,M,100,0,17,17
Yaima,F,100,17,0,17
Yakeisha,F,100,17,0,17
Yamiley,F,100,17,0,17
Yariely,F,100,17,0,17
Yasameen,F,100,17,0,17
Yasmani,M,100,0,17,17
Yavian,M,100,0,17,17
Yazhini,F,100,17,0,17
Yazzmin,F,100,17,0,17
Yisselle,F,100,17,0,17
Yle,M,100,0,17,17
Ymari,F,100,17,0,17
Yosuf,M,100,0,17,17
Younus,M,100,0,17,17
Youstina,F,100,17,0,17
Ysa,F,100,17,0,17
Yukia,F,100,17,0,17
Yuxin,F,100,17,0,17
Zacery,M,100,0,17,17
Zafina,F,100,17,0,17
Zakoria,F,100,17,0,17
Zalynn,F,71,12,5,17
Zanilah,F,100,17,0,17
Zanthony,M,100,0,17,17
Zao,M,100,0,17,17
Zareh,M,100,0,17,17
Zariea,F,100,17,0,17
Zavius,M,100,0,17,17
Zeila,F,100,17,0,17
Zer,F,100,17,0,17
Zianya,F,100,17,0,17
Zinaya,F,100,17,0,17
Zonnie,M,65,6,11,17
Zsa,F,100,17,0,17
Zubaida,F,100,17,0,17
Zuhey,F,100,17,0,17
Aaiza,F,100,16,0,16
Aakeem,M,100,0,16,16
Aaleya,F,100,16,0,16
Aaro,M,100,0,16,16
Aarohan,M,100,0,16,16
Aarshi,F,100,16,0,16
Aatish,M,100,0,16,16
Aban,M,100,0,16,16
Abdulhakim,M,100,0,16,16
Abduljabbar,M,100,0,16,16
Abedallah,M,100,0,16,16
Abiella,F,100,16,0,16
Abisag,F,100,16,0,16
Adavion,M,100,0,16,16
Addai,M,100,0,16,16
Addisan,F,100,16,0,16
Adesola,F,100,16,0,16
Adharsh,M,100,0,16,16
Adidas,M,100,0,16,16
Adony,M,100,0,16,16
Adrialys,F,100,16,0,16
Adrianny,F,100,16,0,16
Adrieanne,F,100,16,0,16
Adyant,M,100,0,16,16
Afrodita,F,100,16,0,16
Agrim,M,100,0,16,16
Ahisha,F,100,16,0,16
Ahlayla,F,100,16,0,16
Ahliana,F,100,16,0,16
Ahmyra,F,100,16,0,16
Ahnaya,F,100,16,0,16
Aidelyn,F,100,16,0,16
Aindrea,F,100,16,0,16
Ainzley,F,100,16,0,16
Ajak,M,100,0,16,16
Ajiyah,F,100,16,0,16
Ajuni,F,100,16,0,16
Akhir,M,100,0,16,16
Akiela,F,100,16,0,16
Alaejah,F,100,16,0,16
Alainey,F,100,16,0,16
Alamar,F,100,16,0,16
Alandus,M,100,0,16,16
Alarice,F,100,16,0,16
Alaye,M,69,5,11,16
Alaythia,F,100,16,0,16
Albani,F,100,16,0,16
Aldren,M,100,0,16,16
Aleahya,F,100,16,0,16
Alecsandra,F,100,16,0,16
Aleki,M,100,0,16,16
Alenka,F,100,16,0,16
Alexandor,M,100,0,16,16
Aleyshka,F,100,16,0,16
Aliki,F,100,16,0,16
Alizette,F,100,16,0,16
Alizeya,F,100,16,0,16
Allistair,M,100,0,16,16
Allysyn,F,100,16,0,16
Alvion,M,100,0,16,16
Alxis,F,100,16,0,16
Alyncia,F,100,16,0,16
Amariyanna,F,100,16,0,16
Amdrea,F,100,16,0,16
Ameara,F,100,16,0,16
Ametra,F,100,16,0,16
Ametria,F,100,16,0,16
Amiriah,F,100,16,0,16
Amruta,F,100,16,0,16
Anaiis,F,100,16,0,16
Analeesa,F,100,16,0,16
Analeyah,F,100,16,0,16
Analin,F,100,16,0,16
Anatoly,M,100,0,16,16
Anayha,F,100,16,0,16
Anayshia,F,100,16,0,16
Ancy,F,100,16,0,16
Anderzon,M,100,0,16,16
Aneas,M,100,0,16,16
Aneia,F,100,16,0,16
Anetia,F,100,16,0,16
Aneudi,M,100,0,16,16
Angelrose,F,100,16,0,16
Anhtony,M,100,0,16,16
Anilya,F,100,16,0,16
Annajean,F,100,16,0,16
Annaluiza,F,100,16,0,16
Annee,F,100,16,0,16
Anosha,F,100,16,0,16
Anthonique,F,100,16,0,16
Antionett,F,100,16,0,16
Antje,F,100,16,0,16
Antonitte,F,100,16,0,16
Anupam,M,100,0,16,16
Anyanka,F,100,16,0,16
Aolany,F,100,16,0,16
Apria,F,100,16,0,16
Aquavious,M,100,0,16,16
Aranxa,F,100,16,0,16
Arati,F,100,16,0,16
Arayiah,F,100,16,0,16
Arcangelo,M,100,0,16,16
Aribel,F,100,16,0,16
Arka,M,100,0,16,16
Arkangel,M,100,0,16,16
Arkia,F,100,16,0,16
Armesha,F,100,16,0,16
Armisha,F,100,16,0,16
Armontae,M,100,0,16,16
Arona,F,62,10,6,16
Arunima,F,100,16,0,16
Arybella,F,100,16,0,16
Asal,F,100,16,0,16
Ashantis,F,100,16,0,16
Ashirah,F,100,16,0,16
Ashvika,F,100,16,0,16
Asonte,M,62,6,10,16
Athira,F,100,16,0,16
Atreal,M,100,0,16,16
Attis,M,100,0,16,16
Audrene,F,100,16,0,16
Aulii,F,100,16,0,16
Aurohom,M,100,0,16,16
Austreberto,M,100,0,16,16
Avaiyah,F,100,16,0,16
Avena,F,100,16,0,16
Averley,F,100,16,0,16
Averyl,F,100,16,0,16
Aydree,F,100,16,0,16
Ayia,F,100,16,0,16
Ayja,F,100,16,0,16
Azaree,F,100,16,0,16
Azriah,F,100,16,0,16
Bahati,F,100,16,0,16
Baotran,F,100,16,0,16
Baranda,F,100,16,0,16
Barbarette,F,100,16,0,16
Bashan,M,100,0,16,16
Baudilio,M,100,0,16,16
Beily,F,100,16,0,16
Bellamae,F,100,16,0,16
Belvie,F,100,16,0,16
Benajamin,M,100,0,16,16
Bilen,F,100,16,0,16
Bindy,F,100,16,0,16
Bitanya,F,100,16,0,16
Bitia,F,100,16,0,16
Bix,M,100,0,16,16
Bluford,M,100,0,16,16
Bobijo,F,100,16,0,16
Bonnette,F,100,16,0,16
Booth,M,100,0,16,16
Branasia,F,100,16,0,16
Braxley,M,100,0,16,16
Braxtynn,M,69,5,11,16
Breahnna,F,100,16,0,16
Breez,F,69,11,5,16
Brendalis,F,100,16,0,16
Brenia,F,100,16,0,16
Brilea,F,100,16,0,16
Brinisha,F,100,16,0,16
Bristy,F,100,16,0,16
Britza,F,100,16,0,16
Bronxton,M,100,0,16,16
Brunhilda,F,100,16,0,16
Bryin,M,100,0,16,16
Buchanan,M,100,0,16,16
Burach,M,100,0,16,16
Burwell,M,100,0,16,16
Caelia,F,100,16,0,16
Cahill,M,100,0,16,16
Caitline,F,100,16,0,16
Caludia,F,100,16,0,16
Camyron,M,69,5,11,16
Caniesha,F,100,16,0,16
Cannie,F,100,16,0,16
Cardel,M,100,0,16,16
Carlotte,F,100,16,0,16
Cashious,M,100,0,16,16
Cataleia,F,100,16,0,16
Cesc,M,100,0,16,16
Chailee,F,100,16,0,16
Chakong,M,100,0,16,16
Chanceton,M,100,0,16,16
Chanielle,F,100,16,0,16
Channen,M,100,0,16,16
Charleson,M,100,0,16,16
Charlynne,F,100,16,0,16
Charnai,F,100,16,0,16
Charrelle,F,100,16,0,16
Charysse,F,100,16,0,16
Chelena,F,100,16,0,16
Chelette,F,100,16,0,16
Chelton,M,100,0,16,16
Cherel,F,100,16,0,16
Chetana,F,100,16,0,16
Chibuzo,M,100,0,16,16
Chinue,F,100,16,0,16
Chinwendu,F,100,16,0,16
Chontell,F,100,16,0,16
Chrisi,F,100,16,0,16
Chrisna,F,62,10,6,16
Chrysanthemum,F,100,16,0,16
Chumy,F,100,16,0,16
Cilas,M,100,0,16,16
Claryce,F,100,16,0,16
Cleva,F,100,16,0,16
Coffy,F,100,16,0,16
Connley,M,100,0,16,16
Coralina,F,100,16,0,16
Cordarell,M,100,0,16,16
Cormack,M,100,0,16,16
Cornelle,M,100,0,16,16
Cranford,M,100,0,16,16
Crisha,F,100,16,0,16
Cynthi,F,100,16,0,16
Daanyal,M,100,0,16,16
Daezha,F,100,16,0,16
Dahana,F,100,16,0,16
Dairl,M,100,0,16,16
Dajaha,F,100,16,0,16
Dakarii,M,100,0,16,16
Dakeria,F,100,16,0,16
Dakhia,F,100,16,0,16
Dalenna,F,100,16,0,16
Dalian,M,100,0,16,16
Dalijah,F,100,16,0,16
Damianna,F,100,16,0,16
Damiere,M,100,0,16,16
Dammion,M,100,0,16,16
Danaca,F,100,16,0,16
Daniellemarie,F,100,16,0,16
Danilee,F,100,16,0,16
Dantasia,F,100,16,0,16
Daon,M,100,0,16,16
Darden,M,100,0,16,16
Dareld,M,100,0,16,16
Dareli,F,100,16,0,16
Darshil,M,100,0,16,16
Davalyn,F,100,16,0,16
Davinee,F,100,16,0,16
Davonia,F,100,16,0,16
Davonya,F,100,16,0,16
Daymin,M,100,0,16,16
Daz,M,100,0,16,16
Dazarion,M,100,0,16,16
Dazya,F,100,16,0,16
Deaijah,F,100,16,0,16
Deambra,F,100,16,0,16
Deaundray,M,100,0,16,16
Deboraa,F,100,16,0,16
Decarius,M,100,0,16,16
Decedric,M,100,0,16,16
Dedie,F,100,16,0,16
Deerick,M,100,0,16,16
Deijon,M,100,0,16,16
Deilany,F,100,16,0,16
Deirra,F,100,16,0,16
Dejarae,F,100,16,0,16
Dejenae,F,100,16,0,16
Delancy,F,69,11,5,16
Delandria,F,100,16,0,16
Deldra,F,100,16,0,16
Delica,F,100,16,0,16
Dellaney,F,100,16,0,16
Delonzo,M,100,0,16,16
Delphinia,F,100,16,0,16
Demaje,M,100,0,16,16
Demecio,M,100,0,16,16
Demel,M,100,0,16,16
Dementrius,M,100,0,16,16
Demicheal,M,100,0,16,16
Demiko,M,100,0,16,16
Demitrie,M,100,0,16,16
Densel,M,100,0,16,16
Denvil,M,100,0,16,16
Denylah,F,100,16,0,16
Deolinda,F,100,16,0,16
Deonca,F,100,16,0,16
Dereyon,M,100,0,16,16
Deridre,F,100,16,0,16
Derringer,M,100,0,16,16
Desaun,M,100,0,16,16
Deshandra,F,100,16,0,16
Dessence,F,100,16,0,16
Desting,F,100,16,0,16
Deterrion,M,100,0,16,16
Deville,M,100,0,16,16
Deylani,F,100,16,0,16
Deyontae,M,100,0,16,16
Deztyni,F,100,16,0,16
Dhir,M,100,0,16,16
Diavionne,F,100,16,0,16
Dicksie,F,100,16,0,16
Dienna,F,100,16,0,16
Dilayla,F,100,16,0,16
Dinese,F,100,16,0,16
Dionca,F,100,16,0,16
Dipali,F,100,16,0,16
Dlyan,M,100,0,16,16
Dobbie,M,69,5,11,16
Dominesha,F,100,16,0,16
Dondrae,M,100,0,16,16
Donitta,F,100,16,0,16
Doniyah,F,100,16,0,16
Donnaven,M,100,0,16,16
Dontey,M,100,0,16,16
Dor,M,69,5,11,16
Doranna,F,100,16,0,16
Dorella,F,100,16,0,16
Dovetta,F,100,16,0,16
Draelyn,M,100,0,16,16
Draiven,M,100,0,16,16
Draxton,M,100,0,16,16
Drelin,M,100,0,16,16
Drenna,F,100,16,0,16
Dreven,M,100,0,16,16
Dreylon,M,100,0,16,16
Driton,M,100,0,16,16
Dusitn,M,100,0,16,16
Dvir,M,100,0,16,16
Dwone,M,100,0,16,16
Dyman,F,100,16,0,16
Eabha,F,100,16,0,16
Echoe,F,100,16,0,16
Edgel,M,100,0,16,16
Edo,M,100,0,16,16
Efthimios,M,100,0,16,16
Egzon,M,100,0,16,16
Eiljah,M,100,0,16,16
Eirini,F,100,16,0,16
Elenoa,F,100,16,0,16
Elexas,F,100,16,0,16
Eliahu,M,100,0,16,16
Elic,M,100,0,16,16
Eliuth,M,100,0,16,16
Elizabath,F,100,16,0,16
Ellys,F,100,16,0,16
Elvi,M,100,0,16,16
Elzina,F,100,16,0,16
Emmasofia,F,100,16,0,16
Emond,M,100,0,16,16
Enjamin,M,100,0,16,16
Envee,F,100,16,0,16
Eriah,F,100,16,0,16
Erianah,F,100,16,0,16
Ernell,F,100,16,0,16
Eryne,F,100,16,0,16
Ethanial,M,100,0,16,16
Eurica,F,100,16,0,16
Eusevio,M,100,0,16,16
Evalyna,F,100,16,0,16
Evening,F,100,16,0,16
Evienne,F,100,16,0,16
Evyenia,F,100,16,0,16
Eyona,F,100,16,0,16
Ezykiel,M,100,0,16,16
Fabia,F,100,16,0,16
Falena,F,100,16,0,16
Farina,F,100,16,0,16
Faybian,M,100,0,16,16
Faylee,F,100,16,0,16
Filmore,M,100,0,16,16
Fitima,F,100,16,0,16
Florestela,F,100,16,0,16
Franc,M,100,0,16,16
Franchell,F,100,16,0,16
Franciska,F,100,16,0,16
Frantzy,M,100,0,16,16
Fraya,F,100,16,0,16
Frica,F,100,16,0,16
Gabin,M,100,0,16,16
Gaiden,M,100,0,16,16
Ganesa,F,100,16,0,16
Gaozong,F,100,16,0,16
Garian,M,100,0,16,16
Garl,M,100,0,16,16
Gearald,M,100,0,16,16
Geffery,M,100,0,16,16
Genara,F,100,16,0,16
Genuine,M,100,0,16,16
Georffrey,M,100,0,16,16
Georgett,F,100,16,0,16
Geradette,F,100,16,0,16
Geraud,M,100,0,16,16
Gerd,M,100,0,16,16
Gerhart,M,100,0,16,16
Gerld,M,100,0,16,16
Gervaise,F,100,16,0,16
Ghaida,F,100,16,0,16
Giacobbe,M,100,0,16,16
Gillyan,F,100,16,0,16
Ginell,F,100,16,0,16
Giustina,F,100,16,0,16
Glendine,F,100,16,0,16
Glendolyn,F,100,16,0,16
Glyndon,M,100,0,16,16
Godofredo,M,100,0,16,16
Graves,M,100,0,16,16
Greggery,M,100,0,16,16
Gumercindo,M,100,0,16,16
Guye,M,100,0,16,16
Guyton,M,100,0,16,16
Gweneviere,F,100,16,0,16
Hadasha,F,100,16,0,16
Haiti,F,100,16,0,16
Hameen,M,100,0,16,16
Haroldo,M,100,0,16,16
Harutun,M,100,0,16,16
Hayllie,F,100,16,0,16
Hazelene,F,100,16,0,16
Heart,F,100,16,0,16
Heartly,F,100,16,0,16
Hendryx,M,100,0,16,16
Heng,M,100,0,16,16
Her,M,100,0,16,16
Hermonie,F,100,16,0,16
Het,M,100,0,16,16
Honoria,F,100,16,0,16
Hopeton,M,100,0,16,16
Hristine,F,100,16,0,16
Huntur,M,100,0,16,16
Idalyz,F,100,16,0,16
Idman,F,100,16,0,16
Ien,M,100,0,16,16
Inbal,F,100,16,0,16
Indrani,F,100,16,0,16
Ineisha,F,100,16,0,16
Inese,F,100,16,0,16
Inoke,M,100,0,16,16
Iraiz,F,100,16,0,16
Irazema,F,100,16,0,16
Ireneo,M,100,0,16,16
Iryana,F,100,16,0,16
Iryanna,F,100,16,0,16
Isabelo,M,100,0,16,16
Isamarie,F,100,16,0,16
Iselda,F,100,16,0,16
Israela,F,100,16,0,16
Issabell,F,100,16,0,16
Iszak,M,100,0,16,16
Ivion,M,100,0,16,16
Iyonah,F,100,16,0,16
Izeck,M,100,0,16,16
Jabali,M,100,0,16,16
Jabrien,M,100,0,16,16
Jabrill,M,100,0,16,16
Jacaiden,M,100,0,16,16
Jacieon,M,100,0,16,16
Jacina,F,100,16,0,16
Jaciyah,F,100,16,0,16
Jackilynn,F,100,16,0,16
Jadalyse,F,100,16,0,16
Jaesun,M,100,0,16,16
Jahair,M,100,0,16,16
Jahmaal,M,100,0,16,16
Jahmauri,M,100,0,16,16
Jahmeel,M,100,0,16,16
Jahyden,M,100,0,16,16
Jaijuan,M,100,0,16,16
Jaiylah,F,100,16,0,16
Jakiara,F,100,16,0,16
Jakylee,F,100,16,0,16
Jalyla,F,100,16,0,16
Jamarieon,M,100,0,16,16
Jamayka,F,100,16,0,16
Jameera,F,100,16,0,16
Jameice,F,100,16,0,16
Jamiece,F,100,16,0,16
Jamiyha,F,100,16,0,16
Jamoria,F,100,16,0,16
Janaeh,F,100,16,0,16
Janishia,F,100,16,0,16
Janluis,M,100,0,16,16
Jannina,F,100,16,0,16
Jarael,M,100,0,16,16
Jaritzy,F,100,16,0,16
Jarnae,F,100,16,0,16
Jaronda,F,100,16,0,16
Jarvion,M,100,0,16,16
Jasinto,M,100,0,16,16
Jasley,F,100,16,0,16
Jasmari,F,100,16,0,16
Jassim,M,100,0,16,16
Jataveon,M,100,0,16,16
Jathon,M,100,0,16,16
Javas,M,100,0,16,16
Javein,M,100,0,16,16
Javiah,F,100,16,0,16
Jaywon,M,100,0,16,16
Jayzeon,M,100,0,16,16
Jazimine,F,100,16,0,16
Jazyriah,F,100,16,0,16
Jea,F,100,16,0,16
Jeilene,F,100,16,0,16
Jekai,M,100,0,16,16
Jemily,F,100,16,0,16
Jenalis,F,100,16,0,16
Jenalynn,F,100,16,0,16
Jenara,F,100,16,0,16
Jenniya,F,100,16,0,16
Jeovanna,F,100,16,0,16
Jequita,F,100,16,0,16
Jeralene,F,100,16,0,16
Jerediah,M,100,0,16,16
Jerimia,M,100,0,16,16
Jerith,M,100,0,16,16
Jermanine,M,100,0,16,16
Jernae,F,100,16,0,16
Jernisha,F,100,16,0,16
Jersei,F,100,16,0,16
Jerud,M,100,0,16,16
Jessicamae,F,100,16,0,16
Jezer,M,100,0,16,16
Jhael,M,100,0,16,16
Jhanee,F,100,16,0,16
Jhanelle,F,100,16,0,16
Jianah,F,100,16,0,16
Jimenez,M,100,0,16,16
Jimyah,F,100,16,0,16
Jiri,M,100,0,16,16
Joed,M,100,0,16,16
Johandy,M,100,0,16,16
Johnethan,M,100,0,16,16
Joliette,F,100,16,0,16
Jonnesha,F,100,16,0,16
Jonson,M,100,0,16,16
Jorddy,M,100,0,16,16
Jorrin,M,100,0,16,16
Josai,M,100,0,16,16
Josehp,M,100,0,16,16
Josephjames,M,100,0,16,16
Joset,M,69,5,11,16
Joshton,M,100,0,16,16
Joshuea,M,100,0,16,16
Josina,F,100,16,0,16
Josiya,M,100,0,16,16
Joslen,F,100,16,0,16
Juanesha,F,100,16,0,16
Juantia,F,100,16,0,16
Jullianne,F,100,16,0,16
Juman,F,100,16,0,16
Jumanne,M,100,0,16,16
Justyse,F,100,16,0,16
Juwanda,F,100,16,0,16
Kaaden,M,100,0,16,16
Kadaysha,F,100,16,0,16
Kadjah,F,100,16,0,16
Kaelana,F,100,16,0,16
Kaeloni,F,100,16,0,16
Kaetlynn,F,100,16,0,16
Kahmel,M,100,0,16,16
Kaitlind,F,100,16,0,16
Kalleen,F,100,16,0,16
Kalonda,F,100,16,0,16
Kameika,F,100,16,0,16
Kametra,F,100,16,0,16
Kamiaya,F,100,16,0,16
Kammeron,M,100,0,16,16
Kamrun,M,100,0,16,16
Kanedra,F,100,16,0,16
Karaann,F,100,16,0,16
Karamia,F,100,16,0,16
Kardae,M,100,0,16,16
Karent,F,100,16,0,16
Karleah,F,100,16,0,16
Karloz,M,100,0,16,16
Karrol,F,100,16,0,16
Karun,M,100,0,16,16
Karym,M,100,0,16,16
Karyne,F,100,16,0,16
Kaseen,M,100,0,16,16
Kashika,F,100,16,0,16
Kassedy,F,100,16,0,16
Kateleigh,F,100,16,0,16
Katelina,F,100,16,0,16
Katherne,F,100,16,0,16
Kathyn,F,100,16,0,16
Katiera,F,100,16,0,16
Katinia,F,100,16,0,16
Katri,F,100,16,0,16
Katrien,F,100,16,0,16
Kavarion,M,100,0,16,16
Kawliga,M,100,0,16,16
Kaydree,F,100,16,0,16
Kaylanicole,F,100,16,0,16
Kaylinda,F,100,16,0,16
Kaysten,M,100,0,16,16
Keaisa,F,100,16,0,16
Keashawn,M,100,0,16,16
Keazia,F,100,16,0,16
Keiauna,F,100,16,0,16
Kelea,F,100,16,0,16
Kelleye,F,100,16,0,16
Kemaree,M,100,0,16,16
Kemariah,F,100,16,0,16
Kemarius,M,100,0,16,16
Kendl,F,100,16,0,16
Kendred,M,100,0,16,16
Kendrich,M,100,0,16,16
Kendryk,M,100,0,16,16
Kenseth,M,100,0,16,16
Kentrelle,M,100,0,16,16
Kenyarda,F,100,16,0,16
Keonya,F,100,16,0,16
Kerilee,F,100,16,0,16
Kessia,F,100,16,0,16
Ketrell,M,100,0,16,16
Kevelyn,F,100,16,0,16
Keyshonda,F,100,16,0,16
Khabir,M,100,0,16,16
Khachik,M,100,0,16,16
Khaos,M,100,0,16,16
Khileigh,F,100,16,0,16
Khushal,M,100,0,16,16
Kianie,F,100,16,0,16
Kiaralee,F,100,16,0,16
Kiayana,F,100,16,0,16
Kidist,F,100,16,0,16
Kijafa,F,100,16,0,16
Kilolo,F,100,16,0,16
Kinnedi,F,100,16,0,16
Kishen,M,100,0,16,16
Kitwana,M,100,0,16,16
Kleah,F,100,16,0,16
Kogan,M,100,0,16,16
Koichi,M,100,0,16,16
Konata,M,100,0,16,16
Koneta,F,100,16,0,16
Koye,M,100,0,16,16
Kray,M,100,0,16,16
Krey,M,100,0,16,16
Krishn,M,100,0,16,16
Krishnan,M,100,0,16,16
Kristah,F,100,16,0,16
Kristiano,M,100,0,16,16
Kujtim,M,100,0,16,16
Kutana,F,100,16,0,16
Kyha,F,100,16,0,16
Kylaya,F,100,16,0,16
Kyliejo,F,100,16,0,16
Kylissa,F,100,16,0,16
Kyvan,M,100,0,16,16
Kyvin,M,100,0,16,16
Lacreisha,F,100,16,0,16
Ladajia,F,100,16,0,16
Ladante,M,100,0,16,16
Laddy,M,100,0,16,16
Lagenia,F,100,16,0,16
Laik,M,100,0,16,16
Laiyana,F,100,16,0,16
Lakaii,F,100,16,0,16
Lakala,F,100,16,0,16
Lakari,M,100,0,16,16
Lakedia,F,100,16,0,16
Lakeeya,F,100,16,0,16
Lakeshi,F,100,16,0,16
Lamech,M,100,0,16,16
Lanedra,F,100,16,0,16
Lanford,M,100,0,16,16
Lanikai,F,100,16,0,16
Lanni,F,100,16,0,16
Lanxton,M,100,0,16,16
Laquista,F,100,16,0,16
Larod,M,100,0,16,16
Lashari,F,100,16,0,16
Lashey,F,100,16,0,16
Latarisha,F,100,16,0,16
Latira,F,100,16,0,16
Latischa,F,100,16,0,16
Latocha,F,100,16,0,16
Latoisha,F,100,16,0,16
Latracia,F,100,16,0,16
Latreal,M,100,0,16,16
Latrishia,F,100,16,0,16
Laurien,F,100,16,0,16
Lavae,F,100,16,0,16
Lavonnia,F,100,16,0,16
Lavont,M,100,0,16,16
Lawandra,F,100,16,0,16
Lawna,F,100,16,0,16
Lawrenzo,M,100,0,16,16
Layelle,F,100,16,0,16
Layota,F,100,16,0,16
Layssa,F,100,16,0,16
Laytona,F,100,16,0,16
Leaja,F,100,16,0,16
Lecedric,M,100,0,16,16
Leeson,M,100,0,16,16
Leighlah,F,100,16,0,16
Leissa,F,100,16,0,16
Lelar,F,100,16,0,16
Lemel,M,100,0,16,16
Lenamarie,F,100,16,0,16
Leneisha,F,100,16,0,16
Lenyn,M,62,6,10,16
Leoda,F,100,16,0,16
Leondrae,M,100,0,16,16
Leonita,F,100,16,0,16
Leslyann,F,100,16,0,16
Lestina,F,100,16,0,16
Letara,F,100,16,0,16
Letavia,F,100,16,0,16
Lexin,M,100,0,16,16
Lezah,F,100,16,0,16
Lieba,F,100,16,0,16
Lieren,F,100,16,0,16
Liliam,F,100,16,0,16
Lilika,F,100,16,0,16
Limayri,F,100,16,0,16
Lindalou,F,100,16,0,16
Lodema,F,100,16,0,16
Lolla,F,100,16,0,16
Lorii,F,100,16,0,16
Lorria,F,100,16,0,16
Lourine,F,100,16,0,16
Louwanna,F,100,16,0,16
Lucelenia,F,100,16,0,16
Luceli,F,100,16,0,16
Lulah,F,100,16,0,16
Luvern,F,69,11,5,16
Lyell,M,100,0,16,16
Lyndze,F,100,16,0,16
Lyndzey,F,100,16,0,16
Lyneth,F,100,16,0,16
Lynse,F,100,16,0,16
Lyria,F,100,16,0,16
Lytisha,F,100,16,0,16
Mackel,M,100,0,16,16
Mackenlee,F,100,16,0,16
Macus,M,100,0,16,16
Maddin,M,100,0,16,16
Madelinne,F,100,16,0,16
Madolin,F,100,16,0,16
Mahlea,F,100,16,0,16
Mahra,F,100,16,0,16
Maiden,F,100,16,0,16
Makaelynn,F,100,16,0,16
Makbel,M,100,0,16,16
Makhy,M,100,0,16,16
Makieya,F,100,16,0,16
Makin,M,100,0,16,16
Maleana,F,100,16,0,16
Maliana,F,100,16,0,16
Mamadi,M,100,0,16,16
Mandelyn,F,100,16,0,16
Manique,F,100,16,0,16
Manoa,M,100,0,16,16
Maralynn,F,100,16,0,16
Marcail,F,100,16,0,16
Marceia,F,100,16,0,16
Marcele,F,100,16,0,16
Marcuss,M,100,0,16,16
Mariadelrosario,F,100,16,0,16
Marious,M,100,0,16,16
Marison,F,100,16,0,16
Marivic,F,100,16,0,16
Markan,F,100,16,0,16
Markeice,M,100,0,16,16
Markeyda,F,100,16,0,16
Marlanna,F,100,16,0,16
Marlenia,F,100,16,0,16
Marlyssa,F,100,16,0,16
Marquae,M,100,0,16,16
Marquieta,F,100,16,0,16
Marquiez,M,100,0,16,16
Marson,M,100,0,16,16
Martay,M,100,0,16,16
Maryesther,F,100,16,0,16
Maryette,F,100,16,0,16
Maryline,F,100,16,0,16
Marypaz,F,100,16,0,16
Masih,M,100,0,16,16
Masonjames,M,100,0,16,16
Matthewryan,M,100,0,16,16
Matvei,M,100,0,16,16
Mauriceo,M,100,0,16,16
Maysn,M,100,0,16,16
Mckella,F,100,16,0,16
Mckinsie,F,100,16,0,16
Meahgan,F,100,16,0,16
Meba,M,100,0,16,16
Medra,F,100,16,0,16
Megna,F,100,16,0,16
Megnan,F,100,16,0,16
Mehtaab,M,100,0,16,16
Mekkah,F,100,16,0,16
Melchi,M,100,0,16,16
Melisande,F,100,16,0,16
Menah,F,100,16,0,16
Mennah,F,100,16,0,16
Merielle,F,100,16,0,16
Meshal,M,100,0,16,16
Mialyn,F,100,16,0,16
Miceala,F,100,16,0,16
Michieal,M,100,0,16,16
Micol,F,100,16,0,16
Miguelantonio,M,100,0,16,16
Mikalla,F,100,16,0,16
Mikhale,M,100,0,16,16
Mileyah,F,100,16,0,16
Milini,F,100,16,0,16
Minato,M,100,0,16,16
Minden,F,100,16,0,16
Miner,M,100,0,16,16
Minhchau,F,100,16,0,16
Minhquan,M,100,0,16,16
Minhthu,F,100,16,0,16
Mirabai,F,100,16,0,16
Mireyna,F,100,16,0,16
Mistyann,F,100,16,0,16
Mkenzi,F,100,16,0,16
Moeez,M,100,0,16,16
Moena,F,100,16,0,16
Mohaned,M,100,0,16,16
Monasha,F,100,16,0,16
Monserrad,F,100,16,0,16
Montarious,M,100,0,16,16
Montaz,M,100,0,16,16
Monteze,M,100,0,16,16
Montisha,F,100,16,0,16
Moryah,F,100,16,0,16
Moshood,M,100,0,16,16
Mugdha,F,100,16,0,16
Mushtaq,F,100,16,0,16
Myanah,F,100,16,0,16
Mylashia,F,100,16,0,16
Mysean,M,100,0,16,16
Najya,F,100,16,0,16
Nakila,F,100,16,0,16
Nanya,M,100,0,16,16
Nasear,M,100,0,16,16
Nathena,F,100,16,0,16
Navian,M,100,0,16,16
Nayo,F,100,16,0,16
Ndya,F,100,16,0,16
Nevaehlynn,F,100,16,0,16
Nhut,M,100,0,16,16
Niamani,F,100,16,0,16
Nichoas,M,100,0,16,16
Nickan,M,100,0,16,16
Nickiya,F,100,16,0,16
Nickles,M,100,0,16,16
Nigal,M,100,0,16,16
Nikkeya,F,100,16,0,16
Nikkos,M,100,0,16,16
Nikylah,F,100,16,0,16
Ninon,F,100,16,0,16
Nipun,M,100,0,16,16
Nishma,F,100,16,0,16
Noelis,F,100,16,0,16
Noname,M,69,5,11,16
Norlisha,F,100,16,0,16
Nouchee,F,100,16,0,16
Novalyn,F,100,16,0,16
Novena,F,100,16,0,16
Nyauna,F,100,16,0,16
Nyier,M,100,0,16,16
Nykeira,F,100,16,0,16
Nyona,F,100,16,0,16
Nyshea,F,100,16,0,16
Obra,M,100,0,16,16
Odes,M,100,0,16,16
Odester,F,100,16,0,16
Oland,M,100,0,16,16
Oleda,F,100,16,0,16
Ololade,F,100,16,0,16
Olushola,M,100,0,16,16
Omariana,F,100,16,0,16
Onis,M,100,0,16,16
Onora,F,100,16,0,16
Ophir,M,100,0,16,16
Oriane,F,100,16,0,16
Orley,M,100,0,16,16
Orva,M,69,5,11,16
Osmary,F,100,16,0,16
Ostyn,M,100,0,16,16
Oxford,M,100,0,16,16
Paesyn,F,100,16,0,16
Partha,M,100,0,16,16
Patarica,F,100,16,0,16
Patrell,M,100,0,16,16
Paulus,M,100,0,16,16
Paysleigh,F,100,16,0,16
Pecos,M,100,0,16,16
Perette,F,100,16,0,16
Pernella,F,100,16,0,16
Pesha,F,100,16,0,16
Phara,F,100,16,0,16
Philomene,F,100,16,0,16
Pinar,F,100,16,0,16
Ping,F,62,10,6,16
Pollux,M,100,0,16,16
Pramod,M,100,0,16,16
Preesha,F,100,16,0,16
Prenell,M,100,0,16,16
Prianna,F,100,16,0,16
Pruitt,M,100,0,16,16
Pryscilla,F,100,16,0,16
Quadaisha,F,100,16,0,16
Qualee,M,100,0,16,16
Quameisha,F,100,16,0,16
Quandarious,M,100,0,16,16
Quantravious,M,100,0,16,16
Quashana,F,100,16,0,16
Quayon,M,100,0,16,16
Queenasia,F,100,16,0,16
Quenita,F,100,16,0,16
Quess,M,100,0,16,16
Quinden,M,100,0,16,16
Quinterria,F,100,16,0,16
Quovadis,F,100,16,0,16
Raanan,M,100,0,16,16
Radine,F,100,16,0,16
Raewyn,F,100,16,0,16
Raheam,M,100,0,16,16
Rahni,F,100,16,0,16
Rahsheen,M,100,0,16,16
Raid,M,100,0,16,16
Raija,F,100,16,0,16
Raiyn,F,100,16,0,16
Rajeana,F,100,16,0,16
Rakaya,F,100,16,0,16
Ranardo,M,100,0,16,16
Randoph,M,100,0,16,16
Raquez,M,100,0,16,16
Rashandra,F,100,16,0,16
Rawlings,M,100,0,16,16
Rayjean,F,100,16,0,16
Raymi,F,100,16,0,16
Rayvone,M,100,0,16,16
Rebeccaann,F,100,16,0,16
Regen,F,62,10,6,16
Regi,M,100,0,16,16
Regory,M,100,0,16,16
Remonda,F,100,16,0,16
Renesmay,F,100,16,0,16
Reshawna,F,100,16,0,16
Reyad,M,100,0,16,16
Reyhana,F,100,16,0,16
Reyshawn,M,100,0,16,16
Rhodia,F,100,16,0,16
Richenda,F,100,16,0,16
Rickyah,F,100,16,0,16
Ridah,F,100,16,0,16
Rikishi,M,62,6,10,16
Rikke,F,100,16,0,16
Roane,M,100,0,16,16
Robeert,M,100,0,16,16
Roderich,M,100,0,16,16
Rodjanae,F,100,16,0,16
Rokeshia,F,100,16,0,16
Rometta,F,100,16,0,16
Ronella,F,100,16,0,16
Ronja,F,100,16,0,16
Roozbeh,M,100,0,16,16
Rosaicela,F,100,16,0,16
Rosalyne,F,100,16,0,16
Rosemaire,F,100,16,0,16
Roshaud,M,100,0,16,16
Roxeann,F,100,16,0,16
Roxsanne,F,100,16,0,16
Rozalin,F,100,16,0,16
Ruah,F,100,16,0,16
Rushon,M,100,0,16,16
Ryhana,F,100,16,0,16
Ryheim,M,100,0,16,16
Rykan,M,100,0,16,16
Saavi,F,100,16,0,16
Sabela,F,100,16,0,16
Saleana,F,100,16,0,16
Saline,F,100,16,0,16
Samihah,F,100,16,0,16
Sangria,F,100,16,0,16
Santania,F,100,16,0,16
Saraly,F,100,16,0,16
Sarmad,M,100,0,16,16
Saro,M,100,0,16,16
Saturnina,F,100,16,0,16
Satyam,M,100,0,16,16
Saudah,F,100,16,0,16
Saviel,M,100,0,16,16
Sayani,F,100,16,0,16
Scan,M,100,0,16,16
Sedricka,F,100,16,0,16
Seinna,F,100,16,0,16
Senator,M,100,0,16,16
Serj,M,100,0,16,16
Severus,M,100,0,16,16
Sevryn,M,100,0,16,16
Shaborn,M,100,0,16,16
Shadey,F,100,16,0,16
Shadricka,F,100,16,0,16
Shafton,M,100,0,16,16
Shaiana,F,100,16,0,16
Shailin,F,100,16,0,16
Shajuanna,F,100,16,0,16
Shakeemah,F,100,16,0,16
Shakyria,F,100,16,0,16
Shalease,F,100,16,0,16
Shaleese,F,100,16,0,16
Shalette,F,100,16,0,16
Shalexis,F,100,16,0,16
Shaliek,M,100,0,16,16
Shamayah,F,100,16,0,16
Shambreka,F,100,16,0,16
Shamecia,F,100,16,0,16
Shanaka,F,100,16,0,16
Shaneah,F,100,16,0,16
Shaneda,F,100,16,0,16
Shaneek,F,100,16,0,16
Shanene,F,100,16,0,16
Shannay,F,100,16,0,16
Shantiana,F,100,16,0,16
Shaqille,M,100,0,16,16
Shaqualia,F,100,16,0,16
Sharal,F,100,16,0,16
Shardi,F,100,16,0,16
Shatanna,F,100,16,0,16
Shawnic,F,100,16,0,16
Shawntai,F,100,16,0,16
Shayln,F,100,16,0,16
Shazad,M,100,0,16,16
Shemari,M,69,5,11,16
Sheneque,F,100,16,0,16
Sheraine,F,100,16,0,16
Shereeta,F,100,16,0,16
Sherianne,F,100,16,0,16
Sherlanda,F,100,16,0,16
Shermia,F,100,16,0,16
Shimira,F,100,16,0,16
Shire,F,100,16,0,16
Shnya,F,100,16,0,16
Shoney,F,69,11,5,16
Shoran,F,100,16,0,16
Shounda,F,100,16,0,16
Shpresa,F,100,16,0,16
Shreyaan,M,100,0,16,16
Shubhan,M,100,0,16,16
Shunn,M,100,0,16,16
Shymeka,F,100,16,0,16
Shymere,M,100,0,16,16
Siddanth,M,100,0,16,16
Sieglinde,F,100,16,0,16
Skylaar,F,100,16,0,16
Skylir,F,100,16,0,16
Sofiyah,F,100,16,0,16
Sohn,M,100,0,16,16
Sonnya,F,100,16,0,16
Souad,F,100,16,0,16
Sourya,M,100,0,16,16
Staccato,M,100,0,16,16
Stanya,F,100,16,0,16
Statler,M,100,0,16,16
Stennis,M,100,0,16,16
Stephe,M,100,0,16,16
Stevenray,M,100,0,16,16
Stevn,M,100,0,16,16
Stevyn,M,100,0,16,16
Striker,M,100,0,16,16
Subin,M,62,6,10,16
Sumin,F,100,16,0,16
Susej,F,100,16,0,16
Svend,M,100,0,16,16
Sylys,M,100,0,16,16
Taana,F,100,16,0,16
Tabish,M,100,0,16,16
Tacita,F,100,16,0,16
Taeven,M,100,0,16,16
Taiyari,F,100,16,0,16
Tajea,F,100,16,0,16
Takaylah,F,100,16,0,16
Takevia,F,100,16,0,16
Talara,F,100,16,0,16
Talianna,F,100,16,0,16
Taloria,F,100,16,0,16
Tamai,F,100,16,0,16
Tamal,M,100,0,16,16
Tamarria,F,100,16,0,16
Tamayah,F,100,16,0,16
Tameco,F,100,16,0,16
Tamicha,F,100,16,0,16
Tamichael,M,100,0,16,16
Tammarra,F,100,16,0,16
Tanajha,F,100,16,0,16
Tanushri,F,100,16,0,16
Tarolyn,F,100,16,0,16
Tarria,F,100,16,0,16
Tashad,M,100,0,16,16
Tashani,F,100,16,0,16
Tashie,F,100,16,0,16
Tausif,M,100,0,16,16
Tavarris,M,100,0,16,16
Taycen,M,100,0,16,16
Taydan,M,100,0,16,16
Taymon,M,100,0,16,16
Tayne,M,69,5,11,16
Tearesa,F,100,16,0,16
Teika,F,100,16,0,16
Teiya,F,100,16,0,16
Tejean,M,100,0,16,16
Tekhi,M,100,0,16,16
Tella,F,100,16,0,16
Tellie,F,100,16,0,16
Teralynn,F,100,16,0,16
Tereca,F,100,16,0,16
Terice,F,100,16,0,16
Terranisha,F,100,16,0,16
Terrod,M,100,0,16,16
Teylar,F,100,16,0,16
Thabiti,M,100,0,16,16
Thalita,F,100,16,0,16
Theretha,F,100,16,0,16
Thirza,F,100,16,0,16
Thomasjohn,M,100,0,16,16
Thomia,F,100,16,0,16
Thorsen,M,100,0,16,16
Tiano,M,100,0,16,16
Timeisha,F,100,16,0,16
Tirus,M,100,0,16,16
Tiyler,M,100,0,16,16
Tonnetta,F,100,16,0,16
Tonyette,F,100,16,0,16
Torrick,M,100,0,16,16
Tradarrius,M,100,0,16,16
Tradon,M,100,0,16,16
Tramelle,M,100,0,16,16
Trasa,F,100,16,0,16
Tressel,M,100,0,16,16
Trevohn,M,100,0,16,16
Trevontay,M,100,0,16,16
Trinitty,F,100,16,0,16
Trinket,F,100,16,0,16
Trint,M,100,0,16,16
Tristun,M,100,0,16,16
Trovon,M,100,0,16,16
Trustyn,M,100,0,16,16
Tulah,F,100,16,0,16
Tullia,F,100,16,0,16
Tulsa,F,100,16,0,16
Tyki,M,100,0,16,16
Tylaysia,F,100,16,0,16
Tymell,M,100,0,16,16
Tynique,F,100,16,0,16
Tyquail,M,100,0,16,16
Tyquashia,F,100,16,0,16
Tyquavius,M,100,0,16,16
Tyrissa,F,100,16,0,16
Tysan,M,100,0,16,16
Tysheema,F,100,16,0,16
Ukari,F,100,16,0,16
Ulyesses,M,100,0,16,16
Uroosa,F,100,16,0,16
Vadra,F,100,16,0,16
Vainavi,F,100,16,0,16
Vairon,M,100,0,16,16
Vanessah,F,100,16,0,16
Vanika,F,100,16,0,16
Vannara,M,100,0,16,16
Vasean,M,100,0,16,16
Vashion,M,69,5,11,16
Velicity,F,100,16,0,16
Velouria,F,100,16,0,16
Verdina,F,100,16,0,16
Verdon,M,100,0,16,16
Veronice,F,100,16,0,16
Veto,M,100,0,16,16
Viance,F,100,16,0,16
Vianette,F,100,16,0,16
Victorie,F,100,16,0,16
Vien,M,100,0,16,16
Vikie,F,100,16,0,16
Vilas,M,100,0,16,16
Vilinda,F,100,16,0,16
Vishva,F,69,11,5,16
Vishwak,M,100,0,16,16
Void,F,56,9,7,16
Vonciel,F,100,16,0,16
Vyacheslav,M,100,0,16,16
Walisha,F,100,16,0,16
Waltina,F,100,16,0,16
Wandalee,F,100,16,0,16
Warnie,M,100,0,16,16
Wesner,M,100,0,16,16
Wilde,M,100,0,16,16
Wuilmer,M,100,0,16,16
Wyvonia,F,100,16,0,16
Xenna,F,100,16,0,16
Xophia,F,100,16,0,16
Yafi,M,100,0,16,16
Yaleska,F,100,16,0,16
Yanexi,F,100,16,0,16
Yanik,M,100,0,16,16
Yaren,F,100,16,0,16
Yaselin,F,100,16,0,16
Yashia,F,100,16,0,16
Yatasha,F,100,16,0,16
Yenitza,F,100,16,0,16
Yishay,M,100,0,16,16
Yohali,F,100,16,0,16
Yohel,M,100,0,16,16
Yosue,M,100,0,16,16
Ysidra,F,100,16,0,16
Yuda,M,100,0,16,16
Zaaron,M,100,0,16,16
Zaavan,M,100,0,16,16
Zacharyah,M,100,0,16,16
Zacherey,M,100,0,16,16
Zackie,M,100,0,16,16
Zadian,M,100,0,16,16
Zaevian,M,100,0,16,16
Zahin,M,100,0,16,16
Zahiya,F,100,16,0,16
Zahyir,M,100,0,16,16
Zakkiyah,F,100,16,0,16
Zaleyah,F,100,16,0,16
Zamoni,F,100,16,0,16
Zarren,M,100,0,16,16
Zavyer,M,100,0,16,16
Zayliana,F,100,16,0,16
Zeik,M,100,0,16,16
Zhaiden,M,100,0,16,16
Zheneavia,F,100,16,0,16
Zikira,F,100,16,0,16
Zikora,M,62,6,10,16
Ziyaad,M,100,0,16,16
Zoen,M,100,0,16,16
Zorica,F,100,16,0,16
Zuhur,F,100,16,0,16
Zuree,F,100,16,0,16
Zyianna,F,100,16,0,16
Zykell,M,100,0,16,16
Zykerion,M,100,0,16,16
Aadesh,M,100,0,15,15
Aaleahya,F,100,15,0,15
Aarjav,M,100,0,15,15
Aashirya,F,100,15,0,15
Aazim,M,100,0,15,15
Abagaile,F,100,15,0,15
Abdrahman,M,100,0,15,15
Abdulmajid,M,100,0,15,15
Abiegail,F,100,15,0,15
Abiela,F,100,15,0,15
Abreonna,F,100,15,0,15
Abrianne,F,100,15,0,15
Abrienne,F,100,15,0,15
Abubacarr,M,100,0,15,15
Adalicia,F,100,15,0,15
Adarien,M,100,0,15,15
Adbiel,M,100,0,15,15
Addrianna,F,100,15,0,15
Addrienne,F,100,15,0,15
Adlie,F,100,15,0,15
Adorah,F,100,15,0,15
Adreinne,F,100,15,0,15
Adryon,M,100,0,15,15
Aeleen,F,100,15,0,15
Aevin,M,100,0,15,15
Afifah,F,100,15,0,15
Agena,F,100,15,0,15
Ahmand,M,100,0,15,15
Ahmauri,M,100,0,15,15
Aia,F,100,15,0,15
Ailena,F,100,15,0,15
Airess,F,100,15,0,15
Ajeya,F,100,15,0,15
Ajsa,F,100,15,0,15
Akinola,M,100,0,15,15
Alahnna,F,100,15,0,15
Alala,F,100,15,0,15
Alameen,M,100,0,15,15
Alazea,F,100,15,0,15
Alby,M,67,5,10,15
Aleezay,F,100,15,0,15
Alexandrine,F,100,15,0,15
Alexe,F,100,15,0,15
Alexendria,F,100,15,0,15
Alexisia,F,100,15,0,15
Alexxandria,F,100,15,0,15
Alfy,M,100,0,15,15
Alivn,M,100,0,15,15
Alizaye,F,100,15,0,15
Allory,F,100,15,0,15
Allynn,F,100,15,0,15
Alyk,M,100,0,15,15
Alyssum,F,100,15,0,15
Amaj,M,100,0,15,15
Amandarose,F,100,15,0,15
Anaida,F,100,15,0,15
Analice,F,100,15,0,15
Andamo,M,100,0,15,15
Andreamarie,F,100,15,0,15
Andreco,M,100,0,15,15
Andriah,F,100,15,0,15
Andriette,F,100,15,0,15
Aneel,M,100,0,15,15
Anga,F,100,15,0,15
Anglo,M,100,0,15,15
Anjely,F,100,15,0,15
Annacarolina,F,100,15,0,15
Annaelise,F,100,15,0,15
Annalesia,F,100,15,0,15
Anneelizabeth,F,100,15,0,15
Annelizabeth,F,100,15,0,15
Antaneisha,F,100,15,0,15
Antaun,M,100,0,15,15
Antavis,M,100,0,15,15
Anterrion,M,100,0,15,15
Aprilann,F,100,15,0,15
Araiza,F,100,15,0,15
Aralee,F,100,15,0,15
Arame,F,100,15,0,15
Arbaaz,M,100,0,15,15
Arcilia,F,100,15,0,15
Arhtur,M,100,0,15,15
Arifa,F,100,15,0,15
Arisela,F,100,15,0,15
Arkeen,M,100,0,15,15
Armante,M,100,0,15,15
Arnaud,M,100,0,15,15
Arric,M,100,0,15,15
Arsenia,F,100,15,0,15
Arzell,M,100,0,15,15
Asena,F,100,15,0,15
Asenet,F,100,15,0,15
Asiha,F,100,15,0,15
Asmahan,F,100,15,0,15
Astry,F,100,15,0,15
Atyia,F,100,15,0,15
Audreigh,F,100,15,0,15
Austinlee,M,100,0,15,15
Avamaria,F,100,15,0,15
Avarielle,F,100,15,0,15
Avenlea,F,100,15,0,15
Avnish,M,100,0,15,15
Avori,F,100,15,0,15
Aybel,M,100,0,15,15
Ayooluwa,F,67,10,5,15
Aythen,M,100,0,15,15
Azaniah,F,67,10,5,15
Azmir,M,100,0,15,15
Babie,F,100,15,0,15
Bahaa,M,100,0,15,15
Bahiya,F,100,15,0,15
Barbaro,M,100,0,15,15
Battal,M,100,0,15,15
Beebe,F,100,15,0,15
Behati,F,100,15,0,15
Belon,F,100,15,0,15
Benjahmin,M,100,0,15,15
Beret,F,100,15,0,15
Bernado,M,100,0,15,15
Bernel,M,100,0,15,15
Bernitha,F,100,15,0,15
Betrina,F,100,15,0,15
Betsabeth,F,100,15,0,15
Bettyanne,F,100,15,0,15
Bioleta,F,100,15,0,15
Bobbylee,M,100,0,15,15
Bonniejo,F,100,15,0,15
Boomer,M,100,0,15,15
Borach,M,100,0,15,15
Bradlyn,M,100,0,15,15
Brandise,F,100,15,0,15
Brandiss,F,100,15,0,15
Brandtly,M,100,0,15,15
Brany,F,100,15,0,15
Brayonna,F,100,15,0,15
Breiden,M,100,0,15,15
Breighlynn,F,100,15,0,15
Breisha,F,100,15,0,15
Breonka,F,100,15,0,15
Brexten,M,100,0,15,15
Breyonia,F,100,15,0,15
Bricker,M,100,0,15,15
Britane,F,100,15,0,15
Brocton,M,100,0,15,15
Bryasia,F,100,15,0,15
Brycson,M,100,0,15,15
Brynesha,F,100,15,0,15
Bryshon,M,100,0,15,15
Buse,F,100,15,0,15
Cadesia,F,100,15,0,15
Cainin,M,100,0,15,15
Caleshia,F,100,15,0,15
Calian,M,100,0,15,15
Camiel,F,100,15,0,15
Camilly,F,100,15,0,15
Candria,F,100,15,0,15
Carell,M,100,0,15,15
Careyann,F,100,15,0,15
Carise,F,100,15,0,15
Carissia,F,100,15,0,15
Carmetta,F,100,15,0,15
Caroletta,F,100,15,0,15
Carpenter,M,100,0,15,15
Carrianna,F,100,15,0,15
Cashara,F,100,15,0,15
Cashaun,M,100,0,15,15
Casiano,M,100,0,15,15
Casino,M,100,0,15,15
Casius,M,100,0,15,15
Cassel,M,100,0,15,15
Cathaleya,F,100,15,0,15
Cathyleen,F,100,15,0,15
Cattina,F,100,15,0,15
Ceji,F,100,15,0,15
Centeria,F,100,15,0,15
Chalandra,F,100,15,0,15
Chali,F,100,15,0,15
Chambria,F,100,15,0,15
Chanina,M,100,0,15,15
Charlas,M,100,0,15,15
Charri,F,100,15,0,15
Chasadie,F,100,15,0,15
Chaskel,M,100,0,15,15
Chawanna,F,100,15,0,15
Chazton,M,100,0,15,15
Chekita,F,100,15,0,15
Cheltzie,F,100,15,0,15
Chenier,M,100,0,15,15
Chentel,F,100,15,0,15
Cherette,F,100,15,0,15
Cheyenn,F,100,15,0,15
Cheylee,F,100,15,0,15
Chezarae,M,60,6,9,15
Chick,M,100,0,15,15
Chiemeka,M,100,0,15,15
Chimeka,F,100,15,0,15
Chisato,F,100,15,0,15
Chrisine,F,100,15,0,15
Chrispher,M,100,0,15,15
Christopehr,M,100,0,15,15
Chyeanne,F,100,15,0,15
Chyral,F,100,15,0,15
Chyrisse,F,100,15,0,15
Chyrle,F,100,15,0,15
Cindyann,F,100,15,0,15
Citali,F,100,15,0,15
Clarenc,M,100,0,15,15
Clevie,M,100,0,15,15
Cliona,F,100,15,0,15
Clotilda,F,100,15,0,15
Cmya,F,100,15,0,15
Conchata,F,100,15,0,15
Cordez,M,100,0,15,15
Cordin,M,100,0,15,15
Cormarion,M,100,0,15,15
Corneil,M,100,0,15,15
Corris,M,100,0,15,15
Corsha,F,100,15,0,15
Creede,M,100,0,15,15
Crissandra,F,100,15,0,15
Crys,F,100,15,0,15
Cymon,M,100,0,15,15
Czaria,F,100,15,0,15
Daan,M,100,0,15,15
Dachia,F,100,15,0,15
Daedric,M,100,0,15,15
Daejia,F,100,15,0,15
Daeyon,M,100,0,15,15
Daguan,M,100,0,15,15
Daishun,M,100,0,15,15
Daisjah,F,100,15,0,15
Daisymae,F,100,15,0,15
Daivian,M,100,0,15,15
Daizsa,F,100,15,0,15
Dajiana,F,100,15,0,15
Dalanna,F,100,15,0,15
Daleisha,F,100,15,0,15
Damarkis,M,100,0,15,15
Damne,F,100,15,0,15
Damontra,M,100,0,15,15
Danelis,F,100,15,0,15
Danien,M,100,0,15,15
Danit,F,100,15,0,15
Dannyell,F,100,15,0,15
Danyielle,F,100,15,0,15
Darita,F,100,15,0,15
Darleane,F,100,15,0,15
Darrent,M,100,0,15,15
Darreus,M,100,0,15,15
Darrus,M,100,0,15,15
Dashane,M,67,5,10,15
Dashanta,F,100,15,0,15
Daudi,M,100,0,15,15
Dausen,M,100,0,15,15
Daviere,M,100,0,15,15
Dawyne,M,100,0,15,15
Dayanari,F,100,15,0,15
Daydrian,M,100,0,15,15
Dayleon,M,100,0,15,15
Daymar,M,100,0,15,15
Deaires,M,100,0,15,15
Deanah,F,100,15,0,15
Deaudre,M,100,0,15,15
Deitre,F,100,15,0,15
Delice,F,100,15,0,15
Delitha,F,100,15,0,15
Deloyd,M,100,0,15,15
Delphene,F,100,15,0,15
Demona,F,100,15,0,15
Denazia,F,100,15,0,15
Deneil,F,100,15,0,15
Derise,F,100,15,0,15
Deshanique,F,100,15,0,15
Deshell,F,100,15,0,15
Desmariah,F,100,15,0,15
Destinei,F,100,15,0,15
Destney,F,100,15,0,15
Deta,F,100,15,0,15
Devale,M,100,0,15,15
Deveah,F,100,15,0,15
Devree,F,100,15,0,15
Dextin,M,100,0,15,15
Dhruthi,F,100,15,0,15
Dierk,M,100,0,15,15
Dilson,M,100,0,15,15
Dinae,F,100,15,0,15
Dixee,F,100,15,0,15
Dominae,F,100,15,0,15
Dominck,M,100,0,15,15
Dominike,M,100,0,15,15
Dominiqu,F,100,15,0,15
Donate,M,100,0,15,15
Donathon,M,100,0,15,15
Donnelly,M,100,0,15,15
Dorjan,M,100,0,15,15
Dorren,F,67,10,5,15
Dradyn,M,100,0,15,15
Drason,M,100,0,15,15
Drevyn,M,100,0,15,15
Duarte,M,100,0,15,15
Dureen,F,100,15,0,15
Dustun,M,100,0,15,15
Duwana,F,100,15,0,15
Dyante,M,100,0,15,15
Dyran,M,100,0,15,15
Dystanie,F,100,15,0,15
Eastynn,F,100,15,0,15
Edelynn,F,100,15,0,15
Edena,F,100,15,0,15
Edwrd,M,100,0,15,15
Eiker,M,100,0,15,15
Eito,M,100,0,15,15
Eldrin,M,100,0,15,15
Elexander,M,100,0,15,15
Elfriede,F,100,15,0,15
Eliannie,F,100,15,0,15
Eliazbeth,F,100,15,0,15
Eliejah,M,100,0,15,15
Elinah,F,100,15,0,15
Elizabel,F,100,15,0,15
Elizamarie,F,100,15,0,15
Ellody,F,100,15,0,15
Elydia,F,100,15,0,15
Elzora,F,100,15,0,15
Emanni,F,100,15,0,15
Emeal,M,100,0,15,15
Emee,F,100,15,0,15
Emmari,F,100,15,0,15
Endiah,F,100,15,0,15
Enise,F,100,15,0,15
Enita,F,100,15,0,15
Epigmenio,M,100,0,15,15
Erena,F,100,15,0,15
Eres,F,100,15,0,15
Eriksson,M,100,0,15,15
Erinmarie,F,100,15,0,15
Esquire,M,100,0,15,15
Etelvina,F,100,15,0,15
Ethanjohn,M,100,0,15,15
Eual,M,100,0,15,15
Evelinda,F,100,15,0,15
Fabin,M,100,0,15,15
Faelan,M,100,0,15,15
Fallin,F,100,15,0,15
Fanci,F,100,15,0,15
Faraday,F,100,15,0,15
Fateen,M,100,0,15,15
Faustin,M,100,0,15,15
Felder,M,100,0,15,15
Felicidad,F,100,15,0,15
Felis,M,100,0,15,15
Fenet,F,100,15,0,15
Ferdie,M,100,0,15,15
Feynman,M,100,0,15,15
Fidencia,F,100,15,0,15
Flem,M,100,0,15,15
Floretha,F,100,15,0,15
Francico,M,100,0,15,15
Franzetta,F,100,15,0,15
Frederi,M,100,0,15,15
Gaebriel,M,100,0,15,15
Gamel,M,100,0,15,15
Garlen,M,100,0,15,15
Geneive,F,100,15,0,15
Genessys,F,100,15,0,15
Genica,F,100,15,0,15
Genola,F,100,15,0,15
Geon,M,100,0,15,15
Gerek,M,100,0,15,15
Geren,M,100,0,15,15
Geriah,F,100,15,0,15
Gerimiah,M,100,0,15,15
Giahnna,F,100,15,0,15
Gioacchino,M,100,0,15,15
Gissette,F,100,15,0,15
Gitana,F,100,15,0,15
Giya,F,100,15,0,15
Glema,F,100,15,0,15
Granada,F,100,15,0,15
Greenlea,F,100,15,0,15
Gregoy,M,100,0,15,15
Guransh,M,100,0,15,15
Gwendalin,F,100,15,0,15
Hadelyn,F,100,15,0,15
Hadija,F,100,15,0,15
Hadya,F,100,15,0,15
Halema,F,100,15,0,15
Hallei,F,100,15,0,15
Hanen,F,100,15,0,15
Haoyu,M,100,0,15,15
Happiness,F,100,15,0,15
Harliegh,F,100,15,0,15
Heartlee,F,100,15,0,15
Heavon,F,100,15,0,15
Hefziba,F,100,15,0,15
Heiko,M,100,0,15,15
Hennesey,F,100,15,0,15
Henrine,F,100,15,0,15
Herica,F,100,15,0,15
Hezeki,M,100,0,15,15
Hodge,M,100,0,15,15
Ibrohim,M,100,0,15,15
Ilenia,F,100,15,0,15
Ilo,M,60,6,9,15
Ilsy,F,100,15,0,15
Imena,F,100,15,0,15
Imothy,M,100,0,15,15
Irian,F,100,15,0,15
Isarel,M,100,0,15,15
Isias,M,100,0,15,15
Ismary,F,100,15,0,15
Ismeralda,F,100,15,0,15
Ivanhoe,M,100,0,15,15
Ivelyn,F,100,15,0,15
Ivyn,M,100,0,15,15
Iyeshia,F,100,15,0,15
Jaazaniah,F,67,10,5,15
Jabaar,M,100,0,15,15
Jabare,M,100,0,15,15
Jaboa,F,100,15,0,15
Jacan,M,100,0,15,15
Jaceton,M,100,0,15,15
Jackielyn,F,100,15,0,15
Jacobia,F,67,10,5,15
Jacobian,M,100,0,15,15
Jadyen,M,100,0,15,15
Jaelinn,F,100,15,0,15
Jahkel,M,100,0,15,15
Jahlik,M,100,0,15,15
Jahmaad,M,100,0,15,15
Jahmyah,F,100,15,0,15
Jaidalynn,F,100,15,0,15
Jalane,F,100,15,0,15
Jalaycia,F,100,15,0,15
Jalencia,F,100,15,0,15
Jalita,F,100,15,0,15
Jamaiah,F,100,15,0,15
Jamerah,F,100,15,0,15
Jamique,M,100,0,15,15
Jamyl,M,100,0,15,15
Jamyre,M,100,0,15,15
Janak,M,100,0,15,15
Janas,F,67,10,5,15
Janirah,F,100,15,0,15
Janitzy,F,100,15,0,15
Janlyn,F,100,15,0,15
Jaquashia,F,100,15,0,15
Jareal,M,100,0,15,15
Jarem,M,100,0,15,15
Jarib,M,100,0,15,15
Jarvas,M,100,0,15,15
Jasavion,M,100,0,15,15
Jasaya,F,100,15,0,15
Jatory,M,100,0,15,15
Javarris,M,100,0,15,15
Javez,M,100,0,15,15
Javiyon,M,100,0,15,15
Javorius,M,100,0,15,15
Jawaher,F,100,15,0,15
Jaxsten,M,100,0,15,15
Jaxzon,M,100,0,15,15
Jayceeon,M,100,0,15,15
Jaydalin,F,100,15,0,15
Jayonni,F,67,10,5,15
Jaytee,M,100,0,15,15
Jazabella,F,100,15,0,15
Jazhiel,M,100,0,15,15
Jazleene,F,100,15,0,15
Jeanel,F,100,15,0,15
Jebria,F,100,15,0,15
Jehnna,F,100,15,0,15
Jeilany,F,100,15,0,15
Jeliah,F,100,15,0,15
Jenneffer,F,100,15,0,15
Jennelyn,F,100,15,0,15
Jennesy,F,100,15,0,15
Jenneth,F,100,15,0,15
Jennicka,F,100,15,0,15
Jennisa,F,100,15,0,15
Jenyce,F,100,15,0,15
Jerikah,F,100,15,0,15
Jermyra,F,100,15,0,15
Jernei,F,100,15,0,15
Jerona,F,100,15,0,15
Jessell,F,100,15,0,15
Jesy,M,67,5,10,15
Jewelee,F,100,15,0,15
Jewliana,F,100,15,0,15
Jezika,F,100,15,0,15
Jezzel,F,100,15,0,15
Jhancarlos,M,100,0,15,15
Jhanya,F,100,15,0,15
Jildardo,M,100,0,15,15
Joelina,F,100,15,0,15
Johnnylee,M,100,0,15,15
Johnray,M,100,0,15,15
Jolet,F,100,15,0,15
Jonaton,M,100,0,15,15
Joo,F,67,10,5,15
Josen,M,100,0,15,15
Josephdaniel,M,100,0,15,15
Josiaha,M,100,0,15,15
Josianne,F,100,15,0,15
Josman,M,100,0,15,15
Jothan,M,100,0,15,15
Juellz,M,100,0,15,15
Jugraj,M,100,0,15,15
Jumoke,M,100,0,15,15
Junayd,M,100,0,15,15
Jurel,M,100,0,15,15
Jyme,F,100,15,0,15
Jynell,F,100,15,0,15
Jyon,M,100,0,15,15
Jyrine,M,100,0,15,15
Kabreyia,F,100,15,0,15
Kadari,M,100,0,15,15
Kadarion,M,100,0,15,15
Kadeedra,F,100,15,0,15
Kadeijah,F,100,15,0,15
Kadezia,F,100,15,0,15
Kahlei,F,100,15,0,15
Kaii,M,100,0,15,15
Kaiona,F,100,15,0,15
Kaitley,F,100,15,0,15
Kaitly,F,100,15,0,15
Kalaiyah,F,100,15,0,15
Kalirose,F,100,15,0,15
Kalishia,F,100,15,0,15
Kalyia,F,100,15,0,15
Kameira,F,100,15,0,15
Kamery,F,100,15,0,15
Kamijah,F,100,15,0,15
Karanja,M,100,0,15,15
Karolin,F,100,15,0,15
Karrem,M,100,0,15,15
Karstin,M,67,5,10,15
Kasani,F,67,10,5,15
Kashi,F,67,10,5,15
Kassan,M,100,0,15,15
Kataliya,F,100,15,0,15
Katheran,F,100,15,0,15
Katrinamarie,F,100,15,0,15
Kattina,F,100,15,0,15
Katylyn,F,100,15,0,15
Katyria,F,100,15,0,15
Kaviya,F,100,15,0,15
Kaw,M,100,0,15,15
Kayleighann,F,100,15,0,15
Kayser,M,100,0,15,15
Kayshon,M,100,0,15,15
Kdence,F,100,15,0,15
Keanya,F,100,15,0,15
Keaura,F,100,15,0,15
Kedrian,M,100,0,15,15
Keesean,M,100,0,15,15
Kejaun,M,100,0,15,15
Kelaya,F,100,15,0,15
Kellian,F,100,15,0,15
Kellynn,F,100,15,0,15
Kemariya,F,100,15,0,15
Kendalle,F,100,15,0,15
Kenenna,M,100,0,15,15
Kennitha,F,100,15,0,15
Kennyatta,F,67,10,5,15
Kennyetta,F,100,15,0,15
Kenyi,M,100,0,15,15
Keoisha,F,100,15,0,15
Ker,M,67,5,10,15
Kerren,F,100,15,0,15
Kerrianna,F,100,15,0,15
Kerrilee,F,100,15,0,15
Kerrissa,F,100,15,0,15
Kevanna,F,100,15,0,15
Kevinjoseph,M,100,0,15,15
Keyo,M,100,0,15,15
Keyondria,F,100,15,0,15
Keyonie,F,100,15,0,15
Keyshanna,F,100,15,0,15
Keyunta,M,67,5,10,15
Keyvonna,F,100,15,0,15
Keywanda,F,100,15,0,15
Khadidra,F,100,15,0,15
Khaleil,M,100,0,15,15
Khedra,F,100,15,0,15
Kiann,F,100,15,0,15
Kierstie,F,100,15,0,15
Kily,F,100,15,0,15
Kimathi,M,100,0,15,15
Kinyon,M,100,0,15,15
Kinzli,F,100,15,0,15
Kirkwood,M,100,0,15,15
Kiser,M,100,0,15,15
Klarysa,F,100,15,0,15
Koamalu,M,100,0,15,15
Kojak,M,100,0,15,15
Kristyan,M,67,5,10,15
Kristyle,F,100,15,0,15
Kyryn,M,100,0,15,15
Laberta,F,100,15,0,15
Ladeanna,F,100,15,0,15
Laetyn,F,67,10,5,15
Lallie,F,100,15,0,15
Lameria,F,100,15,0,15
Lamesa,F,100,15,0,15
Lamicheal,M,100,0,15,15
Lamisa,F,100,15,0,15
Lamoine,M,100,0,15,15
Landonn,M,100,0,15,15
Lanishia,F,100,15,0,15
Lann,M,100,0,15,15
Laquanya,F,100,15,0,15
Laqueeta,F,100,15,0,15
Laqwan,M,100,0,15,15
Larayna,F,100,15,0,15
Lareshia,F,100,15,0,15
Larsyn,F,100,15,0,15
Lasanya,F,100,15,0,15
Lashavia,F,100,15,0,15
Latajia,F,100,15,0,15
Laterius,M,100,0,15,15
Latiah,F,100,15,0,15
Latovia,F,100,15,0,15
Latreasa,F,100,15,0,15
Latundra,F,100,15,0,15
Laurenne,F,100,15,0,15
Lauritz,M,100,0,15,15
Laurne,F,100,15,0,15
Lavander,M,100,0,15,15
Lavontre,M,100,0,15,15
Laylen,M,100,0,15,15
Leajah,F,100,15,0,15
Leathan,M,100,0,15,15
Ledford,M,100,0,15,15
Ledra,F,100,15,0,15
Leedell,M,100,0,15,15
Leemon,M,100,0,15,15
Leiara,F,100,15,0,15
Leilaney,F,100,15,0,15
Lelana,F,100,15,0,15
Lenasia,F,100,15,0,15
Lendale,M,100,0,15,15
Lendel,M,100,0,15,15
Lenina,F,100,15,0,15
Lenoris,M,100,0,15,15
Lenoxx,M,100,0,15,15
Leonzo,M,100,0,15,15
Leshunda,F,100,15,0,15
Letrece,F,100,15,0,15
Lettica,F,100,15,0,15
Lexly,F,100,15,0,15
Lexxy,F,100,15,0,15
Liasia,F,100,15,0,15
Lito,M,100,0,15,15
Llareli,F,100,15,0,15
Loeta,F,100,15,0,15
Loleatha,F,100,15,0,15
Londale,M,100,0,15,15
Lorencita,F,100,15,0,15
Lorett,F,100,15,0,15
Lorreen,F,100,15,0,15
Lotasha,F,100,15,0,15
Lotonya,F,100,15,0,15
Lougenia,F,100,15,0,15
Luai,M,100,0,15,15
Lucritia,F,100,15,0,15
Luisito,M,100,0,15,15
Lul,F,100,15,0,15
Lun,F,100,15,0,15
Lurinda,F,100,15,0,15
Lutrell,M,100,0,15,15
Luzdary,F,100,15,0,15
Lynix,F,100,15,0,15
Lynus,M,100,0,15,15
Lyrix,F,67,10,5,15
Mablene,F,100,15,0,15
Machella,F,100,15,0,15
Macia,F,100,15,0,15
Madaya,F,100,15,0,15
Maevyn,F,100,15,0,15
Magarita,F,100,15,0,15
Mahailey,F,100,15,0,15
Maho,F,100,15,0,15
Mahyar,M,100,0,15,15
Maikia,F,100,15,0,15
Makeeba,F,100,15,0,15
Makeva,F,100,15,0,15
Makkah,F,100,15,0,15
Makson,M,100,0,15,15
Malikhai,M,100,0,15,15
Mancy,F,100,15,0,15
Marbel,F,100,15,0,15
Marenna,F,100,15,0,15
Mariola,F,100,15,0,15
Markwon,M,100,0,15,15
Marnay,F,100,15,0,15
Marnique,F,100,15,0,15
Marquea,F,100,15,0,15
Marrisha,F,100,15,0,15
Martajah,F,100,15,0,15
Martavian,M,100,0,15,15
Marth,F,100,15,0,15
Martrel,M,100,0,15,15
Maryel,F,100,15,0,15
Maryon,F,100,15,0,15
Masan,M,100,0,15,15
Mashyia,F,100,15,0,15
Masika,F,100,15,0,15
Matthey,M,100,0,15,15
Maudry,F,100,15,0,15
Mauel,M,100,0,15,15
Maulik,M,100,0,15,15
Maurielle,F,100,15,0,15
Mawada,F,100,15,0,15
Maxmillion,M,100,0,15,15
Mayen,M,100,0,15,15
Meanna,F,100,15,0,15
Medelyn,F,100,15,0,15
Mehakpreet,F,100,15,0,15
Melkin,M,100,0,15,15
Melynna,F,100,15,0,15
Meraly,F,100,15,0,15
Meriann,F,100,15,0,15
Merjem,F,100,15,0,15
Meshack,M,100,0,15,15
Meshonda,F,100,15,0,15
Mher,M,100,0,15,15
Michaelynn,F,100,15,0,15
Michelena,F,100,15,0,15
Mileidi,F,100,15,0,15
Minique,F,100,15,0,15
Miosoti,F,100,15,0,15
Mirical,F,100,15,0,15
Mistye,F,100,15,0,15
Moneek,F,100,15,0,15
Montral,M,100,0,15,15
Morag,F,100,15,0,15
Mortisha,F,100,15,0,15
Mria,F,100,15,0,15
Mukta,F,100,15,0,15
Muniba,F,100,15,0,15
Mykhal,M,100,0,15,15
Myriana,F,100,15,0,15
Myrisa,F,100,15,0,15
Naaliyah,F,100,15,0,15
Nabia,F,100,15,0,15
Nache,F,100,15,0,15
Nahlah,F,100,15,0,15
Nahomie,F,100,15,0,15
Najeebah,F,100,15,0,15
Nakiaya,F,100,15,0,15
Nakiera,F,100,15,0,15
Nakosha,F,100,15,0,15
Nakuma,M,100,0,15,15
Naleia,F,100,15,0,15
Nalissa,F,100,15,0,15
Nalyssa,F,100,15,0,15
Narai,F,100,15,0,15
Narayani,F,100,15,0,15
Narisa,F,100,15,0,15
Nasasha,F,100,15,0,15
Nasiriyah,F,100,15,0,15
Nateesha,F,100,15,0,15
Natricia,F,100,15,0,15
Natsuko,F,100,15,0,15
Nattie,F,100,15,0,15
Natyra,F,100,15,0,15
Nazariy,M,100,0,15,15
Nazariyah,F,100,15,0,15
Nazeef,M,100,0,15,15
Nazish,F,100,15,0,15
Nealey,F,100,15,0,15
Neeyah,F,100,15,0,15
Negeen,F,100,15,0,15
Neilpatrick,M,100,0,15,15
Neimiah,M,100,0,15,15
Nekedra,F,100,15,0,15
Neliyah,F,100,15,0,15
Nency,F,100,15,0,15
Neptali,M,100,0,15,15
Niaimani,F,100,15,0,15
Nicaela,F,100,15,0,15
Nickelous,M,100,0,15,15
Nicohle,F,100,15,0,15
Nikel,M,67,5,10,15
Niranjana,F,100,15,0,15
Nirja,F,100,15,0,15
Nishta,F,100,15,0,15
Nisma,F,100,15,0,15
Nisson,M,100,0,15,15
Nitalia,F,100,15,0,15
Nitaya,F,100,15,0,15
Noahgabriel,M,100,0,15,15
Norlishia,F,100,15,0,15
Nory,F,100,15,0,15
Novie,F,100,15,0,15
Nyarie,F,100,15,0,15
Nyome,F,100,15,0,15
Obaid,M,100,0,15,15
Ok,F,100,15,0,15
Olanna,F,100,15,0,15
Olatokunbo,F,100,15,0,15
Oleksandr,M,100,0,15,15
Olia,F,100,15,0,15
Oliviyah,F,100,15,0,15
Oluwajomiloju,F,100,15,0,15
Oluwatise,M,67,5,10,15
Ondina,F,100,15,0,15
Onia,F,100,15,0,15
Onyae,F,100,15,0,15
Osamu,M,100,0,15,15
Pantaleon,M,100,0,15,15
Panzy,F,100,15,0,15
Pariis,F,100,15,0,15
Patrenia,F,100,15,0,15
Paulia,F,100,15,0,15
Paulin,M,100,0,15,15
Persayis,F,100,15,0,15
Petronilo,M,100,0,15,15
Phadra,F,100,15,0,15
Phelps,M,100,0,15,15
Philippos,M,100,0,15,15
Poe,M,67,5,10,15
Prajit,M,100,0,15,15
Pranesh,M,100,0,15,15
Preanna,F,100,15,0,15
Princemichael,M,100,0,15,15
Priyam,M,100,0,15,15
Prometheus,M,100,0,15,15
Quaneka,F,100,15,0,15
Quanterius,M,100,0,15,15
Quinlen,M,100,0,15,15
Quinna,F,100,15,0,15
Quinncy,M,67,5,10,15
Quintarus,M,100,0,15,15
Rackwon,M,100,0,15,15
Radlee,M,100,0,15,15
Raenee,F,100,15,0,15
Raeshelle,F,100,15,0,15
Raevynn,F,100,15,0,15
Raffeal,M,100,0,15,15
Rahab,F,100,15,0,15
Rahini,F,100,15,0,15
Rahmya,F,100,15,0,15
Raigyn,F,100,15,0,15
Rajaee,M,100,0,15,15
Rajko,M,100,0,15,15
Rakyla,F,100,15,0,15
Ramen,M,100,0,15,15
Ramis,M,100,0,15,15
Randiel,M,100,0,15,15
Rarity,F,100,15,0,15
Rashina,F,100,15,0,15
Raylina,F,100,15,0,15
Reanee,F,100,15,0,15
Reannen,F,100,15,0,15
Rebella,F,100,15,0,15
Reddick,M,100,0,15,15
Regginal,M,100,0,15,15
Rehab,F,100,15,0,15
Rehma,F,100,15,0,15
Reide,M,100,0,15,15
Rembrandt,M,100,0,15,15
Remey,M,67,5,10,15
Remick,M,100,0,15,15
Renaee,F,100,15,0,15
Renauda,F,100,15,0,15
Reshea,F,100,15,0,15
Rexx,M,100,0,15,15
Reyon,M,100,0,15,15
Riesha,F,100,15,0,15
Rinka,F,100,15,0,15
Rintaro,M,100,0,15,15
Ristina,F,100,15,0,15
Rittney,F,100,15,0,15
Ritvika,F,100,15,0,15
Rocheal,F,100,15,0,15
Romania,F,100,15,0,15
Rondarious,M,100,0,15,15
Rone,M,100,0,15,15
Roneesha,F,100,15,0,15
Ronesia,F,100,15,0,15
Rosaley,F,100,15,0,15
Rosalua,F,100,15,0,15
Roshida,F,100,15,0,15
Rozalind,F,100,15,0,15
Rubiana,F,100,15,0,15
Ryoko,F,100,15,0,15
Saalih,M,100,0,15,15
Saarim,M,100,0,15,15
Sabion,M,100,0,15,15
Sadeem,F,100,15,0,15
Sadiqua,F,100,15,0,15
Saedi,F,100,15,0,15
Safah,F,100,15,0,15
Sahyra,F,100,15,0,15
Saiyan,M,100,0,15,15
Sakima,M,67,5,10,15
Samayia,F,100,15,0,15
Samijah,F,100,15,0,15
Sammey,M,100,0,15,15
Sanav,M,100,0,15,15
Saquon,M,100,0,15,15
Sarem,F,100,15,0,15
Sarom,M,67,5,10,15
Sashi,F,100,15,0,15
Saulius,M,100,0,15,15
Savage,M,100,0,15,15
Savonn,M,100,0,15,15
Sayli,F,100,15,0,15
Schanel,F,100,15,0,15
Schelley,F,100,15,0,15
Schenita,F,100,15,0,15
Scion,M,100,0,15,15
Scooter,M,100,0,15,15
Seandell,M,100,0,15,15
Seanmatthew,M,100,0,15,15
Semirah,F,100,15,0,15
Senada,F,100,15,0,15
Senen,M,100,0,15,15
Seonna,F,100,15,0,15
Serafim,M,100,0,15,15
Seta,F,100,15,0,15
Shakethia,F,100,15,0,15
Shakuria,F,100,15,0,15
Shamese,F,100,15,0,15
Shamichael,M,67,5,10,15
Shanecqua,F,100,15,0,15
Shaneise,F,100,15,0,15
Shanille,F,100,15,0,15
Shaniyla,F,100,15,0,15
Shaquette,F,100,15,0,15
Sharik,F,100,15,0,15
Sharrel,F,100,15,0,15
Shateema,F,100,15,0,15
Shauneen,F,100,15,0,15
Shauntal,F,100,15,0,15
Sheffield,M,100,0,15,15
Sheida,F,100,15,0,15
Shelese,F,100,15,0,15
Shequitta,F,100,15,0,15
Sherdina,F,100,15,0,15
Shibani,F,100,15,0,15
Shikhar,M,100,0,15,15
Shilow,F,100,15,0,15
Shiny,F,100,15,0,15
Shirlon,F,100,15,0,15
Showanda,F,100,15,0,15
Shymia,F,100,15,0,15
Shytavia,F,100,15,0,15
Siddhan,M,100,0,15,15
Signora,F,100,15,0,15
Simarpreet,F,100,15,0,15
Sirenna,F,100,15,0,15
Sirjames,M,100,0,15,15
Sohni,F,100,15,0,15
Sohrob,M,100,0,15,15
Solaya,F,100,15,0,15
Solmaira,F,100,15,0,15
Sonta,F,100,15,0,15
Spiridon,M,100,0,15,15
Standford,M,100,0,15,15
Stclair,M,100,0,15,15
Suada,F,100,15,0,15
Subhi,M,100,0,15,15
Suchi,F,100,15,0,15
Sudha,F,100,15,0,15
Suhaani,F,100,15,0,15
Suhaill,F,100,15,0,15
Sulinda,F,100,15,0,15
Surayyah,F,100,15,0,15
Susano,M,100,0,15,15
Suyog,M,100,0,15,15
Sybastian,M,100,0,15,15
Syndie,F,100,15,0,15
Taaha,M,100,0,15,15
Tahreem,F,100,15,0,15
Tailyr,F,100,15,0,15
Taiyanna,F,100,15,0,15
Talazia,F,100,15,0,15
Taleasha,F,100,15,0,15
Talese,F,100,15,0,15
Tamathy,F,100,15,0,15
Tamille,F,100,15,0,15
Tamson,F,100,15,0,15
Tanaeja,F,100,15,0,15
Taneria,F,100,15,0,15
Tangier,F,100,15,0,15
Tano,M,100,0,15,15
Taqi,M,100,0,15,15
Taryiah,F,100,15,0,15
Tashawnna,F,100,15,0,15
Tassia,F,100,15,0,15
Taurino,M,100,0,15,15
Tawayna,F,100,15,0,15
Tawayne,M,100,0,15,15
Tayha,F,100,15,0,15
Taylorrose,F,100,15,0,15
Taytiana,F,100,15,0,15
Teaire,F,100,15,0,15
Teaka,F,100,15,0,15
Teeka,F,100,15,0,15
Teoni,F,100,15,0,15
Teonte,M,100,0,15,15
Terenia,F,100,15,0,15
Terriyana,F,100,15,0,15
Terryana,F,100,15,0,15
Tesse,F,100,15,0,15
Tevian,M,100,0,15,15
Thaisha,F,100,15,0,15
Thalamus,M,100,0,15,15
Thorton,M,100,0,15,15
Tiania,F,100,15,0,15
Tieg,M,100,0,15,15
Tiemeyer,M,100,0,15,15
Tieria,F,100,15,0,15
Tiferet,F,100,15,0,15
Tiffonie,F,100,15,0,15
Tikiya,F,100,15,0,15
Timbra,F,100,15,0,15
Timothe,M,100,0,15,15
Timyia,F,100,15,0,15
Tinh,M,100,0,15,15
Tishea,F,100,15,0,15
Toccaro,F,100,15,0,15
Tolani,F,100,15,0,15
Tomeaka,F,100,15,0,15
Tomeisha,F,100,15,0,15
Torray,M,100,0,15,15
Tracylynn,F,100,15,0,15
Traelon,M,100,0,15,15
Traevyn,M,100,0,15,15
Tragen,M,100,0,15,15
Tranecia,F,100,15,0,15
Travail,M,100,0,15,15
Travione,M,100,0,15,15
Tredyn,M,100,0,15,15
Treisa,F,100,15,0,15
Trenece,F,100,15,0,15
Trenette,F,100,15,0,15
Trenya,F,100,15,0,15
Trieu,M,100,0,15,15
Trishanna,F,100,15,0,15
Trivon,M,100,0,15,15
Trucker,M,100,0,15,15
Truen,M,100,0,15,15
Trvis,M,100,0,15,15
Tuesdee,F,100,15,0,15
Tuula,F,100,15,0,15
Twayne,M,100,0,15,15
Tyandra,F,100,15,0,15
Tykiara,F,100,15,0,15
Tylajah,F,100,15,0,15
Tylina,F,100,15,0,15
Tylre,M,100,0,15,15
Typhanie,F,100,15,0,15
Tyreeka,F,100,15,0,15
Tyreice,M,100,0,15,15
Tyryn,M,100,0,15,15
Ulizes,M,100,0,15,15
Ulus,M,100,0,15,15
Umekia,F,100,15,0,15
Undre,M,100,0,15,15
Ureka,F,100,15,0,15
Ushna,F,100,15,0,15
Utsav,M,100,0,15,15
Vachon,M,100,0,15,15
Vahn,M,100,0,15,15
Valada,F,100,15,0,15
Valesia,F,100,15,0,15
Vaneeza,F,100,15,0,15
Vanelope,F,100,15,0,15
Vannetta,F,100,15,0,15
Vantrice,F,100,15,0,15
Variah,F,100,15,0,15
Vasanth,M,100,0,15,15
Verenize,F,100,15,0,15
Verneice,F,100,15,0,15
Vernessia,F,100,15,0,15
Vickiann,F,100,15,0,15
Victoralfonso,M,100,0,15,15
Vidhur,M,100,0,15,15
Vihas,M,100,0,15,15
Ville,M,100,0,15,15
Vilmarie,F,100,15,0,15
Virdiana,F,100,15,0,15
Vitas,M,100,0,15,15
Vontina,F,100,15,0,15
Vyonne,F,100,15,0,15
Vytas,M,100,0,15,15
Wakeisha,F,100,15,0,15
Walidah,F,100,15,0,15
Walkiria,F,100,15,0,15
Wan,F,67,10,5,15
Warwick,M,100,0,15,15
Watts,M,100,0,15,15
Weatherly,F,100,15,0,15
Welden,M,100,0,15,15
Wezley,M,100,0,15,15
Winsome,F,100,15,0,15
Wintress,F,100,15,0,15
Wolfram,M,100,0,15,15
Xalen,M,100,0,15,15
Xandar,M,100,0,15,15
Xaylee,F,100,15,0,15
Xinyan,F,100,15,0,15
Xiomary,F,100,15,0,15
Yadeliz,F,100,15,0,15
Yaidel,M,100,0,15,15
Yajat,M,100,0,15,15
Yakini,F,100,15,0,15
Yanetzy,F,100,15,0,15
Yansi,F,100,15,0,15
Yariliz,F,100,15,0,15
Yeleina,F,100,15,0,15
Yeltsin,M,100,0,15,15
Yennhi,F,100,15,0,15
Yescenia,F,100,15,0,15
Yiran,F,67,10,5,15
Yissell,F,100,15,0,15
Yocelynn,F,100,15,0,15
Yuvika,F,100,15,0,15
Zackhary,M,100,0,15,15
Zacorian,M,100,0,15,15
Zaena,F,100,15,0,15
Zahiyah,F,100,15,0,15
Zakeem,M,100,0,15,15
Zakharia,F,100,15,0,15
Zamanta,F,100,15,0,15
Zaneb,F,100,15,0,15
Zarena,F,100,15,0,15
Zarhia,F,100,15,0,15
Zayiah,F,100,15,0,15
Zayvin,M,100,0,15,15
Zelah,F,100,15,0,15
Zeneida,F,100,15,0,15
Zenetta,F,100,15,0,15
Zennia,F,100,15,0,15
Zennon,M,100,0,15,15
Zerena,F,100,15,0,15
Zeyden,M,100,0,15,15
Zoilo,M,100,0,15,15
Zon,M,100,0,15,15
Zoyla,F,100,15,0,15
Zulie,F,100,15,0,15
Zyauna,F,100,15,0,15
Zymal,F,100,15,0,15
Zytaveon,M,100,0,15,15
Aamber,F,100,14,0,14
Aariyanna,F,100,14,0,14
Aavya,F,100,14,0,14
Abryl,F,100,14,0,14
Abubacar,M,100,0,14,14
Adelayda,F,100,14,0,14
Adeley,F,100,14,0,14
Adhara,F,100,14,0,14
Adileigh,F,100,14,0,14
Adonya,F,100,14,0,14
Aedric,M,100,0,14,14
Afzal,M,100,0,14,14
Ahmarie,F,100,14,0,14
Ahriel,F,100,14,0,14
Aideyn,M,100,0,14,14
Aidrick,M,100,0,14,14
Aireyana,F,100,14,0,14
Akriti,F,100,14,0,14
Aleander,M,100,0,14,14
Alexz,F,100,14,0,14
Aliyahna,F,100,14,0,14
Alleshia,F,100,14,0,14
Amauriah,F,100,14,0,14
Amondo,M,100,0,14,14
Amyna,F,100,14,0,14
Analah,F,100,14,0,14
Anayaa,F,100,14,0,14
Anaysa,F,100,14,0,14
Andreniki,F,100,14,0,14
Aneeza,F,100,14,0,14
Angelean,F,100,14,0,14
Angellia,F,100,14,0,14
Angelous,M,100,0,14,14
Angelque,F,100,14,0,14
Annalayah,F,100,14,0,14
Annalin,F,100,14,0,14
Annalya,F,100,14,0,14
Anneliesse,F,100,14,0,14
Annemari,F,100,14,0,14
Annilee,F,100,14,0,14
Ansonia,F,100,14,0,14
Anthonyjr,M,100,0,14,14
Arkeith,M,100,0,14,14
Armelle,F,100,14,0,14
Aryash,M,100,0,14,14
Aubreeann,F,100,14,0,14
Aubreyella,F,100,14,0,14
Audreyann,F,100,14,0,14
Audriona,F,100,14,0,14
Auriyana,F,100,14,0,14
Averyonna,F,100,14,0,14
Avienda,F,100,14,0,14
Ayhan,M,100,0,14,14
Ayofemi,F,100,14,0,14
Azealia,F,100,14,0,14
Azenet,F,100,14,0,14
Azori,F,100,14,0,14
Behruz,M,100,0,14,14
Belford,M,100,0,14,14
Beverlyann,F,100,14,0,14
Branyah,F,100,14,0,14
Brecker,M,100,0,14,14
Breesha,F,100,14,0,14
Breyannah,F,100,14,0,14
Breyawna,F,100,14,0,14
Brialle,F,100,14,0,14
Brixley,F,100,14,0,14
Bronti,F,100,14,0,14
Brooksley,F,100,14,0,14
Bryhana,F,100,14,0,14
Bryken,M,100,0,14,14
Bynum,M,100,0,14,14
Caffrey,M,100,0,14,14
Caleab,M,100,0,14,14
Callison,F,100,14,0,14
Camoni,F,100,14,0,14
Carilee,F,100,14,0,14
Carmah,F,100,14,0,14
Carmia,F,100,14,0,14
Centhia,F,100,14,0,14
Chale,M,100,0,14,14
Chalyse,F,100,14,0,14
Chamisa,F,100,14,0,14
Charlse,M,100,0,14,14
Chayston,M,100,0,14,14
Cherelyn,F,100,14,0,14
Cheriese,F,100,14,0,14
Chizoba,F,100,14,0,14
Chubby,M,100,0,14,14
Chyles,F,100,14,0,14
Clorice,F,100,14,0,14
Cnya,F,100,14,0,14
Coopar,M,100,0,14,14
Corletta,F,100,14,0,14
Corrianna,F,100,14,0,14
Cyrano,M,100,0,14,14
Dahlilah,F,100,14,0,14
Dainette,F,100,14,0,14
Daizja,F,100,14,0,14
Daleyah,F,100,14,0,14
Daleyzah,F,100,14,0,14
Damariana,F,100,14,0,14
Damayanti,F,100,14,0,14
Damontray,M,100,0,14,14
Dancy,F,100,14,0,14
Dannita,F,100,14,0,14
Darail,M,100,0,14,14
Dardi,F,100,14,0,14
Darriane,F,100,14,0,14
Darrylin,F,100,14,0,14
Davant,M,100,0,14,14
Davidalexander,M,100,0,14,14
Deangilo,M,100,0,14,14
Deatria,F,100,14,0,14
Deerika,F,100,14,0,14
Dejahn,M,100,0,14,14
Deonza,F,100,14,0,14
Derlin,M,100,0,14,14
Destinyrose,F,100,14,0,14
Deviana,F,100,14,0,14
Devoe,M,100,0,14,14
Devota,F,100,14,0,14
Dezia,F,100,14,0,14
Djenabou,F,100,14,0,14
Dlylah,F,100,14,0,14
Domineke,M,100,0,14,14
Eevie,F,100,14,0,14
Eimaan,F,100,14,0,14
Elainy,F,100,14,0,14
Eliasz,M,100,0,14,14
Elliekate,F,100,14,0,14
Ellodie,F,100,14,0,14
Elman,M,100,0,14,14
Elnoria,F,100,14,0,14
Elyannah,F,100,14,0,14
Emaleah,F,100,14,0,14
Emalyne,F,100,14,0,14
Emellie,F,100,14,0,14
Emmytt,M,100,0,14,14
Eshita,F,100,14,0,14
Espyn,F,50,7,7,14
Ethany,F,100,14,0,14
Etoy,F,100,14,0,14
Evelynrose,F,100,14,0,14
Ezavier,M,100,0,14,14
Faaiz,M,100,0,14,14
Fadima,F,100,14,0,14
Farad,M,100,0,14,14
Fayt,M,100,0,14,14
Fela,F,64,9,5,14
Ferney,M,100,0,14,14
Florecita,F,100,14,0,14
Flores,M,100,0,14,14
Gaije,M,100,0,14,14
Ganajah,F,100,14,0,14
Garn,M,100,0,14,14
Garrhett,M,100,0,14,14
Gilian,F,100,14,0,14
Grigoriy,M,100,0,14,14
Haaziq,M,100,0,14,14
Haleena,F,100,14,0,14
Hallah,F,100,14,0,14
Haruma,M,100,0,14,14
Harvell,M,100,0,14,14
Havala,F,100,14,0,14
Hayyan,M,100,0,14,14
Heahter,F,100,14,0,14
Herlene,F,100,14,0,14
Herndon,M,100,0,14,14
Hershey,M,100,0,14,14
Hicham,M,100,0,14,14
Hollynd,F,100,14,0,14
Ilayah,F,100,14,0,14
Imana,F,100,14,0,14
Immanol,M,100,0,14,14
Irsa,F,100,14,0,14
Irv,M,100,0,14,14
Isibeal,F,100,14,0,14
Ivyunna,F,100,14,0,14
Jaasir,M,100,0,14,14
Jacobalexander,M,100,0,14,14
Jadaveon,M,100,0,14,14
Jaecyon,M,100,0,14,14
Jahmarcus,M,100,0,14,14
Jahzelle,F,100,14,0,14
Jaier,M,100,0,14,14
Jalessia,F,100,14,0,14
Jamalle,M,100,0,14,14
Jamirr,M,100,0,14,14
Jamuel,M,100,0,14,14
Janaih,F,100,14,0,14
Janiaha,F,100,14,0,14
Janluca,M,100,0,14,14
Jannika,F,100,14,0,14
Jaquincy,M,100,0,14,14
Jareo,M,100,0,14,14
Jarhonda,F,100,14,0,14
Jarielle,F,100,14,0,14
Jayanni,F,100,14,0,14
Jayceonna,F,100,14,0,14
Jaydeep,M,100,0,14,14
Jayleanna,F,100,14,0,14
Jayvis,M,100,0,14,14
Jehoshua,M,100,0,14,14
Jeliel,M,100,0,14,14
Jennely,F,100,14,0,14
Jenohn,F,100,14,0,14
Jerme,M,100,0,14,14
Jermont,M,100,0,14,14
Jessico,F,100,14,0,14
Jetzibe,F,100,14,0,14
Jherika,F,100,14,0,14
Jiquan,M,100,0,14,14
Jodeane,F,100,14,0,14
Johnbenedict,M,100,0,14,14
Jonpatrick,M,100,0,14,14
Jontarius,M,100,0,14,14
Joshelin,F,100,14,0,14
Journy,F,100,14,0,14
Joyful,F,100,14,0,14
Jrew,M,100,0,14,14
Juelez,M,100,0,14,14
Jullius,M,100,0,14,14
Jumalay,F,100,14,0,14
Jzon,M,100,0,14,14
Kadein,M,100,0,14,14
Kadison,F,57,8,6,14
Kagome,F,100,14,0,14
Kahaan,M,100,0,14,14
Kaikane,M,100,0,14,14
Kailob,M,100,0,14,14
Kalysia,F,100,14,0,14
Kamario,M,100,0,14,14
Kamdan,M,100,0,14,14
Kanavis,M,100,0,14,14
Kandida,F,100,14,0,14
Karenina,F,100,14,0,14
Karissia,F,100,14,0,14
Karolena,F,100,14,0,14
Katima,F,100,14,0,14
Kaygan,F,100,14,0,14
Kayleeana,F,100,14,0,14
Kayleeanna,F,100,14,0,14
Kayleeanne,F,100,14,0,14
Kaynon,M,100,0,14,14
Kazlynn,F,100,14,0,14
Keahna,F,100,14,0,14
Keasiah,F,100,14,0,14
Kedeem,M,100,0,14,14
Keele,F,100,14,0,14
Keidi,F,100,14,0,14
Kellsy,F,100,14,0,14
Kemori,M,64,5,9,14
Kenaan,M,100,0,14,14
Kennasia,F,100,14,0,14
Keunte,M,100,0,14,14
Kevyon,M,100,0,14,14
Khailynn,F,100,14,0,14
Kharmyn,F,100,14,0,14
Khevin,M,100,0,14,14
Khodi,F,57,8,6,14
Khushpreet,F,100,14,0,14
Kiahnna,F,100,14,0,14
Kimaka,F,100,14,0,14
Kimaree,F,100,14,0,14
Kinsli,F,100,14,0,14
Kiralee,F,100,14,0,14
Kiska,F,100,14,0,14
Klarke,F,100,14,0,14
Knoa,M,100,0,14,14
Kohlson,M,100,0,14,14
Koleby,M,100,0,14,14
Kollette,F,100,14,0,14
Koretta,F,100,14,0,14
Kovin,M,100,0,14,14
Kritzia,F,100,14,0,14
Kroix,M,100,0,14,14
Kwmaine,M,100,0,14,14
Kyier,M,100,0,14,14
Labree,F,100,14,0,14
Lachyna,F,100,14,0,14
Ladaryl,M,100,0,14,14
Lakhi,M,100,0,14,14
Lakischa,F,100,14,0,14
Lamaris,M,100,0,14,14
Lanaye,F,100,14,0,14
Latricha,F,100,14,0,14
Lauramarie,F,100,14,0,14
Lauretha,F,100,14,0,14
Layanah,F,100,14,0,14
Leanni,F,100,14,0,14
Leddy,F,100,14,0,14
Lederrick,M,100,0,14,14
Leica,F,100,14,0,14
Lelynn,M,100,0,14,14
Levarr,M,100,0,14,14
Lexsey,F,100,14,0,14
Libya,F,100,14,0,14
Lillette,F,100,14,0,14
Liriel,F,100,14,0,14
Llesica,F,100,14,0,14
Loukya,F,100,14,0,14
Loveta,F,100,14,0,14
Lwren,F,100,14,0,14
Lymon,M,100,0,14,14
Lyndin,F,100,14,0,14
Lytia,F,100,14,0,14
Mackennah,F,100,14,0,14
Magabi,F,100,14,0,14
Maielle,F,100,14,0,14
Maithe,F,100,14,0,14
Manijah,F,100,14,0,14
Manuelle,M,100,0,14,14
Marcius,M,100,0,14,14
Mariamne,F,100,14,0,14
Marietha,F,100,14,0,14
Marj,F,100,14,0,14
Marquaveon,M,100,0,14,14
Maryeli,F,100,14,0,14
Masumi,F,100,14,0,14
Mauna,F,100,14,0,14
Mawa,F,100,14,0,14
Mayford,M,100,0,14,14
Mayim,F,100,14,0,14
Mccord,M,100,0,14,14
Mckinli,F,100,14,0,14
Meelad,M,100,0,14,14
Mekena,F,100,14,0,14
Micel,F,100,14,0,14
Micheyla,F,100,14,0,14
Migelangel,M,100,0,14,14
Mishaun,M,100,0,14,14
Miyisha,F,100,14,0,14
Monterrian,M,100,0,14,14
Myeka,F,100,14,0,14
Myhanh,F,100,14,0,14
Mykolas,M,100,0,14,14
Mylania,F,100,14,0,14
Myren,M,100,0,14,14
Naaya,F,100,14,0,14
Nakenzie,F,100,14,0,14
Nariana,F,100,14,0,14
Nasma,F,100,14,0,14
Navey,F,100,14,0,14
Nayarit,F,100,14,0,14
Nayvadius,M,100,0,14,14
Neric,M,100,0,14,14
Nihash,M,100,0,14,14
Nkauj,F,100,14,0,14
Noaah,M,100,0,14,14
Noelya,F,100,14,0,14
Nofer,M,100,0,14,14
Novalei,F,100,14,0,14
Nybria,F,100,14,0,14
Nydra,F,100,14,0,14
Ondrej,M,100,0,14,14
Orlandra,F,100,14,0,14
Paal,M,100,0,14,14
Pagie,F,100,14,0,14
Paizly,F,100,14,0,14
Pandy,F,100,14,0,14
Paridhi,F,100,14,0,14
Paycee,F,100,14,0,14
Philant,M,100,0,14,14
Piffany,F,100,14,0,14
Pranith,M,100,0,14,14
Quanterrius,M,100,0,14,14
Quashawna,F,100,14,0,14
Quayshun,M,100,0,14,14
Raeqwan,M,100,0,14,14
Raielle,F,100,14,0,14
Rainell,F,100,14,0,14
Rajit,M,100,0,14,14
Ratana,M,100,0,14,14
Rayanah,F,100,14,0,14
Rebelle,F,100,14,0,14
Reshay,F,100,14,0,14
Revere,M,100,0,14,14
Rhasaan,M,100,0,14,14
Rhayna,F,100,14,0,14
Rhiyan,F,100,14,0,14
Rhody,M,100,0,14,14
Riquelmer,M,100,0,14,14
Rishil,M,100,0,14,14
Rixon,M,100,0,14,14
Roaa,F,100,14,0,14
Rohanpreet,M,100,0,14,14
Ronde,M,100,0,14,14
Rorke,M,100,0,14,14
Roshondra,F,100,14,0,14
Rosisela,F,100,14,0,14
Ruark,M,100,0,14,14
Rudransh,M,100,0,14,14
Rustam,M,100,0,14,14
Rynlee,F,100,14,0,14
Saaliyah,F,100,14,0,14
Saanchi,F,100,14,0,14
Sadeja,F,100,14,0,14
Samanthalee,F,100,14,0,14
Santara,F,100,14,0,14
Sauel,M,100,0,14,14
Savea,F,100,14,0,14
Saveer,M,100,0,14,14
Seanda,F,100,14,0,14
Sennie,F,100,14,0,14
Sephina,F,100,14,0,14
Shafeqah,F,100,14,0,14
Shakeeka,F,100,14,0,14
Shalexus,F,100,14,0,14
Shanesia,F,100,14,0,14
Shantazia,F,100,14,0,14
Shantra,F,100,14,0,14
Shaunah,F,100,14,0,14
Shieda,F,100,14,0,14
Shikela,F,100,14,0,14
Shrenik,M,100,0,14,14
Shrikar,M,100,0,14,14
Shriyansh,M,100,0,14,14
Shykemmia,F,100,14,0,14
Sirine,F,100,14,0,14
Siyuan,M,100,0,14,14
Sobeida,F,100,14,0,14
Sohanny,F,100,14,0,14
Sophieanne,F,100,14,0,14
Starquasia,F,100,14,0,14
Stas,M,100,0,14,14
Stian,M,100,0,14,14
Suheidy,F,100,14,0,14
Sumeka,F,100,14,0,14
Sunel,M,100,0,14,14
Surveen,F,100,14,0,14
Taccarra,F,100,14,0,14
Tahis,F,100,14,0,14
Tahlik,M,100,0,14,14
Talent,M,100,0,14,14
Tamarisk,F,100,14,0,14
Tamaz,M,100,0,14,14
Tanautica,F,100,14,0,14
Tanilah,F,100,14,0,14
Tavania,F,100,14,0,14
Taviah,F,100,14,0,14
Tayem,M,100,0,14,14
Teaonna,F,100,14,0,14
Tejaun,M,100,0,14,14
Thacher,M,100,0,14,14
Tiaisha,F,100,14,0,14
Todderick,M,100,0,14,14
Toretto,M,100,0,14,14
Traigh,M,100,0,14,14
Tremari,M,100,0,14,14
Trineka,F,100,14,0,14
Tristia,F,100,14,0,14
Tydan,M,100,0,14,14
Tyjaun,M,100,0,14,14
Tyranisha,F,100,14,0,14
Tyshianna,F,100,14,0,14
Umu,F,100,14,0,14
Un,F,50,7,7,14
Vent,M,100,0,14,14
Vontre,M,100,0,14,14
Waine,M,100,0,14,14
Wannette,F,100,14,0,14
Warrior,M,100,0,14,14
Wigberto,M,100,0,14,14
Winfrey,M,100,0,14,14
Xaveria,F,100,14,0,14
Xelha,F,100,14,0,14
Yaara,F,100,14,0,14
Yadhir,M,100,0,14,14
Yafa,F,100,14,0,14
Yesemia,F,100,14,0,14
Yimi,M,100,0,14,14
Yolaunda,F,100,14,0,14
Yoriel,M,100,0,14,14
Ysabell,F,100,14,0,14
Zaelin,M,100,0,14,14
Zahar,M,100,0,14,14
Zamarien,M,100,0,14,14
Zaniaya,F,100,14,0,14
Zareia,F,100,14,0,14
Zarita,F,100,14,0,14
Zarrea,F,100,14,0,14
Zoely,F,100,14,0,14
Zoribel,F,100,14,0,14
Zulekha,F,100,14,0,14
Zylis,M,100,0,14,14
Zyndall,M,100,0,14,14
Zyreon,M,100,0,14,14
Aadvika,F,100,13,0,13
Abaigael,F,100,13,0,13
Abdulbasit,M,100,0,13,13
Abygaile,F,100,13,0,13
Acquanette,F,100,13,0,13
Addysun,F,100,13,0,13
Adiela,F,100,13,0,13
Adika,M,100,0,13,13
Adrainne,F,100,13,0,13
Aelynn,F,100,13,0,13
Aeriella,F,100,13,0,13
Agrima,F,100,13,0,13
Ahlexus,F,100,13,0,13
Ahmina,F,100,13,0,13
Ahrya,F,100,13,0,13
Ahylin,F,100,13,0,13
Airicka,F,100,13,0,13
Aisla,F,100,13,0,13
Ajalae,F,100,13,0,13
Ajournee,F,100,13,0,13
Akeyah,F,100,13,0,13
Alaan,M,100,0,13,13
Alainie,F,100,13,0,13
Alajuwon,M,100,0,13,13
Alakay,M,100,0,13,13
Alarie,F,100,13,0,13
Albrey,F,100,13,0,13
Aleema,F,100,13,0,13
Aleemah,F,100,13,0,13
Alesiram,F,100,13,0,13
Alexendra,F,100,13,0,13
Alezae,F,100,13,0,13
Alimatou,F,100,13,0,13
Allec,M,100,0,13,13
Allonte,M,100,0,13,13
Almarion,M,100,0,13,13
Alviery,M,100,0,13,13
Alzahra,F,100,13,0,13
Amahia,F,100,13,0,13
Amandajean,F,100,13,0,13
Ambere,F,100,13,0,13
Amirykal,F,100,13,0,13
Amnesty,F,100,13,0,13
Amoi,F,100,13,0,13
Anasa,F,100,13,0,13
Anav,M,100,0,13,13
Andew,M,100,0,13,13
Andreyna,F,100,13,0,13
Andrico,M,100,0,13,13
Angeleta,F,100,13,0,13
Angellie,F,100,13,0,13
Anjanique,F,100,13,0,13
Annaliesse,F,100,13,0,13
Annyston,F,100,13,0,13
Annzlee,F,100,13,0,13
Anthny,M,100,0,13,13
Antoniyah,F,100,13,0,13
Antwinette,F,100,13,0,13
Anuska,F,100,13,0,13
Anyeline,F,100,13,0,13
Aquino,M,100,0,13,13
Archith,M,100,0,13,13
Aref,M,100,0,13,13
Areyah,F,100,13,0,13
Arliz,F,100,13,0,13
Arnetria,F,100,13,0,13
Aroara,F,100,13,0,13
Arzjon,M,100,0,13,13
Atonio,M,100,0,13,13
Atrick,M,100,0,13,13
Atrina,F,100,13,0,13
Attiana,F,100,13,0,13
Atyanna,F,100,13,0,13
Aulbrey,F,100,13,0,13
Aurash,M,100,0,13,13
Aurionna,F,100,13,0,13
Autunm,F,100,13,0,13
Avrumy,M,100,0,13,13
Ayoob,M,100,0,13,13
Ayyoub,M,100,0,13,13
Azareel,M,100,0,13,13
Azur,F,100,13,0,13
Baile,F,100,13,0,13
Baillee,F,100,13,0,13
Bailor,M,100,0,13,13
Baiya,F,100,13,0,13
Balil,M,100,0,13,13
Baraah,F,100,13,0,13
Bariah,F,100,13,0,13
Bashirah,F,100,13,0,13
Bavly,M,100,0,13,13
Bekham,M,100,0,13,13
Benjemin,M,100,0,13,13
Beowulf,M,100,0,13,13
Bernay,F,100,13,0,13
Betta,F,100,13,0,13
Bexlee,F,100,13,0,13
Boyan,M,100,0,13,13
Brelle,F,100,13,0,13
Brextyn,M,100,0,13,13
Brijesh,M,100,0,13,13
Brijin,F,100,13,0,13
Brisamar,F,100,13,0,13
Britinee,F,100,13,0,13
Britlany,F,100,13,0,13
Britleigh,F,100,13,0,13
Britlynn,F,100,13,0,13
Brittlee,F,100,13,0,13
Briyit,F,100,13,0,13
Bush,M,100,0,13,13
Cadhla,F,100,13,0,13
Camee,F,100,13,0,13
Cania,F,100,13,0,13
Canye,M,100,0,13,13
Capers,M,100,0,13,13
Caramie,F,100,13,0,13
Cardia,F,100,13,0,13
Catelaya,F,100,13,0,13
Cavani,M,100,0,13,13
Ceasare,M,100,0,13,13
Cenaida,F,100,13,0,13
Ceriyah,F,100,13,0,13
Chandlyr,F,100,13,0,13
Chanyia,F,100,13,0,13
Chazmon,M,100,0,13,13
Chelea,F,100,13,0,13
Chess,M,100,0,13,13
Chiraag,M,100,0,13,13
Chrishanda,F,100,13,0,13
Christabell,F,100,13,0,13
Christianpaul,M,100,0,13,13
Christohpher,M,100,0,13,13
Christopoher,M,100,0,13,13
Chu,M,100,0,13,13
Chukwunonso,M,100,0,13,13
Chutney,F,100,13,0,13
Cindey,F,100,13,0,13
Clanton,M,100,0,13,13
Clarra,F,100,13,0,13
Coleten,M,100,0,13,13
Coline,F,100,13,0,13
Conlon,M,100,0,13,13
Conswala,F,100,13,0,13
Copen,M,100,0,13,13
Corryne,F,100,13,0,13
Coryell,M,100,0,13,13
Coyer,M,100,0,13,13
Cristell,F,100,13,0,13
Curtissa,F,100,13,0,13
Cyinthia,F,100,13,0,13
Cylen,M,100,0,13,13
Cymphony,F,100,13,0,13
Daffie,F,100,13,0,13
Dahndray,M,100,0,13,13
Dainian,M,100,0,13,13
Dairion,M,100,0,13,13
Daishanae,F,100,13,0,13
Dajanea,F,100,13,0,13
Danieljr,M,100,0,13,13
Dannalee,F,100,13,0,13
Danzelle,M,100,0,13,13
Daquasia,F,100,13,0,13
Dareck,M,100,0,13,13
Daretta,F,100,13,0,13
Darielis,F,100,13,0,13
Darlane,F,100,13,0,13
Darrain,M,100,0,13,13
Dasjah,F,100,13,0,13
Daviney,F,100,13,0,13
Davyen,M,100,0,13,13
Dayann,F,100,13,0,13
Deangelis,F,100,13,0,13
Deaquan,M,100,0,13,13
Debb,F,100,13,0,13
Deeshawn,M,100,0,13,13
Deiana,F,100,13,0,13
Deitric,M,100,0,13,13
Deneta,F,100,13,0,13
Denett,F,100,13,0,13
Deonn,F,100,13,0,13
Derez,M,100,0,13,13
Derielle,F,100,13,0,13
Deriya,F,100,13,0,13
Derria,F,100,13,0,13
Deshawnna,F,100,13,0,13
Desjah,F,100,13,0,13
Devaj,M,100,0,13,13
Devanand,M,100,0,13,13
Deviny,F,100,13,0,13
Devki,F,100,13,0,13
Deymar,M,100,0,13,13
Deyvid,M,100,0,13,13
Dhruvin,M,100,0,13,13
Dhyey,M,100,0,13,13
Diamyn,F,100,13,0,13
Dianthe,F,100,13,0,13
Dieynaba,F,100,13,0,13
Dilanjan,M,100,0,13,13
Dimya,F,100,13,0,13
Dixielynn,F,100,13,0,13
Diyan,M,100,0,13,13
Dmarrion,M,100,0,13,13
Domarion,M,100,0,13,13
Donah,F,100,13,0,13
Doniya,F,100,13,0,13
Donmonique,F,100,13,0,13
Donti,M,100,0,13,13
Dorothie,F,100,13,0,13
Dovon,M,100,0,13,13
Drashawn,M,100,0,13,13
Draydin,M,100,0,13,13
Drayvon,M,100,0,13,13
Dreu,M,100,0,13,13
Drex,M,100,0,13,13
Drishya,F,100,13,0,13
Dristi,F,100,13,0,13
Dulaney,F,100,13,0,13
Dzenan,M,100,0,13,13
Earth,F,100,13,0,13
Eddward,M,100,0,13,13
Edrey,M,100,0,13,13
Eera,F,100,13,0,13
Ehron,M,100,0,13,13
Eissa,M,100,0,13,13
Ellajean,F,100,13,0,13
Elliauna,F,100,13,0,13
Elliya,F,100,13,0,13
Elverna,F,100,13,0,13
Emare,M,100,0,13,13
Emeliana,F,100,13,0,13
Emerik,M,100,0,13,13
Emijah,F,100,13,0,13
Emryn,F,100,13,0,13
Enaiya,F,100,13,0,13
Enara,F,100,13,0,13
Eneas,M,100,0,13,13
Enija,F,100,13,0,13
Enso,M,100,0,13,13
Erical,F,100,13,0,13
Erycka,F,100,13,0,13
Esbeydy,F,100,13,0,13
Esmarie,F,100,13,0,13
Estie,F,100,13,0,13
Ethangabriel,M,100,0,13,13
Ethean,M,100,0,13,13
Eunita,F,100,13,0,13
Evalani,F,100,13,0,13
Evalett,F,100,13,0,13
Everli,F,100,13,0,13
Evrin,M,100,0,13,13
Excel,F,54,7,6,13
Ezekio,M,100,0,13,13
Ezias,M,100,0,13,13
Ezperanza,F,100,13,0,13
Ezzah,F,100,13,0,13
Fairen,F,100,13,0,13
Falishia,F,100,13,0,13
Fardy,M,100,0,13,13
Farhiyo,F,100,13,0,13
Faridah,F,100,13,0,13
Fariza,F,100,13,0,13
Forrestt,M,100,0,13,13
Gatlynn,M,62,5,8,13
Genina,F,100,13,0,13
Gethsemani,F,100,13,0,13
Gevena,F,100,13,0,13
Gianluka,M,100,0,13,13
Girlie,F,100,13,0,13
Giuliette,F,100,13,0,13
Giyanna,F,100,13,0,13
Gladies,F,100,13,0,13
Gracely,F,100,13,0,13
Gunars,M,100,0,13,13
Gunnarr,M,100,0,13,13
Guylene,F,100,13,0,13
Gwynette,F,100,13,0,13
Haigen,M,100,0,13,13
Halsten,M,100,0,13,13
Harmanpreet,F,54,7,6,13
Harmoniee,F,100,13,0,13
Harpal,M,100,0,13,13
Harseerat,F,100,13,0,13
Hartly,F,100,13,0,13
Hattan,M,100,0,13,13
Heavenli,F,100,13,0,13
Helsea,F,100,13,0,13
Henly,F,100,13,0,13
Henrika,F,100,13,0,13
Hiyam,F,100,13,0,13
Hopper,M,100,0,13,13
Hossain,M,100,0,13,13
Hovik,M,100,0,13,13
Huie,M,100,0,13,13
Hydea,F,100,13,0,13
Iashia,F,100,13,0,13
Ibette,F,100,13,0,13
Iciss,F,100,13,0,13
Ilyan,M,100,0,13,13
Imperia,F,100,13,0,13
Imrane,M,100,0,13,13
Ineka,F,100,13,0,13
Iremide,M,100,0,13,13
Iron,M,100,0,13,13
Isabelah,F,100,13,0,13
Isaiaha,M,100,0,13,13
Isse,M,100,0,13,13
Ittai,M,100,0,13,13
Itzuri,F,100,13,0,13
Ixzel,F,100,13,0,13
Izabelah,F,100,13,0,13
Izybella,F,100,13,0,13
Jabrina,F,100,13,0,13
Jabriyah,F,100,13,0,13
Jacianna,F,100,13,0,13
Jacop,M,100,0,13,13
Jacoy,M,100,0,13,13
Jadasha,F,100,13,0,13
Jaecee,F,100,13,0,13
Jahkira,F,100,13,0,13
Jahnique,F,100,13,0,13
Jairden,M,100,0,13,13
Jakema,F,100,13,0,13
Jalae,F,100,13,0,13
Jalexi,F,100,13,0,13
Jamaa,M,100,0,13,13
Jamaryon,M,100,0,13,13
Jameriya,F,100,13,0,13
Jamillette,F,100,13,0,13
Jamiroquan,M,100,0,13,13
Jamore,M,100,0,13,13
Janais,F,100,13,0,13
Janaisia,F,100,13,0,13
Janmarco,M,100,0,13,13
Janovia,F,100,13,0,13
Jaquandra,F,100,13,0,13
Jasarah,F,100,13,0,13
Jashiyah,F,100,13,0,13
Jaslenne,F,100,13,0,13
Javonie,M,100,0,13,13
Jayceyon,M,100,0,13,13
Jaycin,M,100,0,13,13
Jaysia,F,100,13,0,13
Jazahria,F,100,13,0,13
Jazalle,F,100,13,0,13
Jefren,M,100,0,13,13
Jelica,F,100,13,0,13
Jemarius,M,100,0,13,13
Jeneka,F,100,13,0,13
Jeniqua,F,100,13,0,13
Jenivieve,F,100,13,0,13
Jenneifer,F,100,13,0,13
Jerem,M,100,0,13,13
Jeremiaha,M,100,0,13,13
Jermiane,M,100,0,13,13
Jerrylee,M,100,0,13,13
Jihoon,M,100,0,13,13
Jissela,F,100,13,0,13
Jiuliana,F,100,13,0,13
Jizele,F,100,13,0,13
Jkari,M,100,0,13,13
Jkhari,M,100,0,13,13
Joakima,F,100,13,0,13
Jocques,M,100,0,13,13
Jodonna,F,100,13,0,13
Joemichael,M,100,0,13,13
Joequan,M,100,0,13,13
Joeray,M,100,0,13,13
Jojean,F,100,13,0,13
Joksan,M,100,0,13,13
Joryn,F,100,13,0,13
Joziel,M,100,0,13,13
Juandalynn,F,100,13,0,13
Juanramon,M,100,0,13,13
Judean,F,100,13,0,13
Justinkyle,M,100,0,13,13
Justinne,F,100,13,0,13
Jutin,M,100,0,13,13
Kaara,F,100,13,0,13
Kadira,F,100,13,0,13
Kaeshawn,M,100,0,13,13
Kaeveon,M,100,0,13,13
Kahliel,M,100,0,13,13
Kaleek,M,100,0,13,13
Kalex,M,100,0,13,13
Kalifornia,F,100,13,0,13
Kalimba,F,100,13,0,13
Kardyn,F,100,13,0,13
Karidee,F,100,13,0,13
Karlyne,F,100,13,0,13
Kartika,F,100,13,0,13
Kasea,F,100,13,0,13
Kassandr,F,100,13,0,13
Katinna,F,100,13,0,13
Katrielle,F,100,13,0,13
Kavis,M,100,0,13,13
Kavonta,M,100,0,13,13
Kayatana,F,100,13,0,13
Kaycin,M,100,0,13,13
Kaylis,F,100,13,0,13
Keaundria,F,100,13,0,13
Keben,M,100,0,13,13
Keeden,M,100,0,13,13
Keedyn,M,100,0,13,13
Keica,F,100,13,0,13
Kellsea,F,100,13,0,13
Kellyjean,F,100,13,0,13
Kemondre,M,100,0,13,13
Kendallynn,F,100,13,0,13
Kenedra,F,100,13,0,13
Kensen,M,100,0,13,13
Kenslea,F,100,13,0,13
Keshundra,F,100,13,0,13
Keyanta,F,100,13,0,13
Keyisha,F,100,13,0,13
Keymond,M,100,0,13,13
Keyvonte,M,100,0,13,13
Khade,M,100,0,13,13
Khadeidra,F,100,13,0,13
Khadeshia,F,100,13,0,13
Khamden,M,100,0,13,13
Khilen,M,100,0,13,13
Khonner,M,100,0,13,13
Kiisha,F,100,13,0,13
Kikyo,F,100,13,0,13
Kimarah,F,100,13,0,13
Kimario,M,100,0,13,13
Kioka,F,100,13,0,13
Kissiah,F,100,13,0,13
Kitzya,F,100,13,0,13
Knighton,M,100,0,13,13
Kobain,M,100,0,13,13
Kolade,M,100,0,13,13
Korday,M,100,0,13,13
Kreigh,M,100,0,13,13
Kreindy,F,100,13,0,13
Kyaw,M,100,0,13,13
Kyeem,M,100,0,13,13
Kyele,M,100,0,13,13
Kynnlee,F,100,13,0,13
Kyrsha,F,100,13,0,13
Lacreesha,F,100,13,0,13
Ladacia,F,100,13,0,13
Laderrica,F,100,13,0,13
Laiton,M,100,0,13,13
Lakee,F,54,7,6,13
Lakeeva,F,100,13,0,13
Lamarc,M,100,0,13,13
Lamariana,F,100,13,0,13
Lanieya,F,100,13,0,13
Laquavia,F,100,13,0,13
Larnce,M,100,0,13,13
Lassana,M,100,0,13,13
Latalya,F,100,13,0,13
Lateasa,F,100,13,0,13
Lateena,F,100,13,0,13
Latichia,F,100,13,0,13
Latosca,F,100,13,0,13
Leahla,F,100,13,0,13
Leaisha,F,100,13,0,13
Leamarie,F,100,13,0,13
Lehana,F,100,13,0,13
Lekenya,F,100,13,0,13
Lenola,F,100,13,0,13
Leviah,F,100,13,0,13
Leylanni,F,100,13,0,13
Lima,F,100,13,0,13
Lindajo,F,100,13,0,13
Linoy,F,100,13,0,13
Linux,M,100,0,13,13
Lizel,F,100,13,0,13
Lizy,F,100,13,0,13
Llulisa,F,100,13,0,13
Londie,F,100,13,0,13
Londonmarie,F,100,13,0,13
Lonzy,M,100,0,13,13
Loucas,M,100,0,13,13
Lovelace,M,100,0,13,13
Luchina,F,100,13,0,13
Luiggi,M,100,0,13,13
Luseane,F,100,13,0,13
Lusiana,F,100,13,0,13
Luzmary,F,100,13,0,13
Lyiah,F,100,13,0,13
Lynaya,F,100,13,0,13
Lynet,F,100,13,0,13
Lyricc,F,100,13,0,13
Lytle,M,100,0,13,13
Mabyn,F,100,13,0,13
Macilyn,F,100,13,0,13
Mackaylee,F,100,13,0,13
Madylen,F,100,13,0,13
Mahalakshmi,F,100,13,0,13
Mahkaylah,F,100,13,0,13
Makaii,M,100,0,13,13
Makiko,F,100,13,0,13
Makynley,F,100,13,0,13
Malakyi,M,100,0,13,13
Malanna,F,100,13,0,13
Maleta,F,100,13,0,13
Mami,F,100,13,0,13
Maquan,M,100,0,13,13
Marguitta,F,100,13,0,13
Mariene,F,100,13,0,13
Marillany,F,100,13,0,13
Marjae,F,100,13,0,13
Marnika,F,100,13,0,13
Maronica,F,100,13,0,13
Marquishia,F,100,13,0,13
Martynas,M,100,0,13,13
Masi,M,100,0,13,13
Mataia,F,100,13,0,13
Maurkice,M,100,0,13,13
Maxston,M,100,0,13,13
Maxtin,M,100,0,13,13
Maxym,M,100,0,13,13
Mearah,F,100,13,0,13
Mehjabeen,F,100,13,0,13
Melette,F,100,13,0,13
Menley,F,100,13,0,13
Meryah,F,100,13,0,13
Miari,F,100,13,0,13
Micailah,F,100,13,0,13
Michelly,F,100,13,0,13
Mickia,F,100,13,0,13
Mikha,M,100,0,13,13
Mikinzi,F,100,13,0,13
Mikolas,M,100,0,13,13
Mirac,M,100,0,13,13
Misel,F,100,13,0,13
Miyosha,F,100,13,0,13
Moneak,F,100,13,0,13
Monyea,F,100,13,0,13
Mordekai,M,100,0,13,13
Mukul,M,100,0,13,13
Murial,F,100,13,0,13
Myaa,F,100,13,0,13
Myliana,F,100,13,0,13
Mynia,F,100,13,0,13
Mynisha,F,100,13,0,13
Myrla,F,100,13,0,13
Myshayla,F,100,13,0,13
Nafeesha,F,100,13,0,13
Naguan,M,100,0,13,13
Nahki,M,100,0,13,13
Nahlani,F,100,13,0,13
Nahzier,M,100,0,13,13
Naily,F,100,13,0,13
Naiyla,F,100,13,0,13
Nanditha,F,100,13,0,13
Naquasha,F,100,13,0,13
Nashari,F,100,13,0,13
Natashi,F,100,13,0,13
Natham,M,100,0,13,13
Natlaie,F,100,13,0,13
Navee,F,100,13,0,13
Naviana,F,100,13,0,13
Nayele,F,100,13,0,13
Nayirah,F,100,13,0,13
Naylanie,F,100,13,0,13
Nayomee,F,100,13,0,13
Nazeem,M,100,0,13,13
Nehimiah,M,100,0,13,13
Nellia,F,100,13,0,13
Nesia,F,100,13,0,13
Nicosia,F,100,13,0,13
Nieasha,F,100,13,0,13
Nieisha,F,100,13,0,13
Nio,M,100,0,13,13
Niran,M,100,0,13,13
Niyelle,F,100,13,0,13
Noli,F,100,13,0,13
Norrie,F,100,13,0,13
Nurto,F,100,13,0,13
Nurul,F,100,13,0,13
Nyjeria,F,100,13,0,13
Nykeshia,F,100,13,0,13
Oaklan,M,100,0,13,13
Oakli,F,100,13,0,13
Olachi,F,100,13,0,13
Olivera,F,100,13,0,13
Omaury,M,100,0,13,13
Oney,M,100,0,13,13
Onisty,F,100,13,0,13
Ontarius,M,100,0,13,13
Osmund,M,100,0,13,13
Ottavia,F,100,13,0,13
Ottmar,M,100,0,13,13
Paikea,F,100,13,0,13
Paison,F,100,13,0,13
Pajtim,M,100,0,13,13
Pashia,F,100,13,0,13
Pataricia,F,100,13,0,13
Paten,M,100,0,13,13
Paulann,F,100,13,0,13
Payzli,F,100,13,0,13
Penisimani,M,100,0,13,13
Penley,F,100,13,0,13
Petal,F,100,13,0,13
Phinnaeus,M,100,0,13,13
Pierrie,M,100,0,13,13
Polli,F,100,13,0,13
Prezlee,F,100,13,0,13
Princetin,M,100,0,13,13
Pryncess,F,100,13,0,13
Qian,M,100,0,13,13
Quadrell,M,100,0,13,13
Quaylin,M,100,0,13,13
Quinston,M,100,0,13,13
Raeyonna,F,100,13,0,13
Rahja,M,54,6,7,13
Raihanna,F,100,13,0,13
Raines,M,100,0,13,13
Rakwan,M,100,0,13,13
Ramee,F,54,7,6,13
Ranarda,F,100,13,0,13
Raqwan,M,100,0,13,13
Rashaundra,F,100,13,0,13
Rasika,F,100,13,0,13
Ravene,F,100,13,0,13
Rayeann,F,100,13,0,13
Reatta,F,100,13,0,13
Redick,M,100,0,13,13
Regginae,F,100,13,0,13
Render,M,100,0,13,13
Revina,F,100,13,0,13
Reyona,F,100,13,0,13
Rianah,F,100,13,0,13
Ribaldo,M,100,0,13,13
Rinah,F,100,13,0,13
Riyanshi,F,100,13,0,13
Roberson,M,100,0,13,13
Robinique,F,100,13,0,13
Rocklynn,F,100,13,0,13
Rodrica,F,100,13,0,13
Rolayne,F,100,13,0,13
Romeshia,F,100,13,0,13
Ronisue,F,100,13,0,13
Roony,M,100,0,13,13
Roseli,F,100,13,0,13
Roshane,M,100,0,13,13
Roze,F,100,13,0,13
Rozilyn,F,100,13,0,13
Ryko,M,100,0,13,13
Ryze,M,100,0,13,13
Sabrah,F,100,13,0,13
Sajata,F,100,13,0,13
Sajda,F,100,13,0,13
Sakayla,F,100,13,0,13
Samanthaann,F,100,13,0,13
Samiyha,F,100,13,0,13
Sanaaya,F,100,13,0,13
Sanavi,F,100,13,0,13
Sarek,M,100,0,13,13
Saryniti,F,100,13,0,13
Satonia,F,100,13,0,13
Schantel,F,100,13,0,13
Scottland,M,100,0,13,13
Seantae,F,100,13,0,13
Sehej,F,62,8,5,13
Seleah,F,100,13,0,13
Seph,M,100,0,13,13
Serkan,M,100,0,13,13
Serrenity,F,100,13,0,13
Serriah,F,100,13,0,13
Shabaz,M,100,0,13,13
Shaelan,F,100,13,0,13
Shakendria,F,100,13,0,13
Shakitha,F,100,13,0,13
Shaleia,F,100,13,0,13
Shameen,F,100,13,0,13
Shannda,F,100,13,0,13
Shantasha,F,100,13,0,13
Shaquanah,F,100,13,0,13
Shaquann,M,100,0,13,13
Shaquenta,F,100,13,0,13
Shaqur,M,100,0,13,13
Sharneka,F,100,13,0,13
Sharnique,F,100,13,0,13
Shatoyia,F,100,13,0,13
Shawntasia,F,100,13,0,13
Shaydie,F,100,13,0,13
Sheene,F,100,13,0,13
Shenoah,F,100,13,0,13
Shevin,M,100,0,13,13
Shevone,F,100,13,0,13
Shieka,F,100,13,0,13
Shontasia,F,100,13,0,13
Shrena,F,100,13,0,13
Shyiem,M,100,0,13,13
Shykim,M,100,0,13,13
Sicely,F,100,13,0,13
Sidea,F,100,13,0,13
Sitha,F,62,8,5,13
Skilah,F,100,13,0,13
Skyden,M,100,0,13,13
Smaya,F,100,13,0,13
Snya,F,100,13,0,13
Sofiarose,F,100,13,0,13
Som,M,100,0,13,13
Sridhar,M,100,0,13,13
Srikanth,M,100,0,13,13
Stellamae,F,100,13,0,13
Summerlee,F,100,13,0,13
Suz,F,100,13,0,13
Swannie,F,100,13,0,13
Sylia,F,100,13,0,13
Sylvio,M,100,0,13,13
Symirah,F,100,13,0,13
Synceer,M,100,0,13,13
Syreena,F,100,13,0,13
Syreniti,F,100,13,0,13
Taasia,F,100,13,0,13
Taelen,M,100,0,13,13
Talayjah,F,100,13,0,13
Tameiko,F,100,13,0,13
Tamita,F,100,13,0,13
Taniylah,F,100,13,0,13
Tashanae,F,100,13,0,13
Tazio,M,100,0,13,13
Tejus,M,100,0,13,13
Temar,M,100,0,13,13
Temre,F,100,13,0,13
Tenlie,F,100,13,0,13
Tennielle,F,100,13,0,13
Terasha,F,100,13,0,13
Terdell,M,100,0,13,13
Tesheena,F,100,13,0,13
Tessanne,F,100,13,0,13
Teysha,F,100,13,0,13
Thalina,F,100,13,0,13
Thandie,F,100,13,0,13
Thyago,M,100,0,13,13
Tianda,F,100,13,0,13
Till,M,100,0,13,13
Timofei,M,100,0,13,13
Tisean,M,100,0,13,13
Tishonda,F,100,13,0,13
Titeanna,F,100,13,0,13
Tobechi,M,100,0,13,13
Torr,M,100,0,13,13
Tradell,M,100,0,13,13
Traesyn,M,100,0,13,13
Traneshia,F,100,13,0,13
Traydon,M,100,0,13,13
Trayshon,M,100,0,13,13
Trejure,F,100,13,0,13
Trenedy,F,100,13,0,13
Treyor,M,100,0,13,13
Trezden,M,100,0,13,13
Trinety,F,100,13,0,13
Trinisa,F,100,13,0,13
Truce,M,100,0,13,13
Turiya,F,100,13,0,13
Twaina,F,100,13,0,13
Tyissha,F,100,13,0,13
Tyley,F,100,13,0,13
Tyven,M,100,0,13,13
Umme,F,100,13,0,13
Valentyna,F,100,13,0,13
Vanaya,F,100,13,0,13
Vanester,F,100,13,0,13
Vareck,M,100,0,13,13
Vasilike,F,100,13,0,13
Vasthi,F,100,13,0,13
Vel,F,100,13,0,13
Velerie,F,100,13,0,13
Verbon,M,100,0,13,13
Vereniz,F,100,13,0,13
Vhonda,F,100,13,0,13
Vianeth,F,100,13,0,13
Viani,F,100,13,0,13
Vidale,M,100,0,13,13
Videll,M,100,0,13,13
Vinci,M,62,5,8,13
Vinzent,M,100,0,13,13
Waldron,M,100,0,13,13
Wick,M,100,0,13,13
Wilmont,M,100,0,13,13
Wina,F,100,13,0,13
Wylma,F,100,13,0,13
Xadyn,M,100,0,13,13
Xanti,M,100,0,13,13
Yaaseen,M,100,0,13,13
Yahilin,F,100,13,0,13
Yanderi,F,100,13,0,13
Yanela,F,100,13,0,13
Yannel,F,100,13,0,13
Yannik,M,100,0,13,13
Yarelys,F,100,13,0,13
Yaricsa,F,100,13,0,13
Yarilis,F,100,13,0,13
Yasari,F,100,13,0,13
Yazuri,F,100,13,0,13
Yin,F,100,13,0,13
Yira,F,100,13,0,13
Yolany,F,100,13,0,13
Yoruba,F,100,13,0,13
Yoselyne,F,100,13,0,13
Yuika,F,100,13,0,13
Yuria,F,100,13,0,13
Yuvraaj,M,100,0,13,13
Zaakira,F,100,13,0,13
Zaelah,F,100,13,0,13
Zaier,M,100,0,13,13
Zairia,F,100,13,0,13
Zakylah,F,100,13,0,13
Zamarie,F,62,8,5,13
Zaykeese,M,100,0,13,13
Zaysha,F,100,13,0,13
Zephyrus,M,100,0,13,13
Zeyd,M,100,0,13,13
Ziane,F,100,13,0,13
Zimbalist,M,100,0,13,13
Ziraili,F,100,13,0,13
Zohan,M,100,0,13,13
Zolah,F,100,13,0,13
Zuleyca,F,100,13,0,13
Zyheem,M,100,0,13,13
Zyiana,F,100,13,0,13
Zykayla,F,100,13,0,13
Zyleah,F,100,13,0,13
Zylia,F,100,13,0,13
Zymaria,F,100,13,0,13
Zyrie,F,100,13,0,13
Aadhi,M,100,0,12,12
Aahaan,M,100,0,12,12
Aaliha,F,100,12,0,12
Aaliyahrose,F,100,12,0,12
Aashiyana,F,100,12,0,12
Aavi,M,100,0,12,12
Abbilyn,F,100,12,0,12
Abbot,M,100,0,12,12
Abdirisaq,M,100,0,12,12
Abian,M,100,0,12,12
Abiezer,M,100,0,12,12
Abiram,M,100,0,12,12
Abryella,F,100,12,0,12
Adaliene,F,100,12,0,12
Adamae,F,100,12,0,12
Adedoyin,F,100,12,0,12
Adelinn,F,100,12,0,12
Adenn,M,100,0,12,12
Adetayo,M,100,0,12,12
Adhitya,M,100,0,12,12
Adithri,F,100,12,0,12
Adner,M,100,0,12,12
Aelita,F,100,12,0,12
Aeryana,F,100,12,0,12
Aesop,M,100,0,12,12
Ahlayna,F,100,12,0,12
Ahmara,F,100,12,0,12
Ahmik,M,100,0,12,12
Ahmyiah,F,100,12,0,12
Ahnalee,F,100,12,0,12
Ahniah,F,100,12,0,12
Ahsia,F,100,12,0,12
Ahva,F,100,12,0,12
Ahziyah,F,100,12,0,12
Aidalyn,F,100,12,0,12
Aidelis,F,100,12,0,12
Ailina,F,100,12,0,12
Ailisa,F,100,12,0,12
Aimara,F,100,12,0,12
Aionna,F,100,12,0,12
Aiylah,F,100,12,0,12
Ajanea,F,100,12,0,12
Ajavian,M,100,0,12,12
Ajea,F,100,12,0,12
Akaiyah,F,100,12,0,12
Alaris,F,100,12,0,12
Alayana,F,100,12,0,12
Albieri,M,100,0,12,12
Aleara,F,100,12,0,12
Aleczandria,F,100,12,0,12
Alesea,F,100,12,0,12
Alexiyana,F,100,12,0,12
Aliciamarie,F,100,12,0,12
Alician,F,100,12,0,12
Alivianna,F,100,12,0,12
Alleana,F,100,12,0,12
Allexander,M,100,0,12,12
Alliemae,F,100,12,0,12
Altamease,F,100,12,0,12
Alterick,M,100,0,12,12
Althena,F,100,12,0,12
Altonia,M,58,5,7,12
Alveiro,M,100,0,12,12
Alvertis,M,100,0,12,12
Alyrah,F,100,12,0,12
Alysianna,F,100,12,0,12
Alyzia,F,100,12,0,12
Alzora,F,100,12,0,12
Amandarae,F,100,12,0,12
Amareion,M,100,0,12,12
Amarieon,M,100,0,12,12
Amaryon,M,100,0,12,12
Amillianna,F,100,12,0,12
Amirali,M,100,0,12,12
Amirjon,M,100,0,12,12
Amitabh,M,100,0,12,12
Ammad,M,100,0,12,12
Ammber,F,100,12,0,12
Amyann,F,100,12,0,12
Amylyn,F,100,12,0,12
Anabeatriz,F,100,12,0,12
Anaelisa,F,100,12,0,12
Anahya,F,100,12,0,12
Anaila,F,100,12,0,12
Analeiah,F,100,12,0,12
Anariyah,F,100,12,0,12
Anasol,F,100,12,0,12
Anastaja,F,100,12,0,12
Anavae,F,100,12,0,12
Andel,M,100,0,12,12
Andes,M,100,0,12,12
Andrenique,F,100,12,0,12
Andrewjacob,M,100,0,12,12
Aneea,F,100,12,0,12
Angeliese,F,100,12,0,12
Angelmiguel,M,100,0,12,12
Angelysse,F,100,12,0,12
Anhuar,M,100,0,12,12
Anjolee,F,100,12,0,12
Annabele,F,100,12,0,12
Annibella,F,100,12,0,12
Annmary,F,100,12,0,12
Anrea,F,100,12,0,12
Antroine,M,100,0,12,12
Antwana,M,58,5,7,12
Antwanne,M,100,0,12,12
Aprillynn,F,100,12,0,12
Aqila,F,100,12,0,12
Arcel,M,100,0,12,12
Archan,M,100,0,12,12
Ardiana,F,100,12,0,12
Areille,F,100,12,0,12
Arelle,F,100,12,0,12
Arianys,F,100,12,0,12
Ariarose,F,100,12,0,12
Arisai,F,100,12,0,12
Aritzi,F,100,12,0,12
Arkeria,F,100,12,0,12
Arlandis,M,100,0,12,12
Arlandria,F,100,12,0,12
Arlow,M,100,0,12,12
Arniya,F,100,12,0,12
Arowyn,F,100,12,0,12
Arrieanna,F,100,12,0,12
Arthena,F,100,12,0,12
Arthenia,F,100,12,0,12
Arvester,M,100,0,12,12
Aryaveer,M,100,0,12,12
Aryen,M,100,0,12,12
Aryion,M,100,0,12,12
Asahi,M,100,0,12,12
Asai,M,100,0,12,12
Asleigh,F,100,12,0,12
Athel,M,100,0,12,12
Atta,M,100,0,12,12
Aubriela,F,100,12,0,12
Audey,M,100,0,12,12
Audreya,F,100,12,0,12
Auner,M,100,0,12,12
Auralee,F,100,12,0,12
Auryanna,F,100,12,0,12
Autumnn,F,100,12,0,12
Aviad,M,100,0,12,12
Avva,F,100,12,0,12
Ayeshah,F,100,12,0,12
Ayrin,F,100,12,0,12
Ayrion,F,50,6,6,12
Ayverie,F,100,12,0,12
Azaylee,F,100,12,0,12
Azelle,F,100,12,0,12
Azilee,F,100,12,0,12
Azmariah,F,100,12,0,12
Azmi,M,100,0,12,12
Azurdee,F,100,12,0,12
Babbi,F,100,12,0,12
Baggio,M,100,0,12,12
Baisha,F,100,12,0,12
Baize,M,100,0,12,12
Bara,M,100,0,12,12
Belgica,F,100,12,0,12
Bellami,F,100,12,0,12
Benette,F,100,12,0,12
Beonica,F,100,12,0,12
Bielka,F,100,12,0,12
Bige,M,100,0,12,12
Birl,M,100,0,12,12
Birt,M,100,0,12,12
Bisher,M,100,0,12,12
Blaydin,M,100,0,12,12
Blesson,M,100,0,12,12
Bonda,F,100,12,0,12
Boyde,M,100,0,12,12
Breighlyn,F,100,12,0,12
Brennley,F,100,12,0,12
Brezlynn,F,100,12,0,12
Briajah,F,100,12,0,12
Brilliant,M,100,0,12,12
Brittiani,F,100,12,0,12
Brodix,M,100,0,12,12
Brttany,F,100,12,0,12
Bryndal,F,100,12,0,12
Brystle,F,100,12,0,12
Byard,M,100,0,12,12
Cadeidra,F,100,12,0,12
Cademon,M,100,0,12,12
Caiah,F,100,12,0,12
Calebe,M,100,0,12,12
Calev,M,100,0,12,12
Calsey,F,100,12,0,12
Camalla,F,100,12,0,12
Camlyn,F,100,12,0,12
Canek,M,100,0,12,12
Caniah,F,100,12,0,12
Canita,F,100,12,0,12
Caprial,F,100,12,0,12
Cardier,M,100,0,12,12
Cardyn,F,100,12,0,12
Cariel,F,100,12,0,12
Carilynn,F,100,12,0,12
Carleon,M,100,0,12,12
Carlianne,F,100,12,0,12
Carlosantonio,M,100,0,12,12
Carlose,M,100,0,12,12
Carmelitta,F,100,12,0,12
Carolinda,F,100,12,0,12
Caroljean,F,100,12,0,12
Carriana,F,100,12,0,12
Caselynn,F,100,12,0,12
Caseton,M,100,0,12,12
Casiana,F,100,12,0,12
Castella,F,100,12,0,12
Catalya,F,100,12,0,12
Caylani,F,100,12,0,12
Cayn,M,100,0,12,12
Cayvion,M,100,0,12,12
Ceandra,F,100,12,0,12
Cedrice,M,100,0,12,12
Celestte,F,100,12,0,12
Celiyah,F,100,12,0,12
Cemiyah,F,100,12,0,12
Cervantes,M,100,0,12,12
Cesalie,F,100,12,0,12
Cesarina,F,100,12,0,12
Cesear,M,100,0,12,12
Chanille,F,100,12,0,12
Channan,F,100,12,0,12
Chaqueta,F,100,12,0,12
Charith,M,100,0,12,12
Charol,F,100,12,0,12
Charu,F,100,12,0,12
Chasmin,F,100,12,0,12
Chelia,F,100,12,0,12
Chelseay,F,100,12,0,12
Cherline,F,100,12,0,12
Cherrye,F,100,12,0,12
Chieko,F,100,12,0,12
Chikaima,F,100,12,0,12
Chikara,F,100,12,0,12
Chiquta,F,100,12,0,12
Chirs,M,100,0,12,12
Chrisalyn,F,100,12,0,12
Chrishae,F,100,12,0,12
Chrishonna,F,100,12,0,12
Christiananthon,M,100,0,12,12
Chrysanne,F,100,12,0,12
Chrystelle,F,100,12,0,12
Chukwubuikem,M,100,0,12,12
Chylah,F,100,12,0,12
Cicel,M,100,0,12,12
Cohyn,M,100,0,12,12
Coleden,M,100,0,12,12
Coleridge,M,100,0,12,12
Colesyn,M,100,0,12,12
Coletyn,M,100,0,12,12
Condola,F,100,12,0,12
Conie,F,100,12,0,12
Contance,F,100,12,0,12
Copelin,M,100,0,12,12
Cordarian,M,100,0,12,12
Coreyanna,F,100,12,0,12
Corlin,M,100,0,12,12
Cornellia,F,100,12,0,12
Corniyah,F,100,12,0,12
Cortaz,M,100,0,12,12
Coryion,M,100,0,12,12
Creedance,F,58,7,5,12
Cristalina,F,100,12,0,12
Crol,F,100,12,0,12
Cyarah,F,100,12,0,12
Cylin,M,100,0,12,12
Cymphonique,F,100,12,0,12
Cynequa,F,100,12,0,12
Daelani,F,100,12,0,12
Daemen,M,100,0,12,12
Dagne,F,100,12,0,12
Dah,M,58,5,7,12
Dahnya,F,100,12,0,12
Daijana,F,100,12,0,12
Daijsha,F,100,12,0,12
Dajea,F,100,12,0,12
Dajona,F,100,12,0,12
Dajun,M,100,0,12,12
Dakara,F,100,12,0,12
Dakayden,M,100,0,12,12
Dalvyn,M,100,0,12,12
Dalziel,M,100,0,12,12
Damariona,F,100,12,0,12
Damaurion,M,100,0,12,12
Danait,F,100,12,0,12
Danela,F,100,12,0,12
Danesh,M,100,0,12,12
Danicah,F,100,12,0,12
Danieljohn,M,100,0,12,12
Danillie,F,100,12,0,12
Dannaly,F,100,12,0,12
Danyail,F,100,12,0,12
Danytza,F,100,12,0,12
Daraly,F,100,12,0,12
Darilynn,F,100,12,0,12
Darquez,M,100,0,12,12
Darquis,M,100,0,12,12
Darreck,M,100,0,12,12
Darsie,F,100,12,0,12
Dasen,M,100,0,12,12
Dashya,F,100,12,0,12
Datavia,F,100,12,0,12
Davanie,F,100,12,0,12
Davany,F,100,12,0,12
Davar,M,100,0,12,12
Davenia,F,100,12,0,12
Dawin,M,100,0,12,12
Dawnae,F,100,12,0,12
Dawnee,F,100,12,0,12
Dawyn,F,100,12,0,12
Daygan,M,100,0,12,12
Daynna,F,100,12,0,12
Dayren,M,100,0,12,12
Dazhanae,F,100,12,0,12
Deaija,F,100,12,0,12
Deajha,F,100,12,0,12
Deandrick,M,100,0,12,12
Deangelio,M,100,0,12,12
Dearron,M,100,0,12,12
Deayra,F,100,12,0,12
Debanhy,F,100,12,0,12
Decatur,M,100,0,12,12
Deedgra,F,100,12,0,12
Deedrick,M,100,0,12,12
Deems,M,100,0,12,12
Deeneen,F,100,12,0,12
Deepthi,F,100,12,0,12
Deguan,M,100,0,12,12
Dehja,F,100,12,0,12
Dejuante,M,100,0,12,12
Dekyla,F,100,12,0,12
Deleen,F,100,12,0,12
Delexus,F,100,12,0,12
Delmonica,F,100,12,0,12
Deloren,M,100,0,12,12
Deloyce,F,100,12,0,12
Demeir,M,100,0,12,12
Demelza,F,100,12,0,12
Demeteria,F,100,12,0,12
Demethra,F,100,12,0,12
Demeturis,M,100,0,12,12
Demorea,M,100,0,12,12
Deniene,F,100,12,0,12
Denotra,F,100,12,0,12
Densil,M,100,0,12,12
Dequanna,F,100,12,0,12
Dequantae,M,100,0,12,12
Derena,F,100,12,0,12
Deriel,M,100,0,12,12
Desai,M,100,0,12,12
Deshawnte,M,100,0,12,12
Desiya,F,100,12,0,12
Destyny,F,100,12,0,12
Detrina,F,100,12,0,12
Devam,M,100,0,12,12
Devaya,F,100,12,0,12
Devendra,M,100,0,12,12
Devente,M,100,0,12,12
Devontia,M,100,0,12,12
Dhane,M,100,0,12,12
Dharmik,M,100,0,12,12
Dharti,F,100,12,0,12
Dhatri,F,100,12,0,12
Diavione,F,100,12,0,12
Dimesha,F,100,12,0,12
Dinasty,F,100,12,0,12
Dishan,M,100,0,12,12
Divija,F,100,12,0,12
Divyansh,M,100,0,12,12
Diyala,F,100,12,0,12
Diyora,F,100,12,0,12
Djuanna,F,100,12,0,12
Dkhari,M,100,0,12,12
Domina,F,100,12,0,12
Dominicc,M,100,0,12,12
Doninic,M,100,0,12,12
Donvan,M,100,0,12,12
Doraly,F,100,12,0,12
Dorese,F,100,12,0,12
Dorienne,F,100,12,0,12
Dovonte,M,100,0,12,12
Durriyah,F,100,12,0,12
Dusean,M,100,0,12,12
Dushan,M,100,0,12,12
Dvyne,F,100,12,0,12
Dyer,M,100,0,12,12
Dylahn,M,100,0,12,12
Dywana,F,100,12,0,12
Dzire,F,100,12,0,12
Ealyn,F,100,12,0,12
Ebay,M,100,0,12,12
Edelle,F,100,12,0,12
Edwana,F,100,12,0,12
Efstratios,M,100,0,12,12
Eftihia,F,100,12,0,12
Eisele,F,100,12,0,12
Eker,M,100,0,12,12
Elaia,F,100,12,0,12
Eleta,F,100,12,0,12
Elilah,F,100,12,0,12
Elite,M,100,0,12,12
Ellani,F,100,12,0,12
Ellender,F,100,12,0,12
Eller,F,100,12,0,12
Ellye,F,100,12,0,12
Elsah,F,100,12,0,12
Elvedin,M,100,0,12,12
Elziabeth,F,100,12,0,12
Emalise,F,100,12,0,12
Emar,M,100,0,12,12
Emerlee,F,100,12,0,12
Emilyah,F,100,12,0,12
Emilyne,F,100,12,0,12
En,M,100,0,12,12
Enderson,M,100,0,12,12
Endesha,F,100,12,0,12
Enny,F,100,12,0,12
Enosh,M,100,0,12,12
Enri,M,100,0,12,12
Eremy,M,100,0,12,12
Erikk,M,100,0,12,12
Erix,M,100,0,12,12
Ermine,F,58,7,5,12
Ernad,M,100,0,12,12
Ersel,M,100,0,12,12
Eseta,F,100,12,0,12
Estafania,F,100,12,0,12
Estus,M,100,0,12,12
Eterniti,F,100,12,0,12
Etter,F,100,12,0,12
Evangel,M,100,0,12,12
Evante,M,100,0,12,12
Evelyse,F,100,12,0,12
Evion,M,100,0,12,12
Evonnie,F,100,12,0,12
Evvy,F,100,12,0,12
Eyvone,F,100,12,0,12
Ezekeial,M,100,0,12,12
Ezion,M,100,0,12,12
Faheemah,F,100,12,0,12
Falando,M,100,0,12,12
Fana,F,100,12,0,12
Fanessa,F,100,12,0,12
Farbod,M,100,0,12,12
Fariah,F,100,12,0,12
Fariba,F,100,12,0,12
Farzona,F,100,12,0,12
Fatu,F,100,12,0,12
Faylin,F,100,12,0,12
Feben,F,100,12,0,12
Fenisha,F,100,12,0,12
Ferdy,M,100,0,12,12
Feyza,F,100,12,0,12
Filsan,F,100,12,0,12
Flemon,M,100,0,12,12
Floyce,F,100,12,0,12
Fotima,F,100,12,0,12
Franchette,F,100,12,0,12
Ganessa,F,100,12,0,12
Garbrielle,F,100,12,0,12
Gariella,F,100,12,0,12
Garylee,M,100,0,12,12
Garyon,M,100,0,12,12
Gattlin,M,100,0,12,12
Gaudalupe,F,100,12,0,12
Gearlean,F,100,12,0,12
Geffen,M,100,0,12,12
Genivieve,F,100,12,0,12
Germane,M,100,0,12,12
Germar,M,100,0,12,12
Gerzon,M,100,0,12,12
Gevan,M,100,0,12,12
Ghabriel,M,100,0,12,12
Ghala,F,100,12,0,12
Ghana,F,100,12,0,12
Gicell,F,100,12,0,12
Ginelie,F,100,12,0,12
Gislaine,F,100,12,0,12
Gladimir,M,100,0,12,12
Glendalis,F,100,12,0,12
Glendalys,F,100,12,0,12
Glendel,M,100,0,12,12
Gniya,F,100,12,0,12
Golan,M,100,0,12,12
Graceleigh,F,100,12,0,12
Graciee,F,100,12,0,12
Grasen,M,100,0,12,12
Great,M,100,0,12,12
Greyling,M,100,0,12,12
Greysun,M,100,0,12,12
Grimm,M,100,0,12,12
Gryffen,M,100,0,12,12
Guendi,F,100,12,0,12
Guerrero,M,100,0,12,12
Guiliano,M,100,0,12,12
Gwynith,F,100,12,0,12
Gysel,F,100,12,0,12
Hadrien,M,100,0,12,12
Hafeeza,F,100,12,0,12
Hanzo,M,100,0,12,12
Haram,F,58,7,5,12
Harrisen,M,100,0,12,12
Hassam,M,100,0,12,12
Hassanah,F,100,12,0,12
Hastings,M,58,5,7,12
Havok,M,100,0,12,12
Hayleah,F,100,12,0,12
Hazal,F,100,12,0,12
Heatherlee,F,100,12,0,12
Helix,M,100,0,12,12
Henreitta,F,100,12,0,12
Hersch,M,100,0,12,12
Hervie,M,100,0,12,12
Heymi,F,100,12,0,12
Hiede,F,100,12,0,12
Hindel,F,100,12,0,12
Huldah,F,100,12,0,12
Hyleigh,F,100,12,0,12
Idona,F,100,12,0,12
Ijanay,F,100,12,0,12
Ikeer,M,100,0,12,12
Iksha,F,100,12,0,12
Ilanah,F,100,12,0,12
Ilhaan,F,100,12,0,12
Ilianah,F,100,12,0,12
Inacio,M,100,0,12,12
Iosua,M,100,0,12,12
Irwing,M,100,0,12,12
Ishanti,F,100,12,0,12
Itasha,F,100,12,0,12
Ivyon,M,100,0,12,12
Ixchell,F,100,12,0,12
Izayha,M,100,0,12,12
Izna,F,100,12,0,12
Jaanna,F,100,12,0,12
Jabrail,M,100,0,12,12
Jacent,M,100,0,12,12
Jacir,M,100,0,12,12
Jacquesha,F,100,12,0,12
Jaderrick,M,100,0,12,12
Jaeron,M,100,0,12,12
Jahaziah,M,100,0,12,12
Jahim,M,100,0,12,12
Jahnel,F,100,12,0,12
Jaidelyn,F,100,12,0,12
Jaileene,F,100,12,0,12
Jakalen,M,100,0,12,12
Jakaylon,M,100,0,12,12
Jakeshia,F,100,12,0,12
Jakierra,F,100,12,0,12
Jakkar,M,100,0,12,12
Jaleria,F,100,12,0,12
Jalill,M,100,0,12,12
Jamarrio,M,100,0,12,12
Jamarya,F,100,12,0,12
Jamequa,F,100,12,0,12
Jamms,M,100,0,12,12
Janahla,F,100,12,0,12
Janayra,F,100,12,0,12
Janelisse,F,100,12,0,12
Janenne,F,100,12,0,12
Janess,F,100,12,0,12
Janieka,F,100,12,0,12
Janieliz,F,100,12,0,12
Janier,M,100,0,12,12
Janiese,F,100,12,0,12
Jankarlo,M,100,0,12,12
Jannik,M,100,0,12,12
Jansiel,M,100,0,12,12
Janzel,M,100,0,12,12
Jaqualen,M,100,0,12,12
Jaqualla,F,100,12,0,12
Jaquelline,F,100,12,0,12
Jaqueria,F,100,12,0,12
Jardin,F,58,7,5,12
Jariell,M,100,0,12,12
Jarma,F,100,12,0,12
Jartavius,M,100,0,12,12
Jarvius,M,100,0,12,12
Jasalin,F,100,12,0,12
Jasilynn,F,100,12,0,12
Jasimen,F,100,12,0,12
Jasirah,F,100,12,0,12
Jaso,M,100,0,12,12
Javarrion,M,100,0,12,12
Javean,M,100,0,12,12
Jaxstin,M,100,0,12,12
Jaydean,M,100,0,12,12
Jaydelin,F,100,12,0,12
Jaydeliz,F,100,12,0,12
Jaylany,F,100,12,0,12
Jaymani,M,100,0,12,12
Jayre,F,100,12,0,12
Jayzin,M,100,0,12,12
Jazib,M,100,0,12,12
Jazilynn,F,100,12,0,12
Jazmun,F,100,12,0,12
Jeanluke,M,100,0,12,12
Jedadia,M,100,0,12,12
Jedarius,M,100,0,12,12
Jeese,M,100,0,12,12
Jeilynn,F,100,12,0,12
Jeiza,F,100,12,0,12
Jekobe,M,100,0,12,12
Jelana,F,100,12,0,12
Jeloni,M,100,0,12,12
Jelyn,F,100,12,0,12
Jemir,M,100,0,12,12
Jenal,F,100,12,0,12
Jeneanne,F,100,12,0,12
Jeneya,F,100,12,0,12
Jenneh,F,100,12,0,12
Jennylyn,F,100,12,0,12
Jephthe,M,100,0,12,12
Jeramaine,M,100,0,12,12
Jerez,M,100,0,12,12
Jericko,M,100,0,12,12
Jerlin,F,100,12,0,12
Jermil,M,100,0,12,12
Jermyia,F,100,12,0,12
Jerniah,F,100,12,0,12
Jerrame,M,100,0,12,12
Jersy,F,100,12,0,12
Jervontae,M,100,0,12,12
Jesiyah,M,100,0,12,12
Jesmin,F,100,12,0,12
Jessena,F,100,12,0,12
Jeycob,M,100,0,12,12
Jhasmine,F,100,12,0,12
Jhayce,M,100,0,12,12
Jhaziel,M,100,0,12,12
Jhet,M,100,0,12,12
Jhoseph,M,100,0,12,12
Jhosmar,M,100,0,12,12
Jhournee,F,100,12,0,12
Jiahao,M,100,0,12,12
Jiarui,M,100,0,12,12
Jillia,F,100,12,0,12
Jillynn,F,100,12,0,12
Jimme,M,100,0,12,12
Jimmesha,F,100,12,0,12
Jimson,M,100,0,12,12
Jivon,M,100,0,12,12
Jiyan,M,100,0,12,12
Jmia,F,100,12,0,12
Jocquez,M,100,0,12,12
Jodina,F,100,12,0,12
Joela,F,100,12,0,12
Joemy,F,100,12,0,12
Joerell,M,100,0,12,12
Joharis,F,100,12,0,12
Johnatho,M,100,0,12,12
Jolien,F,100,12,0,12
Jonahan,M,100,0,12,12
Jonibek,M,100,0,12,12
Jonquavious,M,100,0,12,12
Jontre,M,100,0,12,12
Josejr,M,100,0,12,12
Josephy,M,100,0,12,12
Joshuapaul,M,100,0,12,12
Joshya,M,100,0,12,12
Josiha,M,100,0,12,12
Jovar,M,100,0,12,12
Jozlynne,F,100,12,0,12
Jru,M,100,0,12,12
Juanmarcos,M,100,0,12,12
Juanmartin,M,100,0,12,12
Juba,M,100,0,12,12
Juliaanne,F,100,12,0,12
Jurian,M,100,0,12,12
Jurlene,F,100,12,0,12
Jyheem,M,100,0,12,12
Jyler,M,100,0,12,12
Jyniah,F,100,12,0,12
Kaalyn,F,100,12,0,12
Kaashif,M,100,0,12,12
Kadedria,F,100,12,0,12
Kadejha,F,100,12,0,12
Kadenn,M,100,0,12,12
Kadriana,F,100,12,0,12
Kaella,F,100,12,0,12
Kahden,M,100,0,12,12
Kailayah,F,100,12,0,12
Kaimipono,M,100,0,12,12
Kaitryn,F,100,12,0,12
Kajus,M,100,0,12,12
Kalandria,F,100,12,0,12
Kaleta,F,100,12,0,12
Kaliea,F,100,12,0,12
Kalu,M,100,0,12,12
Kamaehu,M,100,0,12,12
Kamayia,F,100,12,0,12
Kambreigh,F,100,12,0,12
Kamdynn,F,100,12,0,12
Kamielle,F,100,12,0,12
Kaniece,F,100,12,0,12
Kany,F,100,12,0,12
Kanysha,F,100,12,0,12
Kapone,M,100,0,12,12
Kaptain,M,100,0,12,12
Karagen,F,100,12,0,12
Karenza,F,100,12,0,12
Kashen,M,100,0,12,12
Kasib,M,100,0,12,12
Katalynna,F,100,12,0,12
Katashia,F,100,12,0,12
Kathina,F,100,12,0,12
Kathlin,F,100,12,0,12
Katriena,F,100,12,0,12
Katylynn,F,100,12,0,12
Kavante,M,100,0,12,12
Kavaris,M,100,0,12,12
Kavona,F,100,12,0,12
Kayge,M,100,0,12,12
Kayleejo,F,100,12,0,12
Kayleemarie,F,100,12,0,12
Kayzia,F,100,12,0,12
Kealeigh,F,100,12,0,12
Kedryn,M,100,0,12,12
Kedzie,F,100,12,0,12
Keecha,F,100,12,0,12
Keidon,M,100,0,12,12
Keighla,F,100,12,0,12
Keileb,M,100,0,12,12
Keing,M,100,0,12,12
Keishonna,F,100,12,0,12
Kekeli,F,100,12,0,12
Kelvisha,F,100,12,0,12
Kemmy,M,100,0,12,12
Kenberly,F,100,12,0,12
Kendee,F,100,12,0,12
Kendraya,F,100,12,0,12
Kenechi,M,100,0,12,12
Kenija,F,100,12,0,12
Kenndrick,M,100,0,12,12
Kenne,M,100,0,12,12
Kennlee,F,100,12,0,12
Kentay,M,100,0,12,12
Kentrall,M,100,0,12,12
Keontez,M,100,0,12,12
Kermina,F,100,12,0,12
Keshyra,F,100,12,0,12
Kevine,M,100,0,12,12
Keyarie,F,100,12,0,12
Keyhla,F,100,12,0,12
Keylli,F,100,12,0,12
Keyrra,F,100,12,0,12
Khailen,M,100,0,12,12
Khalei,M,58,5,7,12
Kharlee,F,100,12,0,12
Kharson,M,100,0,12,12
Khasim,M,100,0,12,12
Khayriyyah,F,100,12,0,12
Khiri,M,100,0,12,12
Khrystin,F,100,12,0,12
Kiai,M,100,0,12,12
Kiamani,F,100,12,0,12
Kicia,F,100,12,0,12
Kidd,M,100,0,12,12
Kief,M,100,0,12,12
Kingelijah,M,100,0,12,12
Kinita,F,100,12,0,12
Kiptin,M,100,0,12,12
Kiro,M,100,0,12,12
Kiyasha,F,100,12,0,12
Knisha,F,100,12,0,12
Kobina,M,100,0,12,12
Koebe,M,100,0,12,12
Korla,F,100,12,0,12
Krik,M,100,0,12,12
Krimsyn,F,100,12,0,12
Krystallynn,F,100,12,0,12
Kt,F,100,12,0,12
Kulia,F,100,12,0,12
Kurry,M,100,0,12,12
Kyja,F,100,12,0,12
Kyralee,F,100,12,0,12
Kyrei,M,100,0,12,12
Lacarla,F,100,12,0,12
Lachasity,F,100,12,0,12
Lacreta,F,100,12,0,12
Lacrissa,F,100,12,0,12
Ladaesha,F,100,12,0,12
Ladarrien,M,100,0,12,12
Ladarrin,M,100,0,12,12
Laderion,M,100,0,12,12
Laderious,M,100,0,12,12
Lagail,F,100,12,0,12
Laiklynn,F,100,12,0,12
Lailene,F,100,12,0,12
Laissa,F,100,12,0,12
Lajerrica,F,100,12,0,12
Lakosha,F,100,12,0,12
Lanequia,F,100,12,0,12
Lanica,F,100,12,0,12
Laquante,M,100,0,12,12
Laquavis,M,100,0,12,12
Laquieta,F,100,12,0,12
Larcenia,F,100,12,0,12
Larke,F,100,12,0,12
Laronte,M,100,0,12,12
Lashandria,F,100,12,0,12
Lashaunti,F,100,12,0,12
Lastat,M,100,0,12,12
Laterrion,M,100,0,12,12
Lationa,F,100,12,0,12
Latova,F,100,12,0,12
Latreisha,F,100,12,0,12
Lauralai,F,100,12,0,12
Lavail,M,100,0,12,12
Lavoria,F,100,12,0,12
Lawander,F,100,12,0,12
Lay,F,58,7,5,12
Laylan,F,58,7,5,12
Layoya,F,100,12,0,12
Laytonya,F,100,12,0,12
Lazarick,M,100,0,12,12
Lealan,M,100,0,12,12
Leangelo,M,100,0,12,12
Leeandrea,F,100,12,0,12
Lehuanani,F,100,12,0,12
Leiasia,F,100,12,0,12
Leigham,M,100,0,12,12
Leilla,F,100,12,0,12
Lenci,F,100,12,0,12
Lenorah,F,100,12,0,12
Leonah,F,100,12,0,12
Levenia,F,100,12,0,12
Leyni,F,100,12,0,12
Liav,M,100,0,12,12
Libna,F,100,12,0,12
Lieu,F,100,12,0,12
Lihi,F,100,12,0,12
Likesha,F,100,12,0,12
Lilien,F,100,12,0,12
Lillybelle,F,100,12,0,12
Lilyane,F,100,12,0,12
Lindajean,F,100,12,0,12
Linora,F,100,12,0,12
Liria,F,100,12,0,12
Litzie,F,100,12,0,12
Lizah,F,100,12,0,12
Llenifer,F,100,12,0,12
Loegan,M,100,0,12,12
Lohoma,F,100,12,0,12
Lotti,F,100,12,0,12
Lucindia,F,100,12,0,12
Ludwing,M,100,0,12,12
Luie,M,100,0,12,12
Luigy,M,100,0,12,12
Lukeus,M,100,0,12,12
Lukman,M,100,0,12,12
Luzer,M,100,0,12,12
Luzviminda,F,100,12,0,12
Lynlea,F,100,12,0,12
Lynthia,F,100,12,0,12
Macaden,M,100,0,12,12
Macklan,M,100,0,12,12
Madeliz,F,100,12,0,12
Madely,F,100,12,0,12
Madesen,F,100,12,0,12
Madgeline,F,100,12,0,12
Madisynne,F,100,12,0,12
Maegann,F,100,12,0,12
Mahkenna,F,100,12,0,12
Mahkya,F,100,12,0,12
Mahlani,F,100,12,0,12
Mahwish,F,100,12,0,12
Maitreya,F,58,7,5,12
Makah,M,100,0,12,12
Makayley,F,100,12,0,12
Makeen,M,100,0,12,12
Malanda,F,100,12,0,12
Malaysiah,F,100,12,0,12
Malcon,M,100,0,12,12
Malichai,M,100,0,12,12
Manju,F,100,12,0,12
Manvitha,F,100,12,0,12
Maraia,F,100,12,0,12
Marchand,F,58,7,5,12
Marciann,F,100,12,0,12
Marcquel,M,100,0,12,12
Marelli,F,100,12,0,12
Margena,F,100,12,0,12
Margita,F,100,12,0,12
Margurette,F,100,12,0,12
Marhonda,F,100,12,0,12
Mariaines,F,100,12,0,12
Mariangeliz,F,100,12,0,12
Marick,M,100,0,12,12
Maricka,F,100,12,0,12
Marinella,F,100,12,0,12
Marixza,F,100,12,0,12
Marjoe,M,100,0,12,12
Markila,F,100,12,0,12
Marlyin,F,100,12,0,12
Marquietta,F,100,12,0,12
Marqutia,F,100,12,0,12
Marrico,M,100,0,12,12
Martain,M,100,0,12,12
Martarius,M,100,0,12,12
Marvelyn,F,100,12,0,12
Marylinda,F,100,12,0,12
Maslah,M,100,0,12,12
Mauer,M,100,0,12,12
Maveryck,M,100,0,12,12
Maxus,M,100,0,12,12
Mayden,F,100,12,0,12
Maylanie,F,100,12,0,12
Mayrene,F,100,12,0,12
Mayssa,F,100,12,0,12
Mckailyn,F,100,12,0,12
Mckall,F,100,12,0,12
Mckeyla,F,100,12,0,12
Mckye,M,100,0,12,12
Mecedes,F,100,12,0,12
Mecha,F,100,12,0,12
Medelin,F,100,12,0,12
Meganelizabeth,F,100,12,0,12
Meikah,F,100,12,0,12
Meilich,M,100,0,12,12
Mekeisha,F,100,12,0,12
Mekko,M,100,0,12,12
Meleka,F,100,12,0,12
Meleta,F,100,12,0,12
Melvene,F,100,12,0,12
Melvie,F,100,12,0,12
Menyon,F,100,12,0,12
Mercedese,F,100,12,0,12
Mercedita,F,100,12,0,12
Merete,F,100,12,0,12
Mervat,F,100,12,0,12
Miaisha,F,100,12,0,12
Mikayia,F,100,12,0,12
Mikiela,F,100,12,0,12
Mikkala,F,100,12,0,12
Milaysia,F,100,12,0,12
Milthon,M,100,0,12,12
Minesh,M,100,0,12,12
Minya,F,100,12,0,12
Mirandy,F,100,12,0,12
Mireida,F,100,12,0,12
Mirina,F,100,12,0,12
Mizan,F,50,6,6,12
Moisses,M,100,0,12,12
Monaya,F,100,12,0,12
Montesha,F,100,12,0,12
Monyca,F,100,12,0,12
Morine,F,100,12,0,12
Mosley,F,50,6,6,12
Mouctar,M,100,0,12,12
Moyosoreoluwa,F,58,7,5,12
Munisa,F,100,12,0,12
Murlean,F,100,12,0,12
Music,F,50,6,6,12
Muslima,F,100,12,0,12
Myabella,F,100,12,0,12
Myella,F,100,12,0,12
Mykaya,F,100,12,0,12
Mykena,F,100,12,0,12
Myoshia,F,100,12,0,12
Mysia,F,100,12,0,12
Naftuly,M,100,0,12,12
Nahida,F,100,12,0,12
Nahin,M,100,0,12,12
Najuma,F,100,12,0,12
Nakaria,F,100,12,0,12
Nakyrah,F,100,12,0,12
Nalana,F,100,12,0,12
Nalayna,F,100,12,0,12
Nalo,F,100,12,0,12
Nanaakua,F,100,12,0,12
Naor,M,100,0,12,12
Narkita,F,100,12,0,12
Nasaiah,M,100,0,12,12
Nashlie,F,100,12,0,12
Nasiar,M,100,0,12,12
Natalei,F,100,12,0,12
Natalise,F,100,12,0,12
Natanim,M,100,0,12,12
Natellie,F,100,12,0,12
Nateria,F,100,12,0,12
Nathanieljames,M,100,0,12,12
Nathanim,M,100,0,12,12
Nathean,M,100,0,12,12
Nathina,F,100,12,0,12
Naudya,F,100,12,0,12
Navtej,M,100,0,12,12
Nawana,F,100,12,0,12
Naydia,F,100,12,0,12
Nayha,F,100,12,0,12
Nayiri,F,100,12,0,12
Neelan,M,100,0,12,12
Neethu,F,100,12,0,12
Neji,M,100,0,12,12
Nelvia,F,100,12,0,12
Nenia,F,100,12,0,12
Nesean,M,100,0,12,12
Netania,F,100,12,0,12
Niama,F,100,12,0,12
Nickiyah,F,100,12,0,12
Nikeita,F,100,12,0,12
Nikhia,F,100,12,0,12
Nilofar,F,100,12,0,12
Nineth,F,100,12,0,12
Nixin,M,100,0,12,12
Nodia,F,100,12,0,12
Noellie,F,100,12,0,12
Nolawit,F,100,12,0,12
Noriana,F,100,12,0,12
Not,M,100,0,12,12
Nouf,F,100,12,0,12
Novalea,F,100,12,0,12
Novaly,F,100,12,0,12
Nseya,F,100,12,0,12
Nyalise,F,100,12,0,12
Nyangel,F,100,12,0,12
Nyani,F,100,12,0,12
Nychole,F,100,12,0,12
Nyjal,M,100,0,12,12
Nyjee,M,100,0,12,12
Nykeemah,F,100,12,0,12
Nylin,M,58,5,7,12
Nyzere,M,100,0,12,12
Odinn,M,100,0,12,12
Ohemaa,F,100,12,0,12
Okalani,F,100,12,0,12
Okeith,M,100,0,12,12
Oksanna,F,100,12,0,12
Olajuwan,M,100,0,12,12
Olani,F,100,12,0,12
Olea,F,100,12,0,12
Oli,M,100,0,12,12
Omariah,F,100,12,0,12
Omarious,M,100,0,12,12
Omekia,F,100,12,0,12
Omeshia,F,100,12,0,12
Omyra,F,100,12,0,12
Onan,M,100,0,12,12
Onasis,M,100,0,12,12
Ondray,M,100,0,12,12
Onedia,F,100,12,0,12
Oreatha,F,100,12,0,12
Othelia,F,100,12,0,12
Padric,M,100,0,12,12
Parizoda,F,100,12,0,12
Parvaneh,F,100,12,0,12
Parvati,F,100,12,0,12
Paryss,F,100,12,0,12
Patriciaa,F,100,12,0,12
Pedra,F,100,12,0,12
Pegan,F,100,12,0,12
Pennington,M,100,0,12,12
Perriann,F,100,12,0,12
Perrine,F,100,12,0,12
Persephony,F,100,12,0,12
Pershing,M,100,0,12,12
Phillipmichael,M,100,0,12,12
Pihu,F,100,12,0,12
Pippin,F,100,12,0,12
Powers,M,100,0,12,12
Pradyumna,M,100,0,12,12
Pragyan,M,100,0,12,12
Praneet,M,100,0,12,12
Prather,M,100,0,12,12
Prish,M,100,0,12,12
Prodigy,M,100,0,12,12
Prudie,F,100,12,0,12
Quadair,M,100,0,12,12
Quadere,M,100,0,12,12
Qualan,M,100,0,12,12
Quamae,M,100,0,12,12
Quameshia,F,100,12,0,12
Quantas,M,100,0,12,12
Quanterious,M,100,0,12,12
Quiesha,F,100,12,0,12
Quila,F,100,12,0,12
Quindale,M,100,0,12,12
Quinterrious,M,100,0,12,12
Quintesha,F,100,12,0,12
Quinzel,M,100,0,12,12
Quontez,M,100,0,12,12
Quraan,M,100,0,12,12
Quynhnhu,F,100,12,0,12
Raaina,F,100,12,0,12
Rabi,M,100,0,12,12
Racyn,M,100,0,12,12
Raees,M,100,0,12,12
Rahsheed,M,100,0,12,12
Raichelle,F,100,12,0,12
Raidel,M,100,0,12,12
Raily,M,58,5,7,12
Raimondo,M,100,0,12,12
Raiyne,F,100,12,0,12
Rakeia,F,100,12,0,12
Raliek,M,100,0,12,12
Rashidat,F,100,12,0,12
Rashyia,F,100,12,0,12
Rauri,F,100,12,0,12
Raygene,F,100,12,0,12
Raymarion,M,100,0,12,12
Raymart,M,100,0,12,12
Rayneshia,F,100,12,0,12
Reeca,F,100,12,0,12
Reiter,M,100,0,12,12
Rekiya,F,100,12,0,12
Remingtyn,F,100,12,0,12
Remini,F,100,12,0,12
Renezmay,F,100,12,0,12
Rennetta,F,100,12,0,12
Resheda,F,100,12,0,12
Reydavid,M,100,0,12,12
Rhaniyah,F,100,12,0,12
Rheyna,F,100,12,0,12
Ricketa,F,100,12,0,12
Rickiah,F,100,12,0,12
Rigg,M,100,0,12,12
Riho,F,100,12,0,12
Riland,M,100,0,12,12
Risten,F,100,12,0,12
Robette,F,100,12,0,12
Robrt,M,100,0,12,12
Roddick,M,100,0,12,12
Rodena,F,100,12,0,12
Rokas,M,100,0,12,12
Rollyn,M,100,0,12,12
Romilly,F,100,12,0,12
Romiya,F,100,12,0,12
Ronta,M,100,0,12,12
Rosanny,F,100,12,0,12
Roselio,M,100,0,12,12
Rosezina,F,100,12,0,12
Rosolyn,F,100,12,0,12
Rouguiatou,F,100,12,0,12
Rozenia,F,100,12,0,12
Rubylynn,F,100,12,0,12
Ruca,F,100,12,0,12
Rufio,M,100,0,12,12
Rukhsar,F,100,12,0,12
Rukmini,F,100,12,0,12
Runnie,M,100,0,12,12
Rushie,F,100,12,0,12
Ruthine,F,100,12,0,12
Ryanjacob,M,100,0,12,12
Ryniah,F,100,12,0,12
Ryuji,M,100,0,12,12
Saamia,F,100,12,0,12
Sabdiel,M,100,0,12,12
Sacajawea,F,100,12,0,12
Sadam,M,100,0,12,12
Sahaira,F,100,12,0,12
Sahmiyah,F,100,12,0,12
Sailer,F,100,12,0,12
Sakaria,M,100,0,12,12
Salaar,M,100,0,12,12
Salahudin,M,100,0,12,12
Salama,F,100,12,0,12
Samaje,M,100,0,12,12
Samayiah,F,100,12,0,12
Samiaya,F,100,12,0,12
Samyriah,F,100,12,0,12
Sancha,F,100,12,0,12
Sanchi,F,100,12,0,12
Sandrah,F,100,12,0,12
Saniyaa,F,100,12,0,12
Santy,M,100,0,12,12
Sapana,F,100,12,0,12
Sarakate,F,100,12,0,12
Sargent,M,100,0,12,12
Satyana,F,100,12,0,12
Saugat,M,100,0,12,12
Saura,F,100,12,0,12
Saurish,M,100,0,12,12
Savaeh,F,100,12,0,12
Savasia,F,100,12,0,12
Savieon,M,100,0,12,12
Savione,M,100,0,12,12
Sayri,F,100,12,0,12
Schell,M,58,5,7,12
Sebella,F,100,12,0,12
Selestine,F,100,12,0,12
Semara,F,100,12,0,12
Semaria,F,100,12,0,12
Seneka,F,100,12,0,12
Serenaty,F,100,12,0,12
Serious,M,100,0,12,12
Sevda,F,100,12,0,12
Shabd,M,100,0,12,12
Shaemus,M,100,0,12,12
Shakeyah,F,100,12,0,12
Shakieta,F,100,12,0,12
Shakuan,M,100,0,12,12
Shalethia,F,100,12,0,12
Shamae,F,100,12,0,12
Shamariona,F,100,12,0,12
Shamita,F,100,12,0,12
Shamoria,F,100,12,0,12
Shamyria,F,100,12,0,12
Shanana,F,100,12,0,12
Shandice,F,100,12,0,12
Shanegua,F,100,12,0,12
Shanissa,F,100,12,0,12
Shantalle,F,100,12,0,12
Shantrece,F,100,12,0,12
Shanythia,F,100,12,0,12
Shaon,M,100,0,12,12
Shaquara,F,100,12,0,12
Shaque,F,100,12,0,12
Sharease,F,100,12,0,12
Sharema,F,100,12,0,12
Sharitha,F,100,12,0,12
Sharmyn,F,100,12,0,12
Sharnea,F,100,12,0,12
Sharniqua,F,100,12,0,12
Sharonlee,F,100,12,0,12
Sharoya,F,100,12,0,12
Shatique,M,100,0,12,12
Shauntasia,F,100,12,0,12
Shavonya,F,100,12,0,12
Shawntaye,F,100,12,0,12
Shayeeda,F,100,12,0,12
Shdiamond,F,100,12,0,12
Sheenna,F,100,12,0,12
Sheira,F,100,12,0,12
Shelbyann,F,100,12,0,12
Sheleah,F,100,12,0,12
Shellise,F,100,12,0,12
Sheonna,F,100,12,0,12
Shep,M,100,0,12,12
Shernard,M,100,0,12,12
Sherridan,F,100,12,0,12
Shetika,F,100,12,0,12
Shinelle,F,100,12,0,12
Shiwanda,F,100,12,0,12
Shondala,F,100,12,0,12
Shoneen,F,100,12,0,12
Shontoria,F,100,12,0,12
Shouana,F,100,12,0,12
Shue,M,100,0,12,12
Shukriyyah,F,100,12,0,12
Shynese,F,100,12,0,12
Shynika,F,100,12,0,12
Shyrell,F,100,12,0,12
Sig,M,100,0,12,12
Silken,F,100,12,0,12
Simmeon,M,100,0,12,12
Skyelin,F,100,12,0,12
Sobrina,F,100,12,0,12
Socheata,F,100,12,0,12
Solen,M,100,0,12,12
Solmari,F,100,12,0,12
Somayah,F,100,12,0,12
Sonseeahray,F,100,12,0,12
Sophiee,F,100,12,0,12
Sorayda,F,100,12,0,12
Sossity,F,100,12,0,12
Sriyah,F,100,12,0,12
Starshema,F,100,12,0,12
Steave,M,100,0,12,12
Stedmond,M,100,0,12,12
Stefaine,F,100,12,0,12
Steffy,F,100,12,0,12
Stevonna,F,100,12,0,12
Sudhir,M,100,0,12,12
Sujeiry,F,100,12,0,12
Sukie,F,100,12,0,12
Sunia,F,100,12,0,12
Svannah,F,100,12,0,12
Swiyyah,F,100,12,0,12
Sydeny,F,100,12,0,12
Sydnea,F,100,12,0,12
Syia,F,100,12,0,12
Syleste,F,100,12,0,12
Sylviana,F,100,12,0,12
Symanthia,F,100,12,0,12
Synclair,F,100,12,0,12
Syndal,F,100,12,0,12
Tadasia,F,100,12,0,12
Taeo,M,100,0,12,12
Taeon,M,100,0,12,12
Tahliya,F,100,12,0,12
Tairyn,F,100,12,0,12
Takhiya,F,100,12,0,12
Talaiyah,F,100,12,0,12
Taleek,M,100,0,12,12
Taliayah,F,100,12,0,12
Tamilore,F,100,12,0,12
Tamkio,F,100,12,0,12
Tamyko,F,100,12,0,12
Tanden,M,100,0,12,12
Tandie,F,100,12,0,12
Taneca,F,100,12,0,12
Taneishia,F,100,12,0,12
Tansha,F,100,12,0,12
Tanzim,M,100,0,12,12
Tarrus,M,100,0,12,12
Tauryn,F,100,12,0,12
Taveah,F,100,12,0,12
Tavery,F,100,12,0,12
Tavonta,M,100,0,12,12
Tavorris,M,100,0,12,12
Tayln,F,100,12,0,12
Tayma,F,100,12,0,12
Teaera,F,100,12,0,12
Teag,M,100,0,12,12
Tecla,F,100,12,0,12
Teig,M,100,0,12,12
Tekoah,F,100,12,0,12
Teller,M,100,0,12,12
Tempa,F,100,12,0,12
Tenneil,F,100,12,0,12
Tercel,M,100,0,12,12
Tereance,M,100,0,12,12
Ternesha,F,100,12,0,12
Terreka,F,100,12,0,12
Terresha,F,100,12,0,12
Terriss,M,100,0,12,12
Terriya,F,100,12,0,12
Terrlyn,F,100,12,0,12
Tesher,M,100,0,12,12
Teshima,F,100,12,0,12
Tessalynn,F,100,12,0,12
Tetsuya,M,100,0,12,12
Tevaris,M,100,0,12,12
Thaiden,M,100,0,12,12
Thair,M,100,0,12,12
Thary,F,100,12,0,12
Theartis,M,100,0,12,12
Theary,F,100,12,0,12
Thommas,M,100,0,12,12
Tilghman,M,100,0,12,12
Timani,F,100,12,0,12
Timiki,F,100,12,0,12
Timorthy,M,100,0,12,12
Tinalouise,F,100,12,0,12
Tinnley,F,100,12,0,12
Tio,M,100,0,12,12
Tirone,M,100,0,12,12
Tirzo,M,100,0,12,12
Tobian,M,100,0,12,12
Toika,F,100,12,0,12
Tolisha,F,100,12,0,12
Tomecca,F,100,12,0,12
Tonesia,F,100,12,0,12
Tonii,F,100,12,0,12
Toosdhi,F,100,12,0,12
Tracylee,F,100,12,0,12
Traesean,M,100,0,12,12
Traevin,M,100,0,12,12
Traviss,M,100,0,12,12
Trcy,F,100,12,0,12
Treauna,F,100,12,0,12
Tredell,M,100,0,12,12
Treivon,M,100,0,12,12
Trejaun,M,100,0,12,12
Tremelle,M,100,0,12,12
Trezon,M,100,0,12,12
Trinden,M,100,0,12,12
Trintiy,F,100,12,0,12
Trishell,F,100,12,0,12
Trudell,F,100,12,0,12
Tshaka,M,100,0,12,12
Tsunami,F,100,12,0,12
Tulasi,F,100,12,0,12
Twiggy,F,100,12,0,12
Tyaunna,F,100,12,0,12
Tyi,M,100,0,12,12
Tyjana,F,100,12,0,12
Tyricka,F,100,12,0,12
Tyshanti,F,100,12,0,12
Tysheanna,F,100,12,0,12
Tysheika,F,100,12,0,12
Tywona,F,100,12,0,12
Tzivya,F,100,12,0,12
Ulisis,M,100,0,12,12
Unyque,F,100,12,0,12
Valeire,F,100,12,0,12
Valleria,F,100,12,0,12
Vanisa,F,100,12,0,12
Vashone,M,100,0,12,12
Vaugh,M,100,0,12,12
Venesta,F,100,12,0,12
Verah,F,100,12,0,12
Vernetha,F,100,12,0,12
Verronica,F,100,12,0,12
Versia,F,100,12,0,12
Vessie,F,100,12,0,12
Vibiana,F,100,12,0,12
Viktorija,F,100,12,0,12
Vinia,F,100,12,0,12
Virgena,F,100,12,0,12
Vishesh,M,100,0,12,12
Vyshonne,M,100,0,12,12
Wanesha,F,100,12,0,12
Warrene,F,100,12,0,12
Wendeline,F,100,12,0,12
Wendellyn,F,100,12,0,12
Wendra,F,100,12,0,12
Whendy,F,100,12,0,12
Williammichael,M,100,0,12,12
Winnette,F,100,12,0,12
Worthington,M,100,0,12,12
Wryan,M,100,0,12,12
Wyonia,F,100,12,0,12
Xeryus,M,100,0,12,12
Xing,F,58,7,5,12
Xinyu,F,100,12,0,12
Xzaiden,M,100,0,12,12
Yacquelin,F,100,12,0,12
Yadid,M,100,0,12,12
Yailynn,F,100,12,0,12
Yameen,M,100,0,12,12
Yamiah,F,100,12,0,12
Yathziry,F,100,12,0,12
Yatin,M,100,0,12,12
Yeabsira,M,100,0,12,12
Yeferson,M,100,0,12,12
Yeico,M,100,0,12,12
Yeleni,F,100,12,0,12
Yexenia,F,100,12,0,12
Yeyson,M,100,0,12,12
Yhoalibeth,F,100,12,0,12
Yinon,M,100,0,12,12
Yixin,F,100,12,0,12
Yker,M,100,0,12,12
Ylan,F,100,12,0,12
Yoaly,F,100,12,0,12
Yoani,M,100,0,12,12
Yokasta,F,100,12,0,12
Yoo,F,100,12,0,12
Ysrael,M,100,0,12,12
Yurie,F,100,12,0,12
Zabrian,M,100,0,12,12
Zachai,M,100,0,12,12
Zady,F,100,12,0,12
Zahair,M,100,0,12,12
Zahier,M,100,0,12,12
Zahniah,F,100,12,0,12
Zaiveon,M,100,0,12,12
Zakaiyah,F,100,12,0,12
Zakhya,F,100,12,0,12
Zamare,M,100,0,12,12
Zamarria,F,100,12,0,12
Zamarrion,M,100,0,12,12
Zamera,F,100,12,0,12
Zanthia,F,100,12,0,12
Zarihya,F,100,12,0,12
Zavyon,M,100,0,12,12
Zaydian,M,100,0,12,12
Zayliah,F,100,12,0,12
Zean,M,100,0,12,12
Zeline,F,100,12,0,12
Zendell,M,100,0,12,12
Zerrion,M,100,0,12,12
Zico,M,100,0,12,12
Zihao,M,100,0,12,12
Zinn,M,100,0,12,12
Zirel,F,100,12,0,12
Zithlaly,F,100,12,0,12
Znyah,F,100,12,0,12
Zoryana,F,100,12,0,12
Zuliana,F,100,12,0,12
Zuwena,F,100,12,0,12
Zykierra,F,100,12,0,12
Zyonah,F,100,12,0,12
Zyonnah,F,100,12,0,12
Aadison,F,100,11,0,11
Aadiv,M,100,0,11,11
Aalimah,F,100,11,0,11
Aamia,F,100,11,0,11
Aaniylah,F,100,11,0,11
Aansh,M,100,0,11,11
Aaronette,F,100,11,0,11
Aavyn,M,55,5,6,11
Abdulmohsen,M,100,0,11,11
Abedalrahman,M,100,0,11,11
Abigailgrace,F,100,11,0,11
Abigailmarie,F,100,11,0,11
Abla,F,100,11,0,11
Abraxas,M,55,5,6,11
Acesyn,M,100,0,11,11
Adaleya,F,100,11,0,11
Adamo,M,100,0,11,11
Adaneli,F,100,11,0,11
Addelina,F,100,11,0,11
Adderly,M,100,0,11,11
Addey,F,100,11,0,11
Addielynn,F,100,11,0,11
Addisun,F,100,11,0,11
Adeeba,F,100,11,0,11
Adelaina,F,100,11,0,11
Adelinah,F,100,11,0,11
Adene,F,100,11,0,11
Adhem,M,100,0,11,11
Adiline,F,100,11,0,11
Adlen,F,100,11,0,11
Adreina,F,100,11,0,11
Adrianjames,M,100,0,11,11
Adyanna,F,100,11,0,11
Aerowyn,F,100,11,0,11
Aeyla,F,100,11,0,11
Afeef,M,100,0,11,11
Ageliki,F,100,11,0,11
Agha,M,100,0,11,11
Agila,F,100,11,0,11
Ah,F,100,11,0,11
Ahlena,F,100,11,0,11
Ahnylah,F,100,11,0,11
Aibhilin,F,100,11,0,11
Aidana,F,100,11,0,11
Aieden,M,100,0,11,11
Ainesh,M,100,0,11,11
Airabelle,F,100,11,0,11
Aiyan,M,100,0,11,11
Aizayah,M,100,0,11,11
Ajianna,F,100,11,0,11
Ajita,F,100,11,0,11
Akanni,M,100,0,11,11
Akeesha,F,100,11,0,11
Akhari,M,100,0,11,11
Akmal,M,100,0,11,11
Akura,F,100,11,0,11
Alai,M,55,5,6,11
Alaunna,F,100,11,0,11
Alayn,M,100,0,11,11
Alecha,F,100,11,0,11
Alecsa,F,100,11,0,11
Aleezah,F,100,11,0,11
Aleighsha,F,100,11,0,11
Alelia,F,100,11,0,11
Alely,F,100,11,0,11
Aletra,F,100,11,0,11
Alexadra,F,100,11,0,11
Aleynna,F,100,11,0,11
Aleyse,F,100,11,0,11
Alezandro,M,100,0,11,11
Alfornia,M,100,0,11,11
Alicemarie,F,100,11,0,11
Aliina,F,100,11,0,11
Alikah,F,100,11,0,11
Alike,F,100,11,0,11
Alischa,F,100,11,0,11
Alisher,M,100,0,11,11
Aliye,F,100,11,0,11
Alkeem,M,100,0,11,11
Alliyana,F,100,11,0,11
Allston,M,100,0,11,11
Allyanah,F,100,11,0,11
Allyria,F,100,11,0,11
Allyssah,F,100,11,0,11
Almonte,M,100,0,11,11
Alohi,F,100,11,0,11
Alondrea,F,100,11,0,11
Alontay,M,100,0,11,11
Alshawn,M,100,0,11,11
Alula,M,100,0,11,11
Alyssanicole,F,100,11,0,11
Alzada,F,100,11,0,11
Amahya,F,100,11,0,11
Amanat,F,100,11,0,11
Amarelys,F,100,11,0,11
Amazen,F,100,11,0,11
Ambresha,F,100,11,0,11
Amechi,M,100,0,11,11
Amelea,F,100,11,0,11
Amgela,F,100,11,0,11
Amileo,M,100,0,11,11
Amisa,F,100,11,0,11
Amonnie,F,100,11,0,11
Anaejah,F,100,11,0,11
Anahie,F,100,11,0,11
Anaias,M,100,0,11,11
Anania,M,100,0,11,11
Anastaisha,F,100,11,0,11
Anavaeh,F,100,11,0,11
Andela,F,100,11,0,11
Andranae,F,100,11,0,11
Andranique,F,100,11,0,11
Andrelle,F,100,11,0,11
Andrenika,F,100,11,0,11
Anessah,F,100,11,0,11
Anfisa,F,100,11,0,11
Angelamae,F,100,11,0,11
Angelann,F,100,11,0,11
Angeldavid,M,100,0,11,11
Angelicque,F,100,11,0,11
Angelinamarie,F,100,11,0,11
Angeliq,F,100,11,0,11
Angeliza,F,100,11,0,11
Angelleah,F,100,11,0,11
Angleo,M,100,0,11,11
Anilyah,F,100,11,0,11
Anitrice,F,100,11,0,11
Aniyja,F,100,11,0,11
Anjli,F,100,11,0,11
Annabela,F,100,11,0,11
Anneliesa,F,100,11,0,11
Annessia,F,100,11,0,11
Anngelica,F,100,11,0,11
Annielaurie,F,100,11,0,11
Anniemarie,F,100,11,0,11
Anshita,F,100,11,0,11
Antalya,F,100,11,0,11
Anterius,M,100,0,11,11
Antonett,F,100,11,0,11
Antonne,M,100,0,11,11
Antonyio,M,100,0,11,11
Antown,M,100,0,11,11
Antwayne,M,100,0,11,11
Antwoinette,F,100,11,0,11
Antyon,M,100,0,11,11
Anyria,F,100,11,0,11
Anyshia,F,100,11,0,11
Aoibheann,F,100,11,0,11
Aquaria,F,100,11,0,11
Arami,F,100,11,0,11
Aransa,F,100,11,0,11
Arbella,F,100,11,0,11
Arcola,F,100,11,0,11
Areeg,F,100,11,0,11
Areena,F,100,11,0,11
Areeya,F,100,11,0,11
Areiona,F,100,11,0,11
Areonia,F,100,11,0,11
Arezo,F,100,11,0,11
Aricca,F,100,11,0,11
Arielyz,F,100,11,0,11
Arii,F,100,11,0,11
Aristide,M,100,0,11,11
Arit,F,100,11,0,11
Arjav,M,100,0,11,11
Arkady,M,100,0,11,11
Arkeshia,F,100,11,0,11
Arlethea,F,100,11,0,11
Arness,M,100,0,11,11
Arreonna,F,100,11,0,11
Arryonna,F,100,11,0,11
Artricia,F,100,11,0,11
Artrina,F,100,11,0,11
Arvo,M,100,0,11,11
Arvon,M,100,0,11,11
Arwynn,F,100,11,0,11
Aryiel,F,100,11,0,11
Arys,M,55,5,6,11
Asadbek,M,100,0,11,11
Asantae,M,100,0,11,11
Ashariah,F,100,11,0,11
Ashauntee,F,100,11,0,11
Ashiley,F,100,11,0,11
Ashleh,F,100,11,0,11
Ashlly,F,100,11,0,11
Ashneel,M,100,0,11,11
Asier,M,100,0,11,11
Assetou,F,100,11,0,11
Asthon,M,100,0,11,11
Athelia,F,100,11,0,11
Athon,M,100,0,11,11
Atreus,M,100,0,11,11
Attiyya,F,100,11,0,11
Atzhiry,F,100,11,0,11
Aubrieana,F,100,11,0,11
Aubrin,F,100,11,0,11
Audrynna,F,100,11,0,11
Aujane,F,100,11,0,11
Aun,M,100,0,11,11
Aunisti,F,100,11,0,11
Aurbree,F,100,11,0,11
Aurian,F,100,11,0,11
Auryana,F,100,11,0,11
Austinjohn,M,100,0,11,11
Austintyler,M,100,0,11,11
Autin,M,100,0,11,11
Autmn,F,100,11,0,11
Autume,F,100,11,0,11
Auviana,F,100,11,0,11
Avaia,F,100,11,0,11
Avakate,F,100,11,0,11
Avalyne,F,100,11,0,11
Avalyse,F,100,11,0,11
Avanta,M,100,0,11,11
Avaughn,M,100,0,11,11
Avayla,F,100,11,0,11
Avelia,F,100,11,0,11
Avera,F,100,11,0,11
Averion,M,100,0,11,11
Avieon,M,100,0,11,11
Avilee,F,100,11,0,11
Avisha,F,100,11,0,11
Awwab,M,100,0,11,11
Axia,F,100,11,0,11
Ayami,F,100,11,0,11
Ayanle,M,100,0,11,11
Ayantu,F,100,11,0,11
Aydann,M,100,0,11,11
Ayishah,F,100,11,0,11
Aynia,F,100,11,0,11
Ayvan,M,100,0,11,11
Ayvrie,F,100,11,0,11
Ayzen,M,100,0,11,11
Azaleya,F,100,11,0,11
Azden,M,100,0,11,11
Babita,F,100,11,0,11
Baelie,F,100,11,0,11
Baha,M,100,0,11,11
Baheejah,F,100,11,0,11
Bairo,M,100,0,11,11
Barin,M,100,0,11,11
Baris,M,100,0,11,11
Barr,M,100,0,11,11
Baudel,M,100,0,11,11
Beca,F,100,11,0,11
Beighley,F,100,11,0,11
Belmaris,F,100,11,0,11
Benina,F,100,11,0,11
Benjmain,M,100,0,11,11
Bennye,F,100,11,0,11
Benten,M,100,0,11,11
Bera,M,55,5,6,11
Berdena,F,100,11,0,11
Besa,F,100,11,0,11
Beta,F,100,11,0,11
Bethy,F,100,11,0,11
Bethzabel,F,100,11,0,11
Bettey,F,100,11,0,11
Beula,F,100,11,0,11
Bevery,F,100,11,0,11
Bhavi,F,100,11,0,11
Bianeth,F,100,11,0,11
Bin,M,100,0,11,11
Bitsy,F,100,11,0,11
Blakesley,F,100,11,0,11
Blayten,M,100,0,11,11
Blissany,F,100,11,0,11
Blithe,F,100,11,0,11
Blyth,F,100,11,0,11
Bobbisue,F,100,11,0,11
Bocar,M,100,0,11,11
Bradnon,M,100,0,11,11
Brailin,M,100,0,11,11
Brandarius,M,100,0,11,11
Branly,M,100,0,11,11
Brann,M,100,0,11,11
Branoon,M,100,0,11,11
Brantlie,F,100,11,0,11
Braylenn,M,55,5,6,11
Breaden,M,100,0,11,11
Breelee,F,100,11,0,11
Breeyana,F,100,11,0,11
Breianne,F,100,11,0,11
Brendetta,F,100,11,0,11
Breniah,F,100,11,0,11
Brennick,M,100,0,11,11
Brentleigh,F,100,11,0,11
Brentson,M,100,0,11,11
Breonte,M,55,5,6,11
Brettly,M,100,0,11,11
Breylee,F,100,11,0,11
Brezlin,M,55,5,6,11
Bridjette,F,100,11,0,11
Bridon,M,100,0,11,11
Brigden,M,100,0,11,11
Brigdon,M,100,0,11,11
Brijido,M,100,0,11,11
Brindi,F,100,11,0,11
Brinlie,F,100,11,0,11
Brioni,F,100,11,0,11
Brishawn,M,100,0,11,11
Britnye,F,100,11,0,11
Brittainey,F,100,11,0,11
Brittana,F,100,11,0,11
Brittanylee,F,100,11,0,11
Brixtyn,F,100,11,0,11
Broderik,M,100,0,11,11
Brom,M,100,0,11,11
Brona,F,100,11,0,11
Bronston,M,100,0,11,11
Bryianna,F,100,11,0,11
Brynton,M,100,0,11,11
Brytany,F,100,11,0,11
Bryttnie,F,100,11,0,11
Burch,M,100,0,11,11
Caaliyah,F,100,11,0,11
Cadense,F,100,11,0,11
Caed,M,100,0,11,11
Cagan,M,100,0,11,11
Cahlia,F,100,11,0,11
Caile,F,100,11,0,11
Caiyden,M,100,0,11,11
Cajuan,M,100,0,11,11
Calep,M,100,0,11,11
Calimarie,F,100,11,0,11
Camaree,M,55,5,6,11
Camariyah,F,100,11,0,11
Cameria,F,100,11,0,11
Camerynn,F,100,11,0,11
Camica,F,100,11,0,11
Cammille,F,100,11,0,11
Camori,F,100,11,0,11
Camra,F,100,11,0,11
Candic,F,100,11,0,11
Candrea,F,100,11,0,11
Candrice,F,100,11,0,11
Candye,F,100,11,0,11
Caprise,F,100,11,0,11
Carabelle,F,100,11,0,11
Caralyne,F,100,11,0,11
Carilla,F,100,11,0,11
Carisia,F,100,11,0,11
Carlaya,F,100,11,0,11
Carleene,F,100,11,0,11
Carleigha,F,100,11,0,11
Carleshia,F,100,11,0,11
Carnie,F,100,11,0,11
Carold,M,100,0,11,11
Caroyl,F,100,11,0,11
Carryl,F,100,11,0,11
Carsan,M,100,0,11,11
Caryann,F,100,11,0,11
Carye,F,100,11,0,11
Casadi,F,100,11,0,11
Cashala,F,100,11,0,11
Cashous,M,100,0,11,11
Casidhe,F,100,11,0,11
Cassand,F,100,11,0,11
Cassanora,F,100,11,0,11
Cassen,M,100,0,11,11
Cassiday,F,100,11,0,11
Catana,F,100,11,0,11
Cath,F,100,11,0,11
Catinna,F,100,11,0,11
Catya,F,100,11,0,11
Caulen,M,100,0,11,11
Cavonte,M,100,0,11,11
Ceann,F,100,11,0,11
Ceilia,F,100,11,0,11
Celis,F,100,11,0,11
Celleste,F,100,11,0,11
Cendra,F,100,11,0,11
Centrell,M,100,0,11,11
Cenya,F,100,11,0,11
Cerelia,F,100,11,0,11
Ceron,M,100,0,11,11
Cesilee,F,100,11,0,11
Cevion,M,100,0,11,11
Chadwic,M,100,0,11,11
Chaiden,M,100,0,11,11
Chakina,F,100,11,0,11
Chakotay,M,100,0,11,11
Chalette,F,100,11,0,11
Chances,F,100,11,0,11
Chandley,F,100,11,0,11
Chanh,M,100,0,11,11
Chanity,F,100,11,0,11
Chantle,F,100,11,0,11
Chantrel,F,100,11,0,11
Chaplin,M,100,0,11,11
Charade,F,100,11,0,11
Chardell,F,100,11,0,11
Charea,F,100,11,0,11
Charleeann,F,100,11,0,11
Charleszetta,F,100,11,0,11
Charney,F,100,11,0,11
Charvae,F,100,11,0,11
Chasaty,F,100,11,0,11
Chasteline,F,100,11,0,11
Chayanna,F,100,11,0,11
Cheketa,F,100,11,0,11
Chelbe,F,100,11,0,11
Chelssy,F,100,11,0,11
Cherakee,F,100,11,0,11
Cherin,F,100,11,0,11
Cheska,F,100,11,0,11
Chevonda,F,100,11,0,11
Chevone,F,100,11,0,11
Chezkel,M,100,0,11,11
Chidima,F,100,11,0,11
Chiketa,F,100,11,0,11
Chimira,F,100,11,0,11
Chineka,F,100,11,0,11
Chinere,F,100,11,0,11
Chinonye,F,100,11,0,11
Chinou,M,100,0,11,11
Chisholm,M,100,0,11,11
Chiyo,F,100,11,0,11
Chloemae,F,100,11,0,11
Chrishayla,F,100,11,0,11
Christianmichae,M,100,0,11,11
Christopherryan,M,100,0,11,11
Chrsitine,F,100,11,0,11
Chrstine,F,100,11,0,11
Chrysander,M,100,0,11,11
Chrystan,F,100,11,0,11
Chrystiana,F,100,11,0,11
Chumani,F,100,11,0,11
Churchill,M,100,0,11,11
Chuy,M,100,0,11,11
Chy,F,100,11,0,11
Ciaria,F,100,11,0,11
Ciasia,F,100,11,0,11
Cidalia,F,100,11,0,11
Cie,F,100,11,0,11
Cirena,F,100,11,0,11
Cittlali,F,100,11,0,11
Clarica,F,100,11,0,11
Claybourne,M,100,0,11,11
Cledis,M,100,0,11,11
Cleighton,M,100,0,11,11
Clementeen,F,100,11,0,11
Clementene,F,100,11,0,11
Cliffard,M,100,0,11,11
Clydine,F,100,11,0,11
Cne,F,100,11,0,11
Coehn,M,100,0,11,11
Cola,F,55,6,5,11
Colbyn,M,100,0,11,11
Comari,M,100,0,11,11
Commie,F,55,6,5,11
Corbit,M,100,0,11,11
Corderrius,M,100,0,11,11
Cordey,M,100,0,11,11
Corriana,F,100,11,0,11
Corrida,F,100,11,0,11
Corvetta,F,100,11,0,11
Corvus,M,100,0,11,11
Corvyn,M,100,0,11,11
Coryne,F,100,11,0,11
Courtlandt,M,100,0,11,11
Courtneyann,F,100,11,0,11
Crea,F,100,11,0,11
Credence,M,55,5,6,11
Crescentia,F,100,11,0,11
Cristee,F,100,11,0,11
Crystella,F,100,11,0,11
Crystil,F,100,11,0,11
Cullyn,M,100,0,11,11
Cura,F,100,11,0,11
Curtus,M,100,0,11,11
Cynamon,F,100,11,0,11
Cyntheia,F,100,11,0,11
Dacien,M,100,0,11,11
Dacorey,M,100,0,11,11
Dahabo,F,100,11,0,11
Dahmari,M,100,0,11,11
Dainon,M,100,0,11,11
Daiten,M,100,0,11,11
Daizhon,M,100,0,11,11
Dakesha,F,100,11,0,11
Dalaynee,F,100,11,0,11
Dalayni,F,100,11,0,11
Dalee,F,100,11,0,11
Daler,M,100,0,11,11
Damarus,M,100,0,11,11
Damayia,F,100,11,0,11
Dami,F,100,11,0,11
Damiso,M,100,0,11,11
Damla,F,100,11,0,11
Damorris,M,100,0,11,11
Dandridge,M,100,0,11,11
Daneeka,F,100,11,0,11
Daneel,M,100,0,11,11
Danet,F,100,11,0,11
Dannyel,M,100,0,11,11
Dantavis,M,100,0,11,11
Dantoni,M,100,0,11,11
Danute,F,100,11,0,11
Danyra,F,100,11,0,11
Daquarious,M,100,0,11,11
Daquion,M,100,0,11,11
Daralee,F,100,11,0,11
Darelys,F,100,11,0,11
Darhyl,M,100,0,11,11
Darihanna,F,100,11,0,11
Darreion,M,100,0,11,11
Darresha,F,100,11,0,11
Darrias,M,100,0,11,11
Darriyah,F,100,11,0,11
Darshini,F,100,11,0,11
Dartanya,F,100,11,0,11
Darvi,F,100,11,0,11
Daschle,M,100,0,11,11
Dasheena,F,100,11,0,11
Datril,M,55,5,6,11
Davario,M,100,0,11,11
Davidjr,M,100,0,11,11
Davies,M,100,0,11,11
Davinna,F,100,11,0,11
Daviya,F,100,11,0,11
Dawnte,F,55,6,5,11
Daxin,M,100,0,11,11
Daynesha,F,100,11,0,11
Daythan,M,100,0,11,11
Dayvien,M,100,0,11,11
Dayzah,F,100,11,0,11
Ddnald,M,100,0,11,11
Deallen,M,100,0,11,11
Deangelia,F,100,11,0,11
Deangello,M,100,0,11,11
Deboarh,F,100,11,0,11
Deboris,M,100,0,11,11
Debraha,F,100,11,0,11
Debrajo,F,100,11,0,11
Dechen,F,100,11,0,11
Decola,F,100,11,0,11
Dedi,F,100,11,0,11
Dedrian,M,100,0,11,11
Deisel,M,100,0,11,11
Dejsha,F,100,11,0,11
Dekin,M,100,0,11,11
Dekwon,M,100,0,11,11
Delann,F,100,11,0,11
Delayah,F,100,11,0,11
Delayney,F,100,11,0,11
Delci,F,100,11,0,11
Deleana,F,100,11,0,11
Delethia,F,100,11,0,11
Delfa,F,100,11,0,11
Dellah,F,100,11,0,11
Dellareese,F,100,11,0,11
Delmario,M,100,0,11,11
Delsia,F,100,11,0,11
Delvontae,M,100,0,11,11
Demarcio,M,100,0,11,11
Demariya,F,100,11,0,11
Demarrea,M,100,0,11,11
Demeca,F,100,11,0,11
Demetriona,F,100,11,0,11
Demien,M,100,0,11,11
Demitrice,F,55,6,5,11
Denaeja,F,100,11,0,11
Denyia,F,100,11,0,11
Dequesha,F,100,11,0,11
Dequez,M,100,0,11,11
Derba,F,100,11,0,11
Deriek,M,100,0,11,11
Derina,F,100,11,0,11
Derome,M,100,0,11,11
Deronn,M,100,0,11,11
Des,M,55,5,6,11
Deseret,F,100,11,0,11
Deshonta,F,100,11,0,11
Deshonte,F,55,6,5,11
Desmand,M,100,0,11,11
Destery,M,100,0,11,11
Detoya,F,100,11,0,11
Detrevion,M,100,0,11,11
Detzani,F,100,11,0,11
Deus,M,100,0,11,11
Devaron,M,100,0,11,11
Devione,M,100,0,11,11
Devondrick,M,100,0,11,11
Devrie,F,100,11,0,11
Devrim,M,100,0,11,11
Dezaraye,F,100,11,0,11
Dezariyah,F,100,11,0,11
Dezja,F,100,11,0,11
Dhru,M,100,0,11,11
Dianetta,F,100,11,0,11
Dianie,F,100,11,0,11
Diarmuid,M,100,0,11,11
Diba,F,100,11,0,11
Dicy,F,100,11,0,11
Diellza,F,100,11,0,11
Dietmar,M,100,0,11,11
Digby,M,100,0,11,11
Dimani,M,100,0,11,11
Dionza,F,100,11,0,11
Dipti,F,100,11,0,11
Dishita,F,100,11,0,11
Dison,M,100,0,11,11
Divia,F,100,11,0,11
Dlilah,F,100,11,0,11
Doborah,F,100,11,0,11
Dominus,M,100,0,11,11
Domynik,M,100,0,11,11
Dondray,M,100,0,11,11
Doneka,F,100,11,0,11
Donicio,M,100,0,11,11
Donquell,M,100,0,11,11
Dontevious,M,100,0,11,11
Dontonio,M,100,0,11,11
Dorisha,F,100,11,0,11
Dorry,F,100,11,0,11
Dorthia,F,100,11,0,11
Draiman,M,100,0,11,11
Draizy,F,100,11,0,11
Draylan,M,100,0,11,11
Drayon,M,100,0,11,11
Drewey,M,100,0,11,11
Drian,M,100,0,11,11
Duban,M,100,0,11,11
Dulani,M,100,0,11,11
Dupre,M,100,0,11,11
Duretta,F,100,11,0,11
Duwanna,F,100,11,0,11
Dwyla,F,100,11,0,11
Dylaney,F,100,11,0,11
Ea,F,100,11,0,11
Eammon,M,100,0,11,11
Earic,M,100,0,11,11
Earmon,M,100,0,11,11
Earron,M,100,0,11,11
Ebanie,F,100,11,0,11
Ebelina,F,100,11,0,11
Ebonii,F,100,11,0,11
Edisa,F,100,11,0,11
Edrica,F,100,11,0,11
Edricka,F,100,11,0,11
Edwardine,F,100,11,0,11
Edwinn,M,100,0,11,11
Efua,F,100,11,0,11
Eiad,M,100,0,11,11
Eith,M,100,0,11,11
Eithyn,M,100,0,11,11
Eizabella,F,100,11,0,11
Elahni,F,100,11,0,11
Elannah,F,100,11,0,11
Elayshia,F,100,11,0,11
Eleany,F,100,11,0,11
Eleda,F,100,11,0,11
Elee,F,100,11,0,11
Eleesia,F,100,11,0,11
Elenah,F,100,11,0,11
Elenamarie,F,100,11,0,11
Eleodoro,M,100,0,11,11
Eleyah,F,100,11,0,11
Eliano,M,100,0,11,11
Eliason,M,100,0,11,11
Eliesha,F,100,11,0,11
Eliezel,M,100,0,11,11
Elijahjohn,M,100,0,11,11
Elionaid,M,100,0,11,11
Elionna,F,100,11,0,11
Elisiana,F,100,11,0,11
Elitha,F,100,11,0,11
Elixabeth,F,100,11,0,11
Ellamay,F,100,11,0,11
Ellany,F,100,11,0,11
Elloree,F,100,11,0,11
Elmir,M,100,0,11,11
Elmus,M,100,0,11,11
Elom,M,100,0,11,11
Elonte,M,100,0,11,11
Elpidia,F,100,11,0,11
Elyvia,F,100,11,0,11
Elzena,F,100,11,0,11
Embrya,F,100,11,0,11
Emel,F,100,11,0,11
Emelya,F,100,11,0,11
Emerito,M,100,0,11,11
Emilliana,F,100,11,0,11
Emmakay,F,100,11,0,11
Emmalinn,F,100,11,0,11
Emmelyne,F,100,11,0,11
Emperor,M,100,0,11,11
Emraan,M,100,0,11,11
Emryk,M,100,0,11,11
Emyr,M,100,0,11,11
Enalina,F,100,11,0,11
Enasia,F,100,11,0,11
Engel,M,100,0,11,11
Enith,F,100,11,0,11
Eola,F,100,11,0,11
Ephrain,M,100,0,11,11
Ericmichael,M,100,0,11,11
Eriella,F,100,11,0,11
Eriny,F,100,11,0,11
Eriyona,F,100,11,0,11
Ernette,F,100,11,0,11
Eronda,F,100,11,0,11
Ervine,M,100,0,11,11
Esmaralda,F,100,11,0,11
Esmerald,F,100,11,0,11
Esmerie,F,100,11,0,11
Estralita,F,100,11,0,11
Ethelda,F,100,11,0,11
Ethridge,M,100,0,11,11
Etna,F,100,11,0,11
Evangelo,M,100,0,11,11
Eveanna,F,100,11,0,11
Evelean,F,100,11,0,11
Eveliz,F,100,11,0,11
Evemarie,F,100,11,0,11
Evern,F,55,6,5,11
Evyanna,F,100,11,0,11
Evyonne,F,100,11,0,11
Eylan,M,100,0,11,11
Ezmariah,F,100,11,0,11
Ezzie,M,55,5,6,11
Falanda,F,100,11,0,11
Falencia,F,100,11,0,11
Fancie,F,100,11,0,11
Fanuel,M,100,0,11,11
Farihah,F,100,11,0,11
Farisa,F,100,11,0,11
Farouq,M,100,0,11,11
Farrakhan,M,100,0,11,11
Fasha,F,100,11,0,11
Fauzia,F,100,11,0,11
Fawad,M,100,0,11,11
Fayte,F,100,11,0,11
Fayza,F,100,11,0,11
Fazon,M,100,0,11,11
Feryal,F,100,11,0,11
Fiama,F,100,11,0,11
Fidelina,F,100,11,0,11
Fiori,F,100,11,0,11
Firdaws,F,100,11,0,11
Fleetwood,M,100,0,11,11
Flemming,M,100,0,11,11
Fonisha,F,100,11,0,11
Forester,M,100,0,11,11
Franccesca,F,100,11,0,11
Fray,M,100,0,11,11
Frederique,F,100,11,0,11
Frumie,F,100,11,0,11
Fynnley,F,100,11,0,11
Gaberielle,F,100,11,0,11
Gabril,M,100,0,11,11
Gabryal,M,100,0,11,11
Galatea,F,100,11,0,11
Galin,M,100,0,11,11
Galinda,F,100,11,0,11
Gaosheng,F,100,11,0,11
Garran,M,100,0,11,11
Garvens,M,100,0,11,11
Gavi,F,100,11,0,11
Gearldene,F,100,11,0,11
Genesse,F,100,11,0,11
Genessee,F,100,11,0,11
Gennesy,F,100,11,0,11
Genovia,F,100,11,0,11
Georgan,F,100,11,0,11
Georgiaann,F,100,11,0,11
Geovanne,M,100,0,11,11
Gerick,M,100,0,11,11
Gerid,M,100,0,11,11
Gerlean,F,100,11,0,11
Gerran,M,100,0,11,11
Gerrilynn,F,100,11,0,11
Gerrin,M,100,0,11,11
Getzemany,F,100,11,0,11
Ghislane,F,100,11,0,11
Gianmarcos,M,100,0,11,11
Giannella,F,100,11,0,11
Gibb,M,100,0,11,11
Gilson,M,100,0,11,11
Ginetta,F,100,11,0,11
Giuseppa,F,100,11,0,11
Givonni,M,100,0,11,11
Glendall,M,100,0,11,11
Glennys,F,100,11,0,11
Glorida,F,100,11,0,11
Glorine,F,100,11,0,11
Gloryann,F,100,11,0,11
Glynes,F,100,11,0,11
God,M,100,0,11,11
Goku,M,100,0,11,11
Grabriel,M,100,0,11,11
Graidy,M,100,0,11,11
Graycelyn,F,100,11,0,11
Greydy,F,100,11,0,11
Greylin,M,100,0,11,11
Greysi,F,100,11,0,11
Guinn,M,100,0,11,11
Gurshawn,M,100,0,11,11
Gustas,M,100,0,11,11
Guynell,F,100,11,0,11
Guztavo,M,100,0,11,11
Gwenevieve,F,100,11,0,11
Haaheo,M,100,0,11,11
Hailye,F,100,11,0,11
Haithem,M,100,0,11,11
Haize,M,55,5,6,11
Hanady,F,100,11,0,11
Hannabelle,F,100,11,0,11
Haresh,M,100,0,11,11
Harin,M,100,0,11,11
Hartej,M,100,0,11,11
Hasaun,M,100,0,11,11
Hasika,F,100,11,0,11
Hasim,M,100,0,11,11
Hasita,F,100,11,0,11
Hassanatou,F,100,11,0,11
Hassane,M,100,0,11,11
Hather,F,100,11,0,11
Havik,M,100,0,11,11
Hawkeye,M,100,0,11,11
Hawthorn,M,100,0,11,11
Hayah,F,100,11,0,11
Hazleigh,F,100,11,0,11
Heatherlyn,F,100,11,0,11
Heavenlei,F,100,11,0,11
Heavenley,F,100,11,0,11
Heera,F,100,11,0,11
Heiry,F,100,11,0,11
Heisy,F,100,11,0,11
Helaena,F,100,11,0,11
Helenann,F,100,11,0,11
Helo,M,100,0,11,11
Henoc,M,100,0,11,11
Hermelindo,M,100,0,11,11
Heydan,M,100,0,11,11
Hidayah,F,100,11,0,11
Hinano,F,100,11,0,11
Hipolita,F,100,11,0,11
Hitzel,F,100,11,0,11
Hopemarie,F,100,11,0,11
Hoskie,M,100,0,11,11
Hovig,M,100,0,11,11
Howland,M,100,0,11,11
Hozie,M,100,0,11,11
Hrach,M,100,0,11,11
Iannah,F,100,11,0,11
Icel,F,100,11,0,11
Iddo,M,100,0,11,11
Idena,F,100,11,0,11
Iffat,F,100,11,0,11
Ijaz,M,100,0,11,11
Ikera,F,100,11,0,11
Ikie,M,100,0,11,11
Ikira,F,100,11,0,11
Ikraan,F,100,11,0,11
Ilaya,F,100,11,0,11
Ileena,F,100,11,0,11
Ileia,F,100,11,0,11
Ileta,F,100,11,0,11
Ilianis,F,100,11,0,11
Ilinca,F,100,11,0,11
Ilitia,F,100,11,0,11
Imany,F,100,11,0,11
Immacolata,F,100,11,0,11
Immer,M,100,0,11,11
Ineta,F,100,11,0,11
Infantgirl,F,100,11,0,11
Irah,M,55,5,6,11
Iraj,F,100,11,0,11
Iralyn,F,100,11,0,11
Irieana,F,100,11,0,11
Iristine,F,100,11,0,11
Iriz,F,100,11,0,11
Isahias,M,100,0,11,11
Isain,M,100,0,11,11
Isaira,F,100,11,0,11
Isana,F,100,11,0,11
Isavela,F,100,11,0,11
Isbel,F,100,11,0,11
Ishamel,M,100,0,11,11
Islee,F,100,11,0,11
Ismel,M,100,0,11,11
Issel,F,100,11,0,11
Iszac,M,100,0,11,11
Itzury,F,100,11,0,11
Ivica,M,100,0,11,11
Iwana,F,100,11,0,11
Iyaad,M,100,0,11,11
Iyssis,F,100,11,0,11
Izzabellah,F,100,11,0,11
Izzat,M,100,0,11,11
Jaalyn,M,55,5,6,11
Jabarr,M,100,0,11,11
Jabary,M,100,0,11,11
Jaborie,M,100,0,11,11
Jabrielle,F,100,11,0,11
Jabrion,M,100,0,11,11
Jaccari,M,100,0,11,11
Jacklon,F,100,11,0,11
Jackqulin,F,100,11,0,11
Jacopo,M,100,0,11,11
Jacquille,M,100,0,11,11
Jacquitta,F,100,11,0,11
Jacylyn,F,100,11,0,11
Jadeah,F,100,11,0,11
Jadelynne,F,100,11,0,11
Jaderius,M,100,0,11,11
Jaea,F,100,11,0,11
Jahaven,M,100,0,11,11
Jahkim,M,100,0,11,11
Jahmaine,M,100,0,11,11
Jahnyia,F,100,11,0,11
Jaiceion,M,100,0,11,11
Jaidenn,M,100,0,11,11
Jaidlyn,F,100,11,0,11
Jaimz,M,100,0,11,11
Jakavian,M,100,0,11,11
Jakeelah,F,100,11,0,11
Jakeena,F,100,11,0,11
Jakendra,F,100,11,0,11
Jakhyla,F,100,11,0,11
Jakora,F,100,11,0,11
Jakoria,F,100,11,0,11
Jakov,M,100,0,11,11
Jakyriah,F,100,11,0,11
Jakzenny,F,100,11,0,11
Jalay,F,100,11,0,11
Jaleyiah,F,100,11,0,11
Jaliyl,M,100,0,11,11
Jalyssia,F,100,11,0,11
Jamiir,M,100,0,11,11
Jamirion,M,100,0,11,11
Jamyr,M,100,0,11,11
Janaee,F,100,11,0,11
Janayiah,F,100,11,0,11
Janayshia,F,100,11,0,11
Janci,F,100,11,0,11
Jandee,F,100,11,0,11
Janeesha,F,100,11,0,11
Janek,M,100,0,11,11
Janielis,F,100,11,0,11
Japaul,M,100,0,11,11
Japneet,F,100,11,0,11
Jaqari,M,100,0,11,11
Jaquar,M,100,0,11,11
Jaquaun,M,100,0,11,11
Jaquoia,F,100,11,0,11
Jarexy,F,100,11,0,11
Jarina,F,100,11,0,11
Jarlin,F,100,11,0,11
Jarlyn,F,100,11,0,11
Jarquavius,M,100,0,11,11
Jarrelle,M,100,0,11,11
Jarrot,M,100,0,11,11
Jarvus,M,100,0,11,11
Jaryia,F,100,11,0,11
Jaryl,M,100,0,11,11
Jaseena,F,100,11,0,11
Jashandeep,M,100,0,11,11
Jashanna,F,100,11,0,11
Jasminda,F,100,11,0,11
Jaspen,M,100,0,11,11
Jastyn,F,100,11,0,11
Jasya,F,100,11,0,11
Jasyia,F,100,11,0,11
Jaterra,F,100,11,0,11
Jaterrica,F,100,11,0,11
Jatorria,F,100,11,0,11
Jaushua,M,100,0,11,11
Javir,M,100,0,11,11
Javori,M,100,0,11,11
Jawayne,M,100,0,11,11
Jaxs,M,100,0,11,11
Jaydenlee,M,100,0,11,11
Jaylanis,F,100,11,0,11
Jaylann,F,100,11,0,11
Jayliannie,F,100,11,0,11
Jayliany,F,100,11,0,11
Jaymeir,M,100,0,11,11
Jaymez,M,100,0,11,11
Jayonn,M,100,0,11,11
Jayonte,M,100,0,11,11
Jayqwan,M,100,0,11,11
Jaysaun,M,100,0,11,11
Jazamine,F,100,11,0,11
Jazive,F,100,11,0,11
Jazyia,F,100,11,0,11
Jazyria,F,100,11,0,11
Jcyon,M,100,0,11,11
Jealyn,F,100,11,0,11
Jeanete,F,100,11,0,11
Jeaniene,F,100,11,0,11
Jeanique,F,100,11,0,11
Jeccica,F,100,11,0,11
Jeffon,M,100,0,11,11
Jefford,M,100,0,11,11
Jelah,F,100,11,0,11
Jenaliz,F,100,11,0,11
Jencie,F,100,11,0,11
Jenessis,F,100,11,0,11
Jenevi,F,100,11,0,11
Jennaka,F,100,11,0,11
Jennaleigh,F,100,11,0,11
Jennille,F,100,11,0,11
Jennilynn,F,100,11,0,11
Jenrri,M,100,0,11,11
Jenyla,F,100,11,0,11
Jenziel,M,100,0,11,11
Jeovana,F,100,11,0,11
Jepson,M,100,0,11,11
Jerade,M,100,0,11,11
Jeraldi,F,100,11,0,11
Jeremyiah,M,100,0,11,11
Jerimih,M,100,0,11,11
Jerom,M,100,0,11,11
Jerrall,M,100,0,11,11
Jerrud,M,100,0,11,11
Jerwin,M,100,0,11,11
Jeselyn,F,100,11,0,11
Jeser,M,100,0,11,11
Jessmarie,F,100,11,0,11
Jesston,M,100,0,11,11
Jeveon,M,100,0,11,11
Jevonna,F,100,11,0,11
Jeylani,M,55,5,6,11
Jeylene,F,100,11,0,11
Jeylianis,F,100,11,0,11
Jeziyah,F,100,11,0,11
Jhariel,M,100,0,11,11
Jhia,F,100,11,0,11
Jhomar,M,100,0,11,11
Jhonas,M,100,0,11,11
Jhonnatan,M,100,0,11,11
Jiaya,F,100,11,0,11
Jicel,F,100,11,0,11
Jimette,F,100,11,0,11
Jimiya,F,100,11,0,11
Jisha,F,100,11,0,11
Jisiah,M,100,0,11,11
Jisoo,F,100,11,0,11
Jissele,F,100,11,0,11
Jliyah,F,100,11,0,11
Jmyah,F,100,11,0,11
Joahn,M,100,0,11,11
Joakin,M,100,0,11,11
Joaopaulo,M,100,0,11,11
Jodanna,F,100,11,0,11
Johao,M,100,0,11,11
Johhny,M,100,0,11,11
Johnecia,F,100,11,0,11
Johneen,F,100,11,0,11
Johnfrancis,M,100,0,11,11
Johniah,F,100,11,0,11
Johnnessa,F,100,11,0,11
Johnovan,M,100,0,11,11
Johnphillip,M,100,0,11,11
Johon,M,100,0,11,11
Jonathanjames,M,100,0,11,11
Jonicia,F,100,11,0,11
Joquin,M,100,0,11,11
Jordania,F,100,11,0,11
Jordanmichael,M,100,0,11,11
Jorgan,M,100,0,11,11
Joria,F,100,11,0,11
Joriah,M,55,5,6,11
Josaphat,M,100,0,11,11
Joscar,M,100,0,11,11
Joseignacio,M,100,0,11,11
Josepablo,M,100,0,11,11
Joshuaaaron,M,100,0,11,11
Joshuacaleb,M,100,0,11,11
Joshuadaniel,M,100,0,11,11
Josmarie,F,100,11,0,11
Jovahni,M,100,0,11,11
Jovanta,M,100,0,11,11
Jovianne,F,100,11,0,11
Jozaiah,M,100,0,11,11
Jozelle,F,100,11,0,11
Jozephine,F,100,11,0,11
Jozetta,F,100,11,0,11
Jssica,F,100,11,0,11
Juanfelipe,M,100,0,11,11
Juanpedro,M,100,0,11,11
Juawana,F,100,11,0,11
Judalon,F,100,11,0,11
Judia,F,100,11,0,11
Julitsa,F,100,11,0,11
Junice,F,100,11,0,11
Juriah,M,100,0,11,11
Jushawn,M,100,0,11,11
Justinjames,M,100,0,11,11
Jvante,M,100,0,11,11
Jvian,M,100,0,11,11
Jylin,M,100,0,11,11
Kabron,M,100,0,11,11
Kadell,M,100,0,11,11
Kaeliana,F,100,11,0,11
Kaffie,F,100,11,0,11
Kahia,F,100,11,0,11
Kahmia,F,100,11,0,11
Kahree,M,100,0,11,11
Kahyla,F,100,11,0,11
Kaianne,F,100,11,0,11
Kailla,F,100,11,0,11
Kaitelynn,F,100,11,0,11
Kaithleen,F,100,11,0,11
Kaiti,F,100,11,0,11
Kaitleen,F,100,11,0,11
Kaiyanna,F,100,11,0,11
Kajaun,M,100,0,11,11
Kaliff,M,100,0,11,11
Kalyx,M,100,0,11,11
Kamahri,M,100,0,11,11
Kamalu,M,100,0,11,11
Kameil,F,100,11,0,11
Kamekia,F,100,11,0,11
Kameyah,F,100,11,0,11
Kanethia,F,100,11,0,11
Kanish,M,100,0,11,11
Kannyn,F,100,11,0,11
Kapresha,F,100,11,0,11
Karai,F,100,11,0,11
Karana,F,100,11,0,11
Kardarius,M,100,0,11,11
Karega,M,100,0,11,11
Karelia,F,100,11,0,11
Karetha,F,100,11,0,11
Karhonda,F,100,11,0,11
Karionna,F,100,11,0,11
Karlah,F,100,11,0,11
Karlia,F,100,11,0,11
Karliee,F,100,11,0,11
Karm,M,100,0,11,11
Karmya,F,100,11,0,11
Karoleena,F,100,11,0,11
Karran,F,100,11,0,11
Karrar,M,100,0,11,11
Karrena,F,100,11,0,11
Karrianne,F,100,11,0,11
Karsan,M,100,0,11,11
Kashley,F,100,11,0,11
Kassiana,F,100,11,0,11
Kasundra,F,100,11,0,11
Katari,F,55,6,5,11
Katasia,F,100,11,0,11
Katerinne,F,100,11,0,11
Kateshia,F,100,11,0,11
Kathalyn,F,100,11,0,11
Kathlina,F,100,11,0,11
Kathylene,F,100,11,0,11
Katielee,F,100,11,0,11
Katiyah,F,100,11,0,11
Katybeth,F,100,11,0,11
Katyna,F,100,11,0,11
Kaui,F,100,11,0,11
Kavir,M,100,0,11,11
Kawtar,F,100,11,0,11
Kaycey,F,100,11,0,11
Kaydenze,F,100,11,0,11
Kayeden,M,100,0,11,11
Kayella,F,100,11,0,11
Kayenne,F,100,11,0,11
Kayke,M,100,0,11,11
Kayro,M,100,0,11,11
Kazumi,F,100,11,0,11
Kealynn,F,100,11,0,11
Keeron,M,100,0,11,11
Keerra,F,100,11,0,11
Keetra,F,100,11,0,11
Keidren,M,100,0,11,11
Keilanie,F,100,11,0,11
Keiliany,F,100,11,0,11
Keimiyah,F,100,11,0,11
Keiser,M,100,0,11,11
Keish,F,100,11,0,11
Keisher,F,100,11,0,11
Keity,F,100,11,0,11
Kelaia,F,100,11,0,11
Keleen,F,100,11,0,11
Kelvontae,M,100,0,11,11
Kelvonte,M,100,0,11,11
Kemilly,F,100,11,0,11
Kemontay,M,100,0,11,11
Kenara,F,100,11,0,11
Kendrae,M,100,0,11,11
Kendrall,M,100,0,11,11
Keneta,F,100,11,0,11
Kenshiro,M,100,0,11,11
Kentez,M,100,0,11,11
Kenyla,F,100,11,0,11
Keonni,F,100,11,0,11
Kereem,M,100,0,11,11
Keriona,F,100,11,0,11
Kerrey,F,100,11,0,11
Kerstine,F,100,11,0,11
Kertis,M,100,0,11,11
Keshandra,F,100,11,0,11
Keshi,F,100,11,0,11
Kesslyn,F,100,11,0,11
Ketric,M,100,0,11,11
Kevinisha,F,100,11,0,11
Keviyon,M,100,0,11,11
Keydren,M,100,0,11,11
Keyilah,F,100,11,0,11
Keyland,M,100,0,11,11
Keyniah,F,100,11,0,11
Keyonnia,F,100,11,0,11
Keyten,M,100,0,11,11
Keyuntae,M,100,0,11,11
Keywana,F,100,11,0,11
Khadafi,M,100,0,11,11
Khadejia,F,100,11,0,11
Khairee,M,100,0,11,11
Khalan,M,100,0,11,11
Khaleedah,F,100,11,0,11
Khaleyah,F,100,11,0,11
Khalisa,F,100,11,0,11
Khaydin,M,100,0,11,11
Khenadi,F,100,11,0,11
Khendra,F,100,11,0,11
Khimani,M,100,0,11,11
Khorey,M,100,0,11,11
Khouri,F,55,6,5,11
Khyana,F,100,11,0,11
Khyati,F,100,11,0,11
Khyber,M,100,0,11,11
Kianu,M,100,0,11,11
Kiden,F,100,11,0,11
Kiearah,F,100,11,0,11
Kievon,M,100,0,11,11
Killashandra,F,100,11,0,11
Killeen,F,100,11,0,11
Kimbel,M,100,0,11,11
Kimbereley,F,100,11,0,11
Kimely,F,100,11,0,11
Kimona,F,100,11,0,11
Kimoree,F,100,11,0,11
Kinadee,F,100,11,0,11
Kindu,M,100,0,11,11
Kingjosiah,M,100,0,11,11
Kiniya,F,100,11,0,11
Kinnidy,F,100,11,0,11
Kiontae,M,100,0,11,11
Kirklen,M,100,0,11,11
Kiros,M,100,0,11,11
Kirstynn,F,100,11,0,11
Kirsy,F,100,11,0,11
Kirya,F,100,11,0,11
Kison,M,100,0,11,11
Kiyle,M,100,0,11,11
Kiyler,M,100,0,11,11
Klariza,F,100,11,0,11
Klarrisa,F,100,11,0,11
Klorissa,F,100,11,0,11
Kmyah,F,100,11,0,11
Kobby,M,100,0,11,11
Kohyn,M,100,0,11,11
Kokoro,F,100,11,0,11
Kolbin,M,100,0,11,11
Kolsten,M,100,0,11,11
Kondwani,M,100,0,11,11
Koreyon,M,100,0,11,11
Koula,F,100,11,0,11
Koushik,M,100,0,11,11
Krin,F,100,11,0,11
Krisily,F,100,11,0,11
Krisstina,F,100,11,0,11
Kristne,F,100,11,0,11
Kristobal,M,100,0,11,11
Kristophor,M,100,0,11,11
Kruise,M,100,0,11,11
Kum,F,100,11,0,11
Kurosh,M,100,0,11,11
Kwadjo,M,100,0,11,11
Kyeleigh,F,100,11,0,11
Kyeler,M,100,0,11,11
Kyersten,F,100,11,0,11
Kyhia,F,100,11,0,11
Kylaa,F,100,11,0,11
Kylana,F,100,11,0,11
Kylematthew,M,100,0,11,11
Kyliemarie,F,100,11,0,11
Kymbria,F,100,11,0,11
Kymorra,F,100,11,0,11
Kyoka,F,100,11,0,11
Kysan,M,100,0,11,11
Kytana,F,100,11,0,11
Kywaun,M,100,0,11,11
Kyya,F,100,11,0,11
Labelle,F,100,11,0,11
Lacher,F,100,11,0,11
Lachrisa,F,100,11,0,11
Lad,M,100,0,11,11
Ladia,F,100,11,0,11
Lafern,F,100,11,0,11
Lajoi,F,100,11,0,11
Lakay,F,100,11,0,11
Lakelee,F,100,11,0,11
Lakesiha,F,100,11,0,11
Lakicha,F,100,11,0,11
Lakisia,F,100,11,0,11
Lakizzy,F,100,11,0,11
Lakoya,F,100,11,0,11
Lamarea,F,100,11,0,11
Lamariyah,F,100,11,0,11
Lanaeya,F,100,11,0,11
Lanaria,F,100,11,0,11
Lanashia,F,100,11,0,11
Laneigh,F,100,11,0,11
Laneika,F,100,11,0,11
Lanikki,F,100,11,0,11
Laniyha,F,100,11,0,11
Lapresha,F,100,11,0,11
Lapria,F,100,11,0,11
Larasha,F,100,11,0,11
Larris,M,100,0,11,11
Larwance,M,100,0,11,11
Lasana,M,100,0,11,11
Lashada,F,100,11,0,11
Lashella,F,100,11,0,11
Lastasha,F,100,11,0,11
Lasunda,F,100,11,0,11
Laterrious,M,100,0,11,11
Latevin,M,100,0,11,11
Latiasha,F,100,11,0,11
Latiffa,F,100,11,0,11
Latijera,F,100,11,0,11
Latony,M,100,0,11,11
Latoye,F,100,11,0,11
Latoyo,F,100,11,0,11
Latrenia,F,100,11,0,11
Latrevia,F,100,11,0,11
Latryce,F,100,11,0,11
Laurenn,F,100,11,0,11
Lavania,F,100,11,0,11
Laven,M,100,0,11,11
Lavester,M,100,0,11,11
Laxavier,M,100,0,11,11
Lazarria,F,100,11,0,11
Leangela,F,100,11,0,11
Leasie,F,100,11,0,11
Leca,F,100,11,0,11
Leeaira,F,100,11,0,11
Leemichael,M,100,0,11,11
Leeron,M,100,0,11,11
Leilannie,F,100,11,0,11
Lekeia,F,100,11,0,11
Leketha,F,100,11,0,11
Lemmy,M,100,0,11,11
Leonidis,M,100,0,11,11
Leri,M,100,0,11,11
Leroyal,M,100,0,11,11
Lessette,F,100,11,0,11
Letycia,F,100,11,0,11
Leudy,M,100,0,11,11
Levinia,F,100,11,0,11
Levyn,M,100,0,11,11
Lija,F,100,11,0,11
Liliona,F,100,11,0,11
Lilliani,F,100,11,0,11
Lillyaunna,F,100,11,0,11
Linayah,F,100,11,0,11
Lincey,F,100,11,0,11
Lindale,M,100,0,11,11
Lindle,M,100,0,11,11
Linsee,F,100,11,0,11
Lionso,M,100,0,11,11
Lisbett,F,100,11,0,11
Lissbeth,F,100,11,0,11
Lizaida,F,100,11,0,11
Lloyde,M,100,0,11,11
Loisteen,F,100,11,0,11
Lojain,F,100,11,0,11
Loranne,F,100,11,0,11
Loreina,F,100,11,0,11
Loreyna,F,100,11,0,11
Lorez,F,100,11,0,11
Lorrita,F,100,11,0,11
Lotanna,M,55,5,6,11
Lougene,M,100,0,11,11
Loujean,F,100,11,0,11
Lourena,F,100,11,0,11
Loxie,F,100,11,0,11
Lubov,F,100,11,0,11
Lucenda,F,100,11,0,11
Lucesita,F,100,11,0,11
Lucricia,F,100,11,0,11
Ludean,F,100,11,0,11
Ludell,F,100,11,0,11
Ludia,F,100,11,0,11
Luigina,F,100,11,0,11
Luisalejandro,M,100,0,11,11
Luisandres,M,100,0,11,11
Luisgerardo,M,100,0,11,11
Lukeshia,F,100,11,0,11
Lukian,M,100,0,11,11
Lukkas,M,100,0,11,11
Lunda,F,100,11,0,11
Lunell,F,100,11,0,11
Luzero,F,100,11,0,11
Lyanah,F,100,11,0,11
Lyela,F,100,11,0,11
Lyndra,F,100,11,0,11
Lynnesha,F,100,11,0,11
Lynnisha,F,100,11,0,11
Lynnsay,F,100,11,0,11
Lyrie,F,100,11,0,11
Lyta,F,100,11,0,11
Lyudmila,F,100,11,0,11
Maali,F,100,11,0,11
Maber,F,100,11,0,11
Machela,F,100,11,0,11
Machia,F,100,11,0,11
Machiah,F,100,11,0,11
Mackanzie,F,100,11,0,11
Maclan,M,100,0,11,11
Maclay,F,100,11,0,11
Macynn,F,100,11,0,11
Maddan,M,100,0,11,11
Madelayne,F,100,11,0,11
Madhura,F,100,11,0,11
Madisonrose,F,100,11,0,11
Maeleah,F,100,11,0,11
Maelia,F,100,11,0,11
Maesha,F,100,11,0,11
Magalis,F,100,11,0,11
Mahit,M,100,0,11,11
Mahleah,F,100,11,0,11
Mahoghany,F,100,11,0,11
Mahriah,F,100,11,0,11
Mahtab,F,100,11,0,11
Mailia,F,100,11,0,11
Mairene,F,100,11,0,11
Maissa,F,100,11,0,11
Maitlin,F,100,11,0,11
Majda,F,100,11,0,11
Makaili,F,100,11,0,11
Makamae,F,100,11,0,11
Makayda,F,100,11,0,11
Makaylea,F,100,11,0,11
Makhii,M,100,0,11,11
Makil,M,100,0,11,11
Makonnen,M,100,0,11,11
Maksimus,M,100,0,11,11
Malayha,F,100,11,0,11
Malec,M,100,0,11,11
Malen,M,55,5,6,11
Malenda,F,100,11,0,11
Maliak,M,100,0,11,11
Maliaya,F,100,11,0,11
Malinah,F,100,11,0,11
Maliza,F,100,11,0,11
Mallerly,F,100,11,0,11
Malta,F,100,11,0,11
Malysa,F,100,11,0,11
Manetta,F,100,11,0,11
Mannuel,M,100,0,11,11
Maraih,F,100,11,0,11
Maraja,F,100,11,0,11
Maray,F,100,11,0,11
Marcedez,F,100,11,0,11
Marcisha,F,100,11,0,11
Marcusanthony,M,100,0,11,11
Marden,M,100,0,11,11
Mareisha,F,100,11,0,11
Margrethe,F,100,11,0,11
Margurita,F,100,11,0,11
Mariaangelica,F,100,11,0,11
Mariaeduard,F,100,11,0,11
Mariarosa,F,100,11,0,11
Mariby,F,100,11,0,11
Marichelle,F,100,11,0,11
Marideth,F,100,11,0,11
Marieanna,F,100,11,0,11
Marierose,F,100,11,0,11
Mariyan,F,100,11,0,11
Mariyani,F,100,11,0,11
Markangelo,M,100,0,11,11
Marken,M,100,0,11,11
Markiea,F,100,11,0,11
Markiest,M,100,0,11,11
Markieth,M,100,0,11,11
Markina,F,100,11,0,11
Markius,M,100,0,11,11
Marlenee,F,100,11,0,11
Marlenis,F,100,11,0,11
Marlenn,F,100,11,0,11
Marlesa,F,100,11,0,11
Marleyann,F,100,11,0,11
Marlianna,F,100,11,0,11
Marnia,F,100,11,0,11
Marquala,F,100,11,0,11
Marquiss,M,100,0,11,11
Marriam,F,100,11,0,11
Marshaya,F,100,11,0,11
Marsheela,F,100,11,0,11
Martaz,M,100,0,11,11
Marthann,F,100,11,0,11
Maryelle,F,100,11,0,11
Maryjeanne,F,100,11,0,11
Maryke,F,100,11,0,11
Masada,M,55,5,6,11
Mashawna,F,100,11,0,11
Mashaya,F,100,11,0,11
Mashika,F,100,11,0,11
Massi,M,100,0,11,11
Mastin,M,100,0,11,11
Mateos,M,100,0,11,11
Matesha,F,100,11,0,11
Mathison,M,55,5,6,11
Mathu,M,100,0,11,11
Matteen,M,100,0,11,11
Matthewalexande,M,100,0,11,11
Maudell,F,100,11,0,11
Mayalen,F,100,11,0,11
Maybellene,F,100,11,0,11
Mayel,M,100,0,11,11
Maylet,F,100,11,0,11
Maylinn,F,100,11,0,11
Mayon,M,100,0,11,11
Maysha,F,100,11,0,11
Mayven,F,100,11,0,11
Maziya,F,100,11,0,11
Mckalynn,F,100,11,0,11
Mckensy,F,100,11,0,11
Mckinnah,F,100,11,0,11
Mckynli,F,100,11,0,11
Mecos,M,100,0,11,11
Medger,M,100,0,11,11
Meea,F,100,11,0,11
Meina,F,100,11,0,11
Mekhiah,F,100,11,0,11
Mekhya,F,100,11,0,11
Melad,M,100,0,11,11
Melech,M,100,0,11,11
Melian,F,100,11,0,11
Melissaanne,F,100,11,0,11
Mendee,F,100,11,0,11
Menika,F,100,11,0,11
Merdith,F,100,11,0,11
Meritta,F,100,11,0,11
Mertha,F,100,11,0,11
Mertice,F,100,11,0,11
Miajah,F,100,11,0,11
Micalyn,F,100,11,0,11
Michealangelo,M,100,0,11,11
Michellle,F,100,11,0,11
Michonne,F,100,11,0,11
Michyla,F,100,11,0,11
Mickenzy,F,100,11,0,11
Miella,F,100,11,0,11
Mierra,F,100,11,0,11
Mikasia,F,100,11,0,11
Mikecia,F,100,11,0,11
Miketa,F,100,11,0,11
Mikkia,F,100,11,0,11
Milasia,F,100,11,0,11
Milderd,F,100,11,0,11
Milin,M,100,0,11,11
Millian,F,100,11,0,11
Millyana,F,100,11,0,11
Mimma,F,100,11,0,11
Minerba,F,100,11,0,11
Minesha,F,100,11,0,11
Miori,F,100,11,0,11
Mirannda,F,100,11,0,11
Mireyda,F,100,11,0,11
Mitsuki,F,100,11,0,11
Moire,F,100,11,0,11
Monalee,F,100,11,0,11
Moneik,F,100,11,0,11
Moniquie,F,100,11,0,11
Monsserat,F,100,11,0,11
Moreno,M,100,0,11,11
Morghann,F,100,11,0,11
Morgynn,F,100,11,0,11
Mosa,M,100,0,11,11
Moxley,M,100,0,11,11
Moxxi,F,100,11,0,11
Mubina,F,100,11,0,11
Mueez,M,100,0,11,11
Mulani,F,100,11,0,11
Mundy,F,100,11,0,11
Munib,M,100,0,11,11
Murleen,F,100,11,0,11
Musheerah,F,100,11,0,11
Myionna,F,100,11,0,11
Myjah,F,100,11,0,11
Mykenzee,F,100,11,0,11
Mykera,F,100,11,0,11
Mykhail,M,100,0,11,11
Myleena,F,100,11,0,11
Mylla,F,100,11,0,11
Naadirah,F,100,11,0,11
Naazir,M,100,0,11,11
Nabella,F,100,11,0,11
Nachole,F,100,11,0,11
Nadal,M,100,0,11,11
Nadasia,F,100,11,0,11
Naheed,F,100,11,0,11
Nahyla,F,100,11,0,11
Naisa,F,100,11,0,11
Naishawn,M,100,0,11,11
Naiyeli,F,100,11,0,11
Najada,F,100,11,0,11
Najeli,F,100,11,0,11
Najier,M,100,0,11,11
Nakoda,M,100,0,11,11
Nakysha,F,100,11,0,11
Nalan,M,100,0,11,11
Nanaama,F,100,11,0,11
Nandhana,F,100,11,0,11
Nando,M,100,0,11,11
Nang,M,100,0,11,11
Nanna,F,100,11,0,11
Nansy,F,100,11,0,11
Naquanda,F,100,11,0,11
Narcissus,F,100,11,0,11
Narith,M,100,0,11,11
Nashir,M,100,0,11,11
Natalieann,F,100,11,0,11
Natashua,F,100,11,0,11
Natay,F,100,11,0,11
Naterria,F,100,11,0,11
Nathasa,F,100,11,0,11
Nathniel,M,100,0,11,11
Natiana,F,100,11,0,11
Natrina,F,100,11,0,11
Nattalee,F,100,11,0,11
Naum,M,100,0,11,11
Nayelle,F,100,11,0,11
Nayome,F,100,11,0,11
Nayseth,F,100,11,0,11
Nazarah,F,100,11,0,11
Nazeir,M,100,0,11,11
Neako,M,100,0,11,11
Nechemya,M,100,0,11,11
Neeraja,F,100,11,0,11
Negus,M,100,0,11,11
Nelcy,F,100,11,0,11
Nelisa,F,100,11,0,11
Nelsie,F,100,11,0,11
Neon,M,100,0,11,11
Nequita,F,100,11,0,11
Nerlande,F,100,11,0,11
Neshaun,M,100,0,11,11
Ness,M,100,0,11,11
Nev,F,100,11,0,11
Neyamiah,F,55,6,5,11
Neyzer,M,100,0,11,11
Niaylah,F,100,11,0,11
Nickell,F,100,11,0,11
Nicquan,M,100,0,11,11
Nijayah,F,100,11,0,11
Nikali,M,100,0,11,11
Niketta,F,100,11,0,11
Nikith,M,100,0,11,11
Nikohl,F,100,11,0,11
Nikolaas,M,100,0,11,11
Nikoles,M,100,0,11,11
Nikson,M,100,0,11,11
Nilla,F,100,11,0,11
Niloofar,F,100,11,0,11
Nimat,F,100,11,0,11
Ninotchka,F,100,11,0,11
Niriah,F,100,11,0,11
Nirmala,F,100,11,0,11
Nishia,F,100,11,0,11
Nitsa,F,100,11,0,11
Nittaya,F,100,11,0,11
Niyae,F,100,11,0,11
Niyona,F,100,11,0,11
Njideka,F,100,11,0,11
Noahh,M,100,0,11,11
Noalani,F,100,11,0,11
Nodin,M,100,0,11,11
Nolie,F,100,11,0,11
Noori,F,100,11,0,11
Nor,M,55,5,6,11
Norann,F,100,11,0,11
Norelis,F,100,11,0,11
Norrisa,F,100,11,0,11
Noureen,F,100,11,0,11
Nouri,M,100,0,11,11
Nowshin,F,100,11,0,11
Ny,F,100,11,0,11
Nydirah,F,100,11,0,11
Nyre,F,55,6,5,11
Oakly,M,100,0,11,11
Oaks,M,100,0,11,11
Odeh,M,100,0,11,11
Odel,M,55,5,6,11
Odett,F,100,11,0,11
Odies,M,100,0,11,11
Ohene,M,100,0,11,11
Ojany,M,100,0,11,11
Okan,M,100,0,11,11
Oladapo,M,100,0,11,11
Oleatha,F,100,11,0,11
Olijah,M,100,0,11,11
Olubukola,F,100,11,0,11
Oluwaseyifunmi,F,55,6,5,11
Oluwatoniloba,F,55,6,5,11
Omiyah,F,100,11,0,11
Omotola,F,100,11,0,11
Ontonio,M,100,0,11,11
Onyinyechukwu,F,100,11,0,11
Oreanna,F,100,11,0,11
Orisha,F,100,11,0,11
Orlaith,F,100,11,0,11
Orlantha,F,100,11,0,11
Orvie,M,100,0,11,11
Orysia,F,100,11,0,11
Osbert,M,100,0,11,11
Osheana,F,100,11,0,11
Oshia,F,100,11,0,11
Otylia,F,100,11,0,11
Oval,M,100,0,11,11
Paelynn,F,100,11,0,11
Paj,F,100,11,0,11
Palash,M,100,0,11,11
Paradice,F,100,11,0,11
Paramveer,M,100,0,11,11
Pareesa,F,100,11,0,11
Parinita,F,100,11,0,11
Pariz,F,100,11,0,11
Parvathy,F,100,11,0,11
Pascuala,F,100,11,0,11
Pasleigh,F,100,11,0,11
Patracia,F,100,11,0,11
Patron,M,100,0,11,11
Pauljohn,M,100,0,11,11
Peggyanne,F,100,11,0,11
Peighten,F,100,11,0,11
Pela,F,100,11,0,11
Persephany,F,100,11,0,11
Pertina,F,100,11,0,11
Petie,M,100,0,11,11
Pfeiffer,F,100,11,0,11
Phanuel,M,100,0,11,11
Pharon,M,55,5,6,11
Philene,F,100,11,0,11
Phillisha,F,100,11,0,11
Phineus,M,100,0,11,11
Phinn,M,100,0,11,11
Phoenixx,F,100,11,0,11
Phylica,F,100,11,0,11
Phyllisha,F,100,11,0,11
Piccola,F,100,11,0,11
Pita,M,100,0,11,11
Pleasure,F,100,11,0,11
Porcher,F,100,11,0,11
Posy,F,100,11,0,11
Prakhar,M,100,0,11,11
Pranshi,F,100,11,0,11
Praxton,M,100,0,11,11
Preksha,F,100,11,0,11
Prezleigh,F,100,11,0,11
Pristina,F,100,11,0,11
Pritam,M,100,0,11,11
Quaashie,M,100,0,11,11
Quameer,M,100,0,11,11
Quanasha,F,100,11,0,11
Quantesha,F,100,11,0,11
Quanye,M,100,0,11,11
Quarterrio,M,100,0,11,11
Quatia,F,100,11,0,11
Quaylen,M,100,0,11,11
Quaysean,M,100,0,11,11
Queana,F,100,11,0,11
Queanna,F,100,11,0,11
Quiency,M,100,0,11,11
Quill,M,100,0,11,11
Quintonia,F,100,11,0,11
Quwana,F,100,11,0,11
Quwanda,F,100,11,0,11
Racie,F,100,11,0,11
Radcliffe,M,100,0,11,11
Radell,M,55,5,6,11
Radyn,M,100,0,11,11
Rahaman,M,100,0,11,11
Rahquan,M,100,0,11,11
Rahshan,M,100,0,11,11
Rahson,M,100,0,11,11
Ramazan,M,100,0,11,11
Rameer,M,100,0,11,11
Rameir,M,100,0,11,11
Ramire,M,100,0,11,11
Ramo,M,100,0,11,11
Ranaye,F,100,11,0,11
Rashe,M,100,0,11,11
Rashem,M,100,0,11,11
Rashine,M,100,0,11,11
Raulin,M,100,0,11,11
Raushana,F,100,11,0,11
Ravensimone,F,100,11,0,11
Rawle,M,100,0,11,11
Rayborn,M,100,0,11,11
Rayiona,F,100,11,0,11
Rayleah,F,100,11,0,11
Raymonte,M,100,0,11,11
Raynav,M,100,0,11,11
Raynika,F,100,11,0,11
Raynique,F,100,11,0,11
Rayola,F,100,11,0,11
Rayqwan,M,100,0,11,11
Reanetta,F,100,11,0,11
Reeba,F,100,11,0,11
Reider,M,100,0,11,11
Reili,M,55,5,6,11
Reinalda,F,100,11,0,11
Relonda,F,100,11,0,11
Remer,M,100,0,11,11
Remii,F,100,11,0,11
Renina,F,100,11,0,11
Renorda,F,100,11,0,11
Resheena,F,100,11,0,11
Reshelle,F,100,11,0,11
Rethel,F,100,11,0,11
Reynier,M,100,0,11,11
Reyse,F,100,11,0,11
Rhiannen,F,100,11,0,11
Rhiauna,F,100,11,0,11
Rhoen,M,100,0,11,11
Rhydian,M,100,0,11,11
Rhyla,F,100,11,0,11
Rhylinn,F,100,11,0,11
Rialey,F,100,11,0,11
Richon,M,100,0,11,11
Richter,M,100,0,11,11
Ricia,F,100,11,0,11
Rigden,M,100,0,11,11
Riggen,M,100,0,11,11
Rigsby,M,100,0,11,11
Riniya,F,100,11,0,11
Rishitha,F,100,11,0,11
Roberrt,M,100,0,11,11
Rochely,F,100,11,0,11
Rodas,F,100,11,0,11
Roddell,M,100,0,11,11
Rodion,M,100,0,11,11
Rodneka,F,100,11,0,11
Rodrekus,M,100,0,11,11
Roechelle,F,100,11,0,11
Roetta,F,100,11,0,11
Rokeya,F,100,11,0,11
Romiah,F,100,11,0,11
Ronaldino,M,100,0,11,11
Rondald,M,100,0,11,11
Ronicka,F,100,11,0,11
Ronnal,M,100,0,11,11
Ronnasia,F,100,11,0,11
Ronreaco,M,100,0,11,11
Ronzel,M,100,0,11,11
Rorick,M,100,0,11,11
Rosheka,F,100,11,0,11
Rosilind,F,100,11,0,11
Rothana,M,55,5,6,11
Rounak,M,100,0,11,11
Roxxi,F,100,11,0,11
Rozie,F,100,11,0,11
Ruban,M,100,0,11,11
Rubena,F,100,11,0,11
Rubymae,F,100,11,0,11
Rukayat,F,100,11,0,11
Ruqaiya,F,100,11,0,11
Rustan,M,100,0,11,11
Ruthan,F,100,11,0,11
Ruthena,F,100,11,0,11
Rutvi,F,100,11,0,11
Ryasia,F,100,11,0,11
Ryly,F,55,6,5,11
Rynisha,F,100,11,0,11
Ryssa,F,100,11,0,11
Ryuichi,M,100,0,11,11
Saajid,M,100,0,11,11
Saalim,M,100,0,11,11
Saamya,F,100,11,0,11
Saania,F,100,11,0,11
Saaniyah,F,100,11,0,11
Saaphyri,F,100,11,0,11
Saberina,F,100,11,0,11
Saboor,M,100,0,11,11
Sabrinamarie,F,100,11,0,11
Sachika,F,100,11,0,11
Sacia,F,100,11,0,11
Sadan,F,100,11,0,11
Sadora,F,100,11,0,11
Saegan,F,100,11,0,11
Safeerah,F,100,11,0,11
Safiye,F,100,11,0,11
Sahl,M,100,0,11,11
Sahvana,F,100,11,0,11
Sait,M,100,0,11,11
Sajdah,F,100,11,0,11
Salana,F,100,11,0,11
Salette,F,100,11,0,11
Sambo,M,100,0,11,11
Sameeksha,F,100,11,0,11
Samith,M,100,0,11,11
Samoan,F,100,11,0,11
Samridh,M,100,0,11,11
Samuelu,M,100,0,11,11
Sandral,F,100,11,0,11
Sandre,F,100,11,0,11
Sanjeet,M,100,0,11,11
Sannidhi,F,100,11,0,11
Sarahkate,F,100,11,0,11
Sarahlee,F,100,11,0,11
Sarith,M,100,0,11,11
Sarne,F,100,11,0,11
Saronda,F,100,11,0,11
Sarosh,M,100,0,11,11
Saudi,F,100,11,0,11
Sawda,F,100,11,0,11
Saylem,F,100,11,0,11
Seaneen,F,100,11,0,11
Seanette,F,100,11,0,11
Sebastia,M,100,0,11,11
Seela,F,100,11,0,11
Seerit,F,100,11,0,11
Sef,M,100,0,11,11
Selecia,F,100,11,0,11
Selinna,F,100,11,0,11
Senja,F,100,11,0,11
Senneca,M,100,0,11,11
Serenety,F,100,11,0,11
Serenitey,F,100,11,0,11
Seteria,F,100,11,0,11
Sethaniel,M,100,0,11,11
Severine,F,100,11,0,11
Sevina,F,100,11,0,11
Shaakirah,F,100,11,0,11
Shacarla,F,100,11,0,11
Shachar,M,100,0,11,11
Shacorey,M,100,0,11,11
Shacoyia,F,100,11,0,11
Shadan,F,100,11,0,11
Shaderrica,F,100,11,0,11
Shadric,M,100,0,11,11
Shadrika,F,100,11,0,11
Shadron,M,100,0,11,11
Shadyn,F,55,6,5,11
Shaeden,M,100,0,11,11
Shaheeda,F,100,11,0,11
Shahina,F,100,11,0,11
Shaiheem,M,100,0,11,11
Shaimaa,F,100,11,0,11
Shalani,F,100,11,0,11
Shalean,F,100,11,0,11
Shaline,F,100,11,0,11
Shallin,F,100,11,0,11
Shamala,F,100,11,0,11
Shamario,M,100,0,11,11
Shamariya,F,100,11,0,11
Shamiko,F,100,11,0,11
Shamilla,F,100,11,0,11
Shanaira,F,100,11,0,11
Shaneaka,F,100,11,0,11
Shaniaya,F,100,11,0,11
Shanndolyn,F,100,11,0,11
Shannondoah,F,100,11,0,11
Shanque,F,100,11,0,11
Shanquella,F,100,11,0,11
Shantrese,F,100,11,0,11
Shaquashia,F,100,11,0,11
Shaquena,F,100,11,0,11
Shaqura,F,100,11,0,11
Sharath,M,100,0,11,11
Sharidan,F,100,11,0,11
Sharlane,F,100,11,0,11
Sharmine,F,100,11,0,11
Sharnett,F,100,11,0,11
Sharo,F,100,11,0,11
Shatesha,F,100,11,0,11
Shatiana,F,100,11,0,11
Shatica,F,100,11,0,11
Shatice,F,100,11,0,11
Shatondra,F,100,11,0,11
Shaunece,F,100,11,0,11
Shavina,F,100,11,0,11
Shawauna,F,100,11,0,11
Shawen,M,100,0,11,11
Shawnett,F,100,11,0,11
Shawnnessy,F,100,11,0,11
Shawnti,F,100,11,0,11
Shealeen,F,100,11,0,11
Sheereen,F,100,11,0,11
Sheketha,F,100,11,0,11
Shelice,F,100,11,0,11
Shelline,F,100,11,0,11
Shemarr,M,100,0,11,11
Shenisha,F,100,11,0,11
Shephard,M,100,0,11,11
Sheresse,F,100,11,0,11
Sherief,M,100,0,11,11
Sherille,F,100,11,0,11
Sherryle,F,100,11,0,11
Sheryel,F,100,11,0,11
Sheryln,F,100,11,0,11
Shetia,F,100,11,0,11
Shie,M,55,5,6,11
Shinaya,F,100,11,0,11
Shiniece,F,100,11,0,11
Shiobhan,F,100,11,0,11
Shionna,F,100,11,0,11
Shiquana,F,100,11,0,11
Shirena,F,100,11,0,11
Shirlann,F,100,11,0,11
Shivanshi,F,100,11,0,11
Shohn,M,100,0,11,11
Shontice,F,100,11,0,11
Shoronda,F,100,11,0,11
Shoshone,F,100,11,0,11
Shqipe,F,100,11,0,11
Shreen,F,100,11,0,11
Shreyank,M,100,0,11,11
Shua,F,100,11,0,11
Shubhi,F,100,11,0,11
Shynece,F,100,11,0,11
Shyniqua,F,100,11,0,11
Shyrel,F,100,11,0,11
Siaka,M,100,0,11,11
Siale,M,100,0,11,11
Siavash,M,100,0,11,11
Sidona,F,100,11,0,11
Silja,F,100,11,0,11
Silviana,F,100,11,0,11
Sindhura,F,100,11,0,11
Sinh,M,100,0,11,11
Sirin,F,100,11,0,11
Siti,F,100,11,0,11
Sj,M,100,0,11,11
Skylaa,F,100,11,0,11
Snayder,M,100,0,11,11
Sohani,F,100,11,0,11
Sohpia,F,100,11,0,11
Solida,F,100,11,0,11
Solitaire,F,100,11,0,11
Somaria,F,100,11,0,11
Somi,F,100,11,0,11
Sonye,F,100,11,0,11
Soorya,M,100,0,11,11
Sophany,F,100,11,0,11
Sophorn,F,100,11,0,11
Sotera,F,100,11,0,11
Speros,M,100,0,11,11
St,M,100,0,11,11
Starbuck,M,100,0,11,11
Starisha,F,100,11,0,11
Starleana,F,100,11,0,11
Steeler,M,100,0,11,11
Steffenie,F,100,11,0,11
Stefin,M,100,0,11,11
Stephne,F,100,11,0,11
Stevephen,M,100,0,11,11
Stevona,F,100,11,0,11
Stokely,M,100,0,11,11
Stracy,F,100,11,0,11
Strella,F,100,11,0,11
Sudays,M,100,0,11,11
Sudeys,M,100,0,11,11
Suehay,F,100,11,0,11
Suja,F,100,11,0,11
Sukhjot,M,100,0,11,11
Sulieman,M,100,0,11,11
Sulton,M,100,0,11,11
Sulyn,F,100,11,0,11
Sumika,F,100,11,0,11
Sumitra,F,100,11,0,11
Sundara,F,100,11,0,11
Sunidhi,F,100,11,0,11
Sunja,F,100,11,0,11
Surayah,F,100,11,0,11
Suvanna,F,100,11,0,11
Swanson,M,100,0,11,11
Swaraj,M,100,0,11,11
Symari,F,100,11,0,11
Syndy,F,100,11,0,11
Syree,M,55,5,6,11
Syuri,F,100,11,0,11
Tabassum,F,100,11,0,11
Tacorian,M,100,0,11,11
Taeyon,M,100,0,11,11
Tahjmir,M,100,0,11,11
Tahmya,F,100,11,0,11
Taime,F,100,11,0,11
Taishia,F,100,11,0,11
Taishon,M,100,0,11,11
Taiyon,M,100,0,11,11
Tajmah,F,100,11,0,11
Takaia,F,100,11,0,11
Takeita,F,100,11,0,11
Takena,F,100,11,0,11
Takesia,F,100,11,0,11
Takiea,F,100,11,0,11
Takwon,M,100,0,11,11
Takyiah,F,100,11,0,11
Talasha,F,100,11,0,11
Taley,F,100,11,0,11
Talie,F,100,11,0,11
Talla,F,100,11,0,11
Tamaica,F,100,11,0,11
Tamarya,F,100,11,0,11
Tamere,M,100,0,11,11
Taminka,F,100,11,0,11
Tammeka,F,100,11,0,11
Tanar,M,100,0,11,11
Tanari,F,100,11,0,11
Tangerla,F,100,11,0,11
Tanihya,F,100,11,0,11
Tannin,M,100,0,11,11
Tanoa,F,100,11,0,11
Tante,F,100,11,0,11
Tanyette,F,100,11,0,11
Tapan,M,100,0,11,11
Taqiyya,F,100,11,0,11
Taquetta,F,100,11,0,11
Taranda,F,100,11,0,11
Tarja,F,100,11,0,11
Tarkan,M,100,0,11,11
Tarlisha,F,100,11,0,11
Tashaye,F,100,11,0,11
Tatiannah,F,100,11,0,11
Tatiyanah,F,100,11,0,11
Tatiyona,F,100,11,0,11
Tawasha,F,100,11,0,11
Taycie,F,100,11,0,11
Taylani,F,100,11,0,11
Taylorjo,F,100,11,0,11
Tays,F,100,11,0,11
Tayveion,M,100,0,11,11
Tazion,M,100,0,11,11
Teage,M,100,0,11,11
Teajah,F,100,11,0,11
Tearney,F,100,11,0,11
Teckla,F,100,11,0,11
Tederick,M,100,0,11,11
Teeanna,F,100,11,0,11
Teeara,F,100,11,0,11
Teesa,F,100,11,0,11
Tei,M,100,0,11,11
Teiah,F,100,11,0,11
Tejveer,M,100,0,11,11
Teko,M,100,0,11,11
Telli,F,100,11,0,11
Telor,F,100,11,0,11
Temira,F,100,11,0,11
Tempess,F,100,11,0,11
Templeton,M,100,0,11,11
Tenajah,F,100,11,0,11
Tenicka,F,100,11,0,11
Tenniel,F,100,11,0,11
Tenuun,M,100,0,11,11
Teoshia,F,100,11,0,11
Tephen,M,100,0,11,11
Tequoia,F,100,11,0,11
Terece,F,100,11,0,11
Tereva,F,100,11,0,11
Termain,M,100,0,11,11
Terray,M,100,0,11,11
Terrijo,F,100,11,0,11
Tesheka,F,100,11,0,11
Tesslynn,F,100,11,0,11
Teyani,F,100,11,0,11
Thach,M,100,0,11,11
Thaddaus,M,100,0,11,11
Thamer,M,100,0,11,11
Tharin,M,100,0,11,11
Thekla,F,100,11,0,11
Therea,F,100,11,0,11
Theria,F,100,11,0,11
Thomasmichael,M,100,0,11,11
Tieanna,F,100,11,0,11
Tiegen,M,100,0,11,11
Tiembra,F,100,11,0,11
Tifanni,F,100,11,0,11
Tiffanique,F,100,11,0,11
Tifinie,F,100,11,0,11
Tifiny,F,100,11,0,11
Tijay,M,55,5,6,11
Tikayla,F,100,11,0,11
Tikila,F,100,11,0,11
Tikira,F,100,11,0,11
Tilynn,F,100,11,0,11
Timohy,M,100,0,11,11
Timothyy,M,100,0,11,11
Tinaka,F,100,11,0,11
Tiney,F,100,11,0,11
Tinica,F,100,11,0,11
Tippy,F,55,6,5,11
Tiquita,F,100,11,0,11
Tithi,F,100,11,0,11
Tiwatope,F,100,11,0,11
Tkaia,F,100,11,0,11
Tkya,F,100,11,0,11
Tlalli,F,100,11,0,11
Tobijah,M,100,0,11,11
Tojuana,F,100,11,0,11
Tomias,M,100,0,11,11
Tomoka,F,100,11,0,11
Tonaya,F,100,11,0,11
Tondia,F,100,11,0,11
Tonilyn,F,100,11,0,11
Tonnesha,F,100,11,0,11
Tonora,F,100,11,0,11
Tonyell,F,100,11,0,11
Torenzo,M,100,0,11,11
Torrel,M,100,0,11,11
Toshima,F,100,11,0,11
Towonda,F,100,11,0,11
Toyka,F,100,11,0,11
Trahern,M,100,0,11,11
Tranard,M,100,0,11,11
Tranee,F,100,11,0,11
Tranyce,F,100,11,0,11
Trashun,M,100,0,11,11
Travette,F,100,11,0,11
Travolta,M,100,0,11,11
Traylor,M,100,0,11,11
Trekwon,M,100,0,11,11
Tremaya,F,100,11,0,11
Trenon,M,100,0,11,11
Trevez,M,100,0,11,11
Trevien,M,100,0,11,11
Trinite,F,100,11,0,11
Trishonda,F,100,11,0,11
Tristiana,F,100,11,0,11
Tue,M,100,0,11,11
Tumika,F,100,11,0,11
Tuong,M,55,5,6,11
Tureka,F,100,11,0,11
Turell,M,100,0,11,11
Turia,F,100,11,0,11
Tycere,M,100,0,11,11
Tychina,F,100,11,0,11
Tyenna,F,100,11,0,11
Tyeshawn,M,100,0,11,11
Tykerra,F,100,11,0,11
Tykiria,F,100,11,0,11
Tylayah,F,100,11,0,11
Tylette,F,100,11,0,11
Tylun,M,100,0,11,11
Tymirah,F,100,11,0,11
Tynaja,F,100,11,0,11
Tynese,F,100,11,0,11
Tyniyah,F,100,11,0,11
Tyreeq,M,100,0,11,11
Tyrius,M,100,0,11,11
Tyrod,M,100,0,11,11
Tyrra,F,100,11,0,11
Tyshayla,F,100,11,0,11
Tyshone,M,100,0,11,11
Tyteona,F,100,11,0,11
Tziry,F,100,11,0,11
Tzivi,F,100,11,0,11
Vadir,M,100,0,11,11
Valency,F,100,11,0,11
Valette,F,100,11,0,11
Valo,M,100,0,11,11
Vanderlei,M,100,0,11,11
Vane,M,100,0,11,11
Vangela,F,100,11,0,11
Vanora,F,100,11,0,11
Vantrell,M,100,0,11,11
Varonda,F,100,11,0,11
Vashonda,F,100,11,0,11
Velvia,F,100,11,0,11
Venica,F,100,11,0,11
Verniya,F,100,11,0,11
Vernoica,F,100,11,0,11
Victorria,F,100,11,0,11
Vincetta,F,100,11,0,11
Vineeta,F,100,11,0,11
Violeth,F,100,11,0,11
Virma,F,100,11,0,11
Vivyanna,F,100,11,0,11
Vladyslav,M,100,0,11,11
Vondalee,F,100,11,0,11
Vontese,F,100,11,0,11
Vontressa,F,100,11,0,11
Vyanna,F,100,11,0,11
Wakesha,F,100,11,0,11
Watasha,F,100,11,0,11
Watisha,F,100,11,0,11
Wayneshia,F,100,11,0,11
Wendla,F,100,11,0,11
Wendolee,F,100,11,0,11
Widad,F,100,11,0,11
Wilgus,M,100,0,11,11
Williamm,M,100,0,11,11
Williesha,F,100,11,0,11
Willington,M,100,0,11,11
Willisa,F,100,11,0,11
Wister,M,100,0,11,11
Wladimir,M,100,0,11,11
Wysteria,F,100,11,0,11
Wyvette,F,100,11,0,11
Wyvonnia,F,100,11,0,11
Xael,M,100,0,11,11
Xairexis,F,100,11,0,11
Xandir,M,100,0,11,11
Xaniel,M,100,0,11,11
Xanthus,M,100,0,11,11
Xiani,F,100,11,0,11
Xiya,F,100,11,0,11
Xou,M,100,0,11,11
Yahli,M,100,0,11,11
Yamelin,F,100,11,0,11
Yanari,F,100,11,0,11
Yanesa,F,100,11,0,11
Yanichel,F,100,11,0,11
Yanire,F,100,11,0,11
Yanita,F,100,11,0,11
Yarieli,F,100,11,0,11
Yaritzia,F,100,11,0,11
Yasen,M,100,0,11,11
Yasiin,M,100,0,11,11
Yassiel,M,100,0,11,11
Yathziri,F,100,11,0,11
Yency,F,100,11,0,11
Yenta,F,100,11,0,11
Yerika,F,100,11,0,11
Yhael,M,100,0,11,11
Yinessa,F,55,6,5,11
Yna,F,100,11,0,11
Ynes,F,55,6,5,11
Yocasta,F,100,11,0,11
Yonaton,M,100,0,11,11
Yonni,M,100,0,11,11
Yosan,F,100,11,0,11
Yosimar,M,100,0,11,11
Yufei,F,100,11,0,11
Yuisa,F,100,11,0,11
Yulemni,F,100,11,0,11
Yulunda,F,100,11,0,11
Yung,M,100,0,11,11
Yurely,F,100,11,0,11
Yuseff,M,100,0,11,11
Yustin,M,100,0,11,11
Yuva,M,100,0,11,11
Zaaliyah,F,100,11,0,11
Zacardi,M,100,0,11,11
Zacarri,M,100,0,11,11
Zachi,M,100,0,11,11
Zadee,F,100,11,0,11
Zadquiel,M,100,0,11,11
Zaeveon,M,100,0,11,11
Zaheim,M,100,0,11,11
Zahmere,M,100,0,11,11
Zairy,F,100,11,0,11
Zakhar,M,100,0,11,11
Zakria,M,100,0,11,11
Zalaiyah,F,100,11,0,11
Zalina,F,100,11,0,11
Zalon,M,100,0,11,11
Zam,M,100,0,11,11
Zamien,M,100,0,11,11
Zamirra,F,100,11,0,11
Zamonte,M,100,0,11,11
Zaneya,F,100,11,0,11
Zarhiya,F,100,11,0,11
Zarrian,M,100,0,11,11
Zavious,M,100,0,11,11
Zaydien,M,100,0,11,11
Zayia,F,100,11,0,11
Zekai,M,100,0,11,11
Zelta,F,100,11,0,11
Zemarion,M,100,0,11,11
Zendaiya,F,100,11,0,11
Zenzele,F,100,11,0,11
Zereon,M,100,0,11,11
Zevaeh,F,100,11,0,11
Zeyah,F,100,11,0,11
Zhanya,F,100,11,0,11
Zhayne,M,100,0,11,11
Ziniya,F,100,11,0,11
Ziniyah,F,100,11,0,11
Zirah,F,100,11,0,11
Ziyun,M,100,0,11,11
Zmarion,M,100,0,11,11
Zoegrace,F,100,11,0,11
Zubeyr,M,100,0,11,11
Zulimar,F,100,11,0,11
Zuriela,F,100,11,0,11
Zykiera,F,100,11,0,11
Zyquavion,M,100,0,11,11
Zyriyah,F,100,11,0,11
Aabriella,F,100,10,0,10
Aadrika,F,100,10,0,10
Aailiyah,F,100,10,0,10
Aalok,M,100,0,10,10
Aamanda,F,100,10,0,10
Aamarion,M,100,0,10,10
Aamena,F,100,10,0,10
Aamoni,F,100,10,0,10
Aarabella,F,100,10,0,10
Aaronjoshua,M,100,0,10,10
Aaryon,M,100,0,10,10
Aatif,M,100,0,10,10
Aavin,M,100,0,10,10
Aayanah,F,100,10,0,10
Abaigail,F,100,10,0,10
Abdelkareem,M,100,0,10,10
Abdilahi,M,100,0,10,10
Abdoulaziz,M,100,0,10,10
Abdulwahid,M,100,0,10,10
Abhik,M,100,0,10,10
Abhirup,M,100,0,10,10
Abidan,M,100,0,10,10
Abin,M,100,0,10,10
Abira,F,100,10,0,10
Abiyah,F,50,5,5,10
Abney,F,100,10,0,10
Abrille,F,100,10,0,10
Abubakary,M,100,0,10,10
Abyade,F,100,10,0,10
Achraf,M,100,0,10,10
Adalinda,F,100,10,0,10
Adalya,F,100,10,0,10
Adalye,F,100,10,0,10
Adaryl,M,100,0,10,10
Adason,F,50,5,5,10
Addeson,F,100,10,0,10
Adebisi,F,100,10,0,10
Adelais,F,100,10,0,10
Adelinne,F,100,10,0,10
Adelmira,F,100,10,0,10
Adeolu,M,100,0,10,10
Adeyinka,F,50,5,5,10
Adielle,F,100,10,0,10
Adniel,M,100,0,10,10
Adriela,F,100,10,0,10
Advitha,F,100,10,0,10
Aeiden,M,100,0,10,10
Aeries,F,100,10,0,10
Aesa,F,100,10,0,10
Afif,M,100,0,10,10
Afina,F,100,10,0,10
Afrim,M,100,0,10,10
Agee,M,100,0,10,10
Agness,F,100,10,0,10
Ahbree,F,100,10,0,10
Ahlaysia,F,100,10,0,10
Ahmaj,M,100,0,10,10
Ahniyla,F,100,10,0,10
Aidann,M,100,0,10,10
Aideth,F,100,10,0,10
Ailiyah,F,100,10,0,10
Aisah,F,100,10,0,10
Ajasia,F,100,10,0,10
Ajayden,M,100,0,10,10
Ajitesh,M,100,0,10,10
Ajoni,M,100,0,10,10
Akemy,F,100,10,0,10
Akena,F,100,10,0,10
Akenya,F,100,10,0,10
Akerria,F,100,10,0,10
Akhenaton,M,100,0,10,10
Akhirah,F,100,10,0,10
Akimi,F,100,10,0,10
Alac,M,100,0,10,10
Alair,F,100,10,0,10
Alantae,M,100,0,10,10
Alarick,M,100,0,10,10
Alastar,M,100,0,10,10
Alaundra,F,100,10,0,10
Alaxandria,F,100,10,0,10
Alaynie,F,100,10,0,10
Alayzah,F,100,10,0,10
Alazaya,F,100,10,0,10
Alberteen,F,100,10,0,10
Albesa,F,100,10,0,10
Albiona,F,100,10,0,10
Alchemy,F,100,10,0,10
Aldena,F,100,10,0,10
Aldene,F,100,10,0,10
Aldijana,F,100,10,0,10
Aldrena,F,100,10,0,10
Aleciram,F,100,10,0,10
Aleishia,F,100,10,0,10
Aleiza,F,100,10,0,10
Aleron,M,100,0,10,10
Alexaundra,F,100,10,0,10
Alexiel,F,50,5,5,10
Alexiona,F,100,10,0,10
Alexionna,F,100,10,0,10
Alexisa,F,100,10,0,10
Alexuss,F,100,10,0,10
Aleyha,F,100,10,0,10
Alferdo,M,100,0,10,10
Alhan,M,100,0,10,10
Alhanouf,F,100,10,0,10
Alijandro,M,100,0,10,10
Alique,F,50,5,5,10
Alissabeth,F,100,10,0,10
Alixa,F,100,10,0,10
Aliyna,F,100,10,0,10
Alleria,F,100,10,0,10
Allexys,F,100,10,0,10
Allias,M,100,0,10,10
Alliene,F,100,10,0,10
Almanda,F,100,10,0,10
Almena,F,100,10,0,10
Almudena,F,100,10,0,10
Alodie,F,100,10,0,10
Altavious,M,100,0,10,10
Altie,M,100,0,10,10
Altus,M,100,0,10,10
Alyciah,F,100,10,0,10
Alynnah,F,100,10,0,10
Alysin,F,100,10,0,10
Alysta,F,100,10,0,10
Alyxzander,M,100,0,10,10
Amaleah,F,100,10,0,10
Amarey,F,50,5,5,10
Amarillis,F,100,10,0,10
Amarin,F,50,5,5,10
Amariyae,F,100,10,0,10
Amaryss,F,100,10,0,10
Amaurys,M,100,0,10,10
Amba,F,100,10,0,10
Amberjo,F,100,10,0,10
Amberlynne,F,100,10,0,10
Ambernique,F,100,10,0,10
Ambr,F,100,10,0,10
Ambrosha,F,100,10,0,10
Amedee,M,100,0,10,10
Ameesha,F,100,10,0,10
Ameeyah,F,100,10,0,10
Ameliagrace,F,100,10,0,10
Ameyaa,F,100,10,0,10
Amid,M,100,0,10,10
Amielle,F,100,10,0,10
Amilleon,F,100,10,0,10
Amiriya,F,100,10,0,10
Amitha,F,100,10,0,10
Ammaarah,F,100,10,0,10
Ammerie,F,100,10,0,10
Amren,M,100,0,10,10
Amrin,F,100,10,0,10
Amyha,F,100,10,0,10
Anaisabella,F,100,10,0,10
Analu,M,100,0,10,10
Anbria,F,100,10,0,10
Anderew,M,100,0,10,10
Andraia,F,100,10,0,10
Andranette,F,100,10,0,10
Andreena,F,100,10,0,10
Andrenette,F,100,10,0,10
Andreous,M,100,0,10,10
Andrewmichael,M,100,0,10,10
Aneah,F,100,10,0,10
Anee,F,100,10,0,10
Aneecia,F,100,10,0,10
Aneida,F,100,10,0,10
Aneika,F,100,10,0,10
Anesti,F,50,5,5,10
Anesty,F,100,10,0,10
Angelar,F,100,10,0,10
Angelmanuel,M,100,0,10,10
Angenita,F,100,10,0,10
Angyl,F,100,10,0,10
Anikan,M,100,0,10,10
Aniki,M,100,0,10,10
Aniseto,M,100,0,10,10
Anite,F,100,10,0,10
Anlly,F,100,10,0,10
Annalease,F,100,10,0,10
Annaleya,F,100,10,0,10
Annaliece,F,100,10,0,10
Annalouise,F,100,10,0,10
Annastashia,F,100,10,0,10
Anneelise,F,100,10,0,10
Annelouise,F,100,10,0,10
Annysa,F,100,10,0,10
Anorea,F,100,10,0,10
Ansha,F,100,10,0,10
Anshel,M,100,0,10,10
Anslem,M,100,0,10,10
Ansumana,M,100,0,10,10
Antaja,F,100,10,0,10
Antarious,M,100,0,10,10
Anterria,F,100,10,0,10
Anthoula,F,100,10,0,10
Antionna,F,100,10,0,10
Antonay,F,100,10,0,10
Antonello,M,100,0,10,10
Antoniah,F,100,10,0,10
Antonieo,M,100,0,10,10
Antowine,M,100,0,10,10
Antrel,M,100,0,10,10
Antrina,F,100,10,0,10
Antwanae,F,100,10,0,10
Antwanesha,F,100,10,0,10
Anubhav,M,100,0,10,10
Anuoluwa,F,100,10,0,10
Anyhia,F,100,10,0,10
Anza,F,100,10,0,10
Aponi,F,100,10,0,10
Araba,F,100,10,0,10
Arainna,F,100,10,0,10
Arashdeep,M,100,0,10,10
Arathi,F,100,10,0,10
Araxi,F,100,10,0,10
Araylia,F,100,10,0,10
Arbay,F,100,10,0,10
Ardine,F,100,10,0,10
Ared,M,100,0,10,10
Argeniz,M,100,0,10,10
Argenys,M,100,0,10,10
Arhant,M,100,0,10,10
Aribeth,F,100,10,0,10
Aricel,F,100,10,0,10
Ariee,F,100,10,0,10
Arieta,F,100,10,0,10
Ariha,F,100,10,0,10
Arikka,F,100,10,0,10
Aril,F,100,10,0,10
Arinda,F,100,10,0,10
Arinjay,M,100,0,10,10
Arlaina,F,100,10,0,10
Arlandus,M,100,0,10,10
Arlesa,F,100,10,0,10
Arlondo,M,100,0,10,10
Arlynda,F,100,10,0,10
Arlyssa,F,100,10,0,10
Armanti,M,100,0,10,10
Armaun,M,100,0,10,10
Armiah,F,100,10,0,10
Armod,M,100,0,10,10
Arnet,M,100,0,10,10
Aroon,M,100,0,10,10
Arpine,F,100,10,0,10
Arquita,F,100,10,0,10
Arrah,F,100,10,0,10
Arreona,F,100,10,0,10
Arseny,M,100,0,10,10
Arteen,M,100,0,10,10
Arthelia,F,100,10,0,10
Artishia,F,100,10,0,10
Arusha,F,100,10,0,10
Aryane,F,100,10,0,10
Arzel,M,100,0,10,10
Arzo,M,100,0,10,10
Aset,F,100,10,0,10
Ashaiya,F,100,10,0,10
Ashalyn,F,100,10,0,10
Ashantai,F,100,10,0,10
Ashauria,F,100,10,0,10
Ashunta,F,100,10,0,10
Asil,F,50,5,5,10
Asimina,F,100,10,0,10
Assan,M,100,0,10,10
Assitan,F,100,10,0,10
Astraya,F,100,10,0,10
Atahan,M,100,0,10,10
Athleen,F,100,10,0,10
Athryn,F,100,10,0,10
Atiyyah,F,100,10,0,10
Atnhony,M,100,0,10,10
Atoria,F,100,10,0,10
Attiya,F,100,10,0,10
Atzimba,F,100,10,0,10
Aubriann,F,100,10,0,10
Aubriannah,F,100,10,0,10
Audee,F,100,10,0,10
Aujah,F,100,10,0,10
Aukievah,F,100,10,0,10
Auniya,F,100,10,0,10
Aureana,F,100,10,0,10
Aureanna,F,100,10,0,10
Aureon,F,100,10,0,10
Aurieona,F,100,10,0,10
Autom,F,100,10,0,10
Avaelizabeth,F,100,10,0,10
Averionna,F,100,10,0,10
Avrora,F,100,10,0,10
Aweis,M,100,0,10,10
Aweys,M,100,0,10,10
Axeel,M,100,0,10,10
Ayannia,F,100,10,0,10
Ayeh,F,100,10,0,10
Ayele,F,50,5,5,10
Ayeleen,F,100,10,0,10
Aylena,F,100,10,0,10
Ayobami,M,100,0,10,10
Ayria,F,100,10,0,10
Ayten,F,100,10,0,10
Azariea,F,100,10,0,10
Azavian,M,100,0,10,10
Azilyn,F,100,10,0,10
Azira,F,100,10,0,10
Azyon,M,100,0,10,10
Azyrah,F,100,10,0,10
Bai,F,50,5,5,10
Baisley,F,100,10,0,10
Balery,F,100,10,0,10
Balmore,M,100,0,10,10
Balvina,F,100,10,0,10
Banna,F,100,10,0,10
Barbaranne,F,100,10,0,10
Bassey,M,100,0,10,10
Bassirou,M,100,0,10,10
Beate,F,100,10,0,10
Belah,F,100,10,0,10
Bellaluna,F,100,10,0,10
Benae,F,100,10,0,10
Benas,M,100,0,10,10
Benitez,M,100,0,10,10
Benjain,M,100,0,10,10
Bennjamin,M,100,0,10,10
Bente,F,100,10,0,10
Bentura,M,100,0,10,10
Ber,M,100,0,10,10
Beranda,F,100,10,0,10
Bernitta,F,100,10,0,10
Bernt,M,100,0,10,10
Bertell,M,100,0,10,10
Berthold,M,100,0,10,10
Besart,M,100,0,10,10
Besma,F,100,10,0,10
Bettiann,F,100,10,0,10
Bety,F,100,10,0,10
Beyanka,F,100,10,0,10
Biancamarie,F,100,10,0,10
Bibiano,M,100,0,10,10
Bily,M,100,0,10,10
Bison,M,100,0,10,10
Blakeli,F,100,10,0,10
Blayse,M,100,0,10,10
Blazer,M,100,0,10,10
Blessy,F,100,10,0,10
Boady,M,100,0,10,10
Bobbetta,F,100,10,0,10
Bodean,M,100,0,10,10
Bolden,M,100,0,10,10
Bong,M,100,0,10,10
Bonnitta,F,100,10,0,10
Boulder,M,100,0,10,10
Bowin,M,100,0,10,10
Boykin,M,100,0,10,10
Boysie,M,100,0,10,10
Brahin,M,100,0,10,10
Braina,F,100,10,0,10
Bralynne,F,100,10,0,10
Branco,M,100,0,10,10
Brayhan,M,100,0,10,10
Brayven,M,100,0,10,10
Breaira,F,100,10,0,10
Brealle,F,100,10,0,10
Brenea,F,100,10,0,10
Breneisha,F,100,10,0,10
Brensen,M,100,0,10,10
Breshonna,F,100,10,0,10
Breslynn,F,100,10,0,10
Breyauna,F,100,10,0,10
Briannan,F,100,10,0,10
Bricelynn,F,100,10,0,10
Brijida,F,100,10,0,10
Brilie,F,100,10,0,10
Brisseyda,F,100,10,0,10
Britannia,F,100,10,0,10
Briyanah,F,100,10,0,10
Brockman,M,100,0,10,10
Brockston,M,100,0,10,10
Brodderick,M,100,0,10,10
Brookelyne,F,100,10,0,10
Brookly,F,100,10,0,10
Brunson,M,100,0,10,10
Bryceon,M,100,0,10,10
Brynia,F,100,10,0,10
Brysonn,M,100,0,10,10
Brytan,M,100,0,10,10
Brytanni,F,100,10,0,10
Brytin,M,100,0,10,10
Brytne,F,100,10,0,10
Bryttnee,F,100,10,0,10
Bubby,M,100,0,10,10
Bun,M,100,0,10,10
Buna,F,100,10,0,10
Burchell,M,100,0,10,10
Burlene,F,100,10,0,10
Burman,M,100,0,10,10
Burnita,F,100,10,0,10
Butterfly,F,100,10,0,10
Cadejah,F,100,10,0,10
Caezar,M,100,0,10,10
Caite,F,100,10,0,10
Caitria,F,100,10,0,10
Calaeb,M,100,0,10,10
Calese,F,100,10,0,10
Caliel,M,100,0,10,10
Calik,M,100,0,10,10
Caline,F,100,10,0,10
Calondra,F,100,10,0,10
Camaiya,F,100,10,0,10
Camberly,F,100,10,0,10
Cambriah,F,100,10,0,10
Camello,M,100,0,10,10
Camisa,F,100,10,0,10
Camlin,F,50,5,5,10
Camoya,F,100,10,0,10
Candyse,F,100,10,0,10
Cannin,M,100,0,10,10
Cappy,F,50,5,5,10
Car,M,100,0,10,10
Cardine,F,100,10,0,10
Carland,M,100,0,10,10
Carlianna,F,100,10,0,10
Carmynn,F,100,10,0,10
Carolus,M,100,0,10,10
Casadee,F,100,10,0,10
Casiah,F,100,10,0,10
Cassandera,F,100,10,0,10
Cataliyah,F,100,10,0,10
Cathirine,F,100,10,0,10
Cathlena,F,100,10,0,10
Cathreen,F,100,10,0,10
Cattibrie,F,100,10,0,10
Cauan,M,100,0,10,10
Caylem,M,100,0,10,10
Cayo,M,100,0,10,10
Caysi,F,100,10,0,10
Cazden,M,100,0,10,10
Cearah,F,100,10,0,10
Cecellia,F,100,10,0,10
Ceeanna,F,100,10,0,10
Celerino,M,100,0,10,10
Celyne,F,100,10,0,10
Cenith,F,100,10,0,10
Cerese,F,100,10,0,10
Cerrissa,F,100,10,0,10
Cervante,M,100,0,10,10
Cesilie,F,100,10,0,10
Chaffee,F,50,5,5,10
Chairity,F,100,10,0,10
Chakeria,F,100,10,0,10
Chakka,F,100,10,0,10
Chakya,F,100,10,0,10
Chalie,F,100,10,0,10
Chama,F,100,10,0,10
Chambers,M,100,0,10,10
Chamel,F,50,5,5,10
Chamiyah,F,100,10,0,10
Champane,F,100,10,0,10
Chanai,F,100,10,0,10
Chandrell,F,100,10,0,10
Chantill,F,100,10,0,10
Chardanae,F,100,10,0,10
Chardanay,F,100,10,0,10
Charlan,F,100,10,0,10
Charlanda,F,100,10,0,10
Charlecia,F,100,10,0,10
Charliese,F,100,10,0,10
Charliyah,F,100,10,0,10
Charlles,M,100,0,10,10
Charlote,F,100,10,0,10
Charlottee,F,100,10,0,10
Charlytte,F,100,10,0,10
Charme,F,100,10,0,10
Charmecia,F,100,10,0,10
Charmi,F,100,10,0,10
Chass,M,100,0,10,10
Chassady,F,100,10,0,10
Chastain,F,50,5,5,10
Chata,F,100,10,0,10
Chatavia,F,100,10,0,10
Chavaughn,F,100,10,0,10
Cheisa,F,100,10,0,10
Cheli,F,100,10,0,10
Chelseaanne,F,100,10,0,10
Chenese,F,100,10,0,10
Chenia,F,100,10,0,10
Chennelle,F,100,10,0,10
Cherianne,F,100,10,0,10
Cherrica,F,100,10,0,10
Cherrilyn,F,100,10,0,10
Chervon,F,100,10,0,10
Ches,M,100,0,10,10
Chinua,M,100,0,10,10
Chirstian,M,100,0,10,10
Chonna,F,100,10,0,10
Chree,F,100,10,0,10
Chrishay,F,100,10,0,10
Chrisina,F,100,10,0,10
Chrispin,M,100,0,10,10
Chrissean,M,100,0,10,10
Christianjay,M,100,0,10,10
Christyonna,F,100,10,0,10
Chrysanthe,F,100,10,0,10
Chuka,M,100,0,10,10
Chyana,F,100,10,0,10
Cianny,F,100,10,0,10
Ciauna,F,100,10,0,10
Ciriaco,M,100,0,10,10
Cita,F,100,10,0,10
Clairity,F,100,10,0,10
Claramae,F,100,10,0,10
Clarece,F,100,10,0,10
Clarenda,F,100,10,0,10
Clarion,F,100,10,0,10
Claro,M,100,0,10,10
Clemmon,M,100,0,10,10
Clesha,F,100,10,0,10
Clester,M,100,0,10,10
Clinesha,F,100,10,0,10
Clynton,M,100,0,10,10
Coey,F,50,5,5,10
Cohlton,M,100,0,10,10
Coilin,M,100,0,10,10
Coleena,F,100,10,0,10
Coleene,F,100,10,0,10
Coleigh,F,100,10,0,10
Colgan,M,100,0,10,10
Colista,F,100,10,0,10
Collena,F,100,10,0,10
Collete,F,100,10,0,10
Coltn,M,100,0,10,10
Condra,F,100,10,0,10
Conne,F,100,10,0,10
Connolly,F,50,5,5,10
Cono,M,100,0,10,10
Contenia,F,100,10,0,10
Coralea,F,100,10,0,10
Coraleen,F,100,10,0,10
Cordalro,M,100,0,10,10
Corieon,M,100,0,10,10
Corneilous,M,100,0,10,10
Cornesia,F,100,10,0,10
Coryana,F,100,10,0,10
Cosmas,M,100,0,10,10
Cozy,F,50,5,5,10
Creon,M,100,0,10,10
Creshawn,M,100,0,10,10
Crisbel,F,100,10,0,10
Crishon,M,100,0,10,10
Crisma,F,100,10,0,10
Cristinia,F,100,10,0,10
Crusoe,M,100,0,10,10
Crystyl,F,100,10,0,10
Culver,M,100,0,10,10
Curlene,F,100,10,0,10
Curtia,F,100,10,0,10
Curties,M,100,0,10,10
Cyaire,M,100,0,10,10
Cynita,F,100,10,0,10
Cynne,F,100,10,0,10
Cyrell,M,100,0,10,10
Daasia,F,100,10,0,10
Dabne,F,100,10,0,10
Daciana,F,100,10,0,10
Daely,F,100,10,0,10
Daeqwon,M,100,0,10,10
Daevian,M,100,0,10,10
Daezon,M,100,0,10,10
Dahliah,F,100,10,0,10
Daia,F,100,10,0,10
Daimar,M,100,0,10,10
Dainara,F,100,10,0,10
Dairian,F,100,10,0,10
Dairra,F,100,10,0,10
Daishana,F,100,10,0,10
Daisya,F,100,10,0,10
Daizjah,F,100,10,0,10
Dajauna,F,100,10,0,10
Dajee,F,100,10,0,10
Dakera,F,100,10,0,10
Dalaynie,F,100,10,0,10
Dalerie,F,100,10,0,10
Dalhia,F,100,10,0,10
Daliylah,F,100,10,0,10
Dalmar,M,100,0,10,10
Daltan,M,100,0,10,10
Dalven,M,100,0,10,10
Dalyssa,F,100,10,0,10
Damaj,M,100,0,10,10
Damaryon,M,100,0,10,10
Dameko,M,100,0,10,10
Dametris,M,100,0,10,10
Dameyune,M,100,0,10,10
Damiann,M,100,0,10,10
Damiracle,F,100,10,0,10
Damona,F,100,10,0,10
Damonee,M,100,0,10,10
Damonii,M,100,0,10,10
Danal,M,100,0,10,10
Dandi,F,100,10,0,10
Daneika,F,100,10,0,10
Daneisy,F,100,10,0,10
Danforth,M,100,0,10,10
Daniale,F,100,10,0,10
Daniellee,M,100,0,10,10
Dannille,F,100,10,0,10
Danquan,M,100,0,10,10
Danyca,F,100,10,0,10
Daquandre,M,100,0,10,10
Daquesha,F,100,10,0,10
Daralene,F,100,10,0,10
Darine,F,100,10,0,10
Darith,M,100,0,10,10
Darlee,F,100,10,0,10
Darlesha,F,100,10,0,10
Darliene,F,100,10,0,10
Darliss,F,100,10,0,10
Darmani,M,100,0,10,10
Darmesha,F,100,10,0,10
Darniece,F,100,10,0,10
Darniesha,F,100,10,0,10
Darsy,F,100,10,0,10
Dartrell,M,100,0,10,10
Darylene,F,100,10,0,10
Dasa,F,100,10,0,10
Dashani,F,100,10,0,10
Dashawnda,F,100,10,0,10
Dasianae,F,100,10,0,10
Dassy,F,100,10,0,10
Datrick,M,100,0,10,10
Datrion,M,100,0,10,10
Datwon,M,100,0,10,10
Davean,M,100,0,10,10
Daveta,F,100,10,0,10
Davvid,M,100,0,10,10
Dawndra,F,100,10,0,10
Dawny,F,100,10,0,10
Dayanaira,F,100,10,0,10
Dayasia,F,100,10,0,10
Daye,F,100,10,0,10
Dayl,F,50,5,5,10
Daylinn,F,100,10,0,10
Dayman,M,100,0,10,10
Dayzhane,F,100,10,0,10
Dayzi,F,100,10,0,10
Dazhaun,M,100,0,10,10
Dazhia,F,100,10,0,10
Daziel,M,100,0,10,10
Dcorian,M,100,0,10,10
Deair,M,100,0,10,10
Deanise,F,100,10,0,10
Deantoine,M,100,0,10,10
Deason,M,100,0,10,10
Deboroh,F,100,10,0,10
Debrorah,F,100,10,0,10
Decario,M,100,0,10,10
Decarion,M,100,0,10,10
Deevon,M,100,0,10,10
Deianna,F,100,10,0,10
Deida,F,100,10,0,10
Deise,F,100,10,0,10
Dejahna,F,100,10,0,10
Dejarvis,M,100,0,10,10
Dekai,M,100,0,10,10
Dekara,F,100,10,0,10
Dekeshia,F,100,10,0,10
Dekevious,M,100,0,10,10
Dekia,F,100,10,0,10
Dekiyah,F,100,10,0,10
Dekotah,F,100,10,0,10
Delannie,F,100,10,0,10
Delaura,F,100,10,0,10
Deleesa,F,100,10,0,10
Delilia,F,100,10,0,10
Delite,F,100,10,0,10
Delmarco,M,100,0,10,10
Demerion,M,100,0,10,10
Demetrian,M,100,0,10,10
Demille,M,100,0,10,10
Demion,M,100,0,10,10
Demis,M,100,0,10,10
Demontavious,M,100,0,10,10
Demontrell,M,100,0,10,10
Denajia,F,100,10,0,10
Denamarie,F,100,10,0,10
Dendrick,M,100,0,10,10
Denekia,F,100,10,0,10
Denel,F,100,10,0,10
Denerick,M,100,0,10,10
Denero,M,100,0,10,10
Denetrius,F,100,10,0,10
Dennesly,F,100,10,0,10
Dennetta,F,100,10,0,10
Denyell,F,100,10,0,10
Deobrah,F,100,10,0,10
Deondric,M,100,0,10,10
Deora,F,100,10,0,10
Dermont,M,100,0,10,10
Dernell,M,100,0,10,10
Desaraye,F,100,10,0,10
Deshiya,F,100,10,0,10
Deshuan,M,100,0,10,10
Desiri,F,100,10,0,10
Desmend,M,100,0,10,10
Desray,F,100,10,0,10
Desseray,F,100,10,0,10
Destinea,F,100,10,0,10
Destined,M,100,0,10,10
Destinni,F,100,10,0,10
Devaki,F,100,10,0,10
Devantre,M,100,0,10,10
Devarian,M,100,0,10,10
Devaughnte,M,100,0,10,10
Dever,M,100,0,10,10
Devern,M,100,0,10,10
Devia,F,100,10,0,10
Dexiree,F,100,10,0,10
Deyli,F,100,10,0,10
Deyshaun,M,100,0,10,10
Deysia,F,100,10,0,10
Deziraye,F,100,10,0,10
Dezon,M,100,0,10,10
Dezya,F,100,10,0,10
Dhameer,M,100,0,10,10
Dhivya,F,100,10,0,10
Dialo,M,100,0,10,10
Diamondique,F,100,10,0,10
Dianalaura,F,100,10,0,10
Dianalynn,F,100,10,0,10
Dianela,F,100,10,0,10
Dianeliz,F,100,10,0,10
Diary,F,100,10,0,10
Dicey,F,100,10,0,10
Diedrick,M,100,0,10,10
Diena,F,100,10,0,10
Dietta,F,100,10,0,10
Dihanna,F,100,10,0,10
Dikran,M,100,0,10,10
Dilma,F,100,10,0,10
Dilshan,M,100,0,10,10
Dilylah,F,100,10,0,10
Dimante,M,100,0,10,10
Dimonte,M,100,0,10,10
Dineisha,F,100,10,0,10
Dineshia,F,100,10,0,10
Dinnia,F,100,10,0,10
Diocelina,F,100,10,0,10
Diseree,F,100,10,0,10
Diyaa,F,100,10,0,10
Diyor,M,100,0,10,10
Dmyah,F,100,10,0,10
Dnaielle,F,100,10,0,10
Dnisha,F,100,10,0,10
Domiano,M,100,0,10,10
Dominquie,F,50,5,5,10
Domonica,F,100,10,0,10
Donjae,M,100,0,10,10
Donniece,F,100,10,0,10
Donrico,M,100,0,10,10
Dorelle,F,100,10,0,10
Doremus,M,100,0,10,10
Doresha,F,100,10,0,10
Dornisha,F,100,10,0,10
Dovi,M,100,0,10,10
Dquarius,M,100,0,10,10
Draconis,M,100,0,10,10
Dreda,F,100,10,0,10
Drekwon,M,100,0,10,10
Dren,M,100,0,10,10
Dreona,F,100,10,0,10
Dreyken,M,100,0,10,10
Dreylan,M,100,0,10,10
Driver,M,100,0,10,10
Dron,M,100,0,10,10
Duce,M,100,0,10,10
Dunta,M,100,0,10,10
Durke,M,100,0,10,10
Duryea,M,100,0,10,10
Duwaine,M,100,0,10,10
Dwij,M,100,0,10,10
Dylam,M,100,0,10,10
Dylanmichael,M,100,0,10,10
Dyle,M,100,0,10,10
Dylian,M,100,0,10,10
Dyona,F,100,10,0,10
Dyrk,M,100,0,10,10
Dzung,M,100,0,10,10
Earlis,M,100,0,10,10
Earnell,M,100,0,10,10
Easha,F,100,10,0,10
Ecaterina,F,100,10,0,10
Ecstasy,F,100,10,0,10
Edelina,F,100,10,0,10
Edyta,F,100,10,0,10
Eibhleann,F,100,10,0,10
Eid,M,100,0,10,10
Eileigh,F,100,10,0,10
Eilen,F,100,10,0,10
Eilonwy,F,100,10,0,10
Eizley,F,100,10,0,10
Ejaz,M,100,0,10,10
Eldredge,M,100,0,10,10
Elefteria,F,100,10,0,10
Elethia,F,100,10,0,10
Elianni,F,100,10,0,10
Elidio,M,100,0,10,10
Elihue,M,100,0,10,10
Elijahh,M,100,0,10,10
Elishea,F,100,10,0,10
Elishka,F,100,10,0,10
Elitania,F,100,10,0,10
Elizabete,F,100,10,0,10
Elizabethe,F,100,10,0,10
Eljin,M,100,0,10,10
Ellabelle,F,100,10,0,10
Ellissia,F,100,10,0,10
Ellivia,F,100,10,0,10
Ellyona,F,100,10,0,10
Elmedina,F,100,10,0,10
Eloyd,M,100,0,10,10
Eluid,M,100,0,10,10
Elyah,F,50,5,5,10
Elysiana,F,100,10,0,10
Emelita,F,100,10,0,10
Emiel,M,100,0,10,10
Emilianne,F,100,10,0,10
Emman,F,100,10,0,10
Emmariah,F,100,10,0,10
Emmitte,M,100,0,10,10
Emmoni,F,100,10,0,10
Emna,F,100,10,0,10
Emra,F,100,10,0,10
Emyla,F,100,10,0,10
Endsley,F,100,10,0,10
Enzley,F,100,10,0,10
Erbey,M,100,0,10,10
Eribella,F,100,10,0,10
Ericc,M,100,0,10,10
Erickah,F,100,10,0,10
Ericlee,M,100,0,10,10
Erieanna,F,100,10,0,10
Erikc,M,100,0,10,10
Erikia,F,100,10,0,10
Eriqua,F,100,10,0,10
Eryss,F,100,10,0,10
Eshon,M,100,0,10,10
Eshton,M,100,0,10,10
Esmerai,F,100,10,0,10
Esprit,F,100,10,0,10
Estavan,M,100,0,10,10
Eugean,M,100,0,10,10
Eujin,F,100,10,0,10
Eunika,F,100,10,0,10
Eustolio,M,100,0,10,10
Evaggelia,F,100,10,0,10
Evalinda,F,100,10,0,10
Evaney,F,100,10,0,10
Evanston,M,100,0,10,10
Evaughn,F,100,10,0,10
Evdokia,F,100,10,0,10
Evelie,F,100,10,0,10
Evelis,F,100,10,0,10
Everlin,F,100,10,0,10
Evertte,M,100,0,10,10
Evester,M,100,0,10,10
Evonie,F,100,10,0,10
Exavion,M,100,0,10,10
Exiquio,M,100,0,10,10
Eyani,F,100,10,0,10
Ezabelle,F,100,10,0,10
Ezariyah,F,100,10,0,10
Fabrisio,M,100,0,10,10
Faeryn,F,100,10,0,10
Fahmi,M,100,0,10,10
Fajar,F,100,10,0,10
Farrar,F,100,10,0,10
Fatyma,F,100,10,0,10
Fayann,F,100,10,0,10
Fayga,F,100,10,0,10
Fayha,F,100,10,0,10
Fayla,F,100,10,0,10
Faylyn,F,100,10,0,10
Fazal,M,100,0,10,10
Feleicia,F,100,10,0,10
Feltus,M,100,0,10,10
Fenner,M,100,0,10,10
Fentress,M,100,0,10,10
Ferin,F,100,10,0,10
Feroz,M,100,0,10,10
Fiala,F,100,10,0,10
Fidelmar,M,100,0,10,10
Fields,M,100,0,10,10
Fisnik,M,100,0,10,10
Floree,F,100,10,0,10
Floydene,F,100,10,0,10
Folami,F,100,10,0,10
Fontana,F,100,10,0,10
Francell,F,50,5,5,10
Franchetta,F,100,10,0,10
Franciene,F,100,10,0,10
Franey,F,100,10,0,10
Fransica,F,100,10,0,10
Fredricks,M,100,0,10,10
Freidy,F,100,10,0,10
Frenda,F,100,10,0,10
Fritzy,F,100,10,0,10
Fu,M,100,0,10,10
Fumiko,F,100,10,0,10
Funmilayo,F,100,10,0,10
Gabrialla,F,100,10,0,10
Gabrielmichael,M,100,0,10,10
Gabriely,F,100,10,0,10
Galynn,F,100,10,0,10
Gard,M,100,0,10,10
Garic,M,100,0,10,10
Garie,F,50,5,5,10
Garney,M,100,0,10,10
Garric,M,100,0,10,10
Gator,M,100,0,10,10
Geanne,F,100,10,0,10
Gedaliah,M,100,0,10,10
Geetanjali,F,100,10,0,10
Gefen,F,100,10,0,10
Gemia,F,100,10,0,10
Genai,F,100,10,0,10
Genero,M,100,0,10,10
Generosa,F,100,10,0,10
Geobani,M,100,0,10,10
Geogory,M,100,0,10,10
Gequan,M,100,0,10,10
Geradine,F,100,10,0,10
Geraldi,F,100,10,0,10
Geremia,M,100,0,10,10
Gerette,F,100,10,0,10
Gerlyn,F,100,10,0,10
Geromy,M,100,0,10,10
Gerrika,F,100,10,0,10
Ghena,F,100,10,0,10
Ghulam,M,100,0,10,10
Gianinna,F,100,10,0,10
Giavannah,F,100,10,0,10
Gillianna,F,100,10,0,10
Giner,F,100,10,0,10
Gipsy,F,100,10,0,10
Gitta,F,100,10,0,10
Gladine,F,100,10,0,10
Gladiola,F,100,10,0,10
Gladiz,F,100,10,0,10
Glendene,F,100,10,0,10
Glennwood,M,100,0,10,10
Gobind,M,100,0,10,10
Godrick,M,100,0,10,10
Golnaz,F,100,10,0,10
Goodness,F,100,10,0,10
Goretty,F,100,10,0,10
Gracianne,F,100,10,0,10
Gracielle,F,100,10,0,10
Graesen,M,100,0,10,10
Graye,F,50,5,5,10
Griffey,M,100,0,10,10
Guiseppi,M,100,0,10,10
Gulian,M,100,0,10,10
Gurjit,M,100,0,10,10
Gursimar,F,100,10,0,10
Guyon,M,100,0,10,10
Gwana,F,100,10,0,10
Gwynda,F,100,10,0,10
Gypsie,F,100,10,0,10
Habacuc,M,100,0,10,10
Hadiatou,F,100,10,0,10
Haiely,F,100,10,0,10
Hakimah,F,100,10,0,10
Haku,M,100,0,10,10
Halcyon,F,100,10,0,10
Hamdaan,M,100,0,10,10
Harinder,M,100,0,10,10
Harlequinn,F,100,10,0,10
Harmandeep,M,100,0,10,10
Harryette,F,100,10,0,10
Haseena,F,100,10,0,10
Hasya,F,100,10,0,10
Hateya,F,100,10,0,10
Hatty,F,100,10,0,10
Hawaii,F,100,10,0,10
Hayder,M,100,0,10,10
Haylan,F,100,10,0,10
Hayston,M,100,0,10,10
Heang,F,100,10,0,10
Hearther,F,100,10,0,10
Heartlynn,F,100,10,0,10
Heathcliff,M,100,0,10,10
Hellon,F,100,10,0,10
Hemani,F,100,10,0,10
Henrri,M,100,0,10,10
Hernaldo,M,100,0,10,10
Hersel,M,100,0,10,10
Hijinio,M,100,0,10,10
Hilah,F,100,10,0,10
Hildana,F,100,10,0,10
Hillip,M,100,0,10,10
Hirsch,M,100,0,10,10
Hiten,M,100,0,10,10
Hodalis,F,100,10,0,10
Hosannah,F,100,10,0,10
Hrithika,F,100,10,0,10
Hritik,M,100,0,10,10
Hsa,M,100,0,10,10
Hugues,M,100,0,10,10
Humayra,F,100,10,0,10
Hussen,M,100,0,10,10
Hyram,M,100,0,10,10
Icee,F,100,10,0,10
Ichard,M,100,0,10,10
Icysis,F,100,10,0,10
Idalmis,F,100,10,0,10
Ifrain,M,100,0,10,10
Ijnanya,F,100,10,0,10
Ikaia,M,100,0,10,10
Ikeyia,F,100,10,0,10
Ilanie,F,100,10,0,10
Illijah,M,100,0,10,10
Ilwad,F,100,10,0,10
Ilyass,M,100,0,10,10
Imaani,F,100,10,0,10
Imesha,F,100,10,0,10
Imiyah,F,100,10,0,10
Indu,F,100,10,0,10
Ingrida,F,100,10,0,10
Insiyah,F,100,10,0,10
Iosif,M,100,0,10,10
Ireona,F,100,10,0,10
Ireonna,F,100,10,0,10
Irin,F,50,5,5,10
Isabellia,F,100,10,0,10
Isau,M,100,0,10,10
Ishah,F,100,10,0,10
Islynn,F,100,10,0,10
Ismet,M,100,0,10,10
Itayetzi,F,100,10,0,10
Ivree,F,100,10,0,10
Ixtzel,F,100,10,0,10
Izahbella,F,100,10,0,10
Izavella,F,100,10,0,10
Izavier,M,100,0,10,10
Izobel,F,100,10,0,10
Izzaiah,M,100,0,10,10
Jabel,M,100,0,10,10
Jabian,M,100,0,10,10
Jabreon,M,100,0,10,10
Jabriya,F,100,10,0,10
Jacab,M,100,0,10,10
Jacenda,F,100,10,0,10
Jacksin,M,100,0,10,10
Jacorious,M,100,0,10,10
Jacqlene,F,100,10,0,10
Jacquilla,F,100,10,0,10
Jacyeon,M,100,0,10,10
Jadalin,F,100,10,0,10
Jaderian,M,100,0,10,10
Jadiss,M,100,0,10,10
Jadiyah,F,100,10,0,10
Jadonna,F,100,10,0,10
Jadynne,F,100,10,0,10
Jaelina,F,100,10,0,10
Jaemie,F,100,10,0,10
Jagmeet,M,100,0,10,10
Jahana,F,100,10,0,10
Jahanara,F,100,10,0,10
Jaharri,M,100,0,10,10
Jahdae,F,100,10,0,10
Jahde,F,100,10,0,10
Jaheam,M,100,0,10,10
Jahkeim,M,100,0,10,10
Jahkia,F,100,10,0,10
Jahkobe,M,100,0,10,10
Jahlyn,M,100,0,10,10
Jahongir,M,100,0,10,10
Jahquell,M,100,0,10,10
Jahshaun,M,100,0,10,10
Jahzell,F,100,10,0,10
Jaimarion,M,100,0,10,10
Jainiya,F,100,10,0,10
Jaiseon,M,100,0,10,10
Jakahri,M,100,0,10,10
Jakare,M,100,0,10,10
Jakeela,F,100,10,0,10
Jakerah,F,100,10,0,10
Jakeyah,F,100,10,0,10
Jakk,M,100,0,10,10
Jakorie,M,100,0,10,10
Jalaal,M,100,0,10,10
Jalasha,F,100,10,0,10
Jalashia,F,100,10,0,10
Jalaun,M,100,0,10,10
Jalein,M,100,0,10,10
Jalend,M,100,0,10,10
Jalenn,M,100,0,10,10
Jalian,M,100,0,10,10
Jalis,F,100,10,0,10
Jalycia,F,100,10,0,10
Jalyna,F,100,10,0,10
Jamarey,M,100,0,10,10
Jamarin,M,100,0,10,10
Jamaur,M,100,0,10,10
Jameele,F,100,10,0,10
Jameiah,F,100,10,0,10
Jamesena,F,100,10,0,10
Jamess,M,100,0,10,10
Jamik,M,100,0,10,10
Jamiles,F,100,10,0,10
Jamiley,F,100,10,0,10
Jamyis,M,100,0,10,10
Jancey,F,100,10,0,10
Jandriel,M,100,0,10,10
Janeeva,F,100,10,0,10
Janessia,F,100,10,0,10
Janicka,F,100,10,0,10
Jannai,F,100,10,0,10
Jannali,F,100,10,0,10
Jannalyn,F,100,10,0,10
Jannay,F,100,10,0,10
Jannene,F,100,10,0,10
Jannia,F,100,10,0,10
Januarie,F,100,10,0,10
Jaona,F,100,10,0,10
Jaquale,M,100,0,10,10
Jaquayvion,M,100,0,10,10
Jaquwan,M,100,0,10,10
Jareliz,F,100,10,0,10
Jarhett,M,100,0,10,10
Jariely,F,100,10,0,10
Jarodd,M,100,0,10,10
Jaronn,M,100,0,10,10
Jarrit,M,100,0,10,10
Jarvez,M,100,0,10,10
Jasella,F,100,10,0,10
Jasem,M,100,0,10,10
Jasheem,M,100,0,10,10
Jashona,F,100,10,0,10
Jasna,F,100,10,0,10
Jasom,M,100,0,10,10
Jassar,M,100,0,10,10
Jasyra,F,100,10,0,10
Jaten,M,100,0,10,10
Jaterion,M,100,0,10,10
Jaterrian,M,100,0,10,10
Jatiana,F,100,10,0,10
Jatiya,F,100,10,0,10
Jatwan,M,100,0,10,10
Jaustin,M,100,0,10,10
Javair,M,100,0,10,10
Javary,M,100,0,10,10
Javiere,M,100,0,10,10
Jawwad,M,100,0,10,10
Jaybriel,M,100,0,10,10
Jaycia,F,100,10,0,10
Jaydamarie,F,100,10,0,10
Jaydein,M,100,0,10,10
Jayken,M,100,0,10,10
Jaylese,F,100,10,0,10
Jaylex,M,100,0,10,10
Jayliyah,F,100,10,0,10
Jaymiah,F,100,10,0,10
Jaynice,F,100,10,0,10
Jaynne,F,100,10,0,10
Jayslin,F,100,10,0,10
Jaysson,M,100,0,10,10
Jayvee,M,100,0,10,10
Jayvionna,F,100,10,0,10
Jayvius,M,100,0,10,10
Jayze,M,100,0,10,10
Jazabell,F,100,10,0,10
Jazanae,F,100,10,0,10
Jazemine,F,100,10,0,10
Jazyra,F,100,10,0,10
Je,M,100,0,10,10
Jeanaya,F,100,10,0,10
Jeason,M,100,0,10,10
Jecori,M,100,0,10,10
Jeel,F,50,5,5,10
Jeevika,F,100,10,0,10
Jeffries,M,100,0,10,10
Jeilianys,F,100,10,0,10
Jeinny,F,100,10,0,10
Jekari,M,100,0,10,10
Jelia,F,100,10,0,10
Jelisia,F,100,10,0,10
Jelsy,F,100,10,0,10
Jelynn,F,100,10,0,10
Jemi,F,100,10,0,10
Jemichael,M,100,0,10,10
Jemmy,F,100,10,0,10
Jenalyse,F,100,10,0,10
Jenavy,F,100,10,0,10
Jeninne,F,100,10,0,10
Jennabelle,F,100,10,0,10
Jennaca,F,100,10,0,10
Jennalea,F,100,10,0,10
Jennifere,F,100,10,0,10
Jenniferrose,F,100,10,0,10
Jensie,F,100,10,0,10
Jerena,F,100,10,0,10
Jerhonda,F,100,10,0,10
Jerimaine,M,100,0,10,10
Jerimiyah,M,100,0,10,10
Jermir,M,100,0,10,10
Jernya,F,100,10,0,10
Jeromee,M,100,0,10,10
Jerria,F,100,10,0,10
Jerrison,M,100,0,10,10
Jeryme,M,100,0,10,10
Jeseca,F,100,10,0,10
Jeshaiah,M,100,0,10,10
Jeshon,M,100,0,10,10
Jesleen,F,100,10,0,10
Jesli,F,100,10,0,10
Jessalynne,F,100,10,0,10
Jessely,F,100,10,0,10
Jessianne,F,100,10,0,10
Jeveah,F,100,10,0,10
Jeweliet,F,100,10,0,10
Jewl,F,100,10,0,10
Jhalin,M,100,0,10,10
Jhamar,M,100,0,10,10
Jhanna,F,100,10,0,10
Jhasmin,F,100,10,0,10
Jherrica,F,100,10,0,10
Jhosue,M,100,0,10,10
Jihoo,M,100,0,10,10
Jillan,F,100,10,0,10
Jillinda,F,100,10,0,10
Jimal,M,100,0,10,10
Jimere,M,100,0,10,10
Jingyi,F,100,10,0,10
Jinnah,F,100,10,0,10
Jinwoo,M,100,0,10,10
Jiovana,F,100,10,0,10
Jiromi,F,100,10,0,10
Jitesh,M,100,0,10,10
Jlaya,F,100,10,0,10
Joahnna,F,100,10,0,10
Joanah,F,100,10,0,10
Joanita,F,100,10,0,10
Joannette,F,100,10,0,10
Jocasta,F,100,10,0,10
Joce,M,100,0,10,10
Jocinda,F,100,10,0,10
Jocqueline,F,100,10,0,10
Joeisha,F,100,10,0,10
Joelia,F,100,10,0,10
Joelis,F,100,10,0,10
Joesef,M,100,0,10,10
Johnai,F,100,10,0,10
Johnanthan,M,100,0,10,10
Johncarl,M,100,0,10,10
Johneka,F,100,10,0,10
Johnlucas,M,100,0,10,10
Johnnathon,M,100,0,10,10
Johnnel,M,100,0,10,10
Johnnyangel,M,100,0,10,10
Johntyler,M,100,0,10,10
Johnvincent,M,100,0,10,10
Johvanny,M,100,0,10,10
Joji,M,100,0,10,10
Jomaris,F,100,10,0,10
Jomeka,F,100,10,0,10
Jonatthan,M,100,0,10,10
Jonchristopher,M,100,0,10,10
Jonmark,M,100,0,10,10
Jonnika,F,100,10,0,10
Jonpierre,M,100,0,10,10
Jonquel,M,100,0,10,10
Jophy,M,100,0,10,10
Joquetta,F,100,10,0,10
Jorri,F,100,10,0,10
Josan,M,100,0,10,10
Josann,F,100,10,0,10
Josefernando,M,100,0,10,10
Josephlee,M,100,0,10,10
Joshewa,M,100,0,10,10
Joshoua,M,100,0,10,10
Joshusa,M,100,0,10,10
Josielynn,F,100,10,0,10
Josif,M,100,0,10,10
Josse,M,100,0,10,10
Jovette,F,100,10,0,10
Joycene,F,100,10,0,10
Joyden,F,50,5,5,10
Joyette,F,100,10,0,10
Joymarie,F,100,10,0,10
Jrayden,M,100,0,10,10
Judythe,F,100,10,0,10
Juila,F,100,10,0,10
Julain,M,100,0,10,10
Juleny,F,100,10,0,10
Julessa,F,100,10,0,10
Juliaunna,F,100,10,0,10
Juliuz,M,100,0,10,10
Julynn,F,100,10,0,10
Jumari,M,100,0,10,10
Junathean,M,100,0,10,10
Juneann,F,100,10,0,10
Junhao,M,100,0,10,10
Junxi,M,100,0,10,10
Justeena,F,100,10,0,10
Justion,M,100,0,10,10
Justiz,M,100,0,10,10
Justy,F,100,10,0,10
Juvonte,M,100,0,10,10
Jyelle,F,100,10,0,10
Jynae,F,100,10,0,10
Jysir,M,100,0,10,10
Kaamilah,F,100,10,0,10
Kaceon,M,100,0,10,10
Kadaija,F,100,10,0,10
Kaddy,F,100,10,0,10
Kadean,M,100,0,10,10
Kadeija,F,100,10,0,10
Kadrianna,F,100,10,0,10
Kaenon,M,100,0,10,10
Kahlina,F,100,10,0,10
Kailanni,F,100,10,0,10
Kaileeann,F,100,10,0,10
Kajia,F,100,10,0,10
Kalaeb,M,100,0,10,10
Kalaia,F,100,10,0,10
Kalaila,F,100,10,0,10
Kalayiah,F,100,10,0,10
Kaliesha,F,100,10,0,10
Kaliha,F,100,10,0,10
Kalip,M,100,0,10,10
Kaliph,M,100,0,10,10
Kalop,M,100,0,10,10
Kamaj,M,100,0,10,10
Kamakani,M,100,0,10,10
Kamarianna,F,100,10,0,10
Kamaris,M,100,0,10,10
Kambel,F,100,10,0,10
Kameia,F,100,10,0,10
Kamey,F,100,10,0,10
Kamontae,M,100,0,10,10
Kamylla,F,100,10,0,10
Kanajah,F,100,10,0,10
Kandria,F,100,10,0,10
Karabella,F,100,10,0,10
Karanda,F,100,10,0,10
Karif,M,100,0,10,10
Karmann,F,100,10,0,10
Karolis,M,100,0,10,10
Karrell,M,100,0,10,10
Karvin,M,100,0,10,10
Karyle,F,100,10,0,10
Kashlee,F,100,10,0,10
Kasmine,F,100,10,0,10
Katarra,F,100,10,0,10
Katedra,F,100,10,0,10
Kathleeen,F,100,10,0,10
Kathyrne,F,100,10,0,10
Katieanne,F,100,10,0,10
Katiemae,F,100,10,0,10
Katyanna,F,100,10,0,10
Kava,F,100,10,0,10
Kavone,M,100,0,10,10
Kawai,M,100,0,10,10
Kawonna,F,100,10,0,10
Kaydren,M,100,0,10,10
Kayesha,F,100,10,0,10
Kaylannie,F,100,10,0,10
Kaylar,F,100,10,0,10
Kayrene,F,100,10,0,10
Kaysun,M,100,0,10,10
Kazimierz,M,100,0,10,10
Kazuto,M,100,0,10,10
Keadra,F,100,10,0,10
Keambra,F,100,10,0,10
Keandrae,M,100,0,10,10
Keann,F,100,10,0,10
Kearria,F,100,10,0,10
Keason,M,100,0,10,10
Keeaira,F,100,10,0,10
Keetan,M,100,0,10,10
Kehley,F,100,10,0,10
Keiajah,F,100,10,0,10
Keile,F,100,10,0,10
Keimar,M,100,0,10,10
Keiora,F,100,10,0,10
Keisey,F,100,10,0,10
Keishi,M,100,0,10,10
Keiwon,M,100,0,10,10
Keke,F,100,10,0,10
Keldin,M,100,0,10,10
Kelisia,F,100,10,0,10
Kellise,F,100,10,0,10
Kellylynn,F,100,10,0,10
Kemel,M,100,0,10,10
Kenaria,F,100,10,0,10
Kendelyn,F,100,10,0,10
Kendral,F,100,10,0,10
Kendrie,F,100,10,0,10
Kendu,M,100,0,10,10
Keneen,M,100,0,10,10
Kenichiro,M,100,0,10,10
Kenin,M,100,0,10,10
Kenterrius,M,100,0,10,10
Kentravius,M,100,0,10,10
Kenyeta,F,100,10,0,10
Kenze,F,100,10,0,10
Kerk,M,100,0,10,10
Kerl,F,100,10,0,10
Kermith,M,100,0,10,10
Kernisha,F,100,10,0,10
Kerstein,F,100,10,0,10
Kervins,M,100,0,10,10
Keshawnda,F,100,10,0,10
Ketisha,F,100,10,0,10
Keyiona,F,100,10,0,10
Keymar,M,100,0,10,10
Keymaya,F,100,10,0,10
Keyner,M,100,0,10,10
Kez,M,100,0,10,10
Khadjiah,F,100,10,0,10
Khailil,M,100,0,10,10
Khaloni,F,100,10,0,10
Khalya,F,100,10,0,10
Khaseem,M,100,0,10,10
Khawaja,M,100,0,10,10
Khayyam,M,100,0,10,10
Khiari,F,50,5,5,10
Khirey,M,100,0,10,10
Khirsten,F,100,10,0,10
Khizer,M,100,0,10,10
Kholby,M,100,0,10,10
Khora,F,100,10,0,10
Khyier,M,100,0,10,10
Khylia,F,100,10,0,10
Khymani,F,50,5,5,10
Khyrell,M,100,0,10,10
Kiali,F,100,10,0,10
Kidane,M,100,0,10,10
Kiea,F,100,10,0,10
Kielah,F,100,10,0,10
Kiersen,F,100,10,0,10
Kika,F,100,10,0,10
Kimbell,M,100,0,10,10
Kimbler,F,100,10,0,10
Kimbrell,F,50,5,5,10
Kimette,F,100,10,0,10
Kimilee,F,100,10,0,10
Kimlyn,F,100,10,0,10
Kimoralee,F,100,10,0,10
Kinden,M,100,0,10,10
Kinder,F,100,10,0,10
Kineshia,F,100,10,0,10
Kingstun,M,100,0,10,10
Kinika,F,100,10,0,10
Kinson,M,100,0,10,10
Kinyada,F,100,10,0,10
Kinzer,M,100,0,10,10
Kiriakos,M,100,0,10,10
Kirian,F,50,5,5,10
Kirtana,F,100,10,0,10
Kiyanni,F,100,10,0,10
Kiyrah,F,100,10,0,10
Kjay,M,100,0,10,10
Klevis,M,100,0,10,10
Kloye,F,100,10,0,10
Kmani,M,100,0,10,10
Kniko,M,100,0,10,10
Koffi,M,100,0,10,10
Kolee,F,100,10,0,10
Komeka,F,100,10,0,10
Kontina,F,100,10,0,10
Korren,F,100,10,0,10
Korrigan,M,100,0,10,10
Kortlin,M,100,0,10,10
Korwin,M,100,0,10,10
Kostandinos,M,100,0,10,10
Kove,M,100,0,10,10
Kreyton,M,100,0,10,10
Krischelle,F,100,10,0,10
Krishanna,F,100,10,0,10
Krisstopher,M,100,0,10,10
Kristabel,F,100,10,0,10
Kristiina,F,100,10,0,10
Kristil,F,100,10,0,10
Kristilynn,F,100,10,0,10
Kristna,F,100,10,0,10
Krsna,M,100,0,10,10
Krystah,F,100,10,0,10
Krystalina,F,100,10,0,10
Krystallyn,F,100,10,0,10
Kryste,F,100,10,0,10
Krystof,M,100,0,10,10
Kubra,F,100,10,0,10
Kuiana,F,100,10,0,10
Kula,F,100,10,0,10
Kuol,M,100,0,10,10
Kvin,M,100,0,10,10
Kyale,M,100,0,10,10
Kyeesha,F,100,10,0,10
Kyeir,M,100,0,10,10
Kyelan,M,100,0,10,10
Kyeron,M,100,0,10,10
Kyhir,M,100,0,10,10
Kyleia,F,100,10,0,10
Kylel,M,100,0,10,10
Kylepatrick,M,100,0,10,10
Kyliann,F,100,10,0,10
Kylise,F,100,10,0,10
Kyller,M,100,0,10,10
Kymarie,F,100,10,0,10
Kymbra,F,100,10,0,10
Kymisha,F,100,10,0,10
Kymori,F,100,10,0,10
Kyndalyn,F,100,10,0,10
Kyndrah,F,100,10,0,10
Kynnleigh,F,100,10,0,10
Kyonia,F,100,10,0,10
Kyosha,F,100,10,0,10
Kyper,M,100,0,10,10
Kyriel,F,100,10,0,10
Kyus,M,100,0,10,10
Labreshia,F,100,10,0,10
Lacei,F,100,10,0,10
Lachanta,F,100,10,0,10
Lachaundra,F,100,10,0,10
Lachel,F,100,10,0,10
Lachone,F,100,10,0,10
Lacynda,F,100,10,0,10
Lacynthia,F,100,10,0,10
Ladaruis,M,100,0,10,10
Ladenna,F,100,10,0,10
Ladonn,F,100,10,0,10
Ladonnia,F,100,10,0,10
Laeisha,F,100,10,0,10
Lafonya,F,100,10,0,10
Lafoya,F,100,10,0,10
Laika,F,100,10,0,10
Lainah,F,100,10,0,10
Lajaune,M,100,0,10,10
Lakeska,F,100,10,0,10
Lakika,F,100,10,0,10
Lakotah,F,100,10,0,10
Laksha,F,100,10,0,10
Lakshman,M,100,0,10,10
Laliana,F,100,10,0,10
Lalisha,F,100,10,0,10
Lamora,F,100,10,0,10
Landus,M,100,0,10,10
Laneeka,F,100,10,0,10
Lanequa,F,100,10,0,10
Lanyjah,F,100,10,0,10
Lapaul,M,100,0,10,10
Laquala,F,100,10,0,10
Laqueen,F,100,10,0,10
Laqueita,F,100,10,0,10
Laquenda,F,100,10,0,10
Laquincia,F,100,10,0,10
Laqunita,F,100,10,0,10
Laquoia,F,100,10,0,10
Larain,F,100,10,0,10
Laramee,F,100,10,0,10
Larianna,F,100,10,0,10
Laricia,F,100,10,0,10
Lariel,F,100,10,0,10
Larine,F,100,10,0,10
Larkie,F,50,5,5,10
Larmont,M,100,0,10,10
Laronzo,M,100,0,10,10
Lashanay,F,100,10,0,10
Lashanette,F,100,10,0,10
Lashaw,F,50,5,5,10
Lashawda,F,100,10,0,10
Lasheila,F,100,10,0,10
Lashond,F,100,10,0,10
Lasia,F,100,10,0,10
Laster,M,100,0,10,10
Latashua,F,100,10,0,10
Latavis,M,100,0,10,10
Latee,M,100,0,10,10
Lateresa,F,100,10,0,10
Latetia,F,100,10,0,10
Latieka,F,100,10,0,10
Latinia,F,100,10,0,10
Latongia,F,100,10,0,10
Latonjia,F,100,10,0,10
Latonnia,F,100,10,0,10
Latonza,F,100,10,0,10
Latorrie,F,100,10,0,10
Latoyer,F,100,10,0,10
Latraya,F,100,10,0,10
Latrea,F,100,10,0,10
Latronya,F,100,10,0,10
Lauden,M,100,0,10,10
Laur,F,100,10,0,10
Laurae,F,100,10,0,10
Laurale,F,100,10,0,10
Laurean,F,100,10,0,10
Laureana,F,100,10,0,10
Laurilyn,F,100,10,0,10
Lavorn,F,50,5,5,10
Lawon,F,50,5,5,10
Layiah,F,100,10,0,10
Laylanii,F,100,10,0,10
Layleigh,F,100,10,0,10
Layliah,F,100,10,0,10
Laylianna,F,100,10,0,10
Laylon,M,100,0,10,10
Lazaros,M,100,0,10,10
Laziah,F,100,10,0,10
Leamond,M,100,0,10,10
Leaunna,F,100,10,0,10
Lecharles,M,100,0,10,10
Lectoria,F,100,10,0,10
Ledawn,F,100,10,0,10
Leighlynn,F,100,10,0,10
Leihum,M,100,0,10,10
Leilane,F,100,10,0,10
Leiona,F,100,10,0,10
Leise,F,100,10,0,10
Lekethia,F,100,10,0,10
Lelanie,F,100,10,0,10
Lencola,F,100,10,0,10
Lendal,M,100,0,10,10
Lennice,F,100,10,0,10
Leontay,M,100,0,10,10
Lequentin,M,100,0,10,10
Lequesha,F,100,10,0,10
Lequetta,F,100,10,0,10
Leresa,F,100,10,0,10
Leriyah,F,100,10,0,10
Leshaunda,F,100,10,0,10
Leslianne,F,100,10,0,10
Letisa,F,100,10,0,10
Lettice,F,100,10,0,10
Levance,M,100,0,10,10
Levera,F,100,10,0,10
Levian,F,50,5,5,10
Levine,M,100,0,10,10
Levit,M,100,0,10,10
Lexci,F,100,10,0,10
Lexon,M,100,0,10,10
Lidell,M,100,0,10,10
Lilliaunna,F,100,10,0,10
Lilliyan,F,100,10,0,10
Lindall,M,100,0,10,10
Lindse,F,100,10,0,10
Linnett,F,100,10,0,10
Linnetta,F,100,10,0,10
Lionna,F,100,10,0,10
Lisajo,F,100,10,0,10
Lister,M,100,0,10,10
Litha,F,100,10,0,10
Liva,F,100,10,0,10
Lixandro,M,100,0,10,10
Lizardo,M,100,0,10,10
Lizzbeth,F,100,10,0,10
Lizzieann,F,100,10,0,10
Ljiljana,F,100,10,0,10
Llyod,M,100,0,10,10
Loagan,M,100,0,10,10
Loir,F,100,10,0,10
Loralea,F,100,10,0,10
Loreana,F,100,10,0,10
Lorilea,F,100,10,0,10
Lorilie,F,100,10,0,10
Lorisha,F,100,10,0,10
Loronda,F,100,10,0,10
Lorrae,F,100,10,0,10
Lot,M,100,0,10,10
Louwana,F,100,10,0,10
Lovanda,F,100,10,0,10
Lovi,F,100,10,0,10
Lowe,F,50,5,5,10
Loys,F,50,5,5,10
Ltoya,F,100,10,0,10
Lual,M,100,0,10,10
Lucea,F,100,10,0,10
Lugina,F,100,10,0,10
Luicana,F,100,10,0,10
Luk,M,100,0,10,10
Lukan,M,100,0,10,10
Lukin,M,100,0,10,10
Lunamarie,F,100,10,0,10
Lutalo,M,100,0,10,10
Lute,M,100,0,10,10
Lutrica,F,100,10,0,10
Lyiam,M,100,0,10,10
Lyka,F,100,10,0,10
Lylybell,F,100,10,0,10
Lyndelle,F,100,10,0,10
Lyneshia,F,100,10,0,10
Lynh,F,100,10,0,10
Lynnasia,F,100,10,0,10
Lynnise,F,100,10,0,10
Lynton,M,100,0,10,10
Maadhav,M,100,0,10,10
Maaike,F,100,10,0,10
Maariyah,F,100,10,0,10
Mablean,F,100,10,0,10
Macailyn,F,100,10,0,10
Macaire,F,50,5,5,10
Macelynn,F,100,10,0,10
Maceson,M,100,0,10,10
Macheala,F,100,10,0,10
Maciee,F,100,10,0,10
Mackenson,M,100,0,10,10
Mackinnley,M,100,0,10,10
Mackinzey,F,100,10,0,10
Madalinn,F,100,10,0,10
Madaly,F,100,10,0,10
Madilen,F,100,10,0,10
Madon,M,100,0,10,10
Madona,F,100,10,0,10
Maebell,F,100,10,0,10
Maebrie,F,100,10,0,10
Maegon,F,100,10,0,10
Maesen,F,50,5,5,10
Magee,F,100,10,0,10
Mahadi,M,100,0,10,10
Mahali,F,100,10,0,10
Mahdia,F,100,10,0,10
Maheer,M,100,0,10,10
Mahith,M,100,0,10,10
Mahleek,M,100,0,10,10
Mahoganey,F,100,10,0,10
Maidelyn,F,100,10,0,10
Mailene,F,100,10,0,10
Maislyn,F,100,10,0,10
Maiyer,F,100,10,0,10
Maiza,F,100,10,0,10
Maizen,M,100,0,10,10
Makhel,M,100,0,10,10
Makhiyah,F,100,10,0,10
Makida,F,100,10,0,10
Makiesha,F,100,10,0,10
Makinlie,F,100,10,0,10
Malaeka,F,100,10,0,10
Malaisia,F,100,10,0,10
Malanii,F,100,10,0,10
Malanni,F,100,10,0,10
Malcolmjamal,M,100,0,10,10
Malecia,F,100,10,0,10
Malekia,F,100,10,0,10
Maleri,F,100,10,0,10
Maliayah,F,100,10,0,10
Malica,F,100,10,0,10
Malikka,F,100,10,0,10
Malkolm,M,100,0,10,10
Malonnie,F,100,10,0,10
Malyha,F,100,10,0,10
Mandisha,F,100,10,0,10
Manh,M,100,0,10,10
Manjit,F,100,10,0,10
Maquisha,F,100,10,0,10
Marbeth,F,100,10,0,10
Marcellene,F,100,10,0,10
Marcellos,M,100,0,10,10
Marcese,M,100,0,10,10
Marcys,M,100,0,10,10
Mareesha,F,100,10,0,10
Maretha,F,100,10,0,10
Marey,F,100,10,0,10
Marfa,F,100,10,0,10
Margoth,F,100,10,0,10
Margree,F,100,10,0,10
Mariaalejandra,F,100,10,0,10
Mariapaz,F,100,10,0,10
Maricio,M,100,0,10,10
Mariclare,F,100,10,0,10
Mariechristine,F,100,10,0,10
Marielisa,F,100,10,0,10
Marielos,F,100,10,0,10
Marienne,F,100,10,0,10
Marioni,M,100,0,10,10
Mariss,F,100,10,0,10
Marivy,F,100,10,0,10
Mariyha,F,100,10,0,10
Markallen,M,100,0,10,10
Markavius,M,100,0,10,10
Markayden,M,100,0,10,10
Markdaniel,M,100,0,10,10
Markeyia,F,100,10,0,10
Markiss,M,100,0,10,10
Markle,M,100,0,10,10
Markous,M,100,0,10,10
Markquise,M,100,0,10,10
Marlaena,F,100,10,0,10
Marleene,F,100,10,0,10
Marlenea,F,100,10,0,10
Marlii,F,100,10,0,10
Marliz,F,100,10,0,10
Marlou,F,100,10,0,10
Marlyna,F,100,10,0,10
Marqua,M,100,0,10,10
Marquarious,M,100,0,10,10
Marquees,M,100,0,10,10
Marsell,M,100,0,10,10
Martellis,M,100,0,10,10
Martiniano,M,100,0,10,10
Martiqua,F,100,10,0,10
Marvelene,F,100,10,0,10
Maryeileen,F,100,10,0,10
Marzette,F,100,10,0,10
Mashae,F,100,10,0,10
Mashawnda,F,100,10,0,10
Masion,M,100,0,10,10
Maslyn,F,100,10,0,10
Massen,M,100,0,10,10
Mattelynn,F,100,10,0,10
Matthaus,M,100,0,10,10
Matthewjohn,M,100,0,10,10
Mattlyn,F,100,10,0,10
Mattyson,F,100,10,0,10
Maurese,M,100,0,10,10
Maurika,F,100,10,0,10
Mava,F,100,10,0,10
Mawiyah,F,100,10,0,10
Mayani,F,100,10,0,10
Maydell,F,100,10,0,10
Mayeda,F,100,10,0,10
Mayliah,F,100,10,0,10
Maylina,F,100,10,0,10
Mayowa,M,100,0,10,10
Mayre,F,100,10,0,10
Mazarine,F,100,10,0,10
Mazon,M,100,0,10,10
Mckalee,F,100,10,0,10
Mckel,F,50,5,5,10
Mckenli,F,100,10,0,10
Mckennan,M,100,0,10,10
Mckeon,M,100,0,10,10
Mclaine,F,100,10,0,10
Meagann,F,100,10,0,10
Mecaela,F,100,10,0,10
Meganmarie,F,100,10,0,10
Megghan,F,100,10,0,10
Mekos,M,100,0,10,10
Mekya,F,100,10,0,10
Melanieann,F,100,10,0,10
Melanney,F,100,10,0,10
Melchior,M,100,0,10,10
Melenaite,F,100,10,0,10
Melicent,F,100,10,0,10
Melindy,F,100,10,0,10
Melissamarie,F,100,10,0,10
Mellisia,F,100,10,0,10
Melodia,F,100,10,0,10
Melonye,F,100,10,0,10
Melorie,F,100,10,0,10
Meme,F,100,10,0,10
Menphis,M,100,0,10,10
Meraya,F,100,10,0,10
Mercutio,M,100,0,10,10
Merenda,F,100,10,0,10
Merrel,M,100,0,10,10
Merridee,F,100,10,0,10
Mesina,F,100,10,0,10
Messer,M,100,0,10,10
Mianca,F,100,10,0,10
Micaih,M,100,0,10,10
Michaelangel,M,100,0,10,10
Michone,F,100,10,0,10
Midhuna,F,100,10,0,10
Miera,F,100,10,0,10
Migual,M,100,0,10,10
Miguela,F,100,10,0,10
Miguelangelo,M,100,0,10,10
Mikailyn,F,100,10,0,10
Mikenley,F,100,10,0,10
Mikeyia,F,100,10,0,10
Mikio,M,100,0,10,10
Milay,F,100,10,0,10
Mile,M,100,0,10,10
Milesha,F,100,10,0,10
Mileya,F,100,10,0,10
Minton,M,100,0,10,10
Miona,F,100,10,0,10
Mirianna,F,100,10,0,10
Mirsad,M,100,0,10,10
Mirsha,F,100,10,0,10
Mishary,M,100,0,10,10
Missty,F,100,10,0,10
Mkiyah,F,100,10,0,10
Mkyla,F,100,10,0,10
Mlisa,F,100,10,0,10
Mmark,M,100,0,10,10
Modibo,M,100,0,10,10
Mojolaoluwa,F,100,10,0,10
Mokshith,M,100,0,10,10
Monali,F,100,10,0,10
Monce,F,100,10,0,10
Moneta,F,100,10,0,10
Monikia,F,100,10,0,10
Monina,F,100,10,0,10
Monira,F,100,10,0,10
Montea,F,50,5,5,10
Montoria,F,100,10,0,10
Mort,M,100,0,10,10
Motley,M,100,0,10,10
Mozart,M,100,0,10,10
Mugisha,M,100,0,10,10
Muhib,M,100,0,10,10
Muizz,M,100,0,10,10
Munro,M,100,0,10,10
Murissa,F,100,10,0,10
Musashi,M,100,0,10,10
Musette,F,100,10,0,10
Muzette,F,100,10,0,10
Myaira,F,100,10,0,10
Mycaela,F,100,10,0,10
Myel,F,100,10,0,10
Myianna,F,100,10,0,10
Mykeil,M,100,0,10,10
Mykeshia,F,100,10,0,10
Mykiya,F,100,10,0,10
Mykiyah,F,100,10,0,10
Mykola,M,100,0,10,10
Mynette,F,100,10,0,10
Mystee,F,100,10,0,10
Naadia,F,100,10,0,10
Naajia,F,100,10,0,10
Naaz,F,100,10,0,10
Nabhan,M,100,0,10,10
Nacari,M,100,0,10,10
Nadaja,F,100,10,0,10
Nadaya,F,100,10,0,10
Nadelie,F,100,10,0,10
Naderge,F,100,10,0,10
Nadilee,F,100,10,0,10
Nafiz,M,100,0,10,10
Nagwa,F,100,10,0,10
Nahayla,F,100,10,0,10
Nahila,F,100,10,0,10
Nahjai,F,100,10,0,10
Nahya,F,100,10,0,10
Naideline,F,100,10,0,10
Naieem,M,100,0,10,10
Naiylah,F,100,10,0,10
Naiyma,F,100,10,0,10
Najaah,F,100,10,0,10
Najon,M,100,0,10,10
Nakeea,F,100,10,0,10
Nalisa,F,100,10,0,10
Nalya,F,100,10,0,10
Namiko,F,100,10,0,10
Nanakwame,M,100,0,10,10
Nanisha,F,100,10,0,10
Naralie,F,100,10,0,10
Nareen,F,100,10,0,10
Narriah,F,100,10,0,10
Narumi,F,100,10,0,10
Naryia,F,100,10,0,10
Nasaria,F,100,10,0,10
Nasaya,F,100,10,0,10
Nasere,M,100,0,10,10
Nashelly,F,100,10,0,10
Nashwa,F,100,10,0,10
Nashyah,F,100,10,0,10
Nassar,M,100,0,10,10
Nastasja,F,100,10,0,10
Natani,F,100,10,0,10
Nateasha,F,100,10,0,10
Nathale,F,100,10,0,10
Nathasia,F,100,10,0,10
Natheniel,M,100,0,10,10
Natifah,F,100,10,0,10
Nattiel,M,100,0,10,10
Naudiya,F,100,10,0,10
Navonte,M,100,0,10,10
Navor,M,100,0,10,10
Navroop,F,100,10,0,10
Naydean,F,100,10,0,10
Ndrea,F,100,10,0,10
Nehemiyah,M,100,0,10,10
Neidi,F,100,10,0,10
Neilyn,F,100,10,0,10
Neithen,M,100,0,10,10
Nekeda,F,100,10,0,10
Nekishia,F,100,10,0,10
Nelton,M,100,0,10,10
Nerisa,F,100,10,0,10
Nerrissa,F,100,10,0,10
Neshay,F,100,10,0,10
Neshelle,F,100,10,0,10
Nesma,F,100,10,0,10
Nevaehlee,F,100,10,0,10
Niaisha,F,100,10,0,10
Niamalika,F,100,10,0,10
Niamora,F,100,10,0,10
Niari,F,100,10,0,10
Niccola,F,100,10,0,10
Nicey,F,100,10,0,10
Nichalus,M,100,0,10,10
Nicketa,F,100,10,0,10
Niclaus,M,100,0,10,10
Nicoline,F,100,10,0,10
Nieva,F,100,10,0,10
Nihla,F,100,10,0,10
Nijon,M,100,0,10,10
Nikaiya,F,100,10,0,10
Nikaiyah,F,100,10,0,10
Nikiki,F,100,10,0,10
Nikkolette,F,100,10,0,10
Nikolett,F,100,10,0,10
Nikte,F,100,10,0,10
Nilayah,F,100,10,0,10
Niliyah,F,100,10,0,10
Nisarg,M,100,0,10,10
Nishay,F,100,10,0,10
Nivayah,F,100,10,0,10
Niveditha,F,100,10,0,10
Nixaliz,F,100,10,0,10
Niyomi,F,100,10,0,10
Nkiru,F,100,10,0,10
Nojus,M,100,0,10,10
Nolene,F,100,10,0,10
Nooreen,F,100,10,0,10
Norea,F,100,10,0,10
Normaa,F,100,10,0,10
Normando,M,100,0,10,10
Normon,M,100,0,10,10
Nosheen,F,100,10,0,10
Nyasa,F,100,10,0,10
Nycolas,M,100,0,10,10
Nye,M,100,0,10,10
Nyell,F,100,10,0,10
Nygee,M,100,0,10,10
Nykee,M,100,0,10,10
Nykiera,F,100,10,0,10
Nyria,F,100,10,0,10
Nyzae,M,100,0,10,10
Nzuri,F,100,10,0,10
Oaken,M,100,0,10,10
Odon,M,100,0,10,10
Offie,F,50,5,5,10
Ohad,M,100,0,10,10
Olakunle,M,100,0,10,10
Olatunji,M,100,0,10,10
Olexa,F,100,10,0,10
Olisaemeka,M,100,0,10,10
Oliviaann,F,100,10,0,10
Olliyah,F,100,10,0,10
Olyvea,F,100,10,0,10
Omead,M,100,0,10,10
Onkar,M,100,0,10,10
Onnah,F,100,10,0,10
Onyah,F,100,10,0,10
Or,M,100,0,10,10
Orbelin,M,100,0,10,10
Orena,F,100,10,0,10
Orfa,F,100,10,0,10
Orita,F,100,10,0,10
Orlee,F,100,10,0,10
Ormand,M,100,0,10,10
Orran,M,100,0,10,10
Orvilla,F,100,10,0,10
Osahon,M,100,0,10,10
Oshaye,M,100,0,10,10
Osirys,F,100,10,0,10
Osker,M,100,0,10,10
Osyris,M,100,0,10,10
Oteria,F,100,10,0,10
Ousainou,M,100,0,10,10
Oweda,F,100,10,0,10
Oxana,F,100,10,0,10
Oza,M,100,0,10,10
Ozaria,F,100,10,0,10
Ozlem,F,100,10,0,10
Paayal,F,100,10,0,10
Pacita,F,100,10,0,10
Paigelynn,F,100,10,0,10
Panthea,F,100,10,0,10
Par,F,100,10,0,10
Paree,F,100,10,0,10
Parham,M,100,0,10,10
Parmveer,M,100,0,10,10
Patrea,F,100,10,0,10
Pawnee,F,100,10,0,10
Payzley,F,100,10,0,10
Pazong,F,100,10,0,10
Pelma,F,100,10,0,10
Pepi,M,100,0,10,10
Perkins,M,100,0,10,10
Petty,F,100,10,0,10
Peytynn,F,100,10,0,10
Phelicity,F,100,10,0,10
Phelisha,F,100,10,0,10
Phyllisia,F,100,10,0,10
Pierina,F,100,10,0,10
Pino,M,100,0,10,10
Polett,F,100,10,0,10
Pollard,M,100,0,10,10
Pomaikai,F,100,10,0,10
Ppatricia,F,100,10,0,10
Pratima,F,100,10,0,10
Premal,M,100,0,10,10
Presslie,F,100,10,0,10
Prestley,F,100,10,0,10
Prina,F,100,10,0,10
Princewill,M,100,0,10,10
Pryia,F,100,10,0,10
Psymon,M,100,0,10,10
Ptosha,F,100,10,0,10
Pui,F,100,10,0,10
Qmari,M,100,0,10,10
Qua,M,100,0,10,10
Quaadir,M,100,0,10,10
Quadell,M,100,0,10,10
Quala,F,100,10,0,10
Qualen,M,100,0,10,10
Quamayne,M,100,0,10,10
Quamell,M,100,0,10,10
Quanecia,F,100,10,0,10
Quanterrious,M,100,0,10,10
Quantre,M,100,0,10,10
Quashay,F,100,10,0,10
Quavious,M,100,0,10,10
Quayshon,M,100,0,10,10
Queenester,F,100,10,0,10
Queston,M,100,0,10,10
Quetzalcoatl,M,100,0,10,10
Quillian,M,100,0,10,10
Quillie,M,100,0,10,10
Quinsha,F,100,10,0,10
Quinshay,F,100,10,0,10
Quintia,F,100,10,0,10
Quintonio,M,100,0,10,10
Quynhanh,F,100,10,0,10
Qwanda,F,100,10,0,10
Qwendolyn,F,100,10,0,10
Qwenton,M,100,0,10,10
Raashid,M,100,0,10,10
Raaya,F,100,10,0,10
Raayan,M,100,0,10,10
Racel,F,100,10,0,10
Radric,M,100,0,10,10
Raeed,M,100,0,10,10
Raelina,F,100,10,0,10
Rahanna,F,100,10,0,10
Rahsaun,M,100,0,10,10
Rajeeyah,F,100,10,0,10
Rakye,M,100,0,10,10
Raland,M,100,0,10,10
Ramiele,F,100,10,0,10
Rammy,M,100,0,10,10
Ranjani,F,100,10,0,10
Ranjeet,M,100,0,10,10
Raqiya,F,100,10,0,10
Rashael,F,100,10,0,10
Rasheid,M,100,0,10,10
Rashieda,F,100,10,0,10
Rashiyah,F,100,10,0,10
Ratonya,F,100,10,0,10
Ravena,F,100,10,0,10
Raychele,F,100,10,0,10
Rayelyn,F,100,10,0,10
Rayirth,M,100,0,10,10
Rayjay,M,100,0,10,10
Raymell,M,100,0,10,10
Raynal,M,100,0,10,10
Rayqwon,M,100,0,10,10
Rchel,F,100,10,0,10
Reaganne,F,100,10,0,10
Reahna,F,100,10,0,10
Reaiah,F,100,10,0,10
Reasia,F,100,10,0,10
Reeder,M,100,0,10,10
Reeselyn,F,100,10,0,10
Reford,M,100,0,10,10
Regulo,M,100,0,10,10
Rehgan,F,100,10,0,10
Reico,M,100,0,10,10
Reiken,M,100,0,10,10
Reimundo,M,100,0,10,10
Reinhardt,M,100,0,10,10
Reinhart,M,100,0,10,10
Reionna,F,100,10,0,10
Rell,F,50,5,5,10
Revelle,M,100,0,10,10
Revena,F,100,10,0,10
Reyez,M,100,0,10,10
Rhelda,F,100,10,0,10
Rhianah,F,100,10,0,10
Rhome,M,100,0,10,10
Rhonald,M,100,0,10,10
Rhonnie,M,100,0,10,10
Riahanna,F,100,10,0,10
Rial,M,100,0,10,10
Richae,F,100,10,0,10
Ridgley,M,100,0,10,10
Rienna,F,100,10,0,10
Riesa,F,100,10,0,10
Rifa,F,100,10,0,10
Riha,F,100,10,0,10
Riis,M,100,0,10,10
Rijad,M,100,0,10,10
Rikako,F,100,10,0,10
Rikin,M,100,0,10,10
Rilo,M,100,0,10,10
Rilwan,M,100,0,10,10
Rishona,F,100,10,0,10
Riyaz,M,100,0,10,10
Robenson,M,100,0,10,10
Robertina,F,100,10,0,10
Robeto,M,100,0,10,10
Robins,M,100,0,10,10
Roble,M,100,0,10,10
Robret,M,100,0,10,10
Rochon,F,50,5,5,10
Rocklan,M,100,0,10,10
Rodella,F,100,10,0,10
Rodie,M,100,0,10,10
Rodnecia,F,100,10,0,10
Rodnee,M,100,0,10,10
Rodrianna,F,100,10,0,10
Rogel,M,100,0,10,10
Roggie,M,100,0,10,10
Roiann,F,100,10,0,10
Rokko,M,100,0,10,10
Roley,M,100,0,10,10
Romal,M,100,0,10,10
Romare,M,100,0,10,10
Romelda,F,100,10,0,10
Romella,F,100,10,0,10
Romellow,M,100,0,10,10
Ronishia,F,100,10,0,10
Ronnee,F,100,10,0,10
Rosaangelica,F,100,10,0,10
Rosalei,F,100,10,0,10
Rosalino,M,100,0,10,10
Rosane,F,100,10,0,10
Roshea,F,100,10,0,10
Roshika,F,100,10,0,10
Rosilynn,F,100,10,0,10
Rositta,F,100,10,0,10
Rossetta,F,100,10,0,10
Rosston,M,100,0,10,10
Rovenia,F,100,10,0,10
Rowana,F,100,10,0,10
Rowann,F,100,10,0,10
Roxeanne,F,100,10,0,10
Royan,M,100,0,10,10
Royle,M,100,0,10,10
Rozaria,F,100,10,0,10
Rubianna,F,100,10,0,10
Rubyanne,F,100,10,0,10
Ruchir,M,100,0,10,10
Rumana,F,100,10,0,10
Rumina,F,100,10,0,10
Runda,F,100,10,0,10
Runell,F,100,10,0,10
Rutu,F,100,10,0,10
Rutvik,M,100,0,10,10
Rwanda,F,100,10,0,10
Rydder,M,100,0,10,10
Saakshi,F,100,10,0,10
Saaniya,F,100,10,0,10
Sabbath,M,100,0,10,10
Sabia,F,100,10,0,10
Sachary,F,50,5,5,10
Sachiel,M,100,0,10,10
Sadara,F,100,10,0,10
Sadra,F,100,10,0,10
Saedee,F,100,10,0,10
Saelah,F,100,10,0,10
Sager,M,100,0,10,10
Sahniyah,F,100,10,0,10
Saiah,F,100,10,0,10
Sainabou,F,100,10,0,10
Sajidah,F,100,10,0,10
Sakya,F,100,10,0,10
Salahaldin,M,100,0,10,10
Salahudeen,M,100,0,10,10
Salathia,F,100,10,0,10
Saleste,F,100,10,0,10
Salud,F,50,5,5,10
Samajae,M,100,0,10,10
Sameyah,F,100,10,0,10
Samiullah,M,100,0,10,10
Samueldavid,M,100,0,10,10
Samurai,M,100,0,10,10
Samyla,F,100,10,0,10
Sand,F,100,10,0,10
Sandera,F,100,10,0,10
Sandesh,M,100,0,10,10
Sanetra,F,100,10,0,10
Sangeetha,F,100,10,0,10
Sanilah,F,100,10,0,10
Sanjitha,F,100,10,0,10
Sannah,F,100,10,0,10
Sanquenetta,F,100,10,0,10
Sanquita,F,100,10,0,10
Santricia,F,100,10,0,10
Sanura,F,100,10,0,10
Sanyu,F,100,10,0,10
Sao,M,100,0,10,10
Sarahjoy,F,100,10,0,10
Saranna,F,100,10,0,10
Saraphine,F,100,10,0,10
Sarinna,F,100,10,0,10
Saroeun,M,100,0,10,10
Sarrina,F,100,10,0,10
Sassy,F,100,10,0,10
Saturn,F,100,10,0,10
Saumil,M,100,0,10,10
Saun,M,100,0,10,10
Savannahlynn,F,100,10,0,10
Savant,M,100,0,10,10
Savya,F,50,5,5,10
Sawana,F,100,10,0,10
Sayah,F,100,10,0,10
Sayali,F,100,10,0,10
Scarlotte,F,100,10,0,10
Schelle,F,100,10,0,10
Schmeka,F,100,10,0,10
Seager,M,100,0,10,10
Seamas,M,100,0,10,10
Seanchristopher,M,100,0,10,10
Sears,M,100,0,10,10
Sebastyen,M,100,0,10,10
Secunda,F,100,10,0,10
Seeta,F,100,10,0,10
Sekani,M,100,0,10,10
Seleina,F,100,10,0,10
Selika,F,100,10,0,10
Selvyn,M,100,0,10,10
Semajae,F,50,5,5,10
Semhal,F,100,10,0,10
Senda,F,100,10,0,10
Sephia,F,100,10,0,10
Sereana,F,100,10,0,10
Sergiojr,M,100,0,10,10
Serica,F,100,10,0,10
Serrah,F,100,10,0,10
Set,M,100,0,10,10
Sevy,M,100,0,10,10
Sevynn,F,100,10,0,10
Shaaz,M,100,0,10,10
Shabri,F,100,10,0,10
Shabrika,F,100,10,0,10
Shacari,F,100,10,0,10
Shacorra,F,100,10,0,10
Shadale,F,100,10,0,10
Shadarria,F,100,10,0,10
Shaddrick,M,100,0,10,10
Shadera,F,100,10,0,10
Shadin,F,100,10,0,10
Shahryar,M,100,0,10,10
Shaista,F,100,10,0,10
Shakar,M,100,0,10,10
Shakeen,M,100,0,10,10
Shakeenah,F,100,10,0,10
Shakeyta,F,100,10,0,10
Shakwon,M,100,0,10,10
Shaleigha,F,100,10,0,10
Shamayia,F,100,10,0,10
Shameerah,F,100,10,0,10
Shamsa,F,100,10,0,10
Shamsuddin,M,100,0,10,10
Shanbria,F,100,10,0,10
Shance,M,100,0,10,10
Shandal,F,100,10,0,10
Shaneqa,F,100,10,0,10
Shaniyha,F,100,10,0,10
Shanka,F,100,10,0,10
Shanquel,F,100,10,0,10
Shanrika,F,100,10,0,10
Shantail,F,100,10,0,10
Shantaja,F,100,10,0,10
Shantania,F,100,10,0,10
Shantivia,F,100,10,0,10
Shanze,F,100,10,0,10
Shaonna,F,100,10,0,10
Shapree,F,100,10,0,10
Shaquane,F,50,5,5,10
Shaquea,F,100,10,0,10
Shaqulia,F,100,10,0,10
Shaquria,F,100,10,0,10
Sharareh,F,100,10,0,10
Shareca,F,100,10,0,10
Shareeda,F,100,10,0,10
Sharella,F,100,10,0,10
Sharkia,F,100,10,0,10
Sharrief,M,100,0,10,10
Shaska,F,100,10,0,10
Shaterrika,F,100,10,0,10
Shatila,F,100,10,0,10
Shaunique,F,100,10,0,10
Shaunmichael,M,100,0,10,10
Shavae,F,100,10,0,10
Shavia,F,100,10,0,10
Shawday,F,100,10,0,10
Shawntella,F,100,10,0,10
Shawntice,F,100,10,0,10
Shayal,F,100,10,0,10
Shaylor,M,100,0,10,10
Shayni,F,100,10,0,10
Shaynie,F,100,10,0,10
Shayron,F,50,5,5,10
Shazaria,F,100,10,0,10
Shealey,F,100,10,0,10
Sheara,F,100,10,0,10
Shearl,F,50,5,5,10
Shehryar,M,100,0,10,10
Sheilamarie,F,100,10,0,10
Shekeitha,F,100,10,0,10
Sheku,M,100,0,10,10
Sheliyah,F,100,10,0,10
Shellea,F,100,10,0,10
Shenard,M,100,0,10,10
Shenaye,F,100,10,0,10
Shenda,F,100,10,0,10
Shenikwa,F,100,10,0,10
Shenkia,F,100,10,0,10
Shennon,F,100,10,0,10
Sheon,F,50,5,5,10
Shereca,F,100,10,0,10
Sherli,F,100,10,0,10
Shermain,F,50,5,5,10
Sherrena,F,100,10,0,10
Sherrianne,F,100,10,0,10
Sheya,M,100,0,10,10
Shiena,F,100,10,0,10
Shiheim,M,100,0,10,10
Shiho,F,100,10,0,10
Shilla,F,100,10,0,10
Shiloah,F,100,10,0,10
Shing,F,50,5,5,10
Shinise,F,100,10,0,10
Shiniya,F,100,10,0,10
Shiphrah,F,100,10,0,10
Shirle,F,100,10,0,10
Shirrel,F,100,10,0,10
Shivana,F,100,10,0,10
Shivraj,M,100,0,10,10
Shiyah,F,100,10,0,10
Shiyana,F,100,10,0,10
Shlomy,M,100,0,10,10
Shonae,F,100,10,0,10
Shonnell,F,100,10,0,10
Shou,M,100,0,10,10
Shovonne,F,100,10,0,10
Shreeta,F,100,10,0,10
Shundarius,M,100,0,10,10
Shundria,F,100,10,0,10
Shyaira,F,100,10,0,10
Shyloe,F,100,10,0,10
Shyneice,F,100,10,0,10
Shynell,F,100,10,0,10
Siaki,M,100,0,10,10
Siddeeq,M,100,0,10,10
Sieana,F,100,10,0,10
Sifa,F,100,10,0,10
Sifan,F,100,10,0,10
Silvanus,M,100,0,10,10
Silvya,F,100,10,0,10
Simy,F,100,10,0,10
Sindie,F,100,10,0,10
Sinue,M,100,0,10,10
Sinuhe,M,100,0,10,10
Siosaia,M,100,0,10,10
Skylair,F,100,10,0,10
Snezhana,F,100,10,0,10
Sochi,F,100,10,0,10
Sofiamarie,F,100,10,0,10
Sohaila,F,100,10,0,10
Soheila,F,100,10,0,10
Sollie,M,100,0,10,10
Sondria,F,100,10,0,10
Sonnette,F,100,10,0,10
Sonte,F,100,10,0,10
Sooner,F,100,10,0,10
Srivanth,M,100,0,10,10
Srivatsan,M,100,0,10,10
Stalyn,M,100,0,10,10
Stanesha,F,100,10,0,10
Stanette,F,100,10,0,10
Starrlynn,F,100,10,0,10
Staten,M,100,0,10,10
Stayton,M,100,0,10,10
Steeve,M,100,0,10,10
Stefeni,F,100,10,0,10
Stefhany,F,100,10,0,10
Stehpanie,F,100,10,0,10
Stephanieanne,F,100,10,0,10
Stephn,M,100,0,10,10
Stevonte,M,100,0,10,10
Strawberry,F,100,10,0,10
Suchit,M,100,0,10,10
Sudan,M,100,0,10,10
Sukina,F,100,10,0,10
Sulie,F,100,10,0,10
Sumehra,F,100,10,0,10
Sumeja,F,100,10,0,10
Sumerlyn,F,100,10,0,10
Sumiah,F,100,10,0,10
Suneel,M,100,0,10,10
Sunie,F,100,10,0,10
Sureena,F,100,10,0,10
Surely,F,100,10,0,10
Surrey,F,100,10,0,10
Susaa,F,100,10,0,10
Syani,F,100,10,0,10
Sybille,F,100,10,0,10
Sydia,F,100,10,0,10
Syer,M,100,0,10,10
Syion,M,100,0,10,10
Sylee,F,100,10,0,10
Sylvina,F,100,10,0,10
Synthea,F,100,10,0,10
Syntia,F,100,10,0,10
Syrie,F,100,10,0,10
Taaliah,F,100,10,0,10
Taalib,M,100,0,10,10
Taaliba,F,100,10,0,10
Taaron,M,100,0,10,10
Tabrisha,F,100,10,0,10
Tadarious,M,100,0,10,10
Taeghan,F,100,10,0,10
Taemon,M,100,0,10,10
Taffani,F,100,10,0,10
Taffney,F,100,10,0,10
Tahany,F,100,10,0,10
Taheed,M,100,0,10,10
Tahel,F,100,10,0,10
Tahlea,F,100,10,0,10
Tahler,F,100,10,0,10
Tahsha,F,100,10,0,10
Tahtianna,F,100,10,0,10
Tahtyana,F,100,10,0,10
Taily,F,100,10,0,10
Taishan,M,100,0,10,10
Taissa,F,100,10,0,10
Taizo,M,100,0,10,10
Takaila,F,100,10,0,10
Takesa,F,100,10,0,10
Takeyra,F,100,10,0,10
Talaia,F,100,10,0,10
Talaina,F,100,10,0,10
Talayja,F,100,10,0,10
Talee,F,100,10,0,10
Taliesha,F,100,10,0,10
Talulla,F,100,10,0,10
Tamarea,F,100,10,0,10
Tamarind,F,100,10,0,10
Tamarrion,M,100,0,10,10
Tamathia,F,100,10,0,10
Tamecha,F,100,10,0,10
Tamekio,F,100,10,0,10
Tamijo,F,100,10,0,10
Tamisa,F,100,10,0,10
Tammeria,F,100,10,0,10
Tamoni,F,100,10,0,10
Tamoya,F,100,10,0,10
Tampa,F,100,10,0,10
Tanavia,F,100,10,0,10
Tanayja,F,100,10,0,10
Tanayjah,F,100,10,0,10
Tanyelle,F,100,10,0,10
Tanzi,F,100,10,0,10
Tanzila,F,100,10,0,10
Taqee,M,100,0,10,10
Taquoia,F,100,10,0,10
Tarryl,M,100,0,10,10
Tarver,M,100,0,10,10
Tashyana,F,100,10,0,10
Tashyla,F,100,10,0,10
Tatelynn,F,100,10,0,10
Tatiara,F,100,10,0,10
Taton,M,100,0,10,10
Tauras,M,100,0,10,10
Taureon,M,100,0,10,10
Taveres,M,100,0,10,10
Taveyon,M,100,0,10,10
Taviyon,M,100,0,10,10
Tavo,M,100,0,10,10
Tavona,F,100,10,0,10
Tavorian,M,100,0,10,10
Tawain,M,100,0,10,10
Tawnja,F,100,10,0,10
Tawsif,M,100,0,10,10
Tayber,M,100,0,10,10
Taybree,F,100,10,0,10
Tayjuan,M,100,0,10,10
Tayliana,F,100,10,0,10
Taylorlynn,F,100,10,0,10
Taynia,F,100,10,0,10
Tayshawna,F,100,10,0,10
Tazanna,F,100,10,0,10
Taze,M,100,0,10,10
Tazman,M,100,0,10,10
Te,F,100,10,0,10
Teadora,F,100,10,0,10
Teagann,F,100,10,0,10
Tear,F,100,10,0,10
Teguila,F,100,10,0,10
Tejaswini,F,100,10,0,10
Teketa,F,100,10,0,10
Temi,F,100,10,0,10
Temprynce,F,100,10,0,10
Tenchi,M,100,0,10,10
Tennasyn,F,100,10,0,10
Terae,F,50,5,5,10
Terase,F,100,10,0,10
Terene,F,100,10,0,10
Termayne,M,100,0,10,10
Terrae,F,100,10,0,10
Terraine,F,50,5,5,10
Terriauna,F,100,10,0,10
Terryona,F,100,10,0,10
Tertia,F,100,10,0,10
Tetra,F,100,10,0,10
Teveon,M,100,0,10,10
Thaddis,M,100,0,10,10
Thadis,M,100,0,10,10
Thailynn,F,100,10,0,10
Thaliya,F,100,10,0,10
Thearon,M,100,0,10,10
Thedra,F,100,10,0,10
Thedy,F,100,10,0,10
Theofanis,M,100,0,10,10
Therion,M,100,0,10,10
Thoeun,M,100,0,10,10
Thomasin,F,100,10,0,10
Thoran,M,100,0,10,10
Thorian,M,100,0,10,10
Threse,F,100,10,0,10
Thyler,M,100,0,10,10
Tianamarie,F,100,10,0,10
Tielor,M,100,0,10,10
Tiffiani,F,100,10,0,10
Tigerlilly,F,100,10,0,10
Tigra,F,100,10,0,10
Tikeshia,F,100,10,0,10
Tilor,M,100,0,10,10
Timaree,F,100,10,0,10
Timiothy,M,100,0,10,10
Tinamaria,F,100,10,0,10
Tinasha,F,100,10,0,10
Tinashe,F,50,5,5,10
Tini,F,100,10,0,10
Tinka,F,100,10,0,10
Tioni,F,100,10,0,10
Tivis,M,100,0,10,10
Tiyanah,F,100,10,0,10
Tmara,F,100,10,0,10
Tmarion,M,100,0,10,10
Tnaya,F,100,10,0,10
Tobais,M,100,0,10,10
Tobitha,F,100,10,0,10
Tobyas,M,100,0,10,10
Tokunbo,F,50,5,5,10
Tolonda,F,100,10,0,10
Tomicia,F,100,10,0,10
Tomoaki,M,100,0,10,10
Tonua,F,100,10,0,10
Torree,F,100,10,0,10
Toshio,M,100,0,10,10
Tralena,F,100,10,0,10
Tralon,M,100,0,10,10
Tralynn,F,100,10,0,10
Tramale,M,100,0,10,10
Traneice,F,100,10,0,10
Travie,M,100,0,10,10
Travona,F,100,10,0,10
Traycee,F,100,10,0,10
Trayvis,M,100,0,10,10
Treat,M,100,0,10,10
Treble,M,100,0,10,10
Trecie,F,100,10,0,10
Tred,M,100,0,10,10
Trelan,M,100,0,10,10
Trellany,F,100,10,0,10
Tremarcus,M,100,0,10,10
Tremiyah,F,100,10,0,10
Tren,M,100,0,10,10
Trenea,F,100,10,0,10
Trenetta,F,100,10,0,10
Trenitee,F,100,10,0,10
Trennedy,F,100,10,0,10
Tresaun,M,100,0,10,10
Tresor,F,50,5,5,10
Tretha,F,100,10,0,10
Treytin,M,100,0,10,10
Triniya,F,100,10,0,10
Trinnie,F,100,10,0,10
Trixi,F,100,10,0,10
Trond,M,100,0,10,10
Trowa,M,100,0,10,10
Troyvon,M,100,0,10,10
Truely,F,100,10,0,10
Tsai,M,100,0,10,10
Tsean,M,100,0,10,10
Tsega,F,100,10,0,10
Tselane,F,100,10,0,10
Tshara,F,100,10,0,10
Tsubaki,F,100,10,0,10
Tsukasa,M,100,0,10,10
Tuongvy,F,100,10,0,10
Tusha,F,100,10,0,10
Tuyetnhi,F,100,10,0,10
Tyazia,F,100,10,0,10
Tychell,F,100,10,0,10
Tyece,F,100,10,0,10
Tyesia,F,100,10,0,10
Tyhira,F,100,10,0,10
Tylaisha,F,100,10,0,10
Tylasha,F,100,10,0,10
Tylei,F,50,5,5,10
Tyleia,F,100,10,0,10
Tyleke,M,100,0,10,10
Tynlie,F,100,10,0,10
Tyranesha,F,100,10,0,10
Tyras,M,100,0,10,10
Tyrita,F,100,10,0,10
Tyrona,F,100,10,0,10
Tyrrel,M,100,0,10,10
Tyrun,M,100,0,10,10
Tyshelle,F,100,10,0,10
Tytrell,M,100,0,10,10
Tyvonne,M,100,0,10,10
Tyzjuan,M,100,0,10,10
Tzivy,F,100,10,0,10
Ubong,M,100,0,10,10
Ulice,M,100,0,10,10
Ulisess,M,100,0,10,10
Ura,F,50,5,5,10
Ursulla,F,100,10,0,10
Uta,F,100,10,0,10
Uzayr,M,100,0,10,10
Uzuri,F,100,10,0,10
Vachel,M,100,0,10,10
Valdo,M,100,0,10,10
Valentia,F,100,10,0,10
Valiere,F,100,10,0,10
Vananh,F,100,10,0,10
Vaneesa,F,100,10,0,10
Vanicia,F,100,10,0,10
Varon,M,100,0,10,10
Vasil,M,100,0,10,10
Vasudev,M,100,0,10,10
Veeta,F,100,10,0,10
Velvetta,F,100,10,0,10
Vencil,M,100,0,10,10
Veneshia,F,100,10,0,10
Vennetta,F,100,10,0,10
Vergina,F,100,10,0,10
Verlaine,F,100,10,0,10
Vermel,F,100,10,0,10
Verneal,F,50,5,5,10
Vernesa,F,100,10,0,10
Vernise,F,100,10,0,10
Veronicia,F,100,10,0,10
Versace,M,100,0,10,10
Versavia,F,100,10,0,10
Vershon,M,100,0,10,10
Vertell,F,100,10,0,10
Vetra,F,100,10,0,10
Veyron,M,100,0,10,10
Vickilyn,F,100,10,0,10
Victorjr,M,100,0,10,10
Viena,F,100,10,0,10
Vilena,F,100,10,0,10
Vilia,F,100,10,0,10
Vintrell,M,100,0,10,10
Viririana,F,100,10,0,10
Virtue,F,100,10,0,10
Vishan,M,100,0,10,10
Vishrut,M,100,0,10,10
Vivion,F,100,10,0,10
Viya,F,100,10,0,10
Volvy,M,100,0,10,10
Vontavius,M,100,0,10,10
Voronica,F,100,10,0,10
Vritika,F,100,10,0,10
Waiz,M,100,0,10,10
Wakil,M,100,0,10,10
Waldine,F,100,10,0,10
Walik,M,100,0,10,10
Wanyae,M,100,0,10,10
Waren,M,100,0,10,10
Wayd,M,100,0,10,10
Wellsley,F,100,10,0,10
Wendyann,F,100,10,0,10
Wessie,F,100,10,0,10
Wildon,M,100,0,10,10
Wilfried,M,100,0,10,10
Wilhelminia,F,100,10,0,10
Wilhem,M,100,0,10,10
Wilkinson,M,100,0,10,10
Willamae,F,100,10,0,10
Willamena,F,100,10,0,10
Willett,F,50,5,5,10
Wilna,F,100,10,0,10
Wilona,F,100,10,0,10
Windham,M,100,0,10,10
Wintana,F,100,10,0,10
Winterrose,F,100,10,0,10
Wonnie,F,50,5,5,10
Woo,M,100,0,10,10
Wreatha,F,100,10,0,10
Wyconda,F,100,10,0,10
Wydia,F,100,10,0,10
Wykeshia,F,100,10,0,10
Wyoma,F,100,10,0,10
Wytina,F,100,10,0,10
Xabian,M,100,0,10,10
Xalia,F,100,10,0,10
Xanadu,F,100,10,0,10
Xeniah,F,100,10,0,10
Xyanna,F,100,10,0,10
Yabsera,F,100,10,0,10
Yaciel,M,100,0,10,10
Yacir,M,100,0,10,10
Yahav,F,50,5,5,10
Yakina,F,100,10,0,10
Yakob,M,100,0,10,10
Yalexis,F,100,10,0,10
Yaliyah,F,100,10,0,10
Yanahi,F,100,10,0,10
Yanaiza,F,100,10,0,10
Yaniz,F,100,10,0,10
Yannie,F,100,10,0,10
Yaresi,F,100,10,0,10
Yaretza,F,100,10,0,10
Yaroslava,F,100,10,0,10
Yary,F,100,10,0,10
Yaseer,M,100,0,10,10
Yashekia,F,100,10,0,10
Yashraj,M,100,0,10,10
Yasine,M,100,0,10,10
Yasmany,M,100,0,10,10
Yastelin,F,100,10,0,10
Yatta,F,100,10,0,10
Yaxel,M,100,0,10,10
Yazel,F,100,10,0,10
Yazline,F,100,10,0,10
Yazmarie,F,100,10,0,10
Yedid,F,100,10,0,10
Yeilen,F,100,10,0,10
Yemisi,F,100,10,0,10
Yener,M,100,0,10,10
Yesh,M,100,0,10,10
Yeshia,F,50,5,5,10
Yitzchock,M,100,0,10,10
Yixuan,F,100,10,0,10
Ykeisha,F,100,10,0,10
Yolimar,F,100,10,0,10
Yollanda,F,100,10,0,10
Yomaly,F,100,10,0,10
Yonda,F,100,10,0,10
Yosalin,F,100,10,0,10
Yosel,M,100,0,10,10
Yosmely,F,100,10,0,10
Yost,M,100,0,10,10
You,M,100,0,10,10
Youri,M,100,0,10,10
Yudani,F,100,10,0,10
Yukina,F,100,10,0,10
Yulander,F,100,10,0,10
Yuleimi,F,100,10,0,10
Yuleydi,F,100,10,0,10
Yunes,M,100,0,10,10
Yura,F,100,10,0,10
Yurisa,F,100,10,0,10
Yuuka,F,100,10,0,10
Yuxi,F,100,10,0,10
Yva,F,100,10,0,10
Zaaire,M,100,0,10,10
Zabrien,M,100,0,10,10
Zaccaria,M,100,0,10,10
Zaccariah,M,100,0,10,10
Zachaery,M,100,0,10,10
Zachriah,M,100,0,10,10
Zacora,F,100,10,0,10
Zacori,M,100,0,10,10
Zadon,M,100,0,10,10
Zaher,M,100,0,10,10
Zahiem,M,100,0,10,10
Zahrea,F,100,10,0,10
Zaionna,F,100,10,0,10
Zakarian,M,100,0,10,10
Zakerria,F,100,10,0,10
Zakori,M,100,0,10,10
Zaleigha,F,100,10,0,10
Zamaree,M,100,0,10,10
Zamian,M,100,0,10,10
Zanaiah,F,100,10,0,10
Zanajah,F,100,10,0,10
Zanette,F,100,10,0,10
Zann,M,100,0,10,10
Zarahy,F,100,10,0,10
Zaret,F,100,10,0,10
Zariona,F,100,10,0,10
Zarrion,M,100,0,10,10
Zatanna,F,100,10,0,10
Zaundra,F,100,10,0,10
Zaveah,F,100,10,0,10
Zaviyon,M,100,0,10,10
Zefram,M,100,0,10,10
Zeinabou,F,100,10,0,10
Zekariah,M,100,0,10,10
Zemar,M,100,0,10,10
Zenah,F,100,10,0,10
Zenai,F,100,10,0,10
Zene,F,100,10,0,10
Zephania,F,100,10,0,10
Zephram,M,100,0,10,10
Zerelda,F,100,10,0,10
Zeyneb,F,100,10,0,10
Ziar,M,100,0,10,10
Zimya,F,100,10,0,10
Zivon,M,100,0,10,10
Ziyanah,F,100,10,0,10
Ziyang,M,100,0,10,10
Zmari,M,100,0,10,10
Zmiyah,F,100,10,0,10
Zoemarie,F,100,10,0,10
Zoeymarie,F,100,10,0,10
Zolee,F,100,10,0,10
Zorita,F,100,10,0,10
Zory,F,100,10,0,10
Zowey,F,100,10,0,10
Zuhal,F,100,10,0,10
Zuheily,F,100,10,0,10
Zuhra,F,100,10,0,10
Zulai,F,100,10,0,10
Zulaika,F,100,10,0,10
Zuli,F,100,10,0,10
Zyesha,F,100,10,0,10
Zyhier,M,100,0,10,10
Zykaria,F,100,10,0,10
Zyliyah,F,100,10,0,10
Zylynn,F,100,10,0,10
Zynaria,F,100,10,0,10
Zyonn,M,100,0,10,10
Zyrian,M,100,0,10,10
Zyriel,F,100,10,0,10
Zyrin,M,100,0,10,10
Abdihafid,M,100,0,9,9
Adagio,M,100,0,9,9
Adalius,M,100,0,9,9
Adeliah,F,100,9,0,9
Ahking,M,100,0,9,9
Ahrian,M,100,0,9,9
Ahzariah,F,100,9,0,9
Aigne,F,100,9,0,9
Aitlin,F,100,9,0,9
Akadia,F,100,9,0,9
Alancia,F,100,9,0,9
Amillie,F,100,9,0,9
Aneitra,F,100,9,0,9
Angelline,F,100,9,0,9
Anjanet,F,100,9,0,9
Annexie,F,100,9,0,9
Asbiel,M,100,0,9,9
Athos,M,100,0,9,9
Atiyya,F,100,9,0,9
Avoree,F,100,9,0,9
Awet,M,100,0,9,9
Aydain,M,100,0,9,9
Ayela,F,100,9,0,9
Aylet,F,100,9,0,9
Ayrah,F,100,9,0,9
Barika,F,100,9,0,9
Behrang,M,100,0,9,9
Beonce,F,100,9,0,9
Bernadet,F,100,9,0,9
Biranna,F,100,9,0,9
Bjana,F,100,9,0,9
Briggston,M,100,0,9,9
Calbe,M,100,0,9,9
Calirae,F,100,9,0,9
Camili,F,100,9,0,9
Carenda,F,100,9,0,9
Casmira,F,100,9,0,9
Celiana,F,100,9,0,9
Chachi,M,100,0,9,9
Chalsie,F,100,9,0,9
Chaneyra,F,100,9,0,9
Chendra,F,100,9,0,9
Cheniece,F,100,9,0,9
Christophel,M,100,0,9,9
Clairabelle,F,100,9,0,9
Clydean,F,100,9,0,9
Comaneci,F,100,9,0,9
Conquista,F,100,9,0,9
Copelynn,F,100,9,0,9
Corrinda,F,100,9,0,9
Cosmos,M,100,0,9,9
Crystianna,F,100,9,0,9
Cymande,M,100,0,9,9
Daleesa,F,100,9,0,9
Daleysha,F,100,9,0,9
Danayshia,F,100,9,0,9
Dashuan,M,100,0,9,9
Davaria,F,100,9,0,9
Davinah,F,100,9,0,9
Dayceon,M,100,0,9,9
Dayris,F,100,9,0,9
Daytwon,M,100,0,9,9
Deandray,M,100,0,9,9
Demetriu,M,100,0,9,9
Derrus,M,100,0,9,9
Desjambra,F,100,9,0,9
Dhahran,M,100,0,9,9
Diretha,F,100,9,0,9
Djana,F,100,9,0,9
Donzaleigh,F,100,9,0,9
Doward,M,100,0,9,9
Dreshan,M,100,0,9,9
Duuna,F,100,9,0,9
Eduardoluis,M,100,0,9,9
Elondra,F,100,9,0,9
Enchantee,F,100,9,0,9
Enner,M,100,0,9,9
Eriyan,F,100,9,0,9
Esad,M,100,0,9,9
Ethanjoseph,M,100,0,9,9
Eumeka,F,100,9,0,9
Evelet,F,100,9,0,9
Everlea,F,100,9,0,9
Eyas,M,100,0,9,9
Ezmay,F,100,9,0,9
Finas,M,100,0,9,9
Foye,M,100,0,9,9
Frey,M,100,0,9,9
Gadsden,M,100,0,9,9
Geneviev,F,100,9,0,9
Gladystine,F,100,9,0,9
Glenalee,F,100,9,0,9
Graycelynn,F,100,9,0,9
Haakim,M,100,0,9,9
Habeeba,F,100,9,0,9
Haelynn,F,100,9,0,9
Haloa,M,100,0,9,9
Hydiah,F,100,9,0,9
Hydiea,F,100,9,0,9
Idi,M,100,0,9,9
Ieishia,F,100,9,0,9
Ilish,F,100,9,0,9
Ivalee,F,100,9,0,9
Iyisha,F,100,9,0,9
Jabahri,M,100,0,9,9
Jabarion,M,100,0,9,9
Jabreena,F,100,9,0,9
Jaesyn,M,100,0,9,9
Jaimaya,F,100,9,0,9
Jaleyza,F,100,9,0,9
Janaeyah,F,100,9,0,9
Jaqavious,M,100,0,9,9
Jaritsa,F,100,9,0,9
Jarmarion,M,100,0,9,9
Jasandra,F,100,9,0,9
Jasniel,M,100,0,9,9
Javontai,M,100,0,9,9
Jazabelle,F,100,9,0,9
Jealisa,F,100,9,0,9
Jenavicia,F,100,9,0,9
Jerilou,F,100,9,0,9
Jerralyn,F,100,9,0,9
Jewelyssa,F,100,9,0,9
Jimmer,M,100,0,9,9
Jinora,F,100,9,0,9
Jocelene,F,100,9,0,9
Jocylyn,F,100,9,0,9
Jomira,F,100,9,0,9
Juleena,F,100,9,0,9
Juleisy,F,100,9,0,9
Justinthomas,M,100,0,9,9
Kabri,F,100,9,0,9
Kamorian,M,100,0,9,9
Kaneeshia,F,100,9,0,9
Kaoir,F,100,9,0,9
Karisia,F,100,9,0,9
Karyah,F,100,9,0,9
Kashtin,M,100,0,9,9
Kathalia,F,100,9,0,9
Kausar,F,100,9,0,9
Kaylanee,F,100,9,0,9
Kaymin,F,100,9,0,9
Kemyiah,F,100,9,0,9
Kertrina,F,100,9,0,9
Kezzy,F,100,9,0,9
Khotan,M,100,0,9,9
Kiata,F,100,9,0,9
Kristofe,M,100,0,9,9
Ksha,F,100,9,0,9
Kynara,F,100,9,0,9
Lais,F,100,9,0,9
Latayshia,F,100,9,0,9
Latifia,F,100,9,0,9
Leata,F,100,9,0,9
Leetha,F,100,9,0,9
Lielah,F,100,9,0,9
Londynne,F,100,9,0,9
Lynnis,F,100,9,0,9
Mackynze,F,100,9,0,9
Maevis,F,100,9,0,9
Maewyn,F,100,9,0,9
Makua,M,100,0,9,9
Malk,F,100,9,0,9
Markum,M,100,0,9,9
Marriyah,F,100,9,0,9
Marseille,F,100,9,0,9
Matracia,F,100,9,0,9
Mayonna,F,100,9,0,9
Mayzi,F,100,9,0,9
Miniyah,F,100,9,0,9
Mylaya,F,100,9,0,9
Myraa,F,100,9,0,9
Myree,F,100,9,0,9
Nahtanha,F,100,9,0,9
Namarion,M,100,0,9,9
Nata,F,100,9,0,9
Nedenia,F,100,9,0,9
Nekaya,F,100,9,0,9
Neshanta,F,100,9,0,9
Nilyne,F,100,9,0,9
Niveya,F,100,9,0,9
Oaklei,F,100,9,0,9
Okemia,F,100,9,0,9
Pragati,F,100,9,0,9
Princie,F,100,9,0,9
Priscilia,F,100,9,0,9
Queenisha,F,100,9,0,9
Quinnly,F,100,9,0,9
Quisto,M,100,0,9,9
Rahneisha,F,100,9,0,9
Rajane,F,100,9,0,9
Ralphine,F,100,9,0,9
Ranoda,F,100,9,0,9
Rapunzel,F,100,9,0,9
Rashean,M,100,0,9,9
Renarta,F,100,9,0,9
Rexall,M,100,0,9,9
Rixton,M,100,0,9,9
Rmontay,M,100,0,9,9
Rydin,M,100,0,9,9
Rylieann,F,100,9,0,9
Saahiti,F,100,9,0,9
Samus,F,100,9,0,9
Santini,M,100,0,9,9
Shainia,F,100,9,0,9
Shalesa,F,100,9,0,9
Shanquille,M,100,0,9,9
Sharvae,F,100,9,0,9
Sheere,F,100,9,0,9
Shenitta,F,100,9,0,9
Shinese,F,100,9,0,9
Shoan,M,100,0,9,9
Silence,F,100,9,0,9
Sisqo,M,100,0,9,9
Stefoni,F,100,9,0,9
Sukhleen,F,100,9,0,9
Talaja,F,100,9,0,9
Tamka,F,100,9,0,9
Teco,M,100,0,9,9
Teliea,F,100,9,0,9
Terriq,M,100,0,9,9
Tiaura,F,100,9,0,9
Timolyn,F,100,9,0,9
Tomeica,F,100,9,0,9
Tonnica,F,100,9,0,9
Truley,F,100,9,0,9
Tshwanda,F,100,9,0,9
Twanetta,F,100,9,0,9
Tyreace,M,100,0,9,9
Usmaan,M,100,0,9,9
Virjean,F,100,9,0,9
Wakina,F,100,9,0,9
Widline,F,100,9,0,9
Wrenly,F,100,9,0,9
Wynisha,F,100,9,0,9
Yailenys,F,100,9,0,9
Yalimar,F,100,9,0,9
Yanisley,F,100,9,0,9
Yannery,F,100,9,0,9
Yo,F,100,9,0,9
Yomtov,M,100,0,9,9
Yorlet,F,100,9,0,9
Zakeea,F,100,9,0,9
Zakeia,F,100,9,0,9
Zeiden,M,100,0,9,9
Aagam,M,100,0,8,8
Aajon,M,100,0,8,8
Ackley,M,100,0,8,8
Adaleyza,F,100,8,0,8
Addalin,F,100,8,0,8
Adrialis,F,100,8,0,8
Adrianno,M,100,0,8,8
Aeyden,M,100,0,8,8
Ajayceon,M,100,0,8,8
Ajaycia,F,100,8,0,8
Ajenae,F,100,8,0,8
Aketzaly,F,100,8,0,8
Akierra,F,100,8,0,8
Alanood,F,100,8,0,8
Albiery,M,100,0,8,8
Ale,M,100,0,8,8
Alejandr,M,100,0,8,8
Alexcya,F,100,8,0,8
Alexnadra,F,100,8,0,8
Alexzandrya,F,100,8,0,8
Aleyssa,F,100,8,0,8
Alfonson,M,100,0,8,8
Algene,F,100,8,0,8
Aliiyah,F,100,8,0,8
Alo,M,100,0,8,8
Alrik,M,100,0,8,8
Altaf,M,100,0,8,8
Altaira,F,100,8,0,8
Amarye,F,100,8,0,8
Amiliyah,F,100,8,0,8
Anadela,F,100,8,0,8
Anahia,F,100,8,0,8
Anahii,F,100,8,0,8
Anassa,F,100,8,0,8
Anaylah,F,100,8,0,8
Andelynn,F,100,8,0,8
Andreona,F,100,8,0,8
Aneek,M,100,0,8,8
Anindita,F,100,8,0,8
Anmar,M,100,0,8,8
Annye,F,100,8,0,8
Antal,M,100,0,8,8
Anteaus,M,100,0,8,8
Antoinet,F,100,8,0,8
Antria,F,100,8,0,8
Aresenio,M,100,0,8,8
Arnavi,F,100,8,0,8
Ashleyelizabeth,F,100,8,0,8
Astrin,F,100,8,0,8
Audraya,F,100,8,0,8
Augus,M,100,0,8,8
Autianna,F,100,8,0,8
Autzen,M,100,0,8,8
Avahlynn,F,100,8,0,8
Avalanna,F,100,8,0,8
Avren,M,100,0,8,8
Azayliah,F,100,8,0,8
Azella,F,100,8,0,8
Benhur,M,100,0,8,8
Bentlea,F,100,8,0,8
Benzino,M,100,0,8,8
Berthena,F,100,8,0,8
Betony,F,100,8,0,8
Betzhy,F,100,8,0,8
Bhuvi,F,100,8,0,8
Bienvenida,F,100,8,0,8
Binu,M,100,0,8,8
Bionce,F,100,8,0,8
Boey,F,100,8,0,8
Brajon,M,100,0,8,8
Branham,M,100,0,8,8
Braylynne,F,100,8,0,8
Breazae,F,100,8,0,8
Breklynn,F,100,8,0,8
Brigston,M,100,0,8,8
Bronnie,M,100,0,8,8
Byata,F,100,8,0,8
Calizza,F,100,8,0,8
Camiron,M,100,0,8,8
Camoren,M,100,0,8,8
Carinda,F,100,8,0,8
Cariya,F,100,8,0,8
Carlet,F,100,8,0,8
Carmelyn,F,100,8,0,8
Carmesa,F,100,8,0,8
Cassondr,F,100,8,0,8
Caytlynn,F,100,8,0,8
Celeny,F,100,8,0,8
Cetric,M,100,0,8,8
Chaely,F,100,8,0,8
Chander,M,100,0,8,8
Chastelyne,F,100,8,0,8
Cherhonda,F,100,8,0,8
Chermeka,F,100,8,0,8
Chiquitia,F,100,8,0,8
Chrisitan,M,100,0,8,8
Chrisley,F,100,8,0,8
Christerphor,M,100,0,8,8
Christyle,F,100,8,0,8
Chritine,F,100,8,0,8
Clarann,F,100,8,0,8
Cleary,F,100,8,0,8
Constanc,F,100,8,0,8
Conye,M,100,0,8,8
Coreyona,F,100,8,0,8
Corteney,F,100,8,0,8
Crae,M,100,0,8,8
Daffy,F,100,8,0,8
Dailani,F,100,8,0,8
Danetria,F,100,8,0,8
Daquwan,M,100,0,8,8
Darchell,F,100,8,0,8
Darrayl,M,100,0,8,8
Darriah,F,100,8,0,8
Dartagnon,M,100,0,8,8
Darweshi,M,100,0,8,8
Daryell,M,100,0,8,8
Dashyia,F,100,8,0,8
Dauda,M,100,0,8,8
Daveontae,M,100,0,8,8
Davika,F,100,8,0,8
Dawneen,F,100,8,0,8
Dayleigh,F,100,8,0,8
Deandres,M,100,0,8,8
Dedera,F,100,8,0,8
Deedy,F,100,8,0,8
Dejoire,F,100,8,0,8
Dejone,F,100,8,0,8
Delaia,F,100,8,0,8
Demarrie,M,100,0,8,8
Derrance,M,100,0,8,8
Deshya,F,100,8,0,8
Detricia,F,100,8,0,8
Deundray,M,100,0,8,8
Devarsh,M,100,0,8,8
Dexten,M,100,0,8,8
Dezira,F,100,8,0,8
Dharmesh,M,100,0,8,8
Dheer,M,100,0,8,8
Dianney,F,100,8,0,8
Diliana,F,100,8,0,8
Divion,M,100,0,8,8
Domonigue,F,100,8,0,8
Donnovin,M,100,0,8,8
Dotsy,F,100,8,0,8
Drexton,M,100,0,8,8
Dristan,M,100,0,8,8
Dycen,M,100,0,8,8
Dyian,M,100,0,8,8
Eislee,F,100,8,0,8
Ekco,F,100,8,0,8
Eldan,M,100,0,8,8
Elijia,M,100,0,8,8
Elimelec,M,100,0,8,8
Elinam,F,100,8,0,8
Elizha,M,100,0,8,8
Ellexa,F,100,8,0,8
Elliemarie,F,100,8,0,8
Ellika,F,100,8,0,8
Ellyette,F,100,8,0,8
Elves,M,100,0,8,8
Emerlyn,F,100,8,0,8
Emeryn,F,100,8,0,8
Emyree,F,100,8,0,8
Enajiah,F,100,8,0,8
Enchantra,F,100,8,0,8
Esrael,M,100,0,8,8
Etheridge,M,100,0,8,8
Everdeen,F,100,8,0,8
Eyian,M,100,0,8,8
Francellia,F,100,8,0,8
Franchessca,F,100,8,0,8
Francisc,M,100,0,8,8
Francys,F,100,8,0,8
Fredarius,M,100,0,8,8
Frenesi,F,100,8,0,8
Gagik,M,100,0,8,8
Gion,M,100,0,8,8
Gleice,F,100,8,0,8
Goodluck,M,100,0,8,8
Greisy,F,100,8,0,8
Greydys,F,100,8,0,8
Guila,F,100,8,0,8
Gursirat,F,100,8,0,8
Hadeed,M,100,0,8,8
Hadel,F,100,8,0,8
Hadessa,F,100,8,0,8
Halas,M,100,0,8,8
Haoxuan,M,100,0,8,8
Hatch,M,100,0,8,8
Heddie,F,100,8,0,8
Heder,M,100,0,8,8
Hennah,F,100,8,0,8
Herley,M,100,0,8,8
Hessa,F,100,8,0,8
Hiiaka,F,100,8,0,8
Hirsh,M,100,0,8,8
Hombre,M,100,0,8,8
Huner,M,100,0,8,8
Imee,F,100,8,0,8
Indasia,F,100,8,0,8
Isander,M,100,0,8,8
Itiana,F,100,8,0,8
Iuma,F,100,8,0,8
Ivelin,F,100,8,0,8
Jabien,M,100,0,8,8
Jabraylin,M,100,0,8,8
Jacquarius,M,100,0,8,8
Jacquelen,F,100,8,0,8
Jahleil,M,100,0,8,8
Jahmell,M,100,0,8,8
Jahriah,F,100,8,0,8
Jahziya,F,100,8,0,8
Jaicyon,M,100,0,8,8
Jaiheim,M,100,0,8,8
Jakir,M,100,0,8,8
Jamilyah,F,100,8,0,8
Jaonte,M,100,0,8,8
Jaxlynn,F,100,8,0,8
Jayree,M,100,0,8,8
Jayrell,M,100,0,8,8
Jaywanna,F,100,8,0,8
Jemmerio,M,100,0,8,8
Jerahmy,M,100,0,8,8
Jerelly,F,100,8,0,8
Jesue,M,100,0,8,8
Jeth,M,100,0,8,8
Jetzael,M,100,0,8,8
Jetziel,M,100,0,8,8
Jevone,M,100,0,8,8
Jeyshangelise,F,100,8,0,8
Jheryl,M,100,0,8,8
Jillmarie,F,100,8,0,8
Jimon,M,100,0,8,8
Johaun,M,100,0,8,8
Jonjon,M,100,0,8,8
Josgart,M,100,0,8,8
Juanesteban,M,100,0,8,8
Julyn,F,100,8,0,8
Jumanji,M,100,0,8,8
Jurie,F,100,8,0,8
Justien,F,100,8,0,8
Kadraya,F,100,8,0,8
Kahdejah,F,100,8,0,8
Kahniyah,F,100,8,0,8
Kaiba,M,100,0,8,8
Kairaba,M,100,0,8,8
Kaleinani,F,100,8,0,8
Kamariyon,M,100,0,8,8
Kamarrah,F,100,8,0,8
Kamyl,F,100,8,0,8
Kaniyha,F,100,8,0,8
Karinn,F,100,8,0,8
Karlysia,F,100,8,0,8
Karona,F,100,8,0,8
Karylle,F,100,8,0,8
Kaseton,M,100,0,8,8
Kashaf,F,100,8,0,8
Kaze,M,100,0,8,8
Kedisha,F,100,8,0,8
Keivonte,M,100,0,8,8
Keldyn,M,100,0,8,8
Kellyanna,F,100,8,0,8
Kemarah,F,100,8,0,8
Kenah,F,100,8,0,8
Keondric,M,100,0,8,8
Kesten,M,100,0,8,8
Kevondrick,M,100,0,8,8
Keymia,F,100,8,0,8
Khadijia,F,100,8,0,8
Khaleesia,F,100,8,0,8
Khamaron,M,100,0,8,8
Khamilla,F,100,8,0,8
Khemani,M,100,0,8,8
Khodee,M,100,0,8,8
Khonor,M,100,0,8,8
Kiersty,F,100,8,0,8
Kimwana,F,100,8,0,8
Kine,F,100,8,0,8
Knesha,F,100,8,0,8
Knylah,F,100,8,0,8
Koldyn,M,100,0,8,8
Konesha,F,100,8,0,8
Konyae,M,100,0,8,8
Kwabene,M,100,0,8,8
Kylasia,F,100,8,0,8
Kymbre,F,100,8,0,8
Kyonte,M,100,0,8,8
Ladanien,M,100,0,8,8
Ladrick,M,100,0,8,8
Laiten,M,100,0,8,8
Lakeea,F,100,8,0,8
Lakeyah,F,100,8,0,8
Lamarianna,F,100,8,0,8
Lanaijah,F,100,8,0,8
Landee,F,100,8,0,8
Laneyah,F,100,8,0,8
Lanor,F,100,8,0,8
Lasette,F,100,8,0,8
Lashune,F,100,8,0,8
Lebrone,M,100,0,8,8
Legen,M,100,0,8,8
Leisy,F,100,8,0,8
Lemual,M,100,0,8,8
Lendall,M,100,0,8,8
Leroya,F,100,8,0,8
Lesane,M,100,0,8,8
Leshawna,F,100,8,0,8
Lesliee,F,100,8,0,8
Lilynn,F,100,8,0,8
Limuel,M,100,0,8,8
Lisete,F,100,8,0,8
Loistene,F,100,8,0,8
Loken,M,100,0,8,8
Lounell,F,100,8,0,8
Lovann,F,100,8,0,8
Lucyna,F,100,8,0,8
Lynnon,F,100,8,0,8
Lyzah,F,100,8,0,8
Macalla,F,100,8,0,8
Macksen,M,100,0,8,8
Macray,M,100,0,8,8
Madlen,F,100,8,0,8
Maizah,F,100,8,0,8
Makenzlee,F,100,8,0,8
Malinalli,F,100,8,0,8
Mandey,F,100,8,0,8
Manouchka,F,100,8,0,8
Mantej,M,100,0,8,8
Mareco,M,100,0,8,8
Marelys,F,100,8,0,8
Marichal,M,100,0,8,8
Marileysis,F,100,8,0,8
Marpessa,F,100,8,0,8
Marquetia,F,100,8,0,8
Maryla,F,100,8,0,8
Marylea,F,100,8,0,8
Matthijs,M,100,0,8,8
Mauli,F,100,8,0,8
Mavryck,M,100,0,8,8
Mazzi,F,100,8,0,8
Mckinzley,F,100,8,0,8
Melieck,M,100,0,8,8
Meyosha,F,100,8,0,8
Mezmariah,F,100,8,0,8
Micaden,M,100,0,8,8
Michelann,F,100,8,0,8
Michle,M,100,0,8,8
Midnight,F,100,8,0,8
Milada,F,100,8,0,8
Minnetta,F,100,8,0,8
Mirracle,F,100,8,0,8
Moayad,M,100,0,8,8
Montera,F,100,8,0,8
Montserat,F,100,8,0,8
Mykila,F,100,8,0,8
Myleene,F,100,8,0,8
Naana,F,100,8,0,8
Nadilyn,F,100,8,0,8
Nadolyn,F,100,8,0,8
Nagelly,F,100,8,0,8
Nahaven,F,100,8,0,8
Nahema,F,100,8,0,8
Nahyan,M,100,0,8,8
Namit,M,100,0,8,8
Nasrallah,M,100,0,8,8
Nathanjames,M,100,0,8,8
Navaiah,F,100,8,0,8
Nayelii,F,100,8,0,8
Nazayah,F,100,8,0,8
Nciholas,M,100,0,8,8
Neavah,F,100,8,0,8
Neci,F,100,8,0,8
Neecy,F,100,8,0,8
Neelisha,F,100,8,0,8
Neilie,F,100,8,0,8
Nerses,M,100,0,8,8
Neyba,F,100,8,0,8
Nhuy,F,100,8,0,8
Nhya,F,100,8,0,8
Nicayla,F,100,8,0,8
Nna,F,100,8,0,8
Noehly,F,100,8,0,8
Noire,F,100,8,0,8
Novi,F,100,8,0,8
Nyal,M,100,0,8,8
Nyquasia,F,100,8,0,8
Nyvaeh,F,100,8,0,8
Olaiya,F,100,8,0,8
Olha,F,100,8,0,8
Oriona,F,100,8,0,8
Orlandrea,F,100,8,0,8
Orma,F,100,8,0,8
Oumie,F,100,8,0,8
Ozric,M,100,0,8,8
Pars,M,100,0,8,8
Persaus,F,100,8,0,8
Persephoni,F,100,8,0,8
Phaidra,F,100,8,0,8
Qwanesha,F,100,8,0,8
Raashi,F,100,8,0,8
Raeneisha,F,100,8,0,8
Rahf,F,100,8,0,8
Rahila,F,100,8,0,8
Ramatou,F,100,8,0,8
Rancel,M,100,0,8,8
Ransel,M,100,0,8,8
Raquawn,M,100,0,8,8
Rasia,F,100,8,0,8
Reneda,F,100,8,0,8
Reveille,F,100,8,0,8
Rhaelynn,F,100,8,0,8
Rondallyn,F,100,8,0,8
Ronnice,F,100,8,0,8
Ronyn,M,100,0,8,8
Rosabell,F,100,8,0,8
Rosellie,F,100,8,0,8
Roshae,F,100,8,0,8
Rossano,M,100,0,8,8
Rotonya,F,100,8,0,8
Royalti,F,100,8,0,8
Rubicelia,F,100,8,0,8
Rubyjane,F,100,8,0,8
Ruckus,M,100,0,8,8
Sahibdeep,M,100,0,8,8
Sahiry,F,100,8,0,8
Saleth,F,100,8,0,8
Saminah,F,100,8,0,8
Sanniah,F,100,8,0,8
Santiel,M,100,0,8,8
Saphina,F,100,8,0,8
Saraji,F,100,8,0,8
Savreen,F,100,8,0,8
Sawanda,F,100,8,0,8
Seandee,F,100,8,0,8
Sequila,F,100,8,0,8
Serana,F,100,8,0,8
Shafee,M,100,0,8,8
Shakaylah,F,100,8,0,8
Shamim,F,100,8,0,8
Shamor,M,100,0,8,8
Shanequah,F,100,8,0,8
Shanikque,F,100,8,0,8
Shankeria,F,100,8,0,8
Shanteal,F,100,8,0,8
Sharale,F,100,8,0,8
Sharianne,F,100,8,0,8
Shatifah,F,100,8,0,8
Shaunteria,F,100,8,0,8
Shemecka,F,100,8,0,8
Shentel,F,100,8,0,8
Shyreeta,F,100,8,0,8
Silina,F,100,8,0,8
Silk,F,100,8,0,8
Sinit,F,100,8,0,8
Sirica,M,100,0,8,8
Skyee,F,100,8,0,8
Sophan,M,100,0,8,8
Srinitya,F,100,8,0,8
Suezanne,F,100,8,0,8
Suhad,F,100,8,0,8
Suleica,F,100,8,0,8
Sumyah,F,100,8,0,8
Syir,M,100,0,8,8
Syire,M,100,0,8,8
Tachaka,F,100,8,0,8
Taejzon,M,100,0,8,8
Taire,F,100,8,0,8
Taishima,F,100,8,0,8
Takarah,F,100,8,0,8
Takim,M,100,0,8,8
Talaisha,F,100,8,0,8
Tamona,F,100,8,0,8
Tanejah,F,100,8,0,8
Tangle,F,100,8,0,8
Tanila,F,100,8,0,8
Taniyia,F,100,8,0,8
Tannille,F,100,8,0,8
Tantanea,F,100,8,0,8
Tapainga,F,100,8,0,8
Taraoluwa,F,100,8,0,8
Tarijah,F,100,8,0,8
Tashyah,F,100,8,0,8
Tasiya,F,100,8,0,8
Tavarres,M,100,0,8,8
Tavaya,F,100,8,0,8
Tazariah,F,100,8,0,8
Tchalla,M,100,0,8,8
Tegh,M,100,0,8,8
Temarcus,M,100,0,8,8
Tenneal,F,100,8,0,8
Teontae,M,100,0,8,8
Thaliana,F,100,8,0,8
Theren,M,100,0,8,8
Thurma,F,100,8,0,8
Tiniki,F,100,8,0,8
Tkaiya,F,100,8,0,8
Tomm,M,100,0,8,8
Tonta,F,100,8,0,8
Toyah,F,100,8,0,8
Track,M,100,0,8,8
Trager,M,100,0,8,8
Tranel,M,100,0,8,8
Travisha,F,100,8,0,8
Trelen,M,100,0,8,8
Tricity,F,100,8,0,8
Trinley,F,100,8,0,8
Tsitsiki,F,100,8,0,8
Tyandre,M,100,0,8,8
Tyking,M,100,0,8,8
Tylese,F,100,8,0,8
Tyreick,M,100,0,8,8
Tyriese,M,100,0,8,8
Tyrise,M,100,0,8,8
Tysaun,M,100,0,8,8
Ulrika,F,100,8,0,8
Uniyah,F,100,8,0,8
Vadie,F,100,8,0,8
Vardell,M,100,0,8,8
Vardhan,M,100,0,8,8
Varshitha,F,100,8,0,8
Verlane,F,100,8,0,8
Verlia,F,100,8,0,8
Veton,M,100,0,8,8
Veya,F,100,8,0,8
Vondella,F,100,8,0,8
Voris,M,100,0,8,8
Voss,M,100,0,8,8
Vyshonn,M,100,0,8,8
Wadeeah,F,100,8,0,8
Wanjiru,F,100,8,0,8
Wassillie,M,100,0,8,8
Whitton,M,100,0,8,8
Xica,F,100,8,0,8
Xoi,F,100,8,0,8
Xzariah,F,100,8,0,8
Yadieliz,F,100,8,0,8
Yaileny,F,100,8,0,8
Yaindhy,F,100,8,0,8
Yalexia,F,100,8,0,8
Yamaya,F,100,8,0,8
Yelixa,F,100,8,0,8
Yerai,M,100,0,8,8
Yoandi,M,100,0,8,8
Yolaine,F,100,8,0,8
Yoleth,F,100,8,0,8
Yosgarth,M,100,0,8,8
Yoshira,F,100,8,0,8
Yulizza,F,100,8,0,8
Yutong,F,100,8,0,8
Yveth,F,100,8,0,8
Zamaurion,M,100,0,8,8
Zantavious,M,100,0,8,8
Zaravion,M,100,0,8,8
Zaroon,M,100,0,8,8
Zemora,F,100,8,0,8
Zenani,F,100,8,0,8
Zmaya,F,100,8,0,8
Aalaiya,F,100,7,0,7
Aalayiah,F,100,7,0,7
Aalea,F,100,7,0,7
Aaliana,F,100,7,0,7
Aana,F,100,7,0,7
Aanaya,F,100,7,0,7
Aanyla,F,100,7,0,7
Aareona,F,100,7,0,7
Aaronjoseph,M,100,0,7,7
Abery,F,100,7,0,7
Abheek,M,100,0,7,7
Acelino,M,100,0,7,7
Aciel,M,100,0,7,7
Adaisia,F,100,7,0,7
Adaku,F,100,7,0,7
Adalayde,F,100,7,0,7
Adhley,F,100,7,0,7
Adhvika,F,100,7,0,7
Adlei,F,100,7,0,7
Adontae,M,100,0,7,7
Adreann,F,100,7,0,7
Adrene,F,100,7,0,7
Adrianpaul,M,100,0,7,7
Adrika,F,100,7,0,7
Adysan,F,100,7,0,7
Aenea,F,100,7,0,7
Aeona,F,100,7,0,7
Aerius,M,100,0,7,7
Aeshia,F,100,7,0,7
Aglae,F,100,7,0,7
Agna,F,100,7,0,7
Ahmid,M,100,0,7,7
Ahnjayla,F,100,7,0,7
Aided,F,100,7,0,7
Ainhara,F,100,7,0,7
Airah,F,100,7,0,7
Aizha,F,100,7,0,7
Aji,F,100,7,0,7
Akebia,F,100,7,0,7
Akeda,F,100,7,0,7
Akeeyla,F,100,7,0,7
Akerra,F,100,7,0,7
Aksana,F,100,7,0,7
Alajandro,M,100,0,7,7
Alarah,F,100,7,0,7
Alayzhia,F,100,7,0,7
Alazah,F,100,7,0,7
Aldhair,M,100,0,7,7
Ales,M,100,0,7,7
Aletza,F,100,7,0,7
Alexandrer,M,100,0,7,7
Alexanndra,F,100,7,0,7
Alexavior,M,100,0,7,7
Alexeya,F,100,7,0,7
Alexisrose,F,100,7,0,7
Alexsi,M,100,0,7,7
Aliceyn,F,100,7,0,7
Aliee,F,100,7,0,7
Alixx,F,100,7,0,7
Aliyssa,F,100,7,0,7
Aliyya,F,100,7,0,7
Alizabella,F,100,7,0,7
Aljean,F,100,7,0,7
Aljohara,F,100,7,0,7
Allejah,F,100,7,0,7
Allieana,F,100,7,0,7
Alliee,F,100,7,0,7
Allyra,F,100,7,0,7
Almetia,F,100,7,0,7
Alneisha,F,100,7,0,7
Alyca,F,100,7,0,7
Amathyst,F,100,7,0,7
Amidala,F,100,7,0,7
Anabeli,F,100,7,0,7
Analeece,F,100,7,0,7
Anally,F,100,7,0,7
Analyz,F,100,7,0,7
Andino,M,100,0,7,7
Andrekia,F,100,7,0,7
Andrieka,F,100,7,0,7
Aneris,F,100,7,0,7
Angeleia,F,100,7,0,7
Angelicamae,F,100,7,0,7
Angelyce,F,100,7,0,7
Angelynna,F,100,7,0,7
Anibelle,F,100,7,0,7
Anistin,F,100,7,0,7
Anjaly,F,100,7,0,7
Anjeliett,F,100,7,0,7
Anka,F,100,7,0,7
Annelee,F,100,7,0,7
Anniesha,F,100,7,0,7
Annily,F,100,7,0,7
Anterious,M,100,0,7,7
Antvan,M,100,0,7,7
Anyliah,F,100,7,0,7
Applonia,F,100,7,0,7
Aquill,M,100,0,7,7
Aralia,F,100,7,0,7
Arasele,F,100,7,0,7
Archivaldo,M,100,0,7,7
Argyle,M,100,0,7,7
Arielmarie,F,100,7,0,7
Arieyonna,F,100,7,0,7
Arisdelsy,F,100,7,0,7
Arizel,F,100,7,0,7
Arkham,M,100,0,7,7
Arkim,M,100,0,7,7
Arlonda,F,100,7,0,7
Arnay,M,100,0,7,7
Arni,F,100,7,0,7
Arohan,M,100,0,7,7
Arry,M,100,0,7,7
Artavian,M,100,0,7,7
Arthurene,F,100,7,0,7
Aryus,M,100,0,7,7
Asira,F,100,7,0,7
Assiatou,F,100,7,0,7
Atakan,M,100,0,7,7
Ateeb,M,100,0,7,7
Ativa,F,100,7,0,7
Attia,F,100,7,0,7
Aubriahna,F,100,7,0,7
Auddie,M,100,0,7,7
Audette,F,100,7,0,7
Audreauna,F,100,7,0,7
Aunah,F,100,7,0,7
Auriya,F,100,7,0,7
Auriyah,F,100,7,0,7
Austeja,F,100,7,0,7
Avanya,F,100,7,0,7
Averyona,F,100,7,0,7
Avienne,F,100,7,0,7
Avnoor,F,100,7,0,7
Avyona,F,100,7,0,7
Awo,F,100,7,0,7
Axis,M,100,0,7,7
Ayalah,F,100,7,0,7
Aybri,F,100,7,0,7
Ayeza,F,100,7,0,7
Aylynn,F,100,7,0,7
Aynara,F,100,7,0,7
Ayuna,F,100,7,0,7
Ayushmaan,M,100,0,7,7
Ayveri,F,100,7,0,7
Azaneth,F,100,7,0,7
Azria,F,100,7,0,7
Badal,M,100,0,7,7
Badhir,M,100,0,7,7
Balint,M,100,0,7,7
Barbaa,F,100,7,0,7
Barkim,M,100,0,7,7
Basiliki,F,100,7,0,7
Baylian,M,100,0,7,7
Behtzy,F,100,7,0,7
Beige,F,100,7,0,7
Belisario,M,100,0,7,7
Bengi,M,100,0,7,7
Benni,F,100,7,0,7
Bensley,M,100,0,7,7
Bernest,M,100,0,7,7
Bernicia,F,100,7,0,7
Bersain,M,100,0,7,7
Bervin,M,100,0,7,7
Beuford,M,100,0,7,7
Bianaca,F,100,7,0,7
Bianny,F,100,7,0,7
Bictor,M,100,0,7,7
Bisleidy,F,100,7,0,7
Bivian,F,100,7,0,7
Blaid,M,100,0,7,7
Blaney,F,100,7,0,7
Blayson,M,100,0,7,7
Bonanza,M,100,0,7,7
Boran,M,100,0,7,7
Bosie,M,100,0,7,7
Bradyen,M,100,0,7,7
Braelei,F,100,7,0,7
Braham,M,100,0,7,7
Bralie,F,100,7,0,7
Branan,M,100,0,7,7
Brancon,M,100,0,7,7
Brandale,M,100,0,7,7
Brannock,M,100,0,7,7
Branwyn,F,100,7,0,7
Braxlee,M,100,0,7,7
Breandra,F,100,7,0,7
Breiah,F,100,7,0,7
Breinne,F,100,7,0,7
Brejae,F,100,7,0,7
Brekke,F,100,7,0,7
Brete,M,100,0,7,7
Brezae,F,100,7,0,7
Brhianna,F,100,7,0,7
Brishen,M,100,0,7,7
Brithanny,F,100,7,0,7
Britttany,F,100,7,0,7
Broddrick,M,100,0,7,7
Brookson,M,100,0,7,7
Brycon,M,100,0,7,7
Bryndee,F,100,7,0,7
Brynisha,F,100,7,0,7
Brytanie,F,100,7,0,7
Cadian,M,100,0,7,7
Caesyn,M,100,0,7,7
Cahner,M,100,0,7,7
Cailon,F,100,7,0,7
Callisa,F,100,7,0,7
Callye,F,100,7,0,7
Caltlin,F,100,7,0,7
Camrynne,F,100,7,0,7
Candes,F,100,7,0,7
Canishia,F,100,7,0,7
Canuto,M,100,0,7,7
Canyn,M,100,0,7,7
Carlla,F,100,7,0,7
Carlyrose,F,100,7,0,7
Carvon,M,100,0,7,7
Cashanti,F,100,7,0,7
Cassendra,F,100,7,0,7
Cassietta,F,100,7,0,7
Caylib,M,100,0,7,7
Caylinn,F,100,7,0,7
Cedeno,M,100,0,7,7
Celynn,F,100,7,0,7
Cemal,M,100,0,7,7
Cenai,F,100,7,0,7
Cerridwen,F,100,7,0,7
Chadly,M,100,0,7,7
Chamber,M,100,0,7,7
Chamberlyn,F,100,7,0,7
Chambre,F,100,7,0,7
Chanavia,F,100,7,0,7
Chancee,F,100,7,0,7
Chantise,F,100,7,0,7
Chaquitta,F,100,7,0,7
Charlesanthony,M,100,0,7,7
Charliss,F,100,7,0,7
Chary,F,100,7,0,7
Chassiti,F,100,7,0,7
Chaysten,M,100,0,7,7
Chazman,M,100,0,7,7
Cheilon,F,100,7,0,7
Cherone,F,100,7,0,7
Chervonne,F,100,7,0,7
Cherylan,F,100,7,0,7
Chezky,M,100,0,7,7
Chimdi,M,100,0,7,7
Christiandaniel,M,100,0,7,7
Chritian,M,100,0,7,7
Chylar,F,100,7,0,7
Cimora,F,100,7,0,7
Cindal,F,100,7,0,7
Claudinette,F,100,7,0,7
Cliffie,F,100,7,0,7
Cluster,M,100,0,7,7
Clysta,F,100,7,0,7
Coast,M,100,0,7,7
Cobalt,M,100,0,7,7
Codero,M,100,0,7,7
Coit,M,100,0,7,7
Comisha,F,100,7,0,7
Contesa,F,100,7,0,7
Contrella,F,100,7,0,7
Cor,M,100,0,7,7
Corando,M,100,0,7,7
Cordarrow,M,100,0,7,7
Corderia,M,100,0,7,7
Cormari,M,100,0,7,7
Correon,M,100,0,7,7
Credell,M,100,0,7,7
Crisette,F,100,7,0,7
Crispus,M,100,0,7,7
Crustal,F,100,7,0,7
Crysania,F,100,7,0,7
Crysany,F,100,7,0,7
Cupertino,M,100,0,7,7
Cyane,F,100,7,0,7
Cynarra,F,100,7,0,7
Cyndil,F,100,7,0,7
Cyrielle,F,100,7,0,7
Dabriyon,M,100,0,7,7
Daeyonna,F,100,7,0,7
Dafnne,F,100,7,0,7
Dailany,F,100,7,0,7
Daiman,M,100,0,7,7
Daimarion,M,100,0,7,7
Dainera,F,100,7,0,7
Daizhaun,M,100,0,7,7
Dakori,M,100,0,7,7
Dalet,F,100,7,0,7
Damajae,M,100,0,7,7
Dammian,M,100,0,7,7
Damontrae,M,100,0,7,7
Danavia,F,100,7,0,7
Dangello,M,100,0,7,7
Danieka,F,100,7,0,7
Danielynn,F,100,7,0,7
Darayl,M,100,0,7,7
Dareka,F,100,7,0,7
Darnishia,F,100,7,0,7
Darshon,M,100,0,7,7
Davaya,F,100,7,0,7
Daviette,F,100,7,0,7
Dawain,M,100,0,7,7
Dayari,F,100,7,0,7
Daylany,F,100,7,0,7
Daymi,F,100,7,0,7
Dayse,F,100,7,0,7
Dazza,F,100,7,0,7
Deandrey,M,100,0,7,7
Deangalo,M,100,0,7,7
Deantrae,M,100,0,7,7
Deauntre,M,100,0,7,7
Debraca,F,100,7,0,7
Dectrick,M,100,0,7,7
Deddie,F,100,7,0,7
Dedrie,F,100,7,0,7
Deelan,M,100,0,7,7
Deepshika,F,100,7,0,7
Dejahnay,F,100,7,0,7
Dejonna,F,100,7,0,7
Delaili,F,100,7,0,7
Delfreda,F,100,7,0,7
Delinia,F,100,7,0,7
Delino,M,100,0,7,7
Dellen,M,100,0,7,7
Delmis,F,100,7,0,7
Delorenzo,M,100,0,7,7
Demarionna,F,100,7,0,7
Demetrey,M,100,0,7,7
Demire,M,100,0,7,7
Deneena,F,100,7,0,7
Denerio,M,100,0,7,7
Deney,M,100,0,7,7
Denishea,F,100,7,0,7
Dennen,F,100,7,0,7
Denyelle,F,100,7,0,7
Dequandra,F,100,7,0,7
Deriyon,M,100,0,7,7
Desireah,F,100,7,0,7
Deslie,F,100,7,0,7
Desnee,F,100,7,0,7
Dessica,F,100,7,0,7
Dester,M,100,0,7,7
Deucalion,M,100,0,7,7
Deundrea,M,100,0,7,7
Devara,F,100,7,0,7
Devionna,F,100,7,0,7
Devionte,M,100,0,7,7
Dewitte,M,100,0,7,7
Dewuan,M,100,0,7,7
Deylen,M,100,0,7,7
Deyssi,F,100,7,0,7
Dezhanae,F,100,7,0,7
Dezirey,F,100,7,0,7
Dezree,F,100,7,0,7
Dezstany,F,100,7,0,7
Dija,F,100,7,0,7
Dimarcus,M,100,0,7,7
Dinene,F,100,7,0,7
Diti,F,100,7,0,7
Divisha,F,100,7,0,7
Divyanshi,F,100,7,0,7
Djellza,F,100,7,0,7
Dnijah,F,100,7,0,7
Domineek,M,100,0,7,7
Dominice,F,100,7,0,7
Dominykas,M,100,0,7,7
Dontevius,M,100,0,7,7
Doraelia,F,100,7,0,7
Doty,F,100,7,0,7
Draylin,M,100,0,7,7
Dree,F,100,7,0,7
Drevaughn,M,100,0,7,7
Drevonte,M,100,0,7,7
Drewann,F,100,7,0,7
Dreyanna,F,100,7,0,7
Dryver,M,100,0,7,7
Dual,M,100,0,7,7
Dubraska,F,100,7,0,7
Duchein,M,100,0,7,7
Duewa,F,100,7,0,7
Dural,M,100,0,7,7
Duvier,M,100,0,7,7
Dylhan,M,100,0,7,7
Dyoni,F,100,7,0,7
Earlette,F,100,7,0,7
Ediz,M,100,0,7,7
Edmee,F,100,7,0,7
Edner,M,100,0,7,7
Eina,F,100,7,0,7
Eldena,F,100,7,0,7
Eldine,F,100,7,0,7
Eleese,F,100,7,0,7
Elenia,F,100,7,0,7
Elessa,F,100,7,0,7
Elimar,F,100,7,0,7
Elizzabeth,F,100,7,0,7
Elliann,F,100,7,0,7
Elliston,M,100,0,7,7
Ellyne,F,100,7,0,7
Ellysen,F,100,7,0,7
Elmedin,M,100,0,7,7
Elovie,F,100,7,0,7
Elsye,F,100,7,0,7
Emagine,F,100,7,0,7
Emillianna,F,100,7,0,7
Eneri,F,100,7,0,7
Envie,F,100,7,0,7
Enylah,F,100,7,0,7
Ericalynn,F,100,7,0,7
Ernesteen,F,100,7,0,7
Ernetta,F,100,7,0,7
Errion,M,100,0,7,7
Estefhany,F,100,7,0,7
Etherine,F,100,7,0,7
Etoshia,F,100,7,0,7
Etoyi,M,100,0,7,7
Euri,M,100,0,7,7
Evaliz,F,100,7,0,7
Eveli,F,100,7,0,7
Everlyse,F,100,7,0,7
Eyen,M,100,0,7,7
Eylul,F,100,7,0,7
Fadak,F,100,7,0,7
Faedra,F,100,7,0,7
Falco,M,100,0,7,7
Fame,F,100,7,0,7
Fardi,M,100,0,7,7
Farrad,M,100,0,7,7
Farzeen,F,100,7,0,7
Fatia,F,100,7,0,7
Felisitas,F,100,7,0,7
Ferna,F,100,7,0,7
Fernan,M,100,0,7,7
Ferryn,F,100,7,0,7
Flash,M,100,0,7,7
Flesha,F,100,7,0,7
Fracisco,M,100,0,7,7
Franics,M,100,0,7,7
Freesia,F,100,7,0,7
Gabbanelli,F,100,7,0,7
Gabryele,F,100,7,0,7
Gannyn,M,100,0,7,7
Ganyn,M,100,0,7,7
Garmon,M,100,0,7,7
Gaten,M,100,0,7,7
Gavina,F,100,7,0,7
Geissie,F,100,7,0,7
Gelson,M,100,0,7,7
Genisse,F,100,7,0,7
Geretha,F,100,7,0,7
Gerturde,F,100,7,0,7
Getzel,M,100,0,7,7
Ghadah,F,100,7,0,7
Ghael,M,100,0,7,7
Gianetta,F,100,7,0,7
Gibram,M,100,0,7,7
Ginobili,M,100,0,7,7
Giorgios,M,100,0,7,7
Giovannina,F,100,7,0,7
Giuseppi,M,100,0,7,7
Glynne,F,100,7,0,7
Graem,M,100,0,7,7
Gramm,M,100,0,7,7
Grandin,M,100,0,7,7
Granvel,M,100,0,7,7
Greylyn,F,100,7,0,7
Guilda,F,100,7,0,7
Guilian,M,100,0,7,7
Guilliana,F,100,7,0,7
Guisela,F,100,7,0,7
Gurbir,M,100,0,7,7
Gurnie,M,100,0,7,7
Gurtaaj,M,100,0,7,7
Gwendel,F,100,7,0,7
Gwendoyln,F,100,7,0,7
Haashim,M,100,0,7,7
Hadarah,F,100,7,0,7
Haileyjade,F,100,7,0,7
Hajun,M,100,0,7,7
Hammed,M,100,0,7,7
Handerson,M,100,0,7,7
Harihar,M,100,0,7,7
Harryson,M,100,0,7,7
Hartlie,F,100,7,0,7
Havilland,F,100,7,0,7
Hay,M,100,0,7,7
Hayslee,F,100,7,0,7
Hedgar,M,100,0,7,7
Henesy,F,100,7,0,7
Hildie,F,100,7,0,7
Hillarey,F,100,7,0,7
Honie,F,100,7,0,7
Hose,M,100,0,7,7
Hulan,M,100,0,7,7
Hunny,F,100,7,0,7
Ibe,M,100,0,7,7
Ifeyinwa,F,100,7,0,7
Ikher,M,100,0,7,7
Ilithya,F,100,7,0,7
Illiyana,F,100,7,0,7
Inderpreet,M,100,0,7,7
Ingar,F,100,7,0,7
Inia,F,100,7,0,7
Inshirah,F,100,7,0,7
Iolanda,F,100,7,0,7
Ireka,F,100,7,0,7
Irmani,F,100,7,0,7
Iryna,F,100,7,0,7
Isan,M,100,0,7,7
Ishwari,F,100,7,0,7
Ismene,F,100,7,0,7
Israyel,M,100,0,7,7
Ivonn,F,100,7,0,7
Ivoryanna,F,100,7,0,7
Ivoryrose,F,100,7,0,7
Iyuna,F,100,7,0,7
Izabele,F,100,7,0,7
Izavion,M,100,0,7,7
Izhane,F,100,7,0,7
Izyck,M,100,0,7,7
Izzabela,F,100,7,0,7
Jabarius,M,100,0,7,7
Jabina,F,100,7,0,7
Jaboree,M,100,0,7,7
Jaceson,M,100,0,7,7
Jacionna,F,100,7,0,7
Jacquelle,F,100,7,0,7
Jadn,M,100,0,7,7
Jahjuan,M,100,0,7,7
Jahleya,F,100,7,0,7
Jahnathan,M,100,0,7,7
Jahniel,M,100,0,7,7
Jahonna,F,100,7,0,7
Jahtavious,M,100,0,7,7
Jahvari,M,100,0,7,7
Jaico,M,100,0,7,7
Jaidden,M,100,0,7,7
Jaimmie,F,100,7,0,7
Jalante,M,100,0,7,7
Jamaicia,F,100,7,0,7
Jamarley,M,100,0,7,7
Jamayel,M,100,0,7,7
Jameese,F,100,7,0,7
Jamesly,M,100,0,7,7
Janascia,F,100,7,0,7
Jande,F,100,7,0,7
Janeigh,F,100,7,0,7
Janiayah,F,100,7,0,7
Jannean,F,100,7,0,7
Jannuel,M,100,0,7,7
Januell,M,100,0,7,7
Jaquata,F,100,7,0,7
Jaqueisha,F,100,7,0,7
Jaredd,M,100,0,7,7
Jarena,F,100,7,0,7
Jarvous,M,100,0,7,7
Jasek,M,100,0,7,7
Jashonda,F,100,7,0,7
Jasiman,F,100,7,0,7
Jaswiry,F,100,7,0,7
Jatava,F,100,7,0,7
Jauwana,F,100,7,0,7
Javyion,M,100,0,7,7
Jaxxton,M,100,0,7,7
Jaycian,M,100,0,7,7
Jaydalise,F,100,7,0,7
Jaylarose,F,100,7,0,7
Jaymesha,F,100,7,0,7
Jayniyah,F,100,7,0,7
Jazire,F,100,7,0,7
Jazzilynn,F,100,7,0,7
Jeanney,F,100,7,0,7
Jeaven,M,100,0,7,7
Jeconiah,M,100,0,7,7
Jehonadab,M,100,0,7,7
Jekiah,F,100,7,0,7
Jenabelle,F,100,7,0,7
Jenilca,F,100,7,0,7
Jenisys,F,100,7,0,7
Jenniferr,F,100,7,0,7
Jerikka,F,100,7,0,7
Jerlisha,F,100,7,0,7
Jermarkus,M,100,0,7,7
Jermeshia,F,100,7,0,7
Jermonica,F,100,7,0,7
Jeroline,F,100,7,0,7
Jerryca,F,100,7,0,7
Jerwan,M,100,0,7,7
Jeseka,F,100,7,0,7
Jesiree,F,100,7,0,7
Jessamae,F,100,7,0,7
Jessielynn,F,100,7,0,7
Jessimae,F,100,7,0,7
Jesssica,F,100,7,0,7
Jewett,M,100,0,7,7
Jeysen,M,100,0,7,7
Jhalyn,M,100,0,7,7
Jhonattan,M,100,0,7,7
Jhovanna,F,100,7,0,7
Jiapsi,F,100,7,0,7
Jilissa,F,100,7,0,7
Jillesa,F,100,7,0,7
Jimmiah,F,100,7,0,7
Jionnie,M,100,0,7,7
Jitu,M,100,0,7,7
Jkira,F,100,7,0,7
Jocoby,M,100,0,7,7
Jodice,M,100,0,7,7
Johnah,F,100,7,0,7
Johndrea,F,100,7,0,7
Johnparker,M,100,0,7,7
Johnrussell,M,100,0,7,7
Jolesha,F,100,7,0,7
Jonathanjoseph,M,100,0,7,7
Jonhenry,M,100,0,7,7
Jonquin,M,100,0,7,7
Jontyler,M,100,0,7,7
Jordeyn,F,100,7,0,7
Jorien,M,100,0,7,7
Josa,M,100,0,7,7
Josea,M,100,0,7,7
Josianna,F,100,7,0,7
Jovanii,M,100,0,7,7
Jovetta,F,100,7,0,7
Joyana,F,100,7,0,7
Junathaen,M,100,0,7,7
Jvontae,M,100,0,7,7
Jwuan,M,100,0,7,7
Jylisa,F,100,7,0,7
Jymari,M,100,0,7,7
Jynna,F,100,7,0,7
Jysiah,M,100,0,7,7
Kabresha,F,100,7,0,7
Kaceton,M,100,0,7,7
Kadejiah,F,100,7,0,7
Kaeleah,F,100,7,0,7
Kaemen,M,100,0,7,7
Kaeron,M,100,0,7,7
Kaeto,M,100,0,7,7
Kahana,F,100,7,0,7
Kaibree,F,100,7,0,7
Kaiis,M,100,0,7,7
Kailor,M,100,0,7,7
Kait,F,100,7,0,7
Kaitlon,F,100,7,0,7
Kaizlyn,F,100,7,0,7
Kalashia,F,100,7,0,7
Kaleila,F,100,7,0,7
Kaliyanei,F,100,7,0,7
Kanchan,F,100,7,0,7
Kandyn,M,100,0,7,7
Kanira,F,100,7,0,7
Karcynn,F,100,7,0,7
Kareny,F,100,7,0,7
Karmia,F,100,7,0,7
Karmoni,F,100,7,0,7
Kashiff,M,100,0,7,7
Kashondra,F,100,7,0,7
Katyann,F,100,7,0,7
Kaylahni,F,100,7,0,7
Kaylanii,F,100,7,0,7
Kaynin,M,100,0,7,7
Kayvien,M,100,0,7,7
Keaghlan,F,100,7,0,7
Keemo,M,100,0,7,7
Keffer,M,100,0,7,7
Kehila,F,100,7,0,7
Keilianys,F,100,7,0,7
Keimara,F,100,7,0,7
Kelcea,F,100,7,0,7
Keleni,F,100,7,0,7
Kemarcus,M,100,0,7,7
Kemare,M,100,0,7,7
Kengston,M,100,0,7,7
Kennyah,F,100,7,0,7
Kenrich,M,100,0,7,7
Keontai,M,100,0,7,7
Kereen,F,100,7,0,7
Keriyah,F,100,7,0,7
Kerlin,F,100,7,0,7
Ketsy,F,100,7,0,7
Keyonis,M,100,0,7,7
Keyshone,M,100,0,7,7
Keystle,F,100,7,0,7
Khadeijah,F,100,7,0,7
Khadejha,F,100,7,0,7
Khahlil,M,100,0,7,7
Khalika,F,100,7,0,7
Khalim,M,100,0,7,7
Khalisi,F,100,7,0,7
Khamira,F,100,7,0,7
Khason,M,100,0,7,7
Khenan,M,100,0,7,7
Khiryn,M,100,0,7,7
Kiamora,F,100,7,0,7
Kianalee,F,100,7,0,7
Kianti,F,100,7,0,7
Kicha,F,100,7,0,7
Kimarley,M,100,0,7,7
Kimimela,F,100,7,0,7
Kimmika,F,100,7,0,7
Kingmichael,M,100,0,7,7
Kinnon,M,100,0,7,7
Kipchoge,M,100,0,7,7
Kirtland,M,100,0,7,7
Kishun,M,100,0,7,7
Kistin,F,100,7,0,7
Kitrick,M,100,0,7,7
Kiuna,F,100,7,0,7
Kizi,F,100,7,0,7
Klayre,F,100,7,0,7
Klohee,F,100,7,0,7
Koemi,F,100,7,0,7
Kolbyn,M,100,0,7,7
Kongmong,M,100,0,7,7
Konisha,F,100,7,0,7
Kosi,M,100,0,7,7
Kowan,M,100,0,7,7
Kowanda,F,100,7,0,7
Koyasha,F,100,7,0,7
Krishaan,M,100,0,7,7
Krishuna,F,100,7,0,7
Krissinda,F,100,7,0,7
Kristela,F,100,7,0,7
Kristoher,M,100,0,7,7
Kristylee,F,100,7,0,7
Krustal,F,100,7,0,7
Krynn,F,100,7,0,7
Kurissa,F,100,7,0,7
Kurumi,F,100,7,0,7
Kushtrim,M,100,0,7,7
Kween,F,100,7,0,7
Kwenton,M,100,0,7,7
Kyere,M,100,0,7,7
Kyleerae,F,100,7,0,7
Kylieanne,F,100,7,0,7
Kyndl,F,100,7,0,7
Kyreece,M,100,0,7,7
Kyreek,M,100,0,7,7
Kyshawna,F,100,7,0,7
Kywuan,M,100,0,7,7
Lachic,F,100,7,0,7
Lacorsha,F,100,7,0,7
Ladereon,M,100,0,7,7
Ladontae,M,100,0,7,7
Lagarius,M,100,0,7,7
Lailamarie,F,100,7,0,7
Lakeitra,F,100,7,0,7
Lakesh,F,100,7,0,7
Laklynn,F,100,7,0,7
Lakyna,F,100,7,0,7
Lamaine,M,100,0,7,7
Lamauri,M,100,0,7,7
Lamayia,F,100,7,0,7
Lamirah,F,100,7,0,7
Lanease,F,100,7,0,7
Lanoris,M,100,0,7,7
Laquania,F,100,7,0,7
Laquatta,F,100,7,0,7
Larrey,M,100,0,7,7
Lashinda,F,100,7,0,7
Lataura,F,100,7,0,7
Lathisa,F,100,7,0,7
Latreice,F,100,7,0,7
Latrissa,F,100,7,0,7
Latshia,F,100,7,0,7
Latunja,F,100,7,0,7
Lauressa,F,100,7,0,7
Lavatrice,F,100,7,0,7
Lavelda,F,100,7,0,7
Laxmy,F,100,7,0,7
Laycen,M,100,0,7,7
Laylanee,F,100,7,0,7
Leabeth,F,100,7,0,7
Leahnna,F,100,7,0,7
Leaser,F,100,7,0,7
Legolas,M,100,0,7,7
Leighlani,F,100,7,0,7
Lekisa,F,100,7,0,7
Lelandra,F,100,7,0,7
Lemaya,F,100,7,0,7
Lequient,M,100,0,7,7
Lequinta,F,100,7,0,7
Leryn,F,100,7,0,7
Levoy,M,100,0,7,7
Leyver,M,100,0,7,7
Lhiam,M,100,0,7,7
Liamgabriel,M,100,0,7,7
Liammatthew,M,100,0,7,7
Liammichael,M,100,0,7,7
Lidija,F,100,7,0,7
Lilette,F,100,7,0,7
Limairy,F,100,7,0,7
Lish,F,100,7,0,7
Liyam,M,100,0,7,7
Lizzi,F,100,7,0,7
Llandel,M,100,0,7,7
Llona,F,100,7,0,7
Lloyal,M,100,0,7,7
Loanna,F,100,7,0,7
Loggan,M,100,0,7,7
Logic,M,100,0,7,7
Loranna,F,100,7,0,7
Lorese,F,100,7,0,7
Lorrell,F,100,7,0,7
Lovea,F,100,7,0,7
Lovisa,F,100,7,0,7
Lovita,F,100,7,0,7
Ludger,M,100,0,7,7
Luisdiego,M,100,0,7,7
Luisjose,M,100,0,7,7
Lung,M,100,0,7,7
Lurean,F,100,7,0,7
Luxi,F,100,7,0,7
Lyndah,F,100,7,0,7
Lynnai,F,100,7,0,7
Lytonya,F,100,7,0,7
Lyvette,F,100,7,0,7
Macallen,M,100,0,7,7
Machiya,F,100,7,0,7
Madhumita,F,100,7,0,7
Madian,F,100,7,0,7
Madielynn,F,100,7,0,7
Maedot,F,100,7,0,7
Magalli,F,100,7,0,7
Magdalia,F,100,7,0,7
Maidah,F,100,7,0,7
Maivy,F,100,7,0,7
Majenta,F,100,7,0,7
Makal,M,100,0,7,7
Makis,M,100,0,7,7
Malcoln,M,100,0,7,7
Maleisha,F,100,7,0,7
Malillani,F,100,7,0,7
Manaf,M,100,0,7,7
Maneet,M,100,0,7,7
Marayla,F,100,7,0,7
Marayna,F,100,7,0,7
Marchant,M,100,0,7,7
Marciella,F,100,7,0,7
Marcous,M,100,0,7,7
Margarine,F,100,7,0,7
Margherite,F,100,7,0,7
Margory,F,100,7,0,7
Marguerit,F,100,7,0,7
Mariaangela,F,100,7,0,7
Mariagabriela,F,100,7,0,7
Marialaina,F,100,7,0,7
Marialaura,F,100,7,0,7
Marialys,F,100,7,0,7
Maridel,F,100,7,0,7
Marishia,F,100,7,0,7
Marivelle,F,100,7,0,7
Markele,M,100,0,7,7
Markiece,M,100,0,7,7
Marlyss,F,100,7,0,7
Marqwan,M,100,0,7,7
Marschell,F,100,7,0,7
Marshaye,F,100,7,0,7
Marucs,M,100,0,7,7
Marziya,F,100,7,0,7
Maseo,M,100,0,7,7
Mashanti,F,100,7,0,7
Matlin,F,100,7,0,7
Matthis,M,100,0,7,7
Mattlock,M,100,0,7,7
Mavra,F,100,7,0,7
Mayada,F,100,7,0,7
Maydelyn,F,100,7,0,7
Mckenzii,F,100,7,0,7
Mckynsie,F,100,7,0,7
Meahan,F,100,7,0,7
Mechaela,F,100,7,0,7
Megail,M,100,0,7,7
Meggi,F,100,7,0,7
Melaniece,F,100,7,0,7
Melivn,M,100,0,7,7
Melvern,M,100,0,7,7
Merceda,F,100,7,0,7
Merrilynn,F,100,7,0,7
Meryk,M,100,0,7,7
Meshalia,F,100,7,0,7
Messai,M,100,0,7,7
Miagrace,F,100,7,0,7
Miarae,F,100,7,0,7
Michaael,M,100,0,7,7
Mickyla,F,100,7,0,7
Miiangel,F,100,7,0,7
Mikayeel,M,100,0,7,7
Mikaylyn,F,100,7,0,7
Mikenlee,F,100,7,0,7
Milenko,M,100,0,7,7
Millah,F,100,7,0,7
Millenium,F,100,7,0,7
Milvia,F,100,7,0,7
Milynda,F,100,7,0,7
Minako,F,100,7,0,7
Mirium,F,100,7,0,7
Mitsi,F,100,7,0,7
Miyali,F,100,7,0,7
Miyari,F,100,7,0,7
Miyo,F,100,7,0,7
Miyoka,F,100,7,0,7
Mo,M,100,0,7,7
Moayed,M,100,0,7,7
Mollykate,F,100,7,0,7
Montravius,M,100,0,7,7
Montse,F,100,7,0,7
Monyetta,F,100,7,0,7
Monzeratt,F,100,7,0,7
Moona,F,100,7,0,7
Moraya,F,100,7,0,7
Morica,F,100,7,0,7
Morina,F,100,7,0,7
Mufasa,M,100,0,7,7
Mundi,F,100,7,0,7
Mustafe,M,100,0,7,7
Myesheia,F,100,7,0,7
Mylika,F,100,7,0,7
Mystik,F,100,7,0,7
Mytrell,M,100,0,7,7
Nabeelah,F,100,7,0,7
Nacier,M,100,0,7,7
Naiima,F,100,7,0,7
Naizeth,F,100,7,0,7
Najahwan,M,100,0,7,7
Nakasia,F,100,7,0,7
Nakela,F,100,7,0,7
Naledi,F,100,7,0,7
Nalyah,F,100,7,0,7
Naoh,M,100,0,7,7
Naquille,M,100,0,7,7
Nastaja,F,100,7,0,7
Natala,F,100,7,0,7
Nataria,F,100,7,0,7
Nataylia,F,100,7,0,7
Nately,F,100,7,0,7
Natesa,F,100,7,0,7
Naydene,F,100,7,0,7
Nayeem,M,100,0,7,7
Naymon,M,100,0,7,7
Nazya,F,100,7,0,7
Necie,F,100,7,0,7
Nedved,M,100,0,7,7
Neelima,F,100,7,0,7
Nekira,F,100,7,0,7
Nesochi,F,100,7,0,7
Nesren,F,100,7,0,7
Niamke,M,100,0,7,7
Nickai,M,100,0,7,7
Nickos,M,100,0,7,7
Nihya,F,100,7,0,7
Nijeria,F,100,7,0,7
Nikiea,F,100,7,0,7
Nikkoli,M,100,0,7,7
Nikyta,F,100,7,0,7
Nioma,F,100,7,0,7
Nissen,M,100,0,7,7
Nithish,M,100,0,7,7
Nixzaliz,F,100,7,0,7
Niyanah,F,100,7,0,7
Nkemdilim,F,100,7,0,7
Norfleet,M,100,0,7,7
Norielle,F,100,7,0,7
Nydasia,F,100,7,0,7
Nykell,M,100,0,7,7
Nyleigh,F,100,7,0,7
Nyomii,F,100,7,0,7
Nyzair,M,100,0,7,7
Octabio,M,100,0,7,7
Odeal,F,100,7,0,7
Odet,F,100,7,0,7
Ohagi,M,100,0,7,7
Ohaji,M,100,0,7,7
Olamae,F,100,7,0,7
Olu,M,100,0,7,7
Olutosin,F,100,7,0,7
Omaris,F,100,7,0,7
Omaurion,M,100,0,7,7
Onaleigh,F,100,7,0,7
Onekki,F,100,7,0,7
Opel,F,100,7,0,7
Orasio,M,100,0,7,7
Ortiz,M,100,0,7,7
Oshiana,F,100,7,0,7
Owan,M,100,0,7,7
Pacha,F,100,7,0,7
Paraskeve,F,100,7,0,7
Patrickjohn,M,100,0,7,7
Patrricia,F,100,7,0,7
Pavi,F,100,7,0,7
Pearlee,F,100,7,0,7
Pendleton,M,100,0,7,7
Penellope,F,100,7,0,7
Perman,M,100,0,7,7
Phajja,F,100,7,0,7
Phalla,F,100,7,0,7
Phanta,F,100,7,0,7
Philesha,F,100,7,0,7
Phillisa,F,100,7,0,7
Plez,M,100,0,7,7
Porchae,F,100,7,0,7
Poua,F,100,7,0,7
Princetyn,M,100,0,7,7
Prinsesa,F,100,7,0,7
Priscill,F,100,7,0,7
Prisicilla,F,100,7,0,7
Promisse,F,100,7,0,7
Qassam,M,100,0,7,7
Qorianka,F,100,7,0,7
Quanesia,F,100,7,0,7
Quanette,F,100,7,0,7
Quanterra,F,100,7,0,7
Quashia,F,100,7,0,7
Quinnleigh,F,100,7,0,7
Quintaya,F,100,7,0,7
Quintero,M,100,0,7,7
Raafay,M,100,0,7,7
Raavi,F,100,7,0,7
Raehanna,F,100,7,0,7
Rafuel,M,100,0,7,7
Rahmell,M,100,0,7,7
Raice,M,100,0,7,7
Raimund,M,100,0,7,7
Rajab,M,100,0,7,7
Rajeen,F,100,7,0,7
Ranezmae,F,100,7,0,7
Ranezmay,F,100,7,0,7
Raniyha,F,100,7,0,7
Raquela,F,100,7,0,7
Rasim,M,100,0,7,7
Rattana,M,100,0,7,7
Ravonte,M,100,0,7,7
Rayisha,F,100,7,0,7
Raynathan,M,100,0,7,7
Reeselynn,F,100,7,0,7
Regin,F,100,7,0,7
Rejoyce,F,100,7,0,7
Rekina,F,100,7,0,7
Rekker,M,100,0,7,7
Renyah,F,100,7,0,7
Reshaud,M,100,0,7,7
Revyn,M,100,0,7,7
Reydan,M,100,0,7,7
Reynaliz,F,100,7,0,7
Rhiyana,F,100,7,0,7
Rhonan,M,100,0,7,7
Rhonesha,F,100,7,0,7
Richlyn,F,100,7,0,7
Rici,F,100,7,0,7
Ricoh,M,100,0,7,7
Rigina,F,100,7,0,7
Rikkilee,F,100,7,0,7
Rikya,F,100,7,0,7
Rileyn,F,100,7,0,7
Riliegh,F,100,7,0,7
Rinley,F,100,7,0,7
Rishin,M,100,0,7,7
Rithvika,F,100,7,0,7
Riverlynn,F,100,7,0,7
Robann,F,100,7,0,7
Rodnesia,F,100,7,0,7
Rolunda,F,100,7,0,7
Roly,M,100,0,7,7
Ronessa,F,100,7,0,7
Rooke,M,100,0,7,7
Rosaysela,F,100,7,0,7
Rowrenia,F,100,7,0,7
Ruka,F,100,7,0,7
Rund,F,100,7,0,7
Ruoxi,F,100,7,0,7
Rysen,M,100,0,7,7
Ryshon,M,100,0,7,7
Saaliha,F,100,7,0,7
Saalihah,F,100,7,0,7
Sabeena,F,100,7,0,7
Sabrenna,F,100,7,0,7
Sacaria,F,100,7,0,7
Sadaria,F,100,7,0,7
Saee,F,100,7,0,7
Saikrishna,M,100,0,7,7
Saindhavi,F,100,7,0,7
Sajen,M,100,0,7,7
Sakisha,F,100,7,0,7
Salara,F,100,7,0,7
Sali,F,100,7,0,7
Salmo,F,100,7,0,7
Samartha,F,100,7,0,7
Sameko,F,100,7,0,7
Samreet,F,100,7,0,7
Samyha,F,100,7,0,7
Sandrell,F,100,7,0,7
Sanea,F,100,7,0,7
Sanny,M,100,0,7,7
Sanquan,M,100,0,7,7
Sanquetta,F,100,7,0,7
Santigo,M,100,0,7,7
Saral,M,100,0,7,7
Saransh,M,100,0,7,7
Sarda,F,100,7,0,7
Sareeta,F,100,7,0,7
Sarilyn,F,100,7,0,7
Satyra,F,100,7,0,7
Saurya,M,100,0,7,7
Schavon,F,100,7,0,7
Seab,M,100,0,7,7
Seaniya,F,100,7,0,7
Sebaztian,M,100,0,7,7
Sei,M,100,0,7,7
Seija,F,100,7,0,7
Semico,F,100,7,0,7
Senchal,F,100,7,0,7
Sequetta,F,100,7,0,7
Shaam,F,100,7,0,7
Shadajah,F,100,7,0,7
Shadestiny,F,100,7,0,7
Shaefer,M,100,0,7,7
Shaelen,F,100,7,0,7
Shafina,F,100,7,0,7
Shahied,M,100,0,7,7
Shakelah,F,100,7,0,7
Shakella,F,100,7,0,7
Shakiesha,F,100,7,0,7
Shameah,F,100,7,0,7
Shamena,F,100,7,0,7
Shamisha,F,100,7,0,7
Shamod,M,100,0,7,7
Shander,F,100,7,0,7
Shanquell,F,100,7,0,7
Shantha,F,100,7,0,7
Shantierra,F,100,7,0,7
Shantonia,F,100,7,0,7
Shantora,F,100,7,0,7
Shao,M,100,0,7,7
Shaqita,F,100,7,0,7
Shaqueil,M,100,0,7,7
Shardasha,F,100,7,0,7
Shardia,F,100,7,0,7
Sharmar,M,100,0,7,7
Sharnaye,F,100,7,0,7
Sharyne,F,100,7,0,7
Shastity,F,100,7,0,7
Shatae,F,100,7,0,7
Shaunia,F,100,7,0,7
Shawaiz,M,100,0,7,7
Shawnteria,F,100,7,0,7
Sheelagh,F,100,7,0,7
Shekeena,F,100,7,0,7
Shekerra,F,100,7,0,7
Shelissa,F,100,7,0,7
Shenille,F,100,7,0,7
Sherkia,F,100,7,0,7
Sheteka,F,100,7,0,7
Shetera,F,100,7,0,7
Shimaya,F,100,7,0,7
Shinece,F,100,7,0,7
Shinnosuke,M,100,0,7,7
Shizuka,F,100,7,0,7
Shnika,F,100,7,0,7
Shonee,F,100,7,0,7
Shoniece,F,100,7,0,7
Shylea,F,100,7,0,7
Sidiki,M,100,0,7,7
Simayah,F,100,7,0,7
Simeko,F,100,7,0,7
Siosiua,M,100,0,7,7
Sirdarius,M,100,0,7,7
Skiley,F,100,7,0,7
Skylette,F,100,7,0,7
Sobra,F,100,7,0,7
Socheat,M,100,0,7,7
Solo,M,100,0,7,7
Someeka,F,100,7,0,7
Sommers,F,100,7,0,7
Sonje,F,100,7,0,7
Soyoung,F,100,7,0,7
Spriha,F,100,7,0,7
Sravan,M,100,0,7,7
Sree,F,100,7,0,7
Sridevi,F,100,7,0,7
Staphon,M,100,0,7,7
Stefaun,M,100,0,7,7
Stokley,M,100,0,7,7
Stoy,M,100,0,7,7
Stratten,M,100,0,7,7
Stylz,M,100,0,7,7
Suban,F,100,7,0,7
Sulmy,F,100,7,0,7
Sumeko,F,100,7,0,7
Sumeyye,F,100,7,0,7
Summaya,F,100,7,0,7
Sunrise,F,100,7,0,7
Suvali,F,100,7,0,7
Suzu,F,100,7,0,7
Swastik,M,100,0,7,7
Swayzi,F,100,7,0,7
Sybill,F,100,7,0,7
Syden,M,100,0,7,7
Sydonna,F,100,7,0,7
Syndel,F,100,7,0,7
Synetra,F,100,7,0,7
Taaffe,F,100,7,0,7
Tacorra,F,100,7,0,7
Taejohn,M,100,0,7,7
Taelynne,F,100,7,0,7
Tailore,F,100,7,0,7
Takirra,F,100,7,0,7
Tamaree,F,100,7,0,7
Tamarkus,M,100,0,7,7
Tandeka,F,100,7,0,7
Tanjanique,F,100,7,0,7
Tankia,F,100,7,0,7
Tannesha,F,100,7,0,7
Tarajai,F,100,7,0,7
Tario,M,100,0,7,7
Tarkesha,F,100,7,0,7
Tasherra,F,100,7,0,7
Tasir,M,100,0,7,7
Tatania,F,100,7,0,7
Tautiana,F,100,7,0,7
Tavias,M,100,0,7,7
Tawfik,M,100,0,7,7
Teegun,M,100,0,7,7
Teenamarie,F,100,7,0,7
Teirney,F,100,7,0,7
Tellys,M,100,0,7,7
Temaria,F,100,7,0,7
Temecka,F,100,7,0,7
Temikia,F,100,7,0,7
Temilade,F,100,7,0,7
Temmy,F,100,7,0,7
Temuulen,M,100,0,7,7
Tenell,F,100,7,0,7
Tenina,F,100,7,0,7
Tennillie,F,100,7,0,7
Tenyia,F,100,7,0,7
Tequarius,M,100,0,7,7
Terykah,F,100,7,0,7
Thailee,F,100,7,0,7
Thisbe,F,100,7,0,7
Thomaslee,M,100,0,7,7
Thomias,M,100,0,7,7
Thomisha,F,100,7,0,7
Thyais,F,100,7,0,7
Tiahja,F,100,7,0,7
Tiandrea,F,100,7,0,7
Tiaundra,F,100,7,0,7
Tica,F,100,7,0,7
Tieshka,F,100,7,0,7
Tikeyah,F,100,7,0,7
Tikina,F,100,7,0,7
Tilla,F,100,7,0,7
Timaeus,M,100,0,7,7
Timicka,F,100,7,0,7
Timmons,M,100,0,7,7
Tinyah,F,100,7,0,7
Tiso,M,100,0,7,7
Tobiann,F,100,7,0,7
Toisha,F,100,7,0,7
Toki,F,100,7,0,7
Tomo,M,100,0,7,7
Tomoyuki,M,100,0,7,7
Tomyra,F,100,7,0,7
Tonay,F,100,7,0,7
Tondalayo,F,100,7,0,7
Torica,F,100,7,0,7
Toufic,M,100,0,7,7
Traie,F,100,7,0,7
Trakeila,F,100,7,0,7
Tramiah,F,100,7,0,7
Tranaya,F,100,7,0,7
Tranessa,F,100,7,0,7
Trayona,F,100,7,0,7
Tremyah,F,100,7,0,7
Trevarious,M,100,0,7,7
Treyshun,M,100,0,7,7
Treyvonte,M,100,0,7,7
Triscilla,F,100,7,0,7
Troian,F,100,7,0,7
Troyal,M,100,0,7,7
Trunetta,F,100,7,0,7
Trupti,F,100,7,0,7
Tshanti,F,100,7,0,7
Twina,F,100,7,0,7
Twyman,M,100,0,7,7
Tydon,M,100,0,7,7
Tyfani,F,100,7,0,7
Tyhler,M,100,0,7,7
Tyius,M,100,0,7,7
Tyjhawn,M,100,0,7,7
Tymekia,F,100,7,0,7
Tyneasha,F,100,7,0,7
Tyreise,M,100,0,7,7
Tyrianne,F,100,7,0,7
Tyun,M,100,0,7,7
Tyzell,M,100,0,7,7
Ufemia,F,100,7,0,7
Uldis,M,100,0,7,7
Umayah,F,100,7,0,7
Uronda,F,100,7,0,7
Valancia,F,100,7,0,7
Vallene,F,100,7,0,7
Varie,F,100,7,0,7
Varion,M,100,0,7,7
Velkan,M,100,0,7,7
Velvette,F,100,7,0,7
Venera,F,100,7,0,7
Verdean,F,100,7,0,7
Vernesta,F,100,7,0,7
Veshawn,M,100,0,7,7
Vidisha,F,100,7,0,7
Vikita,F,100,7,0,7
Vincene,F,100,7,0,7
Vinyette,F,100,7,0,7
Vitus,M,100,0,7,7
Vivenne,F,100,7,0,7
Volvi,M,100,0,7,7
Wachovia,F,100,7,0,7
Waheedah,F,100,7,0,7
Walela,F,100,7,0,7
Wallene,F,100,7,0,7
Wani,M,100,0,7,7
Waver,F,100,7,0,7
Welda,F,100,7,0,7
Wendey,F,100,7,0,7
Wenzel,M,100,0,7,7
Wilnelia,F,100,7,0,7
Wynna,F,100,7,0,7
Xaylen,M,100,0,7,7
Xinyue,F,100,7,0,7
Xitlalith,F,100,7,0,7
Xyan,M,100,0,7,7
Xzavius,M,100,0,7,7
Yaimara,F,100,7,0,7
Yaisha,F,100,7,0,7
Yajaida,F,100,7,0,7
Yaksh,M,100,0,7,7
Yalini,F,100,7,0,7
Yanesha,F,100,7,0,7
Yanetzi,F,100,7,0,7
Yanibel,F,100,7,0,7
Yanileth,F,100,7,0,7
Yanisse,F,100,7,0,7
Yarali,F,100,7,0,7
Yaressi,F,100,7,0,7
Yarida,F,100,7,0,7
Yarilyn,F,100,7,0,7
Yaxaira,F,100,7,0,7
Yaylin,F,100,7,0,7
Yelenis,F,100,7,0,7
Yentel,F,100,7,0,7
Yerelin,F,100,7,0,7
Yerly,F,100,7,0,7
Yessel,F,100,7,0,7
Yicheng,M,100,0,7,7
Yitong,F,100,7,0,7
Yoshimi,F,100,7,0,7
Yoslan,M,100,0,7,7
Yosuel,M,100,0,7,7
Yubal,M,100,0,7,7
Yupheng,M,100,0,7,7
Yuuta,M,100,0,7,7
Zachaeus,M,100,0,7,7
Zadah,F,100,7,0,7
Zaelon,M,100,0,7,7
Zailan,M,100,0,7,7
Zaiyon,M,100,0,7,7
Zakiria,F,100,7,0,7
Zaleth,F,100,7,0,7
Zamyla,F,100,7,0,7
Zanda,F,100,7,0,7
Zarious,M,100,0,7,7
Zebulah,M,100,0,7,7
Zekiyah,F,100,7,0,7
Zenen,M,100,0,7,7
Zevan,M,100,0,7,7
Zevulun,M,100,0,7,7
Zevyn,M,100,0,7,7
Zhymir,M,100,0,7,7
Ziclali,F,100,7,0,7
Zikeya,F,100,7,0,7
Zilla,F,100,7,0,7
Ziraily,F,100,7,0,7
Zoiie,F,100,7,0,7
Zriah,F,100,7,0,7
Zyhaire,M,100,0,7,7
Zyllah,F,100,7,0,7
Aalap,M,100,0,6,6
Aalayjah,F,100,6,0,6
Aalexus,F,100,6,0,6
Aalysia,F,100,6,0,6
Aanav,M,100,0,6,6
Aaraiz,M,100,0,6,6
Aarolyn,F,100,6,0,6
Aaronisha,F,100,6,0,6
Aaroosh,M,100,0,6,6
Aashia,F,100,6,0,6
Aashita,F,100,6,0,6
Aaydan,M,100,0,6,6
Aayu,M,100,0,6,6
Abbygayl,F,100,6,0,6
Abdala,M,100,0,6,6
Abdalah,M,100,0,6,6
Abdelrhman,M,100,0,6,6
Abdiasis,M,100,0,6,6
Abdisalan,M,100,0,6,6
Abdrew,M,100,0,6,6
Abdule,M,100,0,6,6
Abdussamad,M,100,0,6,6
Abela,F,100,6,0,6
Abibail,F,100,6,0,6
Abigai,F,100,6,0,6
Abigailrose,F,100,6,0,6
Abilynn,F,100,6,0,6
Abiud,M,100,0,6,6
Abnel,M,100,0,6,6
Abreia,F,100,6,0,6
Abren,M,100,0,6,6
Abreona,F,100,6,0,6
Abriannah,F,100,6,0,6
Abrion,M,100,0,6,6
Abriyah,F,100,6,0,6
Abriyana,F,100,6,0,6
Abry,F,100,6,0,6
Abtin,M,100,0,6,6
Acamas,M,100,0,6,6
Access,M,100,0,6,6
Achai,M,100,0,6,6
Achazia,F,100,6,0,6
Acia,F,100,6,0,6
Adaelyn,F,100,6,0,6
Adahy,M,100,0,6,6
Adaleine,F,100,6,0,6
Adalisa,F,100,6,0,6
Adalize,F,100,6,0,6
Adamm,M,100,0,6,6
Adammichael,M,100,0,6,6
Addlie,F,100,6,0,6
Addylen,F,100,6,0,6
Addysn,F,100,6,0,6
Adee,F,100,6,0,6
Adelayne,F,100,6,0,6
Adellynn,F,100,6,0,6
Ademar,M,100,0,6,6
Adeon,M,100,0,6,6
Aderemi,M,100,0,6,6
Adhiraj,M,100,0,6,6
Adhithya,M,100,0,6,6
Adijah,F,100,6,0,6
Adlia,M,100,0,6,6
Adomas,M,100,0,6,6
Adorion,M,100,0,6,6
Adre,M,100,0,6,6
Adrith,M,100,0,6,6
Adyleigh,F,100,6,0,6
Adylyn,F,100,6,0,6
Aelan,F,100,6,0,6
Aelani,F,100,6,0,6
Aelicia,F,100,6,0,6
Aemelia,F,100,6,0,6
Aferdita,F,100,6,0,6
Agassi,M,100,0,6,6
Agela,F,100,6,0,6
Aginah,F,100,6,0,6
Aglaia,F,100,6,0,6
Agnessa,F,100,6,0,6
Ahalya,F,100,6,0,6
Ahanu,M,100,0,6,6
Ahbleza,M,100,0,6,6
Ahian,M,100,0,6,6
Ahkai,M,100,0,6,6
Ahkeel,M,100,0,6,6
Ahkeelah,F,100,6,0,6
Ahleigha,F,100,6,0,6
Ahnalise,F,100,6,0,6
Ahnisty,F,100,6,0,6
Ahriah,F,100,6,0,6
Ahsen,M,100,0,6,6
Ahsir,M,100,0,6,6
Aibel,M,100,0,6,6
Aibileen,F,100,6,0,6
Aidanjames,M,100,0,6,6
Ailan,M,100,0,6,6
Ailanny,F,100,6,0,6
Ailet,F,100,6,0,6
Ailise,F,100,6,0,6
Aimal,M,100,0,6,6
Ainka,F,100,6,0,6
Aitiana,F,100,6,0,6
Aiyani,F,100,6,0,6
Ajaden,M,100,0,6,6
Ajahn,M,100,0,6,6
Aje,F,100,6,0,6
Ajena,F,100,6,0,6
Akaela,F,100,6,0,6
Akeara,F,100,6,0,6
Akenzie,F,100,6,0,6
Akhilleus,M,100,0,6,6
Akiana,F,100,6,0,6
Akieba,F,100,6,0,6
Akishia,F,100,6,0,6
Akol,M,100,0,6,6
Akwete,F,100,6,0,6
Akyiah,F,100,6,0,6
Akyria,F,100,6,0,6
Aladin,M,100,0,6,6
Alagie,M,100,0,6,6
Alannys,F,100,6,0,6
Alay,M,100,0,6,6
Alayjia,F,100,6,0,6
Alayjiah,F,100,6,0,6
Alaynnah,F,100,6,0,6
Albara,M,100,0,6,6
Alberico,M,100,0,6,6
Aldayshein,M,100,0,6,6
Aldis,M,100,0,6,6
Aldonia,F,100,6,0,6
Aleccia,F,100,6,0,6
Aleela,F,100,6,0,6
Aleeshia,F,100,6,0,6
Alejondro,M,100,0,6,6
Alekxa,F,100,6,0,6
Alekya,F,100,6,0,6
Alesso,M,100,0,6,6
Alessondra,F,100,6,0,6
Alessya,F,100,6,0,6
Aletris,F,100,6,0,6
Alexandrah,F,100,6,0,6
Alexaundrea,F,100,6,0,6
Alexzandar,M,100,0,6,6
Alezia,F,100,6,0,6
Alfredrick,M,100,0,6,6
Aliezah,F,100,6,0,6
Alikai,M,100,0,6,6
Alisynn,F,100,6,0,6
Alixon,F,100,6,0,6
Alixzandria,F,100,6,0,6
Alizander,M,100,0,6,6
Aljaquan,M,100,0,6,6
Aljawhara,F,100,6,0,6
Alkeria,F,100,6,0,6
Allera,F,100,6,0,6
Almeter,F,100,6,0,6
Alperen,M,100,0,6,6
Alphus,M,100,0,6,6
Alsiha,F,100,6,0,6
Altovese,F,100,6,0,6
Alvernon,M,100,0,6,6
Alvida,F,100,6,0,6
Alye,F,100,6,0,6
Alyka,F,100,6,0,6
Alyosha,M,100,0,6,6
Alyssea,F,100,6,0,6
Alyssya,F,100,6,0,6
Alzena,F,100,6,0,6
Alzenia,F,100,6,0,6
Amabelle,F,100,6,0,6
Amaire,M,100,0,6,6
Amalin,F,100,6,0,6
Amandip,M,100,0,6,6
Amarily,F,100,6,0,6
Amarley,F,100,6,0,6
Amaryn,F,100,6,0,6
Amayha,F,100,6,0,6
Amberann,F,100,6,0,6
Ambrasia,F,100,6,0,6
Ameelah,F,100,6,0,6
Ameeria,F,100,6,0,6
Ameina,F,100,6,0,6
Amekia,F,100,6,0,6
Amella,F,100,6,0,6
Ameyia,F,100,6,0,6
Amida,F,100,6,0,6
Amilla,F,100,6,0,6
Amilynn,F,100,6,0,6
Amneet,F,100,6,0,6
Amoriana,F,100,6,0,6
Amose,M,100,0,6,6
Amoure,F,100,6,0,6
Amrik,M,100,0,6,6
Amyliah,F,100,6,0,6
Amyrion,M,100,0,6,6
Anabelia,F,100,6,0,6
Anacarina,F,100,6,0,6
Anaee,F,100,6,0,6
Anagabriel,F,100,6,0,6
Anajae,F,100,6,0,6
Anajee,M,100,0,6,6
Analeia,F,100,6,0,6
Analeshia,F,100,6,0,6
Anamda,F,100,6,0,6
Ananshi,F,100,6,0,6
Anaruth,F,100,6,0,6
Anatoli,M,100,0,6,6
Anatolia,F,100,6,0,6
Anayelly,F,100,6,0,6
Anayra,F,100,6,0,6
Anayssa,F,100,6,0,6
Anchita,F,100,6,0,6
Andelin,F,100,6,0,6
Andjoua,F,100,6,0,6
Andreonna,F,100,6,0,6
Andriena,F,100,6,0,6
Andrijana,F,100,6,0,6
Andropolis,M,100,0,6,6
Aneda,F,100,6,0,6
Aneeqa,F,100,6,0,6
Aneiya,F,100,6,0,6
Anelah,F,100,6,0,6
Anemone,F,100,6,0,6
Ang,M,100,0,6,6
Angelenia,F,100,6,0,6
Angelian,F,100,6,0,6
Angeliana,F,100,6,0,6
Angelisha,F,100,6,0,6
Angellique,F,100,6,0,6
Angelray,M,100,0,6,6
Angenique,F,100,6,0,6
Anghel,M,100,0,6,6
Anibella,F,100,6,0,6
Aniq,M,100,0,6,6
Anisjon,M,100,0,6,6
Anitia,F,100,6,0,6
Anjae,F,100,6,0,6
Anjalena,F,100,6,0,6
Anjanie,F,100,6,0,6
Anjelyna,F,100,6,0,6
Ankoma,M,100,0,6,6
Anleigh,F,100,6,0,6
Annachristina,F,100,6,0,6
Annaie,F,100,6,0,6
Annamari,F,100,6,0,6
Annapaula,F,100,6,0,6
Annayeli,F,100,6,0,6
Anndi,F,100,6,0,6
Anneice,F,100,6,0,6
Annettia,F,100,6,0,6
Anngelina,F,100,6,0,6
Anngie,F,100,6,0,6
Annicia,F,100,6,0,6
Annilyn,F,100,6,0,6
Annistin,F,100,6,0,6
Annitte,F,100,6,0,6
Annley,F,100,6,0,6
Antanika,F,100,6,0,6
Antashia,F,100,6,0,6
Antenette,F,100,6,0,6
Anterion,M,100,0,6,6
Anterrius,M,100,0,6,6
Anthnoy,M,100,0,6,6
Antoinae,F,100,6,0,6
Antoiniece,F,100,6,0,6
Antoneisha,F,100,6,0,6
Antoneshia,F,100,6,0,6
Antonion,M,100,0,6,6
Antorion,M,100,0,6,6
Antrese,F,100,6,0,6
Antwaune,M,100,0,6,6
Anyelis,F,100,6,0,6
Anyieth,F,100,6,0,6
Anyya,F,100,6,0,6
Anzar,M,100,0,6,6
Aparajita,F,100,6,0,6
Apples,F,100,6,0,6
Aquina,F,100,6,0,6
Arabian,F,100,6,0,6
Aracele,F,100,6,0,6
Aramus,M,100,0,6,6
Arashel,F,100,6,0,6
Arayana,F,100,6,0,6
Arbrielle,F,100,6,0,6
Arcella,F,100,6,0,6
Archelle,F,100,6,0,6
Architha,F,100,6,0,6
Arcus,M,100,0,6,6
Ardeen,F,100,6,0,6
Ardriana,F,100,6,0,6
Ardynn,F,100,6,0,6
Areah,F,100,6,0,6
Arec,M,100,0,6,6
Arela,F,100,6,0,6
Arelin,F,100,6,0,6
Aretzi,F,100,6,0,6
Arhaam,M,100,0,6,6
Ariadny,F,100,6,0,6
Ariahana,F,100,6,0,6
Aricely,F,100,6,0,6
Arieah,F,100,6,0,6
Arione,F,100,6,0,6
Ariyal,F,100,6,0,6
Ariyeh,M,100,0,6,6
Ariyunna,F,100,6,0,6
Arkayla,F,100,6,0,6
Arleena,F,100,6,0,6
Arleht,F,100,6,0,6
Armar,M,100,0,6,6
Armie,F,100,6,0,6
Army,F,100,6,0,6
Arnee,F,100,6,0,6
Aroha,F,100,6,0,6
Aroosa,F,100,6,0,6
Arreana,F,100,6,0,6
Arriell,F,100,6,0,6
Arriyanah,F,100,6,0,6
Arsalaan,M,100,0,6,6
Arsenial,M,100,0,6,6
Artiana,F,100,6,0,6
Arton,M,100,0,6,6
Artura,F,100,6,0,6
Aruba,F,100,6,0,6
Arvey,M,100,0,6,6
Aryanni,F,100,6,0,6
Aryes,M,100,0,6,6
Asauni,F,100,6,0,6
Asenat,F,100,6,0,6
Ashaan,M,100,0,6,6
Ashanni,F,100,6,0,6
Ashantianna,F,100,6,0,6
Asharra,F,100,6,0,6
Ashelle,F,100,6,0,6
Ashim,M,100,0,6,6
Ashja,F,100,6,0,6
Ashlii,F,100,6,0,6
Ashmeet,F,100,6,0,6
Ashrit,M,100,0,6,6
Ashtion,M,100,0,6,6
Asiamarie,F,100,6,0,6
Asisha,F,100,6,0,6
Aslhey,F,100,6,0,6
Asmitha,F,100,6,0,6
Asoni,F,100,6,0,6
Assaf,M,100,0,6,6
Asteria,F,100,6,0,6
Astreia,F,100,6,0,6
Astride,F,100,6,0,6
Asyra,F,100,6,0,6
Ataja,F,100,6,0,6
Ataliah,F,100,6,0,6
Atanya,F,100,6,0,6
Atef,M,100,0,6,6
Atit,M,100,0,6,6
Atiyanna,F,100,6,0,6
Atreju,M,100,0,6,6
Atrell,M,100,0,6,6
Attache,F,100,6,0,6
Attica,F,100,6,0,6
Aubreerose,F,100,6,0,6
Audeliz,M,100,0,6,6
Audio,M,100,0,6,6
Audriel,F,100,6,0,6
Aulona,F,100,6,0,6
Aundreah,F,100,6,0,6
Aurellia,F,100,6,0,6
Auric,M,100,0,6,6
Auroara,F,100,6,0,6
Automn,F,100,6,0,6
Avaa,F,100,6,0,6
Avaani,F,100,6,0,6
Avajane,F,100,6,0,6
Avaleena,F,100,6,0,6
Avangelia,F,100,6,0,6
Avanicole,F,100,6,0,6
Avareigh,F,100,6,0,6
Avash,M,100,0,6,6
Averett,M,100,0,6,6
Avira,F,100,6,0,6
Avishka,F,100,6,0,6
Avonlee,F,100,6,0,6
Avonni,F,100,6,0,6
Axal,M,100,0,6,6
Ayanda,F,100,6,0,6
Ayati,F,100,6,0,6
Ayatollah,M,100,0,6,6
Ayatt,F,100,6,0,6
Aydeliz,F,100,6,0,6
Aydun,M,100,0,6,6
Ayled,F,100,6,0,6
Aylie,F,100,6,0,6
Aylisha,F,100,6,0,6
Aymeric,M,100,0,6,6
Aynsleigh,F,100,6,0,6
Ayomiposi,M,100,0,6,6
Ayonah,F,100,6,0,6
Ayreana,F,100,6,0,6
Ayumu,M,100,0,6,6
Ayveon,M,100,0,6,6
Ayzel,F,100,6,0,6
Azairah,F,100,6,0,6
Azaliya,F,100,6,0,6
Azareyah,F,100,6,0,6
Azariana,F,100,6,0,6
Azarious,M,100,0,6,6
Azimjon,M,100,0,6,6
Azizjon,M,100,0,6,6
Azleigh,F,100,6,0,6
Azoriah,F,100,6,0,6
Azylah,F,100,6,0,6
Azziah,F,100,6,0,6
Baber,M,100,0,6,6
Bahiyah,F,100,6,0,6
Bahiyyah,F,100,6,0,6
Bailasan,F,100,6,0,6
Bakar,M,100,0,6,6
Baler,M,100,0,6,6
Baliegh,F,100,6,0,6
Balqis,F,100,6,0,6
Bansi,F,100,6,0,6
Baqir,M,100,0,6,6
Barara,F,100,6,0,6
Barbett,F,100,6,0,6
Barkot,F,100,6,0,6
Barrette,M,100,0,6,6
Baruti,M,100,0,6,6
Bashira,F,100,6,0,6
Bashy,F,100,6,0,6
Batrice,F,100,6,0,6
Bayze,M,100,0,6,6
Beacher,M,100,0,6,6
Beasia,F,100,6,0,6
Beauen,M,100,0,6,6
Beautyful,F,100,6,0,6
Beesan,F,100,6,0,6
Beira,F,100,6,0,6
Bekam,M,100,0,6,6
Belana,F,100,6,0,6
Bellanira,F,100,6,0,6
Bellasophia,F,100,6,0,6
Bellissa,F,100,6,0,6
Belsy,F,100,6,0,6
Benee,F,100,6,0,6
Benesha,F,100,6,0,6
Bengt,M,100,0,6,6
Benica,F,100,6,0,6
Bentely,M,100,0,6,6
Berg,M,100,0,6,6
Bernando,M,100,0,6,6
Berni,F,100,6,0,6
Berrett,M,100,0,6,6
Berri,F,100,6,0,6
Bertice,F,100,6,0,6
Berto,M,100,0,6,6
Berwin,M,100,0,6,6
Bethanni,F,100,6,0,6
Bethanya,F,100,6,0,6
Bethlyn,F,100,6,0,6
Bevis,M,100,0,6,6
Beyan,M,100,0,6,6
Beyda,F,100,6,0,6
Biaca,F,100,6,0,6
Billiejoe,F,100,6,0,6
Bimal,M,100,0,6,6
Biren,M,100,0,6,6
Biron,M,100,0,6,6
Bissan,F,100,6,0,6
Bjay,M,100,0,6,6
Blaide,M,100,0,6,6
Blaidyn,M,100,0,6,6
Blandy,F,100,6,0,6
Blayr,F,100,6,0,6
Bnai,F,100,6,0,6
Boback,M,100,0,6,6
Bobbielee,F,100,6,0,6
Bobbyetta,F,100,6,0,6
Bogdana,F,100,6,0,6
Bolaji,M,100,0,6,6
Bourne,M,100,0,6,6
Bowdrie,M,100,0,6,6
Braelyne,F,100,6,0,6
Braesyn,M,100,0,6,6
Bralan,M,100,0,6,6
Bralei,F,100,6,0,6
Brandina,F,100,6,0,6
Brandson,M,100,0,6,6
Brandton,M,100,0,6,6
Brandylynn,F,100,6,0,6
Braneisha,F,100,6,0,6
Branlee,M,100,0,6,6
Brasia,F,100,6,0,6
Bravo,M,100,0,6,6
Braxsten,M,100,0,6,6
Braxstyn,M,100,0,6,6
Braydi,F,100,6,0,6
Brayelle,F,100,6,0,6
Breaanna,F,100,6,0,6
Breahanna,F,100,6,0,6
Breandrea,F,100,6,0,6
Breasya,F,100,6,0,6
Brecklin,F,100,6,0,6
Breckynn,F,100,6,0,6
Breeahna,F,100,6,0,6
Breighana,F,100,6,0,6
Brekkin,M,100,0,6,6
Brendella,F,100,6,0,6
Brennae,F,100,6,0,6
Brentnie,F,100,6,0,6
Breonnah,F,100,6,0,6
Breontae,M,100,0,6,6
Breshia,F,100,6,0,6
Breylyn,F,100,6,0,6
Breyunna,F,100,6,0,6
Brezhane,F,100,6,0,6
Brhea,F,100,6,0,6
Briamarie,F,100,6,0,6
Briannica,F,100,6,0,6
Bridy,F,100,6,0,6
Briette,F,100,6,0,6
Brigina,F,100,6,0,6
Brinli,F,100,6,0,6
Brionni,F,100,6,0,6
Brisais,F,100,6,0,6
Brisna,F,100,6,0,6
Brithny,F,100,6,0,6
Brittanae,F,100,6,0,6
Brittanica,F,100,6,0,6
Brittanynicole,F,100,6,0,6
Broder,M,100,0,6,6
Brookann,F,100,6,0,6
Brownell,M,100,0,6,6
Brutus,M,100,0,6,6
Bryani,F,100,6,0,6
Bryaunna,F,100,6,0,6
Brycie,F,100,6,0,6
Brydin,M,100,0,6,6
Brynlin,F,100,6,0,6
Brynson,M,100,0,6,6
Bryttnii,F,100,6,0,6
Bryxton,M,100,0,6,6
Bulut,M,100,0,6,6
Burdett,M,100,0,6,6
Burim,M,100,0,6,6
Burlon,M,100,0,6,6
Byonce,F,100,6,0,6
Cadem,M,100,0,6,6
Cadge,M,100,0,6,6
Cadillac,M,100,0,6,6
Caelainn,F,100,6,0,6
Caelix,M,100,0,6,6
Cahmari,M,100,0,6,6
Caidenn,M,100,0,6,6
Caimin,M,100,0,6,6
Calaysia,F,100,6,0,6
Caled,M,100,0,6,6
Caleia,F,100,6,0,6
Calek,M,100,0,6,6
Caleob,M,100,0,6,6
Callandra,F,100,6,0,6
Calletano,M,100,0,6,6
Calvinesha,F,100,6,0,6
Cambrya,F,100,6,0,6
Cameca,F,100,6,0,6
Camecia,F,100,6,0,6
Camerone,M,100,0,6,6
Camirah,F,100,6,0,6
Camonte,M,100,0,6,6
Camorra,F,100,6,0,6
Camrun,M,100,0,6,6
Canasia,F,100,6,0,6
Candiance,F,100,6,0,6
Canh,M,100,0,6,6
Canin,M,100,0,6,6
Cape,M,100,0,6,6
Capitola,F,100,6,0,6
Cardea,M,100,0,6,6
Careron,M,100,0,6,6
Carliee,F,100,6,0,6
Carllene,F,100,6,0,6
Carlyse,F,100,6,0,6
Carmala,F,100,6,0,6
Carmena,F,100,6,0,6
Carmille,F,100,6,0,6
Carminia,F,100,6,0,6
Caroljo,F,100,6,0,6
Carolyon,F,100,6,0,6
Carree,F,100,6,0,6
Carrielynn,F,100,6,0,6
Carstyn,M,100,0,6,6
Carthel,M,100,0,6,6
Cartlin,F,100,6,0,6
Caryna,F,100,6,0,6
Casden,M,100,0,6,6
Cashanda,F,100,6,0,6
Casheena,F,100,6,0,6
Cashion,M,100,0,6,6
Cassadra,F,100,6,0,6
Cassin,M,100,0,6,6
Cassye,F,100,6,0,6
Casta,F,100,6,0,6
Castina,F,100,6,0,6
Castro,M,100,0,6,6
Catarena,F,100,6,0,6
Catenia,F,100,6,0,6
Caternia,F,100,6,0,6
Cathrynn,F,100,6,0,6
Catine,F,100,6,0,6
Catoria,F,100,6,0,6
Catosha,F,100,6,0,6
Catreena,F,100,6,0,6
Catriana,F,100,6,0,6
Catrisha,F,100,6,0,6
Caua,M,100,0,6,6
Cawanna,F,100,6,0,6
Caylub,M,100,0,6,6
Caymus,M,100,0,6,6
Cedrea,F,100,6,0,6
Celaya,F,100,6,0,6
Celerina,F,100,6,0,6
Celimar,F,100,6,0,6
Celyn,F,100,6,0,6
Cenae,F,100,6,0,6
Cerrie,F,100,6,0,6
Cescily,F,100,6,0,6
Cessna,F,100,6,0,6
Chabelli,F,100,6,0,6
Chadarius,M,100,0,6,6
Chadijah,F,100,6,0,6
Chadwell,M,100,0,6,6
Chaena,F,100,6,0,6
Chaitan,M,100,0,6,6
Chalei,F,100,6,0,6
Chanella,F,100,6,0,6
Chantaye,F,100,6,0,6
Chardasia,F,100,6,0,6
Charger,M,100,0,6,6
Charissma,F,100,6,0,6
Charlonda,F,100,6,0,6
Charlyann,F,100,6,0,6
Charmica,F,100,6,0,6
Chartese,F,100,6,0,6
Chasadee,F,100,6,0,6
Chavella,F,100,6,0,6
Chaylyn,F,100,6,0,6
Chazaray,M,100,0,6,6
Chelesy,F,100,6,0,6
Chelssie,F,100,6,0,6
Chelzie,F,100,6,0,6
Chenavia,F,100,6,0,6
Cheneka,F,100,6,0,6
Cheralee,F,100,6,0,6
Chericka,F,100,6,0,6
Cheriece,F,100,6,0,6
Cherisha,F,100,6,0,6
Cherlyl,F,100,6,0,6
Cherod,M,100,0,6,6
Cheryllee,F,100,6,0,6
Cheryllyn,F,100,6,0,6
Chesleigh,F,100,6,0,6
Chesten,M,100,0,6,6
Chestin,M,100,0,6,6
Cheval,M,100,0,6,6
Chevala,F,100,6,0,6
Chevaun,F,100,6,0,6
Chidiebube,M,100,0,6,6
Chiebuka,M,100,0,6,6
Chiem,M,100,0,6,6
Chiemela,F,100,6,0,6
Chih,M,100,0,6,6
Childnotnamed,F,100,6,0,6
Chiquana,F,100,6,0,6
Chizitelu,F,100,6,0,6
Chloeigh,F,100,6,0,6
Chloejane,F,100,6,0,6
Chloris,F,100,6,0,6
Chorlette,F,100,6,0,6
Chrie,F,100,6,0,6
Chrisan,F,100,6,0,6
Christann,F,100,6,0,6
Christaphor,M,100,0,6,6
Christeanna,F,100,6,0,6
Christela,F,100,6,0,6
Christianah,F,100,6,0,6
Christieann,F,100,6,0,6
Christiene,F,100,6,0,6
Christlynn,F,100,6,0,6
Christoopher,M,100,0,6,6
Christopheranth,M,100,0,6,6
Chrysanthia,F,100,6,0,6
Ciane,F,100,6,0,6
Ciceley,F,100,6,0,6
Cieran,M,100,0,6,6
Ciersten,F,100,6,0,6
Cija,F,100,6,0,6
Cindye,F,100,6,0,6
Cinnamin,F,100,6,0,6
Cinya,F,100,6,0,6
Cionne,F,100,6,0,6
Cionni,F,100,6,0,6
Ciprian,M,100,0,6,6
Cirenia,F,100,6,0,6
Cirila,F,100,6,0,6
Cirrus,M,100,0,6,6
Cithlali,F,100,6,0,6
Cittlaly,F,100,6,0,6
Claraliz,F,100,6,0,6
Clarette,F,100,6,0,6
Claribelle,F,100,6,0,6
Clarnece,M,100,0,6,6
Classy,F,100,6,0,6
Claudiajoy,F,100,6,0,6
Cleidy,F,100,6,0,6
Clemons,M,100,0,6,6
Clenard,M,100,0,6,6
Cleophis,M,100,0,6,6
Clevette,F,100,6,0,6
Clhoe,F,100,6,0,6
Clift,M,100,0,6,6
Cloudia,F,100,6,0,6
Clutch,M,100,0,6,6
Cobyn,M,100,0,6,6
Codyallen,M,100,0,6,6
Coedy,M,100,0,6,6
Cohner,M,100,0,6,6
Coire,M,100,0,6,6
Colline,F,100,6,0,6
Comekia,F,100,6,0,6
Connall,M,100,0,6,6
Connel,M,100,0,6,6
Conzy,F,100,6,0,6
Coralin,F,100,6,0,6
Coraliz,F,100,6,0,6
Coralline,F,100,6,0,6
Coraly,F,100,6,0,6
Cordelra,M,100,0,6,6
Corette,F,100,6,0,6
Coreyion,M,100,0,6,6
Corneall,M,100,0,6,6
Cornecia,F,100,6,0,6
Cornelieus,M,100,0,6,6
Cornie,M,100,0,6,6
Corny,M,100,0,6,6
Cortazia,F,100,6,0,6
Corteze,M,100,0,6,6
Cosha,F,100,6,0,6
Cotenia,F,100,6,0,6
Couy,M,100,0,6,6
Cova,F,100,6,0,6
Cozell,M,100,0,6,6
Crandon,M,100,0,6,6
Crayson,M,100,0,6,6
Creosha,F,100,6,0,6
Cresenciano,M,100,0,6,6
Creyton,M,100,0,6,6
Crimsyn,F,100,6,0,6
Crisangel,M,100,0,6,6
Criscia,F,100,6,0,6
Criselle,F,100,6,0,6
Crishaun,M,100,0,6,6
Cristyl,F,100,6,0,6
Cuauhtli,M,100,0,6,6
Cupid,M,100,0,6,6
Curtavious,M,100,0,6,6
Custodio,M,100,0,6,6
Cuthbert,M,100,0,6,6
Cyion,M,100,0,6,6
Cylena,F,100,6,0,6
Cynetha,F,100,6,0,6
Cynnthia,F,100,6,0,6
Cynthnia,F,100,6,0,6
Cyrenna,F,100,6,0,6
Dabriel,M,100,0,6,6
Dadriana,F,100,6,0,6
Daedrian,M,100,0,6,6
Daerion,M,100,0,6,6
Daeun,F,100,6,0,6
Daevaughn,M,100,0,6,6
Daevyn,M,100,0,6,6
Dagmara,F,100,6,0,6
Daiah,F,100,6,0,6
Daidrian,M,100,0,6,6
Daigen,M,100,0,6,6
Dailynne,F,100,6,0,6
Daimarely,F,100,6,0,6
Daintry,F,100,6,0,6
Dairus,M,100,0,6,6
Daishanay,F,100,6,0,6
Daityn,F,100,6,0,6
Dajan,M,100,0,6,6
Dajonique,F,100,6,0,6
Dajua,F,100,6,0,6
Dakhi,M,100,0,6,6
Daks,M,100,0,6,6
Dakya,F,100,6,0,6
Dalaine,F,100,6,0,6
Dalainee,F,100,6,0,6
Dalajah,F,100,6,0,6
Dalery,F,100,6,0,6
Dalida,F,100,6,0,6
Dallion,M,100,0,6,6
Daltry,M,100,0,6,6
Damaje,M,100,0,6,6
Damarieon,M,100,0,6,6
Damasio,M,100,0,6,6
Damauni,M,100,0,6,6
Damiesha,F,100,6,0,6
Damisi,M,100,0,6,6
Damitrius,M,100,0,6,6
Damiyan,M,100,0,6,6
Danail,M,100,0,6,6
Danayara,F,100,6,0,6
Danaysy,F,100,6,0,6
Danielis,F,100,6,0,6
Daniellah,F,100,6,0,6
Daniellerose,F,100,6,0,6
Danijel,M,100,0,6,6
Dannaka,F,100,6,0,6
Dannielyn,F,100,6,0,6
Danovan,M,100,0,6,6
Danterius,M,100,0,6,6
Dantes,M,100,0,6,6
Danti,M,100,0,6,6
Dantoinette,F,100,6,0,6
Danyall,F,100,6,0,6
Danyeil,F,100,6,0,6
Danyne,F,100,6,0,6
Daphen,F,100,6,0,6
Darann,F,100,6,0,6
Darikson,M,100,0,6,6
Darinesha,F,100,6,0,6
Darlana,F,100,6,0,6
Darley,F,100,6,0,6
Darlicia,F,100,6,0,6
Darlise,F,100,6,0,6
Darnetha,F,100,6,0,6
Daronn,M,100,0,6,6
Darquise,M,100,0,6,6
Darrika,F,100,6,0,6
Darshanna,F,100,6,0,6
Daryiah,F,100,6,0,6
Darylle,M,100,0,6,6
Dasaan,M,100,0,6,6
Dasael,M,100,0,6,6
Dashiyah,F,100,6,0,6
Dasian,M,100,0,6,6
Dasmon,M,100,0,6,6
Davein,M,100,0,6,6
Daveisha,F,100,6,0,6
Daveonte,M,100,0,6,6
Davionta,M,100,0,6,6
Daviyah,F,100,6,0,6
Davohn,M,100,0,6,6
Davontaye,M,100,0,6,6
Davor,M,100,0,6,6
Davynn,F,100,6,0,6
Dawnda,F,100,6,0,6
Dawnene,F,100,6,0,6
Daxia,F,100,6,0,6
Dayahna,F,100,6,0,6
Dayde,M,100,0,6,6
Daykota,M,100,0,6,6
Dayro,M,100,0,6,6
Daytwan,M,100,0,6,6
Dazlyn,F,100,6,0,6
Dazlynn,F,100,6,0,6
Deajane,F,100,6,0,6
Deanca,F,100,6,0,6
Dearria,F,100,6,0,6
Deawn,F,100,6,0,6
Debr,F,100,6,0,6
Debraa,F,100,6,0,6
Decan,M,100,0,6,6
Decarri,M,100,0,6,6
Decarter,M,100,0,6,6
Dechane,M,100,0,6,6
Dedrianna,F,100,6,0,6
Deea,F,100,6,0,6
Deeasia,F,100,6,0,6
Deeddra,F,100,6,0,6
Deene,F,100,6,0,6
Deett,F,100,6,0,6
Defonta,M,100,0,6,6
Deiadra,F,100,6,0,6
Deione,M,100,0,6,6
Deirde,F,100,6,0,6
Deith,M,100,0,6,6
Deizel,M,100,0,6,6
Dejahne,F,100,6,0,6
Dejamarie,F,100,6,0,6
Dejonnae,F,100,6,0,6
Dejuna,F,100,6,0,6
Deker,M,100,0,6,6
Dekobe,M,100,0,6,6
Delajah,F,100,6,0,6
Delcy,F,100,6,0,6
Delilha,F,100,6,0,6
Delphenia,F,100,6,0,6
Deltina,F,100,6,0,6
Delvaughn,M,100,0,6,6
Delvion,M,100,0,6,6
Delycia,F,100,6,0,6
Delyza,F,100,6,0,6
Demaine,M,100,0,6,6
Demajae,M,100,0,6,6
Demarkas,M,100,0,6,6
Demaurie,M,100,0,6,6
Demeri,F,100,6,0,6
Demetirus,M,100,0,6,6
Demingo,M,100,0,6,6
Demitric,M,100,0,6,6
Denarious,M,100,0,6,6
Denilah,F,100,6,0,6
Dennita,F,100,6,0,6
Denroy,M,100,0,6,6
Denysse,F,100,6,0,6
Deonia,F,100,6,0,6
Deonsha,F,100,6,0,6
Deonshay,F,100,6,0,6
Deontee,M,100,0,6,6
Depriest,M,100,0,6,6
Dequentin,M,100,0,6,6
Derekia,F,100,6,0,6
Derf,M,100,0,6,6
Derike,M,100,0,6,6
Derlene,F,100,6,0,6
Deronne,M,100,0,6,6
Derontae,M,100,0,6,6
Derriyah,F,100,6,0,6
Derward,M,100,0,6,6
Desery,F,100,6,0,6
Deshanay,F,100,6,0,6
Deshard,M,100,0,6,6
Deshaud,M,100,0,6,6
Deshaunta,F,100,6,0,6
Deshown,M,100,0,6,6
Desieree,F,100,6,0,6
Desiraee,F,100,6,0,6
Desirrae,F,100,6,0,6
Detrail,M,100,0,6,6
Deundrae,M,100,0,6,6
Deuntray,M,100,0,6,6
Deveraux,M,100,0,6,6
Devereux,M,100,0,6,6
Deverne,M,100,0,6,6
Devola,F,100,6,0,6
Devunta,M,100,0,6,6
Dexx,M,100,0,6,6
Deyadira,F,100,6,0,6
Deybi,M,100,0,6,6
Deycy,F,100,6,0,6
Deza,F,100,6,0,6
Dezerai,F,100,6,0,6
Dezerey,F,100,6,0,6
Dezyah,F,100,6,0,6
Dhanesh,M,100,0,6,6
Dhyaan,M,100,0,6,6
Diadra,F,100,6,0,6
Diangela,F,100,6,0,6
Dierick,M,100,0,6,6
Dijone,F,100,6,0,6
Dijoun,M,100,0,6,6
Dilenny,F,100,6,0,6
Dileydi,F,100,6,0,6
Dililah,F,100,6,0,6
Dilyla,F,100,6,0,6
Dinalee,F,100,6,0,6
Dinasti,F,100,6,0,6
Diondray,M,100,0,6,6
Diop,M,100,0,6,6
Divesh,M,100,0,6,6
Divyne,F,100,6,0,6
Djaun,M,100,0,6,6
Djordje,M,100,0,6,6
Dkwon,M,100,0,6,6
Dlaney,F,100,6,0,6
Dmaria,F,100,6,0,6
Dnajah,F,100,6,0,6
Doctor,M,100,0,6,6
Dolora,F,100,6,0,6
Doloras,F,100,6,0,6
Domeeka,F,100,6,0,6
Domico,M,100,0,6,6
Dominador,M,100,0,6,6
Dominicia,F,100,6,0,6
Domynique,F,100,6,0,6
Donchevell,M,100,0,6,6
Doneal,M,100,0,6,6
Donese,F,100,6,0,6
Donitra,F,100,6,0,6
Donjay,M,100,0,6,6
Donje,M,100,0,6,6
Donnay,F,100,6,0,6
Donnitta,F,100,6,0,6
Dontaz,M,100,0,6,6
Dontrice,F,100,6,0,6
Doralynn,F,100,6,0,6
Dorelia,F,100,6,0,6
Doriel,M,100,0,6,6
Dorinna,F,100,6,0,6
Dorlis,F,100,6,0,6
Dorthie,F,100,6,0,6
Dorthula,F,100,6,0,6
Douachee,F,100,6,0,6
Dovan,M,100,0,6,6
Dovion,F,100,6,0,6
Draedon,M,100,0,6,6
Draevyn,M,100,0,6,6
Draidyn,M,100,0,6,6
Drakar,M,100,0,6,6
Drashti,F,100,6,0,6
Drayten,M,100,0,6,6
Dreema,F,100,6,0,6
Drenisha,F,100,6,0,6
Drevonn,M,100,0,6,6
Drexal,M,100,0,6,6
Dreydin,M,100,0,6,6
Driggs,M,100,0,6,6
Dristy,F,100,6,0,6
Drucie,F,100,6,0,6
Duffie,M,100,0,6,6
Durane,M,100,0,6,6
Duuana,F,100,6,0,6
Duward,M,100,0,6,6
Dward,M,100,0,6,6
Dwendolyn,F,100,6,0,6
Dyce,M,100,0,6,6
Dyego,M,100,0,6,6
Dyllyn,M,100,0,6,6
Dynelle,F,100,6,0,6
Dysha,F,100,6,0,6
Dysheka,F,100,6,0,6
Dywanna,F,100,6,0,6
Dzion,M,100,0,6,6
Dzuy,M,100,0,6,6
Eadon,M,100,0,6,6
Earland,M,100,0,6,6
Earlina,F,100,6,0,6
Eathel,F,100,6,0,6
Eavie,F,100,6,0,6
Ebere,F,100,6,0,6
Edberg,M,100,0,6,6
Eddis,M,100,0,6,6
Edgerin,M,100,0,6,6
Edguin,M,100,0,6,6
Edmilson,M,100,0,6,6
Ednesha,F,100,6,0,6
Edrianna,F,100,6,0,6
Edurdo,M,100,0,6,6
Eduviges,F,100,6,0,6
Edwad,M,100,0,6,6
Edwardjames,M,100,0,6,6
Eelyn,F,100,6,0,6
Eeman,F,100,6,0,6
Efrosini,F,100,6,0,6
Egla,F,100,6,0,6
Eichael,M,100,0,6,6
Eidy,F,100,6,0,6
Eilean,F,100,6,0,6
Eilin,F,100,6,0,6
Eillen,F,100,6,0,6
Eilynn,F,100,6,0,6
Eimaj,M,100,0,6,6
Einin,F,100,6,0,6
Eino,M,100,0,6,6
Ekaansh,M,100,0,6,6
Elaisa,F,100,6,0,6
Elajuwon,M,100,0,6,6
Eldo,M,100,0,6,6
Elec,M,100,0,6,6
Eleeza,F,100,6,0,6
Elefterios,M,100,0,6,6
Eleisa,F,100,6,0,6
Elenis,F,100,6,0,6
Elided,F,100,6,0,6
Elieen,F,100,6,0,6
Elijahpaul,M,100,0,6,6
Elijahwan,M,100,0,6,6
Elik,M,100,0,6,6
Elissabeth,F,100,6,0,6
Elix,M,100,0,6,6
Eliyjah,M,100,0,6,6
Elizaida,F,100,6,0,6
Elizama,F,100,6,0,6
Elleona,F,100,6,0,6
Ellierose,F,100,6,0,6
Ellynor,F,100,6,0,6
Elnaz,F,100,6,0,6
Elrod,M,100,0,6,6
Elshaddai,M,100,0,6,6
Elveta,F,100,6,0,6
Elviz,M,100,0,6,6
Elvyn,M,100,0,6,6
Elyane,F,100,6,0,6
Elyis,M,100,0,6,6
Elynne,F,100,6,0,6
Emalene,F,100,6,0,6
Emalynne,F,100,6,0,6
Emariya,F,100,6,0,6
Emarosa,F,100,6,0,6
Emarri,M,100,0,6,6
Embra,F,100,6,0,6
Embri,F,100,6,0,6
Emele,F,100,6,0,6
Emeliah,F,100,6,0,6
Emellia,F,100,6,0,6
Emerii,F,100,6,0,6
Emerlynn,F,100,6,0,6
Emeth,M,100,0,6,6
Emisha,F,100,6,0,6
Emmalani,F,100,6,0,6
Emmalisa,F,100,6,0,6
Emmalouise,F,100,6,0,6
Emmanouel,M,100,0,6,6
Emmielou,F,100,6,0,6
Emoney,F,100,6,0,6
Empris,F,100,6,0,6
Emyleigh,F,100,6,0,6
Emzie,M,100,0,6,6
Enam,M,100,0,6,6
Enchante,F,100,6,0,6
Endri,M,100,0,6,6
Enely,F,100,6,0,6
Enfinity,F,100,6,0,6
Enger,F,100,6,0,6
Enilda,F,100,6,0,6
Envyi,F,100,6,0,6
Enzlee,F,100,6,0,6
Enzlie,F,100,6,0,6
Enzzo,M,100,0,6,6
Ephratah,F,100,6,0,6
Eraldo,M,100,0,6,6
Ercel,M,100,0,6,6
Erec,M,100,0,6,6
Ereny,F,100,6,0,6
Erfan,M,100,0,6,6
Eriksen,M,100,0,6,6
Erinique,F,100,6,0,6
Erka,F,100,6,0,6
Ernice,F,100,6,0,6
Erny,M,100,0,6,6
Eroz,M,100,0,6,6
Erran,M,100,0,6,6
Ery,M,100,0,6,6
Eryonna,F,100,6,0,6
Esean,M,100,0,6,6
Esmerlda,F,100,6,0,6
Esquiel,M,100,0,6,6
Esterlene,F,100,6,0,6
Estibaliz,F,100,6,0,6
Etasha,F,100,6,0,6
Ethanandrew,M,100,0,6,6
Ethanpaul,M,100,0,6,6
Euphoria,F,100,6,0,6
Eurijah,M,100,0,6,6
Eury,M,100,0,6,6
Evamae,F,100,6,0,6
Evay,M,100,0,6,6
Evenny,F,100,6,0,6
Evina,F,100,6,0,6
Evonia,F,100,6,0,6
Exa,F,100,6,0,6
Exael,M,100,0,6,6
Eya,F,100,6,0,6
Eymy,F,100,6,0,6
Ezaan,M,100,0,6,6
Ezara,F,100,6,0,6
Eze,M,100,0,6,6
Ezekias,M,100,0,6,6
Ezmie,F,100,6,0,6
Faaizah,F,100,6,0,6
Faaz,M,100,0,6,6
Fabius,M,100,0,6,6
Fachon,F,100,6,0,6
Fadila,F,100,6,0,6
Fahtima,F,100,6,0,6
Faiha,F,100,6,0,6
Faira,F,100,6,0,6
Fairah,F,100,6,0,6
Falone,F,100,6,0,6
Falysha,F,100,6,0,6
Farai,M,100,0,6,6
Farjana,F,100,6,0,6
Farwa,F,100,6,0,6
Fateha,F,100,6,0,6
Fawzia,F,100,6,0,6
Faya,F,100,6,0,6
Febra,F,100,6,0,6
Fedaa,F,100,6,0,6
Feffrey,M,100,0,6,6
Felando,M,100,0,6,6
Felena,F,100,6,0,6
Feliscia,F,100,6,0,6
Felizia,F,100,6,0,6
Fenwick,M,100,0,6,6
Fernell,M,100,0,6,6
Ferrie,F,100,6,0,6
Fidelio,M,100,0,6,6
Fidensio,M,100,0,6,6
Fielder,M,100,0,6,6
Fiesta,F,100,6,0,6
Fiffany,F,100,6,0,6
Filippos,M,100,0,6,6
Fillmore,M,100,0,6,6
Finau,M,100,0,6,6
Fitzwilliam,M,100,0,6,6
Florentine,F,100,6,0,6
Florenzo,M,100,0,6,6
Florin,M,100,0,6,6
Foley,M,100,0,6,6
Fraak,M,100,0,6,6
Francelle,F,100,6,0,6
Franchezca,F,100,6,0,6
Francise,F,100,6,0,6
Francita,F,100,6,0,6
Frankel,M,100,0,6,6
Fredasia,F,100,6,0,6
Fredreka,F,100,6,0,6
Freyah,F,100,6,0,6
Frosty,M,100,0,6,6
Froy,M,100,0,6,6
Funda,F,100,6,0,6
Furlon,M,100,0,6,6
Fushia,F,100,6,0,6
Fynnlee,F,100,6,0,6
Gabiela,F,100,6,0,6
Gabrielalexande,M,100,0,6,6
Gaibriel,M,100,0,6,6
Galaxie,F,100,6,0,6
Gamari,M,100,0,6,6
Gania,F,100,6,0,6
Garbielle,F,100,6,0,6
Garlund,M,100,0,6,6
Garlyn,M,100,0,6,6
Garrey,M,100,0,6,6
Gaviota,F,100,6,0,6
Gavvin,M,100,0,6,6
Gayge,M,100,0,6,6
Gaylynne,F,100,6,0,6
Gearlene,F,100,6,0,6
Geffory,M,100,0,6,6
Gelisha,F,100,6,0,6
Gemarion,M,100,0,6,6
Gemise,F,100,6,0,6
Gemmalynn,F,100,6,0,6
Geneane,F,100,6,0,6
Geneiveve,F,100,6,0,6
Genghis,M,100,0,6,6
Genisus,F,100,6,0,6
Genisys,F,100,6,0,6
Gennavive,F,100,6,0,6
Gennelle,F,100,6,0,6
Gennia,F,100,6,0,6
Geoffory,M,100,0,6,6
Geontae,M,100,0,6,6
Georgeanthony,M,100,0,6,6
Gerelene,F,100,6,0,6
Gericho,M,100,0,6,6
Germon,M,100,0,6,6
Geroldine,F,100,6,0,6
Gersain,M,100,0,6,6
Gervais,M,100,0,6,6
Gesele,F,100,6,0,6
Gesell,F,100,6,0,6
Ghaleb,M,100,0,6,6
Gibelly,F,100,6,0,6
Gidgette,F,100,6,0,6
Gieselle,F,100,6,0,6
Ginaya,F,100,6,0,6
Ginine,F,100,6,0,6
Ginneh,F,100,6,0,6
Ginno,M,100,0,6,6
Giovanii,M,100,0,6,6
Giovannah,F,100,6,0,6
Gisette,F,100,6,0,6
Glenesha,F,100,6,0,6
Glenton,M,100,0,6,6
Glenward,M,100,0,6,6
Glorian,F,100,6,0,6
Gloryvee,F,100,6,0,6
Glyniss,F,100,6,0,6
Godwill,M,100,0,6,6
Gogi,F,100,6,0,6
Gordean,F,100,6,0,6
Gorgonio,M,100,0,6,6
Govany,M,100,0,6,6
Graecie,F,100,6,0,6
Grahame,M,100,0,6,6
Graidys,F,100,6,0,6
Granderson,M,100,0,6,6
Granvil,M,100,0,6,6
Gratia,F,100,6,0,6
Graydin,M,100,0,6,6
Greatness,M,100,0,6,6
Grenisha,F,100,6,0,6
Gresa,F,100,6,0,6
Gretha,F,100,6,0,6
Greycin,M,100,0,6,6
Greys,F,100,6,0,6
Gricell,F,100,6,0,6
Guan,M,100,0,6,6
Gwanda,F,100,6,0,6
Gwendalina,F,100,6,0,6
Gwendola,F,100,6,0,6
Gwenne,F,100,6,0,6
Gyda,F,100,6,0,6
Haajar,F,100,6,0,6
Haamid,M,100,0,6,6
Haaniya,F,100,6,0,6
Haashir,M,100,0,6,6
Habeba,F,100,6,0,6
Habraham,M,100,0,6,6
Hadari,M,100,0,6,6
Haddley,F,100,6,0,6
Hadin,M,100,0,6,6
Hadlynn,F,100,6,0,6
Haegan,M,100,0,6,6
Haether,F,100,6,0,6
Hafid,M,100,0,6,6
Hahna,F,100,6,0,6
Haileyrose,F,100,6,0,6
Haislee,F,100,6,0,6
Haizen,M,100,0,6,6
Hajari,M,100,0,6,6
Hajj,M,100,0,6,6
Hakeema,F,100,6,0,6
Haliana,F,100,6,0,6
Halid,M,100,0,6,6
Hamim,M,100,0,6,6
Hammie,M,100,0,6,6
Haneefa,F,100,6,0,6
Haniff,M,100,0,6,6
Hannahjo,F,100,6,0,6
Hannie,F,100,6,0,6
Hanoch,M,100,0,6,6
Hansell,M,100,0,6,6
Haoran,M,100,0,6,6
Haowen,M,100,0,6,6
Harbert,M,100,0,6,6
Harbin,M,100,0,6,6
Harfateh,M,100,0,6,6
Harkeem,M,100,0,6,6
Haroldine,F,100,6,0,6
Harshiv,M,100,0,6,6
Hasly,F,100,6,0,6
Haslyn,F,100,6,0,6
Hassain,M,100,0,6,6
Hatina,F,100,6,0,6
Havick,M,100,0,6,6
Hawwaa,F,100,6,0,6
Haydi,F,100,6,0,6
Hayne,M,100,0,6,6
Haythem,M,100,0,6,6
Hazeleigh,F,100,6,0,6
Hazin,M,100,0,6,6
Healani,F,100,6,0,6
Heathre,F,100,6,0,6
Heavenlyn,F,100,6,0,6
Heilly,F,100,6,0,6
Hein,M,100,0,6,6
Heiner,M,100,0,6,6
Heitor,M,100,0,6,6
Hemerson,M,100,0,6,6
Henach,M,100,0,6,6
Hennley,F,100,6,0,6
Henzley,F,100,6,0,6
Herlane,F,100,6,0,6
Hermanda,F,100,6,0,6
Hewey,M,100,0,6,6
Hezekiel,M,100,0,6,6
Hilla,F,100,6,0,6
Hinaea,F,100,6,0,6
Hinatea,F,100,6,0,6
Hinsley,F,100,6,0,6
Hirvin,M,100,0,6,6
Hitney,F,100,6,0,6
Hixon,M,100,0,6,6
Hjordis,F,100,6,0,6
Hobbs,M,100,0,6,6
Holter,M,100,0,6,6
Hommy,M,100,0,6,6
Horrace,M,100,0,6,6
Hoshi,F,100,6,0,6
Housten,M,100,0,6,6
Hrehaan,M,100,0,6,6
Hrishik,M,100,0,6,6
Huberto,M,100,0,6,6
Huckston,M,100,0,6,6
Humphery,M,100,0,6,6
Hunnie,F,100,6,0,6
Hurman,M,100,0,6,6
Hussin,M,100,0,6,6
Iahn,M,100,0,6,6
Ianthia,F,100,6,0,6
Ianto,M,100,0,6,6
Icsel,F,100,6,0,6
Idahlia,F,100,6,0,6
Idette,F,100,6,0,6
Idus,M,100,0,6,6
Iian,M,100,0,6,6
Iiana,F,100,6,0,6
Ilenne,F,100,6,0,6
Ilette,F,100,6,0,6
Ilga,F,100,6,0,6
Ilyne,F,100,6,0,6
Imajae,F,100,6,0,6
Imiya,F,100,6,0,6
Inah,F,100,6,0,6
Inci,F,100,6,0,6
Indsay,F,100,6,0,6
Ingmar,M,100,0,6,6
Ingrit,F,100,6,0,6
Innaya,F,100,6,0,6
Innessa,F,100,6,0,6
Insley,F,100,6,0,6
Ioma,F,100,6,0,6
Irayda,F,100,6,0,6
Ireion,F,100,6,0,6
Ireyanna,F,100,6,0,6
Irha,F,100,6,0,6
Irmak,F,100,6,0,6
Iroha,F,100,6,0,6
Irvina,F,100,6,0,6
Isaam,M,100,0,6,6
Isaaq,M,100,0,6,6
Isaihas,M,100,0,6,6
Isamel,M,100,0,6,6
Isarely,F,100,6,0,6
Isavella,F,100,6,0,6
Isayiah,M,100,0,6,6
Ishaal,F,100,6,0,6
Ishaanvi,F,100,6,0,6
Ishanae,F,100,6,0,6
Ishayu,M,100,0,6,6
Ishiah,M,100,0,6,6
Ishman,M,100,0,6,6
Ishna,F,100,6,0,6
Isiash,M,100,0,6,6
Isibella,F,100,6,0,6
Islah,F,100,6,0,6
Isoke,F,100,6,0,6
Issei,M,100,0,6,6
Itianna,F,100,6,0,6
Itisha,F,100,6,0,6
Itzcoatl,M,100,0,6,6
Itzelt,F,100,6,0,6
Itziar,M,100,0,6,6
Ivanya,F,100,6,0,6
Ivaya,F,100,6,0,6
Ive,F,100,6,0,6
Ixareli,F,100,6,0,6
Iyasia,F,100,6,0,6
Iyhana,F,100,6,0,6
Iyleen,F,100,6,0,6
Izaeh,M,100,0,6,6
Izaic,M,100,0,6,6
Jaali,M,100,0,6,6
Jaasritha,F,100,6,0,6
Jabob,M,100,0,6,6
Jabon,M,100,0,6,6
Jabraun,M,100,0,6,6
Jabrayah,F,100,6,0,6
Jacare,M,100,0,6,6
Jacarey,M,100,0,6,6
Jacella,F,100,6,0,6
Jacetin,M,100,0,6,6
Jacgueline,F,100,6,0,6
Jache,F,100,6,0,6
Jackia,F,100,6,0,6
Jackthomas,M,100,0,6,6
Jacoblee,M,100,0,6,6
Jacobrobert,M,100,0,6,6
Jacoury,M,100,0,6,6
Jacovian,M,100,0,6,6
Jacquee,F,100,6,0,6
Jacquleen,F,100,6,0,6
Jacqulina,F,100,6,0,6
Jacyion,M,100,0,6,6
Jadalys,F,100,6,0,6
Jadaria,F,100,6,0,6
Jadenne,F,100,6,0,6
Jadison,M,100,0,6,6
Jadius,M,100,0,6,6
Jaelia,F,100,6,0,6
Jaeliyah,F,100,6,0,6
Jaenelle,F,100,6,0,6
Jaeona,F,100,6,0,6
Jaesa,F,100,6,0,6
Jaevien,M,100,0,6,6
Jagjot,M,100,0,6,6
Jagroop,M,100,0,6,6
Jahai,M,100,0,6,6
Jahcure,M,100,0,6,6
Jahdon,M,100,0,6,6
Jahiel,M,100,0,6,6
Jahkhi,M,100,0,6,6
Jahlissa,F,100,6,0,6
Jahnise,F,100,6,0,6
Jahseir,M,100,0,6,6
Jahsire,M,100,0,6,6
Jahvaughn,M,100,0,6,6
Jahvel,M,100,0,6,6
Jaiceyon,M,100,0,6,6
Jaiiden,M,100,0,6,6
Jaik,M,100,0,6,6
Jailinne,F,100,6,0,6
Jailiyah,F,100,6,0,6
Jaimielee,F,100,6,0,6
Jaimyn,M,100,0,6,6
Jairee,M,100,0,6,6
Jaisal,M,100,0,6,6
Jaisiah,M,100,0,6,6
Jaisy,F,100,6,0,6
Jaiwan,M,100,0,6,6
Jakab,M,100,0,6,6
Jakalia,F,100,6,0,6
Jakanye,M,100,0,6,6
Jakarah,F,100,6,0,6
Jakasia,F,100,6,0,6
Jakauri,M,100,0,6,6
Jakayia,F,100,6,0,6
Jakeveon,M,100,0,6,6
Jakiaya,F,100,6,0,6
Jakier,M,100,0,6,6
Jakii,M,100,0,6,6
Jakiyra,F,100,6,0,6
Jakyran,M,100,0,6,6
Jakyrian,M,100,0,6,6
Jalanni,F,100,6,0,6
Jaliea,F,100,6,0,6
Jaliek,M,100,0,6,6
Jaliene,F,100,6,0,6
Jalisse,F,100,6,0,6
Jalob,M,100,0,6,6
Jalyza,F,100,6,0,6
Jamalyn,F,100,6,0,6
Jamarae,M,100,0,6,6
Jamareo,M,100,0,6,6
Jamariae,M,100,0,6,6
Jamariea,M,100,0,6,6
Jamay,F,100,6,0,6
Jamayiah,F,100,6,0,6
Jamescia,F,100,6,0,6
Jameswilliam,M,100,0,6,6
Jamiann,F,100,6,0,6
Jamianne,F,100,6,0,6
Jamikel,M,100,0,6,6
Jamilliah,F,100,6,0,6
Jamily,F,100,6,0,6
Jamiqua,F,100,6,0,6
Jamiron,M,100,0,6,6
Jamiylah,F,100,6,0,6
Jamontay,M,100,0,6,6
Jamyleth,F,100,6,0,6
Jamyn,M,100,0,6,6
Jamyrie,F,100,6,0,6
Janaan,F,100,6,0,6
Janada,F,100,6,0,6
Janadia,F,100,6,0,6
Janaijah,F,100,6,0,6
Janaira,F,100,6,0,6
Janaliz,F,100,6,0,6
Janayja,F,100,6,0,6
Janeiah,F,100,6,0,6
Janeily,F,100,6,0,6
Janeiro,M,100,0,6,6
Janeiya,F,100,6,0,6
Janien,F,100,6,0,6
Janiera,F,100,6,0,6
Janihya,F,100,6,0,6
Janilya,F,100,6,0,6
Janitra,F,100,6,0,6
Janitta,F,100,6,0,6
Janiyan,F,100,6,0,6
Janmarcos,M,100,0,6,6
Jannike,F,100,6,0,6
Janyi,F,100,6,0,6
Janyl,F,100,6,0,6
Jaqaun,M,100,0,6,6
Jaquaisha,F,100,6,0,6
Jaquandre,M,100,0,6,6
Jaqueal,M,100,0,6,6
Jaquelinee,F,100,6,0,6
Jaquice,F,100,6,0,6
Jaquoya,F,100,6,0,6
Jard,M,100,0,6,6
Jareka,F,100,6,0,6
Jario,M,100,0,6,6
Jarisa,F,100,6,0,6
Jaromir,M,100,0,6,6
Jasahn,M,100,0,6,6
Jasear,M,100,0,6,6
Jaselin,F,100,6,0,6
Jashala,F,100,6,0,6
Jashana,F,100,6,0,6
Jashante,F,100,6,0,6
Jashara,F,100,6,0,6
Jashelle,F,100,6,0,6
Jasian,M,100,0,6,6
Jasicianna,F,100,6,0,6
Jasielle,F,100,6,0,6
Jasjeet,M,100,0,6,6
Jasmany,M,100,0,6,6
Jasmary,F,100,6,0,6
Jasmely,F,100,6,0,6
Jasonlee,M,100,0,6,6
Jasonn,M,100,0,6,6
Jassmen,F,100,6,0,6
Jauquan,M,100,0,6,6
Javare,M,100,0,6,6
Javarron,M,100,0,6,6
Javaunte,M,100,0,6,6
Javondre,M,100,0,6,6
Jawhar,M,100,0,6,6
Jawwaad,M,100,0,6,6
Jaxun,M,100,0,6,6
Jayace,M,100,0,6,6
Jayandre,M,100,0,6,6
Jayanti,F,100,6,0,6
Jaydhen,M,100,0,6,6
Jayela,F,100,6,0,6
Jayiah,F,100,6,0,6
Jaylaah,F,100,6,0,6
Jaylamarie,F,100,6,0,6
Jaylaun,M,100,0,6,6
Jaylem,M,100,0,6,6
Jayllen,M,100,0,6,6
Jayman,M,100,0,6,6
Jaymichael,M,100,0,6,6
Jaymisha,F,100,6,0,6
Jayneen,F,100,6,0,6
Jaynisha,F,100,6,0,6
Jayonah,F,100,6,0,6
Jaysea,F,100,6,0,6
Jaysian,M,100,0,6,6
Jaythian,M,100,0,6,6
Jayvean,M,100,0,6,6
Jayvia,F,100,6,0,6
Jazay,F,100,6,0,6
Jazlean,F,100,6,0,6
Jazlina,F,100,6,0,6
Jazymne,F,100,6,0,6
Jazzabelle,F,100,6,0,6
Jazziah,F,100,6,0,6
Jazzmun,F,100,6,0,6
Jdin,M,100,0,6,6
Jeanasia,F,100,6,0,6
Jeanchristophe,M,100,0,6,6
Jeanlucas,M,100,0,6,6
Jeckson,M,100,0,6,6
Jedric,M,100,0,6,6
Jefferi,M,100,0,6,6
Jehilyn,F,100,6,0,6
Jeiny,F,100,6,0,6
Jeliana,F,100,6,0,6
Jelysa,F,100,6,0,6
Jemarr,M,100,0,6,6
Jemeria,F,100,6,0,6
Jemilla,F,100,6,0,6
Jemira,F,100,6,0,6
Jemmie,M,100,0,6,6
Jenacia,F,100,6,0,6
Jenaka,F,100,6,0,6
Jenalea,F,100,6,0,6
Jenali,F,100,6,0,6
Jenesha,F,100,6,0,6
Jenett,F,100,6,0,6
Jenicia,F,100,6,0,6
Jenith,F,100,6,0,6
Jennedy,F,100,6,0,6
Jenuel,M,100,0,6,6
Jenysis,F,100,6,0,6
Jenzel,M,100,0,6,6
Jeopardy,F,100,6,0,6
Jequarius,M,100,0,6,6
Jeraldyn,F,100,6,0,6
Jeramya,M,100,0,6,6
Jereck,M,100,0,6,6
Jerelin,F,100,6,0,6
Jerely,F,100,6,0,6
Jeremial,M,100,0,6,6
Jeremiya,M,100,0,6,6
Jereny,M,100,0,6,6
Jereomy,M,100,0,6,6
Jeria,F,100,6,0,6
Jeriana,F,100,6,0,6
Jerianna,F,100,6,0,6
Jermanii,F,100,6,0,6
Jermaria,F,100,6,0,6
Jermih,M,100,0,6,6
Jermol,M,100,0,6,6
Jeroen,M,100,0,6,6
Jerrail,M,100,0,6,6
Jerriana,F,100,6,0,6
Jerricca,F,100,6,0,6
Jerricha,F,100,6,0,6
Jerrisa,F,100,6,0,6
Jerrita,F,100,6,0,6
Jerrome,M,100,0,6,6
Jervin,M,100,0,6,6
Jerykah,F,100,6,0,6
Jerymiah,M,100,0,6,6
Jerzei,F,100,6,0,6
Jesai,M,100,0,6,6
Jesel,F,100,6,0,6
Jessiel,M,100,0,6,6
Jessiyah,F,100,6,0,6
Jesusenrique,M,100,0,6,6
Jethroe,M,100,0,6,6
Jetton,M,100,0,6,6
Jevonn,M,100,0,6,6
Jewellia,F,100,6,0,6
Jewlius,M,100,0,6,6
Jeyko,M,100,0,6,6
Jeylon,M,100,0,6,6
Jeyly,F,100,6,0,6
Jezenia,F,100,6,0,6
Jhala,F,100,6,0,6
Jhamarion,M,100,0,6,6
Jhamya,F,100,6,0,6
Jhenae,F,100,6,0,6
Jhoshua,M,100,0,6,6
Jiaming,M,100,0,6,6
Jiaxin,F,100,6,0,6
Jibreal,M,100,0,6,6
Jilla,F,100,6,0,6
Jima,F,100,6,0,6
Jimbob,M,100,0,6,6
Jimell,M,100,0,6,6
Jio,M,100,0,6,6
Jiron,M,100,0,6,6
Jiyaan,M,100,0,6,6
Jiyu,F,100,6,0,6
Jjames,M,100,0,6,6
Jkiyah,F,100,6,0,6
Jkyla,F,100,6,0,6
Jlan,M,100,0,6,6
Jlayah,F,100,6,0,6
Jlyssa,F,100,6,0,6
Jmir,M,100,0,6,6
Joacim,M,100,0,6,6
Joahna,F,100,6,0,6
Joandaly,F,100,6,0,6
Joandri,M,100,0,6,6
Joaneliz,F,100,6,0,6
Joaogabriel,M,100,0,6,6
Joban,M,100,0,6,6
Jobyna,F,100,6,0,6
Jocelinne,F,100,6,0,6
Jocene,F,100,6,0,6
Jochelle,F,100,6,0,6
Jociah,M,100,0,6,6
Joeana,F,100,6,0,6
Joedon,M,100,0,6,6
Joesiyah,M,100,0,6,6
Joeylynn,F,100,6,0,6
Johnaaron,M,100,0,6,6
Johnan,M,100,0,6,6
Johniesha,F,100,6,0,6
Johntel,M,100,0,6,6
Johntell,M,100,0,6,6
Johnya,F,100,6,0,6
Johnyla,F,100,6,0,6
Joielle,F,100,6,0,6
Joise,F,100,6,0,6
Jolenna,F,100,6,0,6
Jolesa,F,100,6,0,6
Joletha,F,100,6,0,6
Jomarcus,M,100,0,6,6
Jonael,M,100,0,6,6
Jonam,M,100,0,6,6
Jonce,M,100,0,6,6
Jonethen,M,100,0,6,6
Jonnica,F,100,6,0,6
Jonryan,M,100,0,6,6
Jonteria,F,100,6,0,6
Jophiel,M,100,0,6,6
Joplynn,F,100,6,0,6
Jordai,F,100,6,0,6
Jordinn,F,100,6,0,6
Jorgeantonio,M,100,0,6,6
Jorgi,F,100,6,0,6
Jorn,M,100,0,6,6
Jorren,M,100,0,6,6
Josalyne,F,100,6,0,6
Josaphina,F,100,6,0,6
Joseluiz,M,100,0,6,6
Josericardo,M,100,0,6,6
Josheua,M,100,0,6,6
Joshitha,F,100,6,0,6
Joshuaanthony,M,100,0,6,6
Josje,M,100,0,6,6
Joslene,F,100,6,0,6
Josmine,F,100,6,0,6
Jostein,M,100,0,6,6
Jotavious,M,100,0,6,6
Jouanna,F,100,6,0,6
Jourdynn,F,100,6,0,6
Journeii,F,100,6,0,6
Jovell,M,100,0,6,6
Joyetta,F,100,6,0,6
Jsamine,F,100,6,0,6
Juaniqua,F,100,6,0,6
Juden,M,100,0,6,6
Judette,F,100,6,0,6
Judiel,M,100,0,6,6
Judilyn,F,100,6,0,6
Juels,M,100,0,6,6
Julein,M,100,0,6,6
Juliean,M,100,0,6,6
Juliemarie,F,100,6,0,6
Julienn,M,100,0,6,6
Jumah,M,100,0,6,6
Junpei,M,100,0,6,6
Junyi,M,100,0,6,6
Jurate,F,100,6,0,6
Jussica,F,100,6,0,6
Justain,M,100,0,6,6
Justic,M,100,0,6,6
Jusus,M,100,0,6,6
Jvonne,M,100,0,6,6
Jwyanza,M,100,0,6,6
Jysaiah,M,100,0,6,6
Jzabehl,F,100,6,0,6
Jziah,M,100,0,6,6
Kaayla,F,100,6,0,6
Kaben,M,100,0,6,6
Kacei,F,100,6,0,6
Kachet,F,100,6,0,6
Kadetra,F,100,6,0,6
Kadis,M,100,0,6,6
Kaebri,F,100,6,0,6
Kaelyb,M,100,0,6,6
Kaeon,M,100,0,6,6
Kahdeem,M,100,0,6,6
Kahir,M,100,0,6,6
Kahmal,M,100,0,6,6
Kahnye,M,100,0,6,6
Kaiann,F,100,6,0,6
Kaibren,M,100,0,6,6
Kaicey,F,100,6,0,6
Kaidince,F,100,6,0,6
Kaielle,F,100,6,0,6
Kaihan,M,100,0,6,6
Kaiicen,M,100,0,6,6
Kaiiden,M,100,0,6,6
Kailanny,F,100,6,0,6
Kailianna,F,100,6,0,6
Kaille,F,100,6,0,6
Kaimarie,F,100,6,0,6
Kainyn,M,100,0,6,6
Kaisean,M,100,0,6,6
Kaishaun,M,100,0,6,6
Kaishonta,F,100,6,0,6
Kaitee,F,100,6,0,6
Kajetan,M,100,0,6,6
Kajira,F,100,6,0,6
Kalaiya,F,100,6,0,6
Kalajah,F,100,6,0,6
Kalayia,F,100,6,0,6
Kaleana,F,100,6,0,6
Kaletha,F,100,6,0,6
Kaliber,M,100,0,6,6
Kaliee,F,100,6,0,6
Kalisse,F,100,6,0,6
Kaliym,M,100,0,6,6
Kalliann,F,100,6,0,6
Kallina,F,100,6,0,6
Kalyanna,F,100,6,0,6
Kalyl,M,100,0,6,6
Kamaliyah,F,100,6,0,6
Kamarcus,M,100,0,6,6
Kamaura,F,100,6,0,6
Kamellia,F,100,6,0,6
Kameriah,F,100,6,0,6
Kamien,M,100,0,6,6
Kamilyah,F,100,6,0,6
Kamishia,F,100,6,0,6
Kamiyha,F,100,6,0,6
Kamiyra,F,100,6,0,6
Kamsi,F,100,6,0,6
Kamuri,M,100,0,6,6
Kamyree,F,100,6,0,6
Kamyrie,F,100,6,0,6
Kan,M,100,0,6,6
Kanalu,M,100,0,6,6
Kandence,F,100,6,0,6
Kanea,F,100,6,0,6
Kanessha,F,100,6,0,6
Kanica,F,100,6,0,6
Kanisa,F,100,6,0,6
Kanyjah,F,100,6,0,6
Kar,F,100,6,0,6
Karalea,F,100,6,0,6
Karde,M,100,0,6,6
Karizmah,F,100,6,0,6
Karolann,F,100,6,0,6
Karras,M,100,0,6,6
Karre,F,100,6,0,6
Kartar,M,100,0,6,6
Kasadee,F,100,6,0,6
Kashaundra,F,100,6,0,6
Kashdyn,M,100,0,6,6
Kashmiere,F,100,6,0,6
Kashona,F,100,6,0,6
Kasmin,F,100,6,0,6
Kataleiya,F,100,6,0,6
Katalya,F,100,6,0,6
Katence,F,100,6,0,6
Kathen,M,100,0,6,6
Katherline,F,100,6,0,6
Kathleenmary,F,100,6,0,6
Kathyanne,F,100,6,0,6
Kathyrine,F,100,6,0,6
Katravia,F,100,6,0,6
Kaustav,M,100,0,6,6
Kavalli,M,100,0,6,6
Kavonda,F,100,6,0,6
Kawsar,F,100,6,0,6
Kawuan,M,100,0,6,6
Kayahna,F,100,6,0,6
Kaydian,M,100,0,6,6
Kaydrie,F,100,6,0,6
Kayedon,M,100,0,6,6
Kayisha,F,100,6,0,6
Kayky,M,100,0,6,6
Kaylaanne,F,100,6,0,6
Kaylae,F,100,6,0,6
Kaylese,F,100,6,0,6
Kaylisha,F,100,6,0,6
Kayllie,F,100,6,0,6
Kaymani,F,100,6,0,6
Kaymie,F,100,6,0,6
Keacha,F,100,6,0,6
Keadon,M,100,0,6,6
Keaundrea,F,100,6,0,6
Keauri,F,100,6,0,6
Kebria,F,100,6,0,6
Kechelle,F,100,6,0,6
Kedarious,M,100,0,6,6
Kededra,F,100,6,0,6
Keegun,M,100,0,6,6
Keemya,F,100,6,0,6
Keeng,M,100,0,6,6
Keeno,M,100,0,6,6
Keerah,F,100,6,0,6
Keijah,F,100,6,0,6
Keijon,M,100,0,6,6
Keimaya,F,100,6,0,6
Keinya,F,100,6,0,6
Keiralyn,F,100,6,0,6
Keiten,M,100,0,6,6
Keiundra,F,100,6,0,6
Keiveon,M,100,0,6,6
Keiyara,F,100,6,0,6
Kelaine,F,100,6,0,6
Kelechukwu,M,100,0,6,6
Kelei,F,100,6,0,6
Kelela,F,100,6,0,6
Kelianne,F,100,6,0,6
Kelland,M,100,0,6,6
Kelline,F,100,6,0,6
Keltsey,F,100,6,0,6
Kelvan,M,100,0,6,6
Kemariyah,F,100,6,0,6
Kemberli,F,100,6,0,6
Keme,F,100,6,0,6
Kenari,F,100,6,0,6
Kender,M,100,0,6,6
Kendin,M,100,0,6,6
Kendo,M,100,0,6,6
Kendrika,F,100,6,0,6
Keneasha,F,100,6,0,6
Keneka,F,100,6,0,6
Kenesia,F,100,6,0,6
Kenidie,F,100,6,0,6
Kenithia,F,100,6,0,6
Kennae,F,100,6,0,6
Kennaya,F,100,6,0,6
Kennecia,F,100,6,0,6
Kennell,M,100,0,6,6
Kennyel,M,100,0,6,6
Kennysha,F,100,6,0,6
Kensha,F,100,6,0,6
Kenshaun,M,100,0,6,6
Kensingtyn,F,100,6,0,6
Kentrina,F,100,6,0,6
Kentyn,M,100,0,6,6
Kenward,M,100,0,6,6
Kenyiah,F,100,6,0,6
Keomi,F,100,6,0,6
Kepa,M,100,0,6,6
Kerea,F,100,6,0,6
Keriah,F,100,6,0,6
Kerick,M,100,0,6,6
Kernis,M,100,0,6,6
Kerric,M,100,0,6,6
Kerrye,F,100,6,0,6
Kersty,F,100,6,0,6
Kerynn,F,100,6,0,6
Kesar,F,100,6,0,6
Kescha,F,100,6,0,6
Keshira,F,100,6,0,6
Kestyn,M,100,0,6,6
Kesuan,M,100,0,6,6
Kethry,F,100,6,0,6
Keton,M,100,0,6,6
Kevaeh,F,100,6,0,6
Kevari,M,100,0,6,6
Kevinjohn,M,100,0,6,6
Kevinkhang,M,100,0,6,6
Keyin,M,100,0,6,6
Keynia,F,100,6,0,6
Keyora,F,100,6,0,6
Keyshona,F,100,6,0,6
Keza,F,100,6,0,6
Khadeisha,F,100,6,0,6
Khaelyn,F,100,6,0,6
Khalayah,F,100,6,0,6
Khaleia,F,100,6,0,6
Khalii,F,100,6,0,6
Khalijah,M,100,0,6,6
Khaliliah,F,100,6,0,6
Khalill,M,100,0,6,6
Khalisah,F,100,6,0,6
Khamare,M,100,0,6,6
Khamyra,F,100,6,0,6
Khansa,F,100,6,0,6
Kharla,F,100,6,0,6
Kharmin,F,100,6,0,6
Khaza,M,100,0,6,6
Kheri,F,100,6,0,6
Khiala,F,100,6,0,6
Khloemarie,F,100,6,0,6
Khloye,F,100,6,0,6
Kholee,F,100,6,0,6
Khyair,M,100,0,6,6
Khysen,M,100,0,6,6
Kialie,F,100,6,0,6
Kialyn,F,100,6,0,6
Kiaran,M,100,0,6,6
Kiayra,F,100,6,0,6
Kidron,M,100,0,6,6
Kieriana,F,100,6,0,6
Kieston,M,100,0,6,6
Kievan,M,100,0,6,6
Kihry,M,100,0,6,6
Kilby,M,100,0,6,6
Kileyann,F,100,6,0,6
Killion,M,100,0,6,6
Kilmer,M,100,0,6,6
Kimako,F,100,6,0,6
Kimberland,F,100,6,0,6
Kimberline,F,100,6,0,6
Kimblyn,F,100,6,0,6
Kimby,F,100,6,0,6
Kimitra,F,100,6,0,6
Kimmori,F,100,6,0,6
Kimyia,F,100,6,0,6
Kindalyn,F,100,6,0,6
Kingcharles,M,100,0,6,6
Kingman,M,100,0,6,6
Kinnith,M,100,0,6,6
Kinsington,F,100,6,0,6
Kinzington,F,100,6,0,6
Kiomy,F,100,6,0,6
Kiotti,M,100,0,6,6
Kirara,F,100,6,0,6
Kirstopher,M,100,0,6,6
Kirthana,F,100,6,0,6
Kirtley,M,100,0,6,6
Kishea,F,100,6,0,6
Kitsia,F,100,6,0,6
Kitzi,F,100,6,0,6
Kivan,M,100,0,6,6
Kiyann,F,100,6,0,6
Kiyarra,F,100,6,0,6
Kiylie,F,100,6,0,6
Kiyora,F,100,6,0,6
Kiyuana,F,100,6,0,6
Klah,F,100,6,0,6
Klairissa,F,100,6,0,6
Klarrissa,F,100,6,0,6
Klisha,F,100,6,0,6
Klowi,F,100,6,0,6
Knia,F,100,6,0,6
Knightly,M,100,0,6,6
Knoxley,M,100,0,6,6
Koalton,M,100,0,6,6
Kojiro,M,100,0,6,6
Koketa,F,100,6,0,6
Koley,F,100,6,0,6
Konar,M,100,0,6,6
Kono,M,100,0,6,6
Konstantino,M,100,0,6,6
Kontar,M,100,0,6,6
Konur,M,100,0,6,6
Kopelynn,F,100,6,0,6
Koralyne,F,100,6,0,6
Korbon,M,100,0,6,6
Korbynn,F,100,6,0,6
Korei,M,100,0,6,6
Koressa,F,100,6,0,6
Korrion,M,100,0,6,6
Korsica,F,100,6,0,6
Kortlan,M,100,0,6,6
Koryne,F,100,6,0,6
Kothan,M,100,0,6,6
Kovu,M,100,0,6,6
Kricia,F,100,6,0,6
Krisana,F,100,6,0,6
Kriscinda,F,100,6,0,6
Krisheena,F,100,6,0,6
Krisina,F,100,6,0,6
Kristamarie,F,100,6,0,6
Kristanne,F,100,6,0,6
Kristhel,F,100,6,0,6
Kristilee,F,100,6,0,6
Kristjana,F,100,6,0,6
Krushi,F,100,6,0,6
Krysha,F,100,6,0,6
Kson,M,100,0,6,6
Ktina,F,100,6,0,6
Kujuan,M,100,0,6,6
Kullin,M,100,0,6,6
Kuntakinte,M,100,0,6,6
Kuyper,M,100,0,6,6
Kyaisha,F,100,6,0,6
Kyajah,F,100,6,0,6
Kyeana,F,100,6,0,6
Kyjaun,M,100,0,6,6
Kyleighann,F,100,6,0,6
Kylierose,F,100,6,0,6
Kymera,F,100,6,0,6
Kymya,F,100,6,0,6
Kynden,M,100,0,6,6
Kynder,F,100,6,0,6
Kyneshia,F,100,6,0,6
Kynidee,F,100,6,0,6
Kynnadee,F,100,6,0,6
Kynndal,F,100,6,0,6
Kynnidi,F,100,6,0,6
Kynnlie,F,100,6,0,6
Kynslea,F,100,6,0,6
Kyohei,M,100,0,6,6
Kyondra,F,100,6,0,6
Kyric,M,100,0,6,6
Kyriee,M,100,0,6,6
Kyzier,M,100,0,6,6
Lacandis,F,100,6,0,6
Lacasta,F,100,6,0,6
Lachan,F,100,6,0,6
Lachaun,F,100,6,0,6
Lachay,F,100,6,0,6
Lachlann,M,100,0,6,6
Lacurtis,M,100,0,6,6
Ladaisia,F,100,6,0,6
Ladazia,F,100,6,0,6
Laderian,M,100,0,6,6
Laderick,M,100,0,6,6
Ladislado,M,100,0,6,6
Laeh,F,100,6,0,6
Laeloni,F,100,6,0,6
Lafiamma,M,100,0,6,6
Lailarose,F,100,6,0,6
Lajoia,F,100,6,0,6
Lakeashia,F,100,6,0,6
Lakelsha,F,100,6,0,6
Laketria,F,100,6,0,6
Lakiara,F,100,6,0,6
Lakieth,M,100,0,6,6
Laking,M,100,0,6,6
Lakissa,F,100,6,0,6
Lakissia,F,100,6,0,6
Lakreisha,F,100,6,0,6
Lakwan,M,100,0,6,6
Lakyria,F,100,6,0,6
Lakyshia,F,100,6,0,6
Laliyah,F,100,6,0,6
Lamaar,M,100,0,6,6
Lamarie,F,100,6,0,6
Lameen,M,100,0,6,6
Lametrice,F,100,6,0,6
Lamondo,M,100,0,6,6
Lamonique,F,100,6,0,6
Lanavia,F,100,6,0,6
Lanazia,F,100,6,0,6
Landell,M,100,0,6,6
Landrick,M,100,0,6,6
Laneita,F,100,6,0,6
Lanicka,F,100,6,0,6
Lanndon,M,100,0,6,6
Lanston,M,100,0,6,6
Laporschia,F,100,6,0,6
Lapriest,M,100,0,6,6
Laqresha,F,100,6,0,6
Laquela,F,100,6,0,6
Laquella,F,100,6,0,6
Larencia,F,100,6,0,6
Lareta,F,100,6,0,6
Larhea,F,100,6,0,6
Lartarsha,F,100,6,0,6
Larvell,M,100,0,6,6
Lasanda,F,100,6,0,6
Lashaon,F,100,6,0,6
Lasharee,F,100,6,0,6
Lasharia,F,100,6,0,6
Lasheen,F,100,6,0,6
Lashenda,F,100,6,0,6
Lashiyah,F,100,6,0,6
Lashounda,F,100,6,0,6
Lasiah,F,100,6,0,6
Lasiyah,F,100,6,0,6
Lasse,M,100,0,6,6
Lastarza,M,100,0,6,6
Lataesha,F,100,6,0,6
Latashi,F,100,6,0,6
Lataska,F,100,6,0,6
Lateafa,F,100,6,0,6
Lateek,M,100,0,6,6
Lateeka,F,100,6,0,6
Lateen,F,100,6,0,6
Latefia,F,100,6,0,6
Laterese,F,100,6,0,6
Latericka,F,100,6,0,6
Latessia,F,100,6,0,6
Lathasha,F,100,6,0,6
Latique,M,100,0,6,6
Lativa,F,100,6,0,6
Latiyah,F,100,6,0,6
Latoscha,F,100,6,0,6
Latoynia,F,100,6,0,6
Latrae,M,100,0,6,6
Latrika,F,100,6,0,6
Latris,F,100,6,0,6
Latwanna,F,100,6,0,6
Latwon,M,100,0,6,6
Lauire,F,100,6,0,6
Lauraelizabeth,F,100,6,0,6
Laurenann,F,100,6,0,6
Laurennicole,F,100,6,0,6
Laurentino,M,100,0,6,6
Laurietta,F,100,6,0,6
Laurnea,F,100,6,0,6
Lavani,F,100,6,0,6
Lavelton,M,100,0,6,6
Laver,M,100,0,6,6
Lavetra,F,100,6,0,6
Lavie,F,100,6,0,6
Lavitta,F,100,6,0,6
Lavonde,F,100,6,0,6
Lavonnie,F,100,6,0,6
Lawarren,M,100,0,6,6
Lawra,F,100,6,0,6
Layahna,F,100,6,0,6
Laykyn,F,100,6,0,6
Laylagrace,F,100,6,0,6
Laylannie,F,100,6,0,6
Laylene,F,100,6,0,6
Lazario,M,100,0,6,6
Lazarion,M,100,0,6,6
Lazariya,F,100,6,0,6
Lb,M,100,0,6,6
Leath,F,100,6,0,6
Leayla,F,100,6,0,6
Lebrea,F,100,6,0,6
Leconte,M,100,0,6,6
Leddi,F,100,6,0,6
Leelou,F,100,6,0,6
Leiliany,F,100,6,0,6
Leiyla,F,100,6,0,6
Lejeune,F,100,6,0,6
Lekevia,F,100,6,0,6
Lekishia,F,100,6,0,6
Lelen,M,100,0,6,6
Lemaj,M,100,0,6,6
Lenalee,F,100,6,0,6
Leneka,F,100,6,0,6
Leniece,F,100,6,0,6
Lennora,F,100,6,0,6
Lenoir,F,100,6,0,6
Leosvel,M,100,0,6,6
Leretha,F,100,6,0,6
Leshe,F,100,6,0,6
Lesliann,F,100,6,0,6
Letarsha,F,100,6,0,6
Levarn,F,100,6,0,6
Levid,M,100,0,6,6
Levitt,M,100,0,6,6
Lewey,M,100,0,6,6
Lewyn,M,100,0,6,6
Lexah,F,100,6,0,6
Lexanie,F,100,6,0,6
Lexanni,F,100,6,0,6
Lexsis,F,100,6,0,6
Leyiah,F,100,6,0,6
Lezanne,F,100,6,0,6
Liamm,M,100,0,6,6
Lianett,F,100,6,0,6
Liannette,F,100,6,0,6
Liannie,F,100,6,0,6
Liddia,F,100,6,0,6
Liera,F,100,6,0,6
Lierra,F,100,6,0,6
Liiam,M,100,0,6,6
Liiban,M,100,0,6,6
Lijana,F,100,6,0,6
Like,M,100,0,6,6
Likhita,F,100,6,0,6
Lilarose,F,100,6,0,6
Liliuokalani,F,100,6,0,6
Lillea,F,100,6,0,6
Lilleah,F,100,6,0,6
Lilyiana,F,100,6,0,6
Lilyrae,F,100,6,0,6
Lindal,M,100,0,6,6
Lindiwe,F,100,6,0,6
Lindra,F,100,6,0,6
Linesha,F,100,6,0,6
Lingyi,F,100,6,0,6
Linny,M,100,0,6,6
Linoshka,F,100,6,0,6
Linsday,F,100,6,0,6
Lipman,M,100,0,6,6
Lirim,M,100,0,6,6
Lisanna,F,100,6,0,6
Lismari,F,100,6,0,6
Lisveth,F,100,6,0,6
Litany,F,100,6,0,6
Litcy,F,100,6,0,6
Litsi,F,100,6,0,6
Lixy,F,100,6,0,6
Lizsandra,F,100,6,0,6
Lizz,F,100,6,0,6
Llamile,F,100,6,0,6
Llaneli,F,100,6,0,6
Llia,F,100,6,0,6
Llinda,F,100,6,0,6
Lloydene,F,100,6,0,6
Llubia,F,100,6,0,6
Lluviana,F,100,6,0,6
Loah,F,100,6,0,6
Loammi,F,100,6,0,6
Locklin,M,100,0,6,6
Lolani,F,100,6,0,6
Lolene,F,100,6,0,6
Londynmarie,F,100,6,0,6
Lonniel,M,100,0,6,6
Lontrell,M,100,0,6,6
Lorece,F,100,6,0,6
Loriyah,F,100,6,0,6
Lornell,M,100,0,6,6
Lorrainne,F,100,6,0,6
Lothario,M,100,0,6,6
Lotosha,F,100,6,0,6
Loubertha,F,100,6,0,6
Loudes,F,100,6,0,6
Lourd,F,100,6,0,6
Louretha,F,100,6,0,6
Lovada,F,100,6,0,6
Loveaya,F,100,6,0,6
Lovis,M,100,0,6,6
Lovonne,F,100,6,0,6
Lowella,F,100,6,0,6
Lucabella,F,100,6,0,6
Lucendia,F,100,6,0,6
Lucha,F,100,6,0,6
Lucreshia,F,100,6,0,6
Ludene,F,100,6,0,6
Lueann,F,100,6,0,6
Luisgabriel,M,100,0,6,6
Luisiana,F,100,6,0,6
Luisita,F,100,6,0,6
Luispablo,M,100,0,6,6
Lukyan,M,100,0,6,6
Lulamae,F,100,6,0,6
Lulla,F,100,6,0,6
Lulya,F,100,6,0,6
Lumin,F,100,6,0,6
Luray,F,100,6,0,6
Lureen,F,100,6,0,6
Luscious,F,100,6,0,6
Lushana,F,100,6,0,6
Lutie,F,100,6,0,6
Luxx,F,100,6,0,6
Luzma,F,100,6,0,6
Lyannah,F,100,6,0,6
Lyanni,F,100,6,0,6
Lyllia,F,100,6,0,6
Lyndzy,F,100,6,0,6
Lynika,F,100,6,0,6
Lynnly,F,100,6,0,6
Lynsea,F,100,6,0,6
Lyonna,F,100,6,0,6
Lyth,M,100,0,6,6
Lywanda,F,100,6,0,6
Mabelyn,F,100,6,0,6
Macartney,F,100,6,0,6
Macenna,F,100,6,0,6
Macenzi,F,100,6,0,6
Mache,F,100,6,0,6
Mackai,M,100,0,6,6
Macker,M,100,0,6,6
Mackynzi,F,100,6,0,6
Maclynn,F,100,6,0,6
Macson,M,100,0,6,6
Madaleno,M,100,0,6,6
Madaliene,F,100,6,0,6
Maddee,F,100,6,0,6
Maddisson,F,100,6,0,6
Maddlynn,F,100,6,0,6
Madel,F,100,6,0,6
Madelyngrace,F,100,6,0,6
Madhulika,F,100,6,0,6
Madielyn,F,100,6,0,6
Madilene,F,100,6,0,6
Madrona,F,100,6,0,6
Maelah,F,100,6,0,6
Maelei,F,100,6,0,6
Maelis,F,100,6,0,6
Maesie,F,100,6,0,6
Mafata,F,100,6,0,6
Magdelana,F,100,6,0,6
Magdelin,F,100,6,0,6
Maghann,F,100,6,0,6
Mahaela,F,100,6,0,6
Mahal,F,100,6,0,6
Mahalya,F,100,6,0,6
Mahbeer,M,100,0,6,6
Mahjabeen,F,100,6,0,6
Mahnaz,F,100,6,0,6
Mahsiah,M,100,0,6,6
Maijah,F,100,6,0,6
Maiken,F,100,6,0,6
Maileigh,F,100,6,0,6
Mailk,M,100,0,6,6
Maiquel,F,100,6,0,6
Mairenn,F,100,6,0,6
Majella,F,100,6,0,6
Majok,M,100,0,6,6
Makahia,F,100,6,0,6
Makaiden,M,100,0,6,6
Makaira,F,100,6,0,6
Makaleb,M,100,0,6,6
Makario,M,100,0,6,6
Makasha,F,100,6,0,6
Makea,F,100,6,0,6
Makeira,F,100,6,0,6
Makeitha,F,100,6,0,6
Makeo,M,100,0,6,6
Makiy,M,100,0,6,6
Maksen,M,100,0,6,6
Makyleigh,F,100,6,0,6
Malahni,F,100,6,0,6
Malaz,F,100,6,0,6
Malcum,M,100,0,6,6
Maleck,M,100,0,6,6
Maletha,F,100,6,0,6
Mallee,F,100,6,0,6
Malonni,F,100,6,0,6
Manahel,F,100,6,0,6
Manard,M,100,0,6,6
Mancil,M,100,0,6,6
Mandrel,M,100,0,6,6
Manija,F,100,6,0,6
Manjari,F,100,6,0,6
Manlio,M,100,0,6,6
Mansha,F,100,6,0,6
Manushri,F,100,6,0,6
Marabel,F,100,6,0,6
Marbeli,F,100,6,0,6
Marcandre,M,100,0,6,6
Marcandrew,M,100,0,6,6
Marchelo,M,100,0,6,6
Marcon,M,100,0,6,6
Mardina,F,100,6,0,6
Margare,F,100,6,0,6
Margerite,F,100,6,0,6
Margrete,F,100,6,0,6
Marhsall,M,100,0,6,6
Mariacecilia,F,100,6,0,6
Mariaesther,F,100,6,0,6
Mariahann,F,100,6,0,6
Mariahlynn,F,100,6,0,6
Mariamu,F,100,6,0,6
Mariangelis,F,100,6,0,6
Maricelis,F,100,6,0,6
Maricielo,F,100,6,0,6
Marines,F,100,6,0,6
Marique,M,100,0,6,6
Marivella,F,100,6,0,6
Markchristopher,M,100,0,6,6
Markco,M,100,0,6,6
Markeeda,F,100,6,0,6
Markeon,M,100,0,6,6
Markesa,F,100,6,0,6
Markisa,F,100,6,0,6
Markysha,F,100,6,0,6
Marlania,F,100,6,0,6
Marliah,F,100,6,0,6
Marnina,F,100,6,0,6
Marqueese,M,100,0,6,6
Marquitte,F,100,6,0,6
Marqwon,M,100,0,6,6
Marretta,F,100,6,0,6
Marrius,M,100,0,6,6
Marryn,F,100,6,0,6
Marselina,F,100,6,0,6
Marshanti,F,100,6,0,6
Marsheena,F,100,6,0,6
Martaveon,M,100,0,6,6
Marterrius,M,100,0,6,6
Marthana,F,100,6,0,6
Marthony,M,100,0,6,6
Martinque,F,100,6,0,6
Martricia,F,100,6,0,6
Maruf,M,100,0,6,6
Maruska,F,100,6,0,6
Marvela,F,100,6,0,6
Marvely,F,100,6,0,6
Marvenia,F,100,6,0,6
Marvinia,F,100,6,0,6
Maryjoe,F,100,6,0,6
Maryliz,F,100,6,0,6
Marymae,F,100,6,0,6
Maryona,F,100,6,0,6
Maryory,F,100,6,0,6
Marzel,M,100,0,6,6
Mascud,M,100,0,6,6
Mashad,M,100,0,6,6
Mashana,F,100,6,0,6
Mashanna,F,100,6,0,6
Mashon,M,100,0,6,6
Maurquise,M,100,0,6,6
Mauryn,F,100,6,0,6
Maxamis,M,100,0,6,6
Maximilan,M,100,0,6,6
Maximilano,M,100,0,6,6
Maximillien,M,100,0,6,6
Maxxton,M,100,0,6,6
Maxxwel,M,100,0,6,6
Maxy,M,100,0,6,6
Mayaar,F,100,6,0,6
Mayarose,F,100,6,0,6
Maybelin,F,100,6,0,6
Maycey,F,100,6,0,6
Maydean,F,100,6,0,6
Mayhem,M,100,0,6,6
Mayko,M,100,0,6,6
Maysaa,F,100,6,0,6
Maysan,F,100,6,0,6
Mazari,F,100,6,0,6
Mccai,M,100,0,6,6
Mcclane,M,100,0,6,6
Mckae,F,100,6,0,6
Mckayden,F,100,6,0,6
Mckaylan,F,100,6,0,6
Mckaylen,F,100,6,0,6
Mckaylia,F,100,6,0,6
Mckaylynn,F,100,6,0,6
Mckelvey,F,100,6,0,6
Mckinlea,F,100,6,0,6
Meccah,F,100,6,0,6
Meerah,F,100,6,0,6
Megaan,F,100,6,0,6
Mehrdad,M,100,0,6,6
Meichele,F,100,6,0,6
Meier,M,100,0,6,6
Meilany,F,100,6,0,6
Meissa,F,100,6,0,6
Meiyah,F,100,6,0,6
Meiyi,F,100,6,0,6
Mekail,M,100,0,6,6
Mekella,F,100,6,0,6
Mekkhi,M,100,0,6,6
Mekyah,F,100,6,0,6
Melandy,F,100,6,0,6
Meldia,F,100,6,0,6
Meldin,M,100,0,6,6
Meleya,F,100,6,0,6
Melindasue,F,100,6,0,6
Melissha,F,100,6,0,6
Mellette,F,100,6,0,6
Mellyssa,F,100,6,0,6
Melodyrose,F,100,6,0,6
Menachemmendel,M,100,0,6,6
Menelek,M,100,0,6,6
Meraris,F,100,6,0,6
Mercedi,F,100,6,0,6
Mercedys,F,100,6,0,6
Merena,F,100,6,0,6
Meridy,F,100,6,0,6
Meriya,F,100,6,0,6
Merlena,F,100,6,0,6
Merolla,F,100,6,0,6
Mersaydez,F,100,6,0,6
Merville,M,100,0,6,6
Meryll,F,100,6,0,6
Meshan,F,100,6,0,6
Meshaun,F,100,6,0,6
Meshon,F,100,6,0,6
Mesut,M,100,0,6,6
Meyers,M,100,0,6,6
Meyling,F,100,6,0,6
Miaandrea,F,100,6,0,6
Miaha,F,100,6,0,6
Miamore,F,100,6,0,6
Micchael,M,100,0,6,6
Michaelena,F,100,6,0,6
Michaelgabriel,M,100,0,6,6
Michaeljay,M,100,0,6,6
Michalann,F,100,6,0,6
Michellemarie,F,100,6,0,6
Michie,M,100,0,6,6
Micia,F,100,6,0,6
Mickaylah,F,100,6,0,6
Mihit,M,100,0,6,6
Mijael,M,100,0,6,6
Mikelann,F,100,6,0,6
Mikoto,F,100,6,0,6
Mikylla,F,100,6,0,6
Milele,F,100,6,0,6
Milosz,M,100,0,6,6
Minea,F,100,6,0,6
Minisha,F,100,6,0,6
Minjae,M,100,0,6,6
Minseo,F,100,6,0,6
Miosoty,F,100,6,0,6
Miquesha,F,100,6,0,6
Mirakal,F,100,6,0,6
Miricale,F,100,6,0,6
Miryea,F,100,6,0,6
Mishaila,F,100,6,0,6
Mishale,F,100,6,0,6
Mishall,F,100,6,0,6
Mishea,F,100,6,0,6
Mishonda,F,100,6,0,6
Mistaya,F,100,6,0,6
Mitia,F,100,6,0,6
Mlak,F,100,6,0,6
Modesti,F,100,6,0,6
Moeko,F,100,6,0,6
Molique,M,100,0,6,6
Monchello,M,100,0,6,6
Moneika,F,100,6,0,6
Monek,F,100,6,0,6
Monekia,F,100,6,0,6
Monelle,F,100,6,0,6
Monja,F,100,6,0,6
Monserratte,F,100,6,0,6
Montavian,M,100,0,6,6
Monterey,F,100,6,0,6
Montrece,F,100,6,0,6
Montsho,M,100,0,6,6
Mordy,M,100,0,6,6
Morghyn,F,100,6,0,6
Moriel,M,100,0,6,6
Morrine,F,100,6,0,6
Morsal,F,100,6,0,6
Mostyn,M,100,0,6,6
Mryah,F,100,6,0,6
Mtthew,M,100,0,6,6
Mua,M,100,0,6,6
Mucaad,M,100,0,6,6
Muffy,F,100,6,0,6
Muhab,M,100,0,6,6
Muhamadou,M,100,0,6,6
Muhtasim,M,100,0,6,6
Mumtas,F,100,6,0,6
Murle,M,100,0,6,6
Murlin,M,100,0,6,6
Murphee,F,100,6,0,6
Murtis,F,100,6,0,6
Musfirah,F,100,6,0,6
Muzik,M,100,0,6,6
Myannah,F,100,6,0,6
Myckala,F,100,6,0,6
Myion,M,100,0,6,6
Myiona,F,100,6,0,6
Mykaella,F,100,6,0,6
Mykeya,F,100,6,0,6
Myki,M,100,0,6,6
Myloh,M,100,0,6,6
Mynika,F,100,6,0,6
Myreya,F,100,6,0,6
Myrin,M,100,0,6,6
Myshae,F,100,6,0,6
Mytien,F,100,6,0,6
Myung,F,100,6,0,6
Nacala,F,100,6,0,6
Naedelyn,F,100,6,0,6
Naelah,F,100,6,0,6
Naequan,M,100,0,6,6
Naeshaun,M,100,0,6,6
Naetochukwu,M,100,0,6,6
Nagham,F,100,6,0,6
Nagisa,F,100,6,0,6
Nahiomy,F,100,6,0,6
Nahliyah,F,100,6,0,6
Naidaly,F,100,6,0,6
Naikia,F,100,6,0,6
Naileen,F,100,6,0,6
Naisaiah,M,100,0,6,6
Nakaiah,F,100,6,0,6
Nakaylee,F,100,6,0,6
Nakijah,F,100,6,0,6
Nakitia,F,100,6,0,6
Nalda,F,100,6,0,6
Nalei,F,100,6,0,6
Namyia,F,100,6,0,6
Nancilee,F,100,6,0,6
Nancyjean,F,100,6,0,6
Nantambu,M,100,0,6,6
Napua,F,100,6,0,6
Naquasia,F,100,6,0,6
Naquelle,F,100,6,0,6
Narnia,F,100,6,0,6
Narong,M,100,0,6,6
Narrissa,F,100,6,0,6
Narvell,M,100,0,6,6
Narvis,F,100,6,0,6
Nascha,F,100,6,0,6
Naseir,M,100,0,6,6
Nashan,M,100,0,6,6
Nashli,F,100,6,0,6
Nasjah,F,100,6,0,6
Nasly,F,100,6,0,6
Nassem,M,100,0,6,6
Naszire,M,100,0,6,6
Natahja,F,100,6,0,6
Nataka,F,100,6,0,6
Nataliemarie,F,100,6,0,6
Natalierose,F,100,6,0,6
Natashya,F,100,6,0,6
Nateka,F,100,6,0,6
Natelee,F,100,6,0,6
Nateya,F,100,6,0,6
Nathann,M,100,0,6,6
Nathia,F,100,6,0,6
Natisa,F,100,6,0,6
Nave,F,100,6,0,6
Navidad,F,100,6,0,6
Navindra,M,100,0,6,6
Nayaly,F,100,6,0,6
Nayelin,F,100,6,0,6
Nayisha,F,100,6,0,6
Nayloni,F,100,6,0,6
Naymar,M,100,0,6,6
Nayonika,F,100,6,0,6
Nazarria,F,100,6,0,6
Nazavier,M,100,0,6,6
Nazeeh,M,100,0,6,6
Nazeli,F,100,6,0,6
Nazhae,F,100,6,0,6
Nectarios,M,100,0,6,6
Nedine,F,100,6,0,6
Neeah,F,100,6,0,6
Neelia,F,100,6,0,6
Neepa,F,100,6,0,6
Neeson,M,100,0,6,6
Neferteria,F,100,6,0,6
Negan,F,100,6,0,6
Neishaly,F,100,6,0,6
Neiya,F,100,6,0,6
Nekeysha,F,100,6,0,6
Nekiesha,F,100,6,0,6
Nelena,F,100,6,0,6
Nemya,F,100,6,0,6
Nenette,F,100,6,0,6
Neolani,F,100,6,0,6
Neomie,F,100,6,0,6
Neomy,F,100,6,0,6
Neoshia,F,100,6,0,6
Neshama,F,100,6,0,6
Nevaha,F,100,6,0,6
Nevelle,M,100,0,6,6
Neziyah,F,100,6,0,6
Ngone,F,100,6,0,6
Niarose,F,100,6,0,6
Niaz,M,100,0,6,6
Nicasia,F,100,6,0,6
Niccoli,M,100,0,6,6
Nichalaus,M,100,0,6,6
Nicholsa,M,100,0,6,6
Nicoe,F,100,6,0,6
Nicolene,F,100,6,0,6
Nicson,M,100,0,6,6
Nidhish,M,100,0,6,6
Nieco,M,100,0,6,6
Niem,M,100,0,6,6
Nieman,M,100,0,6,6
Nigell,M,100,0,6,6
Niia,F,100,6,0,6
Nijash,M,100,0,6,6
Nikalette,F,100,6,0,6
Nikasha,F,100,6,0,6
Nikayia,F,100,6,0,6
Nikkitta,F,100,6,0,6
Nikkolaus,M,100,0,6,6
Nikoll,M,100,0,6,6
Nikul,M,100,0,6,6
Nileah,F,100,6,0,6
Nimish,M,100,0,6,6
Nin,F,100,6,0,6
Niobi,F,100,6,0,6
Nisiah,M,100,0,6,6
Niyahlee,F,100,6,0,6
Niyahna,F,100,6,0,6
Niyara,F,100,6,0,6
Niyaz,M,100,0,6,6
Niyema,F,100,6,0,6
Nizhonii,F,100,6,0,6
Nkiya,F,100,6,0,6
Noahalexander,M,100,0,6,6
Noeliz,F,100,6,0,6
Noeme,F,100,6,0,6
Norabelle,F,100,6,0,6
Norbu,M,100,0,6,6
Norna,F,100,6,0,6
Norreen,F,100,6,0,6
Norvil,M,100,0,6,6
Norward,M,100,0,6,6
Nouci,F,100,6,0,6
Nourah,F,100,6,0,6
Noureddine,M,100,0,6,6
Noveline,F,100,6,0,6
Nuam,F,100,6,0,6
Nyakume,F,100,6,0,6
Nyerere,M,100,0,6,6
Nygia,F,100,6,0,6
Nyiasia,F,100,6,0,6
Nykeah,F,100,6,0,6
Nykeema,F,100,6,0,6
Nyquasha,F,100,6,0,6
Nysire,M,100,0,6,6
Nytisha,F,100,6,0,6
Nyvea,F,100,6,0,6
Nyzaire,M,100,0,6,6
Obaida,M,100,0,6,6
Obera,F,100,6,0,6
Obiora,M,100,0,6,6
Oconnor,M,100,0,6,6
Odarrius,M,100,0,6,6
Oddis,M,100,0,6,6
Oded,M,100,0,6,6
Odia,F,100,6,0,6
Ofri,F,100,6,0,6
Ohajee,M,100,0,6,6
Ohani,M,100,0,6,6
Ojasvi,F,100,6,0,6
Ojetta,F,100,6,0,6
Okley,M,100,0,6,6
Olamiposi,M,100,0,6,6
Olaniyan,M,100,0,6,6
Olaya,F,100,6,0,6
Olethia,F,100,6,0,6
Oliyah,F,100,6,0,6
Ollivander,M,100,0,6,6
Olurotimi,M,100,0,6,6
Oluwabukunmi,F,100,6,0,6
Oluwadurotimi,M,100,0,6,6
Oluwamayowa,M,100,0,6,6
Olwyn,F,100,6,0,6
Olya,F,100,6,0,6
Olyn,M,100,0,6,6
Omarianna,F,100,6,0,6
Omayma,F,100,6,0,6
Omotara,F,100,6,0,6
Ondraya,F,100,6,0,6
Onyedikachi,M,100,0,6,6
Ophelie,F,100,6,0,6
Orentha,M,100,0,6,6
Orfalinda,F,100,6,0,6
Orinda,F,100,6,0,6
Orlagh,F,100,6,0,6
Ortega,M,100,0,6,6
Orvell,M,100,0,6,6
Orven,M,100,0,6,6
Osaretin,M,100,0,6,6
Oswyn,F,100,6,0,6
Ottilia,F,100,6,0,6
Oussama,M,100,0,6,6
Oveda,F,100,6,0,6
Ozvaldo,M,100,0,6,6
Pablita,F,100,6,0,6
Pacifica,F,100,6,0,6
Paetra,F,100,6,0,6
Pai,F,100,6,0,6
Paightyn,F,100,6,0,6
Paishance,F,100,6,0,6
Paitlynn,F,100,6,0,6
Paje,F,100,6,0,6
Pammela,F,100,6,0,6
Panagiotes,M,100,0,6,6
Paria,F,100,6,0,6
Parina,F,100,6,0,6
Parren,M,100,0,6,6
Pashun,F,100,6,0,6
Patress,F,100,6,0,6
Patriana,F,100,6,0,6
Patriccia,F,100,6,0,6
Pattii,F,100,6,0,6
Pattina,F,100,6,0,6
Pattsy,F,100,6,0,6
Pauleth,F,100,6,0,6
Pauljoseph,M,100,0,6,6
Pavitra,F,100,6,0,6
Paydin,M,100,0,6,6
Payeng,F,100,6,0,6
Paylan,F,100,6,0,6
Payshance,F,100,6,0,6
Paytynn,F,100,6,0,6
Pearleen,F,100,6,0,6
Pedrojose,M,100,0,6,6
Pedroluis,M,100,0,6,6
Peerless,M,100,0,6,6
Peggyjo,F,100,6,0,6
Pejmon,M,100,0,6,6
Peneloperose,F,100,6,0,6
Penrose,F,100,6,0,6
Perrish,M,100,0,6,6
Peta,F,100,6,0,6
Pharis,M,100,0,6,6
Phelecia,F,100,6,0,6
Philece,F,100,6,0,6
Philicity,F,100,6,0,6
Phinneaus,M,100,0,6,6
Phuongvy,F,100,6,0,6
Phylea,F,100,6,0,6
Phylisa,F,100,6,0,6
Pierette,F,100,6,0,6
Piney,F,100,6,0,6
Poem,F,100,6,0,6
Poppie,F,100,6,0,6
Pouya,M,100,0,6,6
Power,M,100,0,6,6
Prabhat,M,100,0,6,6
Pranisha,F,100,6,0,6
Prashanth,M,100,0,6,6
Pratiksha,F,100,6,0,6
Pray,M,100,0,6,6
Prayas,M,100,0,6,6
Prayze,F,100,6,0,6
Preetham,M,100,0,6,6
Preonda,F,100,6,0,6
Presila,F,100,6,0,6
Princejohn,M,100,0,6,6
Princton,M,100,0,6,6
Priscyla,F,100,6,0,6
Prithiv,M,100,0,6,6
Priyanshu,M,100,0,6,6
Procopio,M,100,0,6,6
Prue,F,100,6,0,6
Prysilla,F,100,6,0,6
Pushti,F,100,6,0,6
Qalid,M,100,0,6,6
Qamari,M,100,0,6,6
Qiona,F,100,6,0,6
Quadeer,M,100,0,6,6
Quadijah,F,100,6,0,6
Quadrevion,M,100,0,6,6
Quali,M,100,0,6,6
Qualiek,M,100,0,6,6
Qualisha,F,100,6,0,6
Qualiyah,F,100,6,0,6
Quamisha,F,100,6,0,6
Quannisha,F,100,6,0,6
Quanshae,F,100,6,0,6
Quanshay,F,100,6,0,6
Quantashia,F,100,6,0,6
Quarmaine,M,100,0,6,6
Quaseem,M,100,0,6,6
Quashayla,F,100,6,0,6
Quavonte,M,100,0,6,6
Qudarius,M,100,0,6,6
Quentisha,F,100,6,0,6
Queta,F,100,6,0,6
Quienten,M,100,0,6,6
Quinnlynn,F,100,6,0,6
Quintay,M,100,0,6,6
Quinte,M,100,0,6,6
Quirt,M,100,0,6,6
Quisean,M,100,0,6,6
Qumari,M,100,0,6,6
Quneisha,F,100,6,0,6
Quon,M,100,0,6,6
Quvondo,M,100,0,6,6
Quwanna,F,100,6,0,6
Qwana,F,100,6,0,6
Raamond,M,100,0,6,6
Racio,F,100,6,0,6
Racy,F,100,6,0,6
Radi,M,100,0,6,6
Radly,M,100,0,6,6
Raegina,F,100,6,0,6
Raegine,F,100,6,0,6
Raemi,F,100,6,0,6
Raen,F,100,6,0,6
Raenna,F,100,6,0,6
Raequawn,M,100,0,6,6
Raeyah,F,100,6,0,6
Rafaelita,F,100,6,0,6
Ragin,F,100,6,0,6
Rahama,F,100,6,0,6
Raheemah,F,100,6,0,6
Rahela,F,100,6,0,6
Rahib,M,100,0,6,6
Rahmad,M,100,0,6,6
Rahmo,F,100,6,0,6
Raida,F,100,6,0,6
Raiesha,F,100,6,0,6
Raifah,F,100,6,0,6
Raisah,F,100,6,0,6
Raisean,M,100,0,6,6
Raiyna,F,100,6,0,6
Rajana,F,100,6,0,6
Rajneesh,M,100,0,6,6
Raju,M,100,0,6,6
Rakeria,F,100,6,0,6
Rakib,M,100,0,6,6
Ral,M,100,0,6,6
Ralana,F,100,6,0,6
Ralique,M,100,0,6,6
Ramario,M,100,0,6,6
Ramayah,F,100,6,0,6
Ranaiya,F,100,6,0,6
Ranajah,F,100,6,0,6
Ranayah,F,100,6,0,6
Ranford,M,100,0,6,6
Ranjan,M,100,0,6,6
Ranota,F,100,6,0,6
Ransford,M,100,0,6,6
Ranzel,M,100,0,6,6
Raqib,M,100,0,6,6
Raquele,F,100,6,0,6
Raqwon,M,100,0,6,6
Raschell,F,100,6,0,6
Rashamel,M,100,0,6,6
Rashanique,F,100,6,0,6
Rashara,F,100,6,0,6
Rashaya,F,100,6,0,6
Rasleen,F,100,6,0,6
Rauchelle,F,100,6,0,6
Raviv,M,100,0,6,6
Rawly,M,100,0,6,6
Raxton,M,100,0,6,6
Raybert,M,100,0,6,6
Raydrick,M,100,0,6,6
Rayella,F,100,6,0,6
Raygina,F,100,6,0,6
Rayjanae,F,100,6,0,6
Raykwan,M,100,0,6,6
Raymod,M,100,0,6,6
Rayshelle,F,100,6,0,6
Razaria,F,100,6,0,6
Razmig,M,100,0,6,6
Reahanna,F,100,6,0,6
Reaksmey,M,100,0,6,6
Reannan,F,100,6,0,6
Reaven,F,100,6,0,6
Rebecaa,F,100,6,0,6
Rebecc,F,100,6,0,6
Rebeccajo,F,100,6,0,6
Record,M,100,0,6,6
Reddington,M,100,0,6,6
Redge,M,100,0,6,6
Redginald,M,100,0,6,6
Reedy,M,100,0,6,6
Reetal,F,100,6,0,6
Regenal,M,100,0,6,6
Regetta,F,100,6,0,6
Reigha,F,100,6,0,6
Reja,F,100,6,0,6
Rejena,F,100,6,0,6
Rejino,M,100,0,6,6
Rekiyah,F,100,6,0,6
Relanda,F,100,6,0,6
Relando,M,100,0,6,6
Remley,F,100,6,0,6
Renat,M,100,0,6,6
Renauta,F,100,6,0,6
Renetia,F,100,6,0,6
Renford,M,100,0,6,6
Reniesha,F,100,6,0,6
Reniqua,F,100,6,0,6
Renleigh,F,100,6,0,6
Rennata,F,100,6,0,6
Reshika,F,100,6,0,6
Rethea,F,100,6,0,6
Retisha,F,100,6,0,6
Retonia,F,100,6,0,6
Revathi,F,100,6,0,6
Reylee,F,100,6,0,6
Reynell,F,100,6,0,6
Rhania,F,100,6,0,6
Rhasheen,M,100,0,6,6
Rhion,M,100,0,6,6
Rhory,M,100,0,6,6
Rhoslyn,F,100,6,0,6
Rhyane,F,100,6,0,6
Ricayla,F,100,6,0,6
Richara,F,100,6,0,6
Richaud,M,100,0,6,6
Rickira,F,100,6,0,6
Riken,M,100,0,6,6
Rikesh,M,100,0,6,6
Rikkita,F,100,6,0,6
Rileah,F,100,6,0,6
Rimantas,M,100,0,6,6
Rimi,F,100,6,0,6
Rimya,F,100,6,0,6
Rinata,F,100,6,0,6
Rinyah,F,100,6,0,6
Rishima,F,100,6,0,6
Ritage,F,100,6,0,6
Riyonna,F,100,6,0,6
Rizza,F,100,6,0,6
Rmon,M,100,0,6,6
Roanan,M,100,0,6,6
Roba,F,100,6,0,6
Robbey,M,100,0,6,6
Robertjr,M,100,0,6,6
Robiya,F,100,6,0,6
Rocci,M,100,0,6,6
Rocelin,F,100,6,0,6
Rockston,M,100,0,6,6
Roddey,M,100,0,6,6
Roddney,M,100,0,6,6
Rodessa,F,100,6,0,6
Rodna,F,100,6,0,6
Rodrika,F,100,6,0,6
Roesha,F,100,6,0,6
Rogelia,F,100,6,0,6
Roham,M,100,0,6,6
Roline,F,100,6,0,6
Rolley,M,100,0,6,6
Rolman,M,100,0,6,6
Romeisha,F,100,6,0,6
Romita,F,100,6,0,6
Rondella,F,100,6,0,6
Ronnda,F,100,6,0,6
Rorrie,F,100,6,0,6
Rosealina,F,100,6,0,6
Rosel,F,100,6,0,6
Roseleen,F,100,6,0,6
Rosell,M,100,0,6,6
Rosemarry,F,100,6,0,6
Rosezanna,F,100,6,0,6
Rosezena,F,100,6,0,6
Rosheen,M,100,0,6,6
Rosilee,F,100,6,0,6
Rotha,M,100,0,6,6
Rovin,M,100,0,6,6
Rownan,M,100,0,6,6
Royesha,F,100,6,0,6
Roynesha,F,100,6,0,6
Rreon,F,100,6,0,6
Ruaa,F,100,6,0,6
Rubiel,M,100,0,6,6
Ruchelle,F,100,6,0,6
Rudhra,M,100,0,6,6
Rushda,F,100,6,0,6
Ruslana,F,100,6,0,6
Russelle,M,100,0,6,6
Ruthella,F,100,6,0,6
Rutva,F,100,6,0,6
Rydia,F,100,6,0,6
Rydon,M,100,0,6,6
Ryion,M,100,0,6,6
Rylii,F,100,6,0,6
Ryshaun,M,100,0,6,6
Ryston,M,100,0,6,6
Ryzer,M,100,0,6,6
Saaim,M,100,0,6,6
Saamiyah,F,100,6,0,6
Saarang,M,100,0,6,6
Saasha,F,100,6,0,6
Sabastin,M,100,0,6,6
Sabbir,M,100,0,6,6
Sabeeh,M,100,0,6,6
Sabiel,M,100,0,6,6
Sabreana,F,100,6,0,6
Sachelle,F,100,6,0,6
Sadena,F,100,6,0,6
Sadika,F,100,6,0,6
Sadonte,M,100,0,6,6
Saequan,M,100,0,6,6
Safeya,F,100,6,0,6
Safoora,F,100,6,0,6
Safwaan,M,100,0,6,6
Sahri,F,100,6,0,6
Sahrish,F,100,6,0,6
Sahriya,F,100,6,0,6
Sahriyah,F,100,6,0,6
Saikou,M,100,0,6,6
Sairam,M,100,0,6,6
Sairi,F,100,6,0,6
Sakariya,M,100,0,6,6
Sakeithia,F,100,6,0,6
Saketha,F,100,6,0,6
Salea,F,100,6,0,6
Salis,M,100,0,6,6
Salise,F,100,6,0,6
Salissa,F,100,6,0,6
Salvina,F,100,6,0,6
Samantaha,F,100,6,0,6
Samanvita,F,100,6,0,6
Samed,M,100,0,6,6
Sameed,M,100,0,6,6
Sameisha,F,100,6,0,6
Samena,F,100,6,0,6
Sameriah,F,100,6,0,6
Samien,M,100,0,6,6
Samiira,F,100,6,0,6
Samirrah,F,100,6,0,6
Samisha,F,100,6,0,6
Sammiejo,F,100,6,0,6
Samonte,M,100,0,6,6
Samriddhi,F,100,6,0,6
Samtha,F,100,6,0,6
Samyog,M,100,0,6,6
Sanantonio,M,100,0,6,6
Sandibel,F,100,6,0,6
Sanetta,F,100,6,0,6
Saniiyah,F,100,6,0,6
Sanin,M,100,0,6,6
Santangela,F,100,6,0,6
Santangelo,M,100,0,6,6
Santerica,F,100,6,0,6
Santerria,F,100,6,0,6
Santha,F,100,6,0,6
Santrese,F,100,6,0,6
Saraa,F,100,6,0,6
Sarala,F,100,6,0,6
Sardor,M,100,0,6,6
Sare,F,100,6,0,6
Sarhiya,F,100,6,0,6
Saritha,F,100,6,0,6
Sasia,F,100,6,0,6
Sataria,F,100,6,0,6
Satavia,F,100,6,0,6
Satoru,M,100,0,6,6
Saunti,F,100,6,0,6
Savanh,F,100,6,0,6
Savar,M,100,0,6,6
Savonia,F,100,6,0,6
Sawan,M,100,0,6,6
Sayden,M,100,0,6,6
Sayeeda,F,100,6,0,6
Saylar,F,100,6,0,6
Sayonara,F,100,6,0,6
Schandra,F,100,6,0,6
Schane,M,100,0,6,6
Scharron,F,100,6,0,6
Schrita,F,100,6,0,6
Sebert,M,100,0,6,6
Sebian,M,100,0,6,6
Secelia,F,100,6,0,6
Secia,F,100,6,0,6
Seeya,F,100,6,0,6
Seiko,F,100,6,0,6
Seily,F,100,6,0,6
Sein,M,100,0,6,6
Sejin,M,100,0,6,6
Seka,F,100,6,0,6
Sekena,F,100,6,0,6
Seleem,M,100,0,6,6
Selema,F,100,6,0,6
Selenamarie,F,100,6,0,6
Selestina,F,100,6,0,6
Selethia,F,100,6,0,6
Seleyna,F,100,6,0,6
Semahj,M,100,0,6,6
Semeko,F,100,6,0,6
Semetria,F,100,6,0,6
Semora,F,100,6,0,6
Semyon,M,100,0,6,6
Semyra,F,100,6,0,6
Seneatha,F,100,6,0,6
Senetta,F,100,6,0,6
Senikka,F,100,6,0,6
Sennett,M,100,0,6,6
Senobia,F,100,6,0,6
Senovio,M,100,0,6,6
Senyah,F,100,6,0,6
Seprina,F,100,6,0,6
Sereda,F,100,6,0,6
Serenityrose,F,100,6,0,6
Serinah,F,100,6,0,6
Sessily,F,100,6,0,6
Sevara,F,100,6,0,6
Seveah,F,100,6,0,6
Sevinch,F,100,6,0,6
Seyvon,M,100,0,6,6
Shabrie,F,100,6,0,6
Shacori,F,100,6,0,6
Shacquille,M,100,0,6,6
Shadany,F,100,6,0,6
Shadel,F,100,6,0,6
Shadena,F,100,6,0,6
Shadijah,F,100,6,0,6
Shadina,F,100,6,0,6
Shadley,M,100,0,6,6
Shadra,F,100,6,0,6
Shadya,F,100,6,0,6
Shaenna,F,100,6,0,6
Shafeeq,M,100,0,6,6
Shaguanda,F,100,6,0,6
Shaharra,F,100,6,0,6
Shaiasia,F,100,6,0,6
Shaileigh,F,100,6,0,6
Shakana,F,100,6,0,6
Shakeba,F,100,6,0,6
Shaked,M,100,0,6,6
Shakee,M,100,0,6,6
Shaketra,F,100,6,0,6
Shakitta,F,100,6,0,6
Shakobe,M,100,0,6,6
Shalako,M,100,0,6,6
Shaleece,F,100,6,0,6
Shamael,F,100,6,0,6
Shamaiah,F,100,6,0,6
Shamauria,F,100,6,0,6
Shamber,F,100,6,0,6
Shambrika,F,100,6,0,6
Shameekia,F,100,6,0,6
Shameera,F,100,6,0,6
Shameko,F,100,6,0,6
Shameta,F,100,6,0,6
Shamkia,F,100,6,0,6
Shamore,M,100,0,6,6
Shamorrow,F,100,6,0,6
Shanaja,F,100,6,0,6
Shanata,F,100,6,0,6
Shanei,F,100,6,0,6
Shanett,F,100,6,0,6
Shaniayah,F,100,6,0,6
Shanil,F,100,6,0,6
Shannequa,F,100,6,0,6
Shanniece,F,100,6,0,6
Shanyk,F,100,6,0,6
Shanyka,F,100,6,0,6
Shaquandria,F,100,6,0,6
Shaquinda,F,100,6,0,6
Shaquinna,F,100,6,0,6
Shaqula,F,100,6,0,6
Shaqulle,M,100,0,6,6
Sharaea,F,100,6,0,6
Sharana,F,100,6,0,6
Sharann,F,100,6,0,6
Sharav,M,100,0,6,6
Sharenna,F,100,6,0,6
Sharessa,F,100,6,0,6
Shariana,F,100,6,0,6
Sharitza,F,100,6,0,6
Sharlayne,F,100,6,0,6
Sharleez,F,100,6,0,6
Sharlinda,F,100,6,0,6
Sharmeta,F,100,6,0,6
Sharnequa,F,100,6,0,6
Sharnia,F,100,6,0,6
Sharnyce,F,100,6,0,6
Sharold,F,100,6,0,6
Sharrona,F,100,6,0,6
Sharvani,F,100,6,0,6
Shateia,F,100,6,0,6
Shaude,F,100,6,0,6
Shaunea,F,100,6,0,6
Shauney,F,100,6,0,6
Shaunyce,F,100,6,0,6
Shauwn,M,100,0,6,6
Shawandra,F,100,6,0,6
Shawkat,M,100,0,6,6
Shawndria,F,100,6,0,6
Shawneece,F,100,6,0,6
Shayah,F,100,6,0,6
Shayane,F,100,6,0,6
Shaynell,F,100,6,0,6
Shaynne,F,100,6,0,6
Shaz,M,100,0,6,6
Shazeb,M,100,0,6,6
Shederick,M,100,0,6,6
Sheenika,F,100,6,0,6
Sheery,F,100,6,0,6
Shehzeen,F,100,6,0,6
Shekayla,F,100,6,0,6
Shekeita,F,100,6,0,6
Shekevia,F,100,6,0,6
Shekeya,F,100,6,0,6
Shemarion,M,100,0,6,6
Shemieka,F,100,6,0,6
Shenade,F,100,6,0,6
Shentell,F,100,6,0,6
Sheonta,F,100,6,0,6
Sherayne,F,100,6,0,6
Shereef,M,100,0,6,6
Sherick,M,100,0,6,6
Sheridon,F,100,6,0,6
Sheriee,F,100,6,0,6
Sherlee,F,100,6,0,6
Sherlena,F,100,6,0,6
Sherraine,F,100,6,0,6
Sherrone,F,100,6,0,6
Sherwyn,M,100,0,6,6
Shetal,F,100,6,0,6
Shevell,F,100,6,0,6
Sheylla,F,100,6,0,6
Shida,F,100,6,0,6
Shikari,F,100,6,0,6
Shilat,F,100,6,0,6
Shimara,F,100,6,0,6
Shinetta,F,100,6,0,6
Shinna,F,100,6,0,6
Shivonni,F,100,6,0,6
Shiwana,F,100,6,0,6
Shloke,M,100,0,6,6
Shnequa,F,100,6,0,6
Shohjahon,M,100,0,6,6
Shoma,M,100,0,6,6
Shondelle,F,100,6,0,6
Shontaya,F,100,6,0,6
Shontoya,F,100,6,0,6
Shoumik,M,100,0,6,6
Shoun,M,100,0,6,6
Shovan,F,100,6,0,6
Shreenidhi,F,100,6,0,6
Shreyans,M,100,0,6,6
Shristopher,M,100,0,6,6
Shuji,M,100,0,6,6
Shundell,M,100,0,6,6
Shunette,F,100,6,0,6
Shuniya,F,100,6,0,6
Shuvon,F,100,6,0,6
Shyeeda,F,100,6,0,6
Shykeyla,F,100,6,0,6
Shymeek,M,100,0,6,6
Shynequa,F,100,6,0,6
Shynise,F,100,6,0,6
Shynisha,F,100,6,0,6
Shyrle,F,100,6,0,6
Sianah,F,100,6,0,6
Siba,F,100,6,0,6
Sibbie,F,100,6,0,6
Sibora,F,100,6,0,6
Sicilee,F,100,6,0,6
Siddeegah,F,100,6,0,6
Siene,F,100,6,0,6
Sigmond,M,100,0,6,6
Silton,M,100,0,6,6
Sincerely,F,100,6,0,6
Siran,M,100,0,6,6
Siriana,F,100,6,0,6
Sisco,M,100,0,6,6
Sisley,F,100,6,0,6
Skailar,F,100,6,0,6
Skiilar,F,100,6,0,6
Skipp,M,100,0,6,6
Slayder,M,100,0,6,6
Sohaan,M,100,0,6,6
Soheil,M,100,0,6,6
Sohom,M,100,0,6,6
Solage,F,100,6,0,6
Solee,F,100,6,0,6
Soline,F,100,6,0,6
Sook,F,100,6,0,6
Sopheia,F,100,6,0,6
Sophyia,F,100,6,0,6
Soroosh,M,100,0,6,6
Souriya,M,100,0,6,6
Spanky,M,100,0,6,6
Sparkel,F,100,6,0,6
Spontaneous,F,100,6,0,6
Srikari,F,100,6,0,6
Srilakshmi,F,100,6,0,6
Srividya,F,100,6,0,6
Stacci,F,100,6,0,6
Stajah,F,100,6,0,6
Stallone,M,100,0,6,6
Stanja,F,100,6,0,6
Stassa,F,100,6,0,6
Stedmen,M,100,0,6,6
Steffane,F,100,6,0,6
Stefnie,F,100,6,0,6
Steohanie,F,100,6,0,6
Stepahanie,F,100,6,0,6
Stephenee,F,100,6,0,6
Stephenmichael,M,100,0,6,6
Stepheno,M,100,0,6,6
Stephin,M,100,0,6,6
Steuart,M,100,0,6,6
Stevenn,M,100,0,6,6
Stevii,F,100,6,0,6
Storii,F,100,6,0,6
Stranje,F,100,6,0,6
Subira,F,100,6,0,6
Suean,F,100,6,0,6
Sugei,F,100,6,0,6
Suhanth,M,100,0,6,6
Sunehri,F,100,6,0,6
Sunflower,F,100,6,0,6
Susaye,F,100,6,0,6
Susel,F,100,6,0,6
Suveer,M,100,0,6,6
Suze,F,100,6,0,6
Swapnil,M,100,0,6,6
Swarna,F,100,6,0,6
Swasti,F,100,6,0,6
Swendy,F,100,6,0,6
Sydea,F,100,6,0,6
Sydnii,F,100,6,0,6
Syedmuhammad,M,100,0,6,6
Syeria,F,100,6,0,6
Syhir,M,100,0,6,6
Syier,M,100,0,6,6
Sykora,F,100,6,0,6
Sylias,M,100,0,6,6
Synaya,F,100,6,0,6
Synnove,F,100,6,0,6
Syntyche,F,100,6,0,6
Syonna,F,100,6,0,6
Syretha,F,100,6,0,6
Syrinity,F,100,6,0,6
Syvella,F,100,6,0,6
Tabata,F,100,6,0,6
Tadrian,M,100,0,6,6
Tadyn,M,100,0,6,6
Tagert,M,100,0,6,6
Tahan,M,100,0,6,6
Tahisa,F,100,6,0,6
Tahjanay,F,100,6,0,6
Tahjia,F,100,6,0,6
Tahlee,M,100,0,6,6
Tahmel,M,100,0,6,6
Tahseen,M,100,0,6,6
Taij,M,100,0,6,6
Taijanae,F,100,6,0,6
Taijay,M,100,0,6,6
Tairiq,M,100,0,6,6
Tairy,F,100,6,0,6
Taisen,M,100,0,6,6
Taiwanda,F,100,6,0,6
Taizlee,F,100,6,0,6
Tajanai,F,100,6,0,6
Tajiah,F,100,6,0,6
Tajion,M,100,0,6,6
Tajsa,F,100,6,0,6
Tajuanda,F,100,6,0,6
Takaiyah,F,100,6,0,6
Takanori,M,100,0,6,6
Takeiya,F,100,6,0,6
Takeyshia,F,100,6,0,6
Takindra,F,100,6,0,6
Taknisha,F,100,6,0,6
Takobe,M,100,0,6,6
Talaiah,F,100,6,0,6
Talandra,F,100,6,0,6
Talayiah,F,100,6,0,6
Talbott,M,100,0,6,6
Taleiya,F,100,6,0,6
Taleka,F,100,6,0,6
Talexis,F,100,6,0,6
Taliea,F,100,6,0,6
Talim,F,100,6,0,6
Talion,M,100,0,6,6
Talyr,F,100,6,0,6
Tamaine,M,100,0,6,6
Tamaran,F,100,6,0,6
Tamariana,F,100,6,0,6
Tamarsha,F,100,6,0,6
Tamerick,M,100,0,6,6
Tammany,F,100,6,0,6
Tammis,F,100,6,0,6
Tammyann,F,100,6,0,6
Tamzen,F,100,6,0,6
Tamzyn,F,100,6,0,6
Tanechia,F,100,6,0,6
Tanielu,M,100,0,6,6
Taniha,F,100,6,0,6
Tanishea,F,100,6,0,6
Tanitha,F,100,6,0,6
Tannetta,F,100,6,0,6
Tanni,F,100,6,0,6
Tanyea,F,100,6,0,6
Tanyja,F,100,6,0,6
Tapatha,F,100,6,0,6
Taqueena,F,100,6,0,6
Taquil,M,100,0,6,6
Tarajhi,F,100,6,0,6
Taraneka,F,100,6,0,6
Taranisha,F,100,6,0,6
Tareena,F,100,6,0,6
Tarnell,M,100,0,6,6
Taronica,F,100,6,0,6
Tarrik,M,100,0,6,6
Tashard,M,100,0,6,6
Tasheona,F,100,6,0,6
Tasheria,F,100,6,0,6
Tashiem,M,100,0,6,6
Tashma,F,100,6,0,6
Tasos,M,100,0,6,6
Tassa,F,100,6,0,6
Tatevik,F,100,6,0,6
Tathan,M,100,0,6,6
Tatsuki,M,100,0,6,6
Tattyana,F,100,6,0,6
Tauja,F,100,6,0,6
Taunda,F,100,6,0,6
Tavleen,F,100,6,0,6
Tavonya,F,100,6,0,6
Tawauna,F,100,6,0,6
Taylianna,F,100,6,0,6
Taymur,M,100,0,6,6
Tayvione,M,100,0,6,6
Tazkia,F,100,6,0,6
Tazlyn,F,100,6,0,6
Tecoa,F,100,6,0,6
Teddra,F,100,6,0,6
Tedrina,F,100,6,0,6
Teffanie,F,100,6,0,6
Tehana,F,100,6,0,6
Tehilah,F,100,6,0,6
Teijah,F,100,6,0,6
Tejash,M,100,0,6,6
Telishia,F,100,6,0,6
Temecia,F,100,6,0,6
Teneha,F,100,6,0,6
Teni,F,100,6,0,6
Tenice,F,100,6,0,6
Tennesha,F,100,6,0,6
Tenyah,F,100,6,0,6
Tenzley,F,100,6,0,6
Tequilia,F,100,6,0,6
Teranique,F,100,6,0,6
Teriya,F,100,6,0,6
Teriyana,F,100,6,0,6
Terranc,M,100,0,6,6
Terranesha,F,100,6,0,6
Terrone,M,100,0,6,6
Tertius,M,100,0,6,6
Terynn,F,100,6,0,6
Teshika,F,100,6,0,6
Tessalee,F,100,6,0,6
Teuna,F,100,6,0,6
Tevez,M,100,0,6,6
Tevy,F,100,6,0,6
Thackery,M,100,0,6,6
Thalassa,F,100,6,0,6
Tharron,M,100,0,6,6
Thayli,F,100,6,0,6
Thesha,F,100,6,0,6
Thienlong,M,100,0,6,6
Thilo,M,100,0,6,6
Thoedore,M,100,0,6,6
Thorpe,M,100,0,6,6
Thristen,M,100,0,6,6
Thurnell,M,100,0,6,6
Tianee,F,100,6,0,6
Tianie,F,100,6,0,6
Tibisay,F,100,6,0,6
Tiereny,F,100,6,0,6
Tierni,F,100,6,0,6
Tieson,M,100,0,6,6
Tieysha,F,100,6,0,6
Tifeoluwa,M,100,0,6,6
Tifffany,F,100,6,0,6
Tiffoni,F,100,6,0,6
Tifphanie,F,100,6,0,6
Tijae,F,100,6,0,6
Tijanae,F,100,6,0,6
Tilan,M,100,0,6,6
Timayah,F,100,6,0,6
Timberley,F,100,6,0,6
Timeria,F,100,6,0,6
Timmeshia,F,100,6,0,6
Timmon,M,100,0,6,6
Timnesha,F,100,6,0,6
Timothhy,M,100,0,6,6
Tinelle,F,100,6,0,6
Tinina,F,100,6,0,6
Tiniqua,F,100,6,0,6
Tinothy,M,100,0,6,6
Tippany,F,100,6,0,6
Tiranke,F,100,6,0,6
Tirenioluwa,F,100,6,0,6
Tirian,M,100,0,6,6
Tiriq,M,100,0,6,6
Tirra,F,100,6,0,6
Tishika,F,100,6,0,6
Titilope,F,100,6,0,6
Tiy,F,100,6,0,6
Tkyra,F,100,6,0,6
Tliyah,F,100,6,0,6
Tlyer,M,100,0,6,6
Tobiloba,M,100,0,6,6
Tocarro,F,100,6,0,6
Todo,M,100,0,6,6
Toie,F,100,6,0,6
Tolly,F,100,6,0,6
Toltu,F,100,6,0,6
Tomatra,M,100,0,6,6
Tomii,F,100,6,0,6
Tomiyah,F,100,6,0,6
Tomorra,F,100,6,0,6
Tondi,F,100,6,0,6
Tondrea,F,100,6,0,6
Tondria,F,100,6,0,6
Tonicka,F,100,6,0,6
Tonielle,F,100,6,0,6
Tonirose,F,100,6,0,6
Tonyeka,F,100,6,0,6
Tonyna,F,100,6,0,6
Tonyua,F,100,6,0,6
Toriono,M,100,0,6,6
Torrianna,F,100,6,0,6
Torrica,F,100,6,0,6
Torstein,M,100,0,6,6
Toyce,F,100,6,0,6
Toynelle,F,100,6,0,6
Toyota,F,100,6,0,6
Tpring,F,100,6,0,6
Tquan,M,100,0,6,6
Trabian,M,100,0,6,6
Trachell,F,100,6,0,6
Tracilynn,F,100,6,0,6
Traelyn,M,100,0,6,6
Traequan,M,100,0,6,6
Traeshon,M,100,0,6,6
Trais,M,100,0,6,6
Traiten,M,100,0,6,6
Trakelia,F,100,6,0,6
Trami,F,100,6,0,6
Tranis,M,100,0,6,6
Trasi,F,100,6,0,6
Traveyon,M,100,0,6,6
Travond,M,100,0,6,6
Trawn,M,100,0,6,6
Trayci,F,100,6,0,6
Traysean,M,100,0,6,6
Trayshun,M,100,0,6,6
Treasia,F,100,6,0,6
Tredena,F,100,6,0,6
Trelana,F,100,6,0,6
Trema,F,100,6,0,6
Tremekia,F,100,6,0,6
Tremere,M,100,0,6,6
Trenica,F,100,6,0,6
Trentity,F,100,6,0,6
Treqwan,M,100,0,6,6
Treshad,M,100,0,6,6
Treshia,F,100,6,0,6
Trevail,M,100,0,6,6
Trevelyan,M,100,0,6,6
Treylyn,M,100,0,6,6
Tribeca,F,100,6,0,6
Trier,F,100,6,0,6
Trimika,F,100,6,0,6
Trinicia,F,100,6,0,6
Triniyah,F,100,6,0,6
Triny,F,100,6,0,6
Trippton,M,100,0,6,6
Trisco,M,100,0,6,6
Trissie,F,100,6,0,6
Tristah,F,100,6,0,6
Tristica,F,100,6,0,6
Tristien,M,100,0,6,6
Triya,F,100,6,0,6
Troyanne,F,100,6,0,6
Tryp,M,100,0,6,6
Tsosie,M,100,0,6,6
Tsuyoshi,M,100,0,6,6
Tunde,M,100,0,6,6
Tunis,M,100,0,6,6
Turmaine,M,100,0,6,6
Twanika,F,100,6,0,6
Twynette,F,100,6,0,6
Tyane,F,100,6,0,6
Tybrea,F,100,6,0,6
Tybresha,F,100,6,0,6
Tyecha,F,100,6,0,6
Tyeka,F,100,6,0,6
Tyelar,M,100,0,6,6
Tyelise,F,100,6,0,6
Tyequan,M,100,0,6,6
Tyer,M,100,0,6,6
Tyghe,M,100,0,6,6
Tyhisa,F,100,6,0,6
Tyjanay,F,100,6,0,6
Tyjanique,F,100,6,0,6
Tykenya,F,100,6,0,6
Tykevion,M,100,0,6,6
Tykie,M,100,0,6,6
Tykirra,F,100,6,0,6
Tyleesha,F,100,6,0,6
Tyleyah,F,100,6,0,6
Tylissa,F,100,6,0,6
Tylr,M,100,0,6,6
Tynaya,F,100,6,0,6
Tyneika,F,100,6,0,6
Tynijah,F,100,6,0,6
Tynisia,F,100,6,0,6
Tynli,F,100,6,0,6
Tyquese,M,100,0,6,6
Tyrael,M,100,0,6,6
Tyrand,M,100,0,6,6
Tyrecia,F,100,6,0,6
Tyseana,F,100,6,0,6
Tyshanta,F,100,6,0,6
Tysheim,M,100,0,6,6
Tysyn,M,100,0,6,6
Tyunna,F,100,6,0,6
Uladimir,M,100,0,6,6
Uland,M,100,0,6,6
Ulrik,M,100,0,6,6
Umaira,F,100,6,0,6
Umamah,F,100,6,0,6
Uneek,F,100,6,0,6
Uneka,F,100,6,0,6
Urielle,F,100,6,0,6
Urijha,M,100,0,6,6
Usayd,M,100,0,6,6
Valaire,F,100,6,0,6
Valeshia,F,100,6,0,6
Vally,F,100,6,0,6
Vandela,F,100,6,0,6
Vaneka,F,100,6,0,6
Vanille,F,100,6,0,6
Vanise,F,100,6,0,6
Varee,F,100,6,0,6
Varney,M,100,0,6,6
Varshita,F,100,6,0,6
Vatasha,F,100,6,0,6
Vedat,M,100,0,6,6
Veeraj,M,100,0,6,6
Veloria,F,100,6,0,6
Venassa,F,100,6,0,6
Veneita,F,100,6,0,6
Venellope,F,100,6,0,6
Venika,F,100,6,0,6
Venishia,F,100,6,0,6
Venture,M,100,0,6,6
Veonka,F,100,6,0,6
Verble,M,100,0,6,6
Verdale,M,100,0,6,6
Verdene,F,100,6,0,6
Vergia,F,100,6,0,6
Verinda,F,100,6,0,6
Verlana,F,100,6,0,6
Verland,M,100,0,6,6
Vernadean,F,100,6,0,6
Veronyca,F,100,6,0,6
Vershaun,M,100,0,6,6
Vidula,F,100,6,0,6
Vieri,M,100,0,6,6
Vihaa,F,100,6,0,6
Vihaanreddy,M,100,0,6,6
Vilene,F,100,6,0,6
Vinathi,F,100,6,0,6
Vincci,F,100,6,0,6
Vincentmichael,M,100,0,6,6
Vinecia,F,100,6,0,6
Vionda,F,100,6,0,6
Vionna,F,100,6,0,6
Virdie,F,100,6,0,6
Virigina,F,100,6,0,6
Virl,M,100,0,6,6
Vishak,M,100,0,6,6
Vivette,F,100,6,0,6
Vividiana,F,100,6,0,6
Vivy,F,100,6,0,6
Vondale,M,100,0,6,6
Vonmarie,F,100,6,0,6
Vonnesha,F,100,6,0,6
Vontresa,F,100,6,0,6
Vriti,F,100,6,0,6
Vrunda,F,100,6,0,6
Vulnavia,F,100,6,0,6
Vyaan,M,100,0,6,6
Vynessa,F,100,6,0,6
Vyolette,F,100,6,0,6
Vyto,M,100,0,6,6
Waino,M,100,0,6,6
Wakia,F,100,6,0,6
Wala,F,100,6,0,6
Wambui,F,100,6,0,6
Warees,M,100,0,6,6
Warne,M,100,0,6,6
Warrenetta,F,100,6,0,6
Wasseem,M,100,0,6,6
Welborn,M,100,0,6,6
Wensley,M,100,0,6,6
Weylan,M,100,0,6,6
Whitnay,F,100,6,0,6
Wicahpi,F,100,6,0,6
Wilard,M,100,0,6,6
Wilhemena,F,100,6,0,6
Wilibaldo,M,100,0,6,6
Williaa,M,100,0,6,6
Williamrobert,M,100,0,6,6
Willibaldo,M,100,0,6,6
Wilsie,F,100,6,0,6
Wily,M,100,0,6,6
Winchester,M,100,0,6,6
Winslet,F,100,6,0,6
Winsley,M,100,0,6,6
Wonya,M,100,0,6,6
Woodfin,M,100,0,6,6
Wrett,M,100,0,6,6
Wylen,M,100,0,6,6
Wyndsor,F,100,6,0,6
Xaia,F,100,6,0,6
Xaida,F,100,6,0,6
Xaira,F,100,6,0,6
Xaivion,M,100,0,6,6
Xhavier,M,100,0,6,6
Xi,F,100,6,0,6
Xinia,F,100,6,0,6
Xinran,F,100,6,0,6
Xiomayra,F,100,6,0,6
Xithlaly,F,100,6,0,6
Xitlalie,F,100,6,0,6
Xoaquin,M,100,0,6,6
Xuri,F,100,6,0,6
Xyana,F,100,6,0,6
Xylen,M,100,0,6,6
Xyliah,F,100,6,0,6
Xylus,M,100,0,6,6
Xyomara,F,100,6,0,6
Xyra,F,100,6,0,6
Xzarion,M,100,0,6,6
Xzayvien,M,100,0,6,6
Yachica,F,100,6,0,6
Yaditzel,F,100,6,0,6
Yahara,F,100,6,0,6
Yahire,F,100,6,0,6
Yaicha,F,100,6,0,6
Yain,M,100,0,6,6
Yairet,F,100,6,0,6
Yairon,M,100,0,6,6
Yakeem,M,100,0,6,6
Yakema,F,100,6,0,6
Yaleiza,F,100,6,0,6
Yalia,F,100,6,0,6
Yankarlo,M,100,0,6,6
Yannette,F,100,6,0,6
Yannira,F,100,6,0,6
Yannuel,M,100,0,6,6
Yaqoub,M,100,0,6,6
Yaralis,F,100,6,0,6
Yarazeth,F,100,6,0,6
Yardena,F,100,6,0,6
Yareily,F,100,6,0,6
Yarianny,F,100,6,0,6
Yaricelis,F,100,6,0,6
Yarik,M,100,0,6,6
Yarisleidi,F,100,6,0,6
Yarixsa,F,100,6,0,6
Yarley,M,100,0,6,6
Yaschica,F,100,6,0,6
Yasel,M,100,0,6,6
Yashaswini,F,100,6,0,6
Yasheca,F,100,6,0,6
Yashima,F,100,6,0,6
Yashita,F,100,6,0,6
Yashley,F,100,6,0,6
Yasina,F,100,6,0,6
Yasly,F,100,6,0,6
Yasmeli,F,100,6,0,6
Yasminda,F,100,6,0,6
Yasmira,F,100,6,0,6
Yasuhiro,M,100,0,6,6
Yatisha,F,100,6,0,6
Yavonna,F,100,6,0,6
Yaxiry,F,100,6,0,6
Yazareth,F,100,6,0,6
Ydania,F,100,6,0,6
Yeiry,F,100,6,0,6
Yejun,M,100,0,6,6
Yeleini,F,100,6,0,6
Yelisa,F,100,6,0,6
Yendy,F,100,6,0,6
Yenisel,F,100,6,0,6
Yensy,F,100,6,0,6
Yered,M,100,0,6,6
Yeritza,F,100,6,0,6
Yerli,F,100,6,0,6
Yermi,M,100,0,6,6
Yeruchem,M,100,0,6,6
Yesania,F,100,6,0,6
Yesenio,F,100,6,0,6
Yessi,F,100,6,0,6
Yetziel,M,100,0,6,6
Yevgeniy,M,100,0,6,6
Yhadira,F,100,6,0,6
Yiesha,F,100,6,0,6
Yilia,F,100,6,0,6
Yinuo,M,100,0,6,6
Yiyang,M,100,0,6,6
Yiyi,F,100,6,0,6
Ynhi,F,100,6,0,6
Yoexis,M,100,0,6,6
Yohandry,M,100,0,6,6
Yojaira,F,100,6,0,6
Yojhan,M,100,0,6,6
Yolandita,F,100,6,0,6
Yom,M,100,0,6,6
Yoram,M,100,0,6,6
Yorgelis,F,100,6,0,6
Yoshani,F,100,6,0,6
Yoshica,F,100,6,0,6
Yoshigey,F,100,6,0,6
Youseph,M,100,0,6,6
Ysidoro,M,100,0,6,6
Yudelca,F,100,6,0,6
Yudiel,M,100,0,6,6
Yulene,F,100,6,0,6
Yulexi,F,100,6,0,6
Yuleysi,F,100,6,0,6
Yurith,F,100,6,0,6
Yurivia,F,100,6,0,6
Yusof,M,100,0,6,6
Yusupha,M,100,0,6,6
Yutzil,F,100,6,0,6
Yuvansh,M,100,0,6,6
Yuvonka,F,100,6,0,6
Yuze,M,100,0,6,6
Yveline,F,100,6,0,6
Yvianna,F,100,6,0,6
Yzamar,F,100,6,0,6
Zabdy,F,100,6,0,6
Zabryna,F,100,6,0,6
Zacarion,M,100,0,6,6
Zackeria,M,100,0,6,6
Zadi,F,100,6,0,6
Zaen,M,100,0,6,6
Zahire,M,100,0,6,6
Zahkir,M,100,0,6,6
Zahmier,M,100,0,6,6
Zahmira,F,100,6,0,6
Zahnae,F,100,6,0,6
Zainaldeen,M,100,0,6,6
Zaisha,F,100,6,0,6
Zakaira,F,100,6,0,6
Zakarah,F,100,6,0,6
Zakayah,F,100,6,0,6
Zakaylah,F,100,6,0,6
Zakeri,M,100,0,6,6
Zakkariah,M,100,0,6,6
Zakrey,M,100,0,6,6
Zakyriah,F,100,6,0,6
Zalee,F,100,6,0,6
Zamarcus,M,100,0,6,6
Zamil,M,100,0,6,6
Zamorion,M,100,0,6,6
Zanaia,F,100,6,0,6
Zandaya,F,100,6,0,6
Zanisha,F,100,6,0,6
Zanoviah,F,100,6,0,6
Zantasia,F,100,6,0,6
Zanye,F,100,6,0,6
Zanyria,F,100,6,0,6
Zaory,F,100,6,0,6
Zaragoza,M,100,0,6,6
Zarchary,M,100,0,6,6
Zarella,F,100,6,0,6
Zarmina,F,100,6,0,6
Zarrius,M,100,0,6,6
Zasia,F,100,6,0,6
Zatavia,F,100,6,0,6
Zavhary,M,100,0,6,6
Zayleen,F,100,6,0,6
Zayshaun,M,100,0,6,6
Zebula,M,100,0,6,6
Zeenia,F,100,6,0,6
Zeilin,F,100,6,0,6
Zekial,M,100,0,6,6
Zekira,F,100,6,0,6
Zeljko,M,100,0,6,6
Zeron,M,100,0,6,6
Zeyla,F,100,6,0,6
Zhakira,F,100,6,0,6
Zhari,F,100,6,0,6
Zheng,M,100,0,6,6
Zhiya,F,100,6,0,6
Ziannah,F,100,6,0,6
Ziley,F,100,6,0,6
Zilin,F,100,6,0,6
Zilphia,F,100,6,0,6
Zim,M,100,0,6,6
Zimarion,M,100,0,6,6
Zoelyn,F,100,6,0,6
Zofie,F,100,6,0,6
Zoia,F,100,6,0,6
Zolin,M,100,0,6,6
Zophie,F,100,6,0,6
Zoravar,M,100,0,6,6
Zowii,F,100,6,0,6
Zsolt,M,100,0,6,6
Zui,M,100,0,6,6
Zunilda,F,100,6,0,6
Zuriana,F,100,6,0,6
Zurina,F,100,6,0,6
Zyahna,F,100,6,0,6
Zyairra,F,100,6,0,6
Zyariah,F,100,6,0,6
Zyashia,F,100,6,0,6
Zye,M,100,0,6,6
Zyell,M,100,0,6,6
Zyerre,M,100,0,6,6
Zyin,M,100,0,6,6
Zykerriah,F,100,6,0,6
Zyking,M,100,0,6,6
Zymair,M,100,0,6,6
Zymeire,M,100,0,6,6
Zymya,F,100,6,0,6
Zynovia,F,100,6,0,6
Zyrhiana,F,100,6,0,6
Zyri,F,100,6,0,6
Zyyanna,F,100,6,0,6
Zyyon,M,100,0,6,6
Aabid,M,100,0,5,5
Aadhyan,M,100,0,5,5
Aadian,M,100,0,5,5
Aadrian,M,100,0,5,5
Aadrit,M,100,0,5,5
Aafreen,F,100,5,0,5
Aahron,M,100,0,5,5
Aaiyana,F,100,5,0,5
Aaja,F,100,5,0,5
Aakanksha,F,100,5,0,5
Aakira,F,100,5,0,5
Aakiyah,F,100,5,0,5
Aaleeya,F,100,5,0,5
Aalias,M,100,0,5,5
Aalicia,F,100,5,0,5
Aaliyaa,F,100,5,0,5
Aallyah,F,100,5,0,5
Aalon,M,100,0,5,5
Aalyia,F,100,5,0,5
Aalyvia,F,100,5,0,5
Aamar,M,100,0,5,5
Aamaya,F,100,5,0,5
Aanand,M,100,0,5,5
Aanijah,F,100,5,0,5
Aapri,F,100,5,0,5
Aaraon,M,100,0,5,5
Aaratrika,F,100,5,0,5
Aari,M,100,0,5,5
Aarie,F,100,5,0,5
Aariyan,M,100,0,5,5
Aariyona,F,100,5,0,5
Aariyonna,F,100,5,0,5
Aaroh,M,100,0,5,5
Aarona,F,100,5,0,5
Aaronae,F,100,5,0,5
Aaronda,F,100,5,0,5
Aaronjacob,M,100,0,5,5
Aaronjosh,M,100,0,5,5
Aaronlee,M,100,0,5,5
Aarren,M,100,0,5,5
Aarshiya,F,100,5,0,5
Aarvin,M,100,0,5,5
Aaryona,F,100,5,0,5
Aaser,M,100,0,5,5
Aashana,F,100,5,0,5
Aashini,F,100,5,0,5
Aashman,M,100,0,5,5
Aashray,M,100,0,5,5
Aathan,M,100,0,5,5
Aavyan,M,100,0,5,5
Aayam,M,100,0,5,5
Aayra,F,100,5,0,5
Aayusha,F,100,5,0,5
Aazan,M,100,0,5,5
Abbaas,M,100,0,5,5
Abdalrhman,M,100,0,5,5
Abdelhadi,M,100,0,5,5
Abderrahman,M,100,0,5,5
Abdihamid,M,100,0,5,5
Abdikhaliq,M,100,0,5,5
Abdinajib,M,100,0,5,5
Abdisalam,M,100,0,5,5
Abdiwali,M,100,0,5,5
Abdourahman,M,100,0,5,5
Abduel,M,100,0,5,5
Abdulaye,M,100,0,5,5
Abdulazeem,M,100,0,5,5
Abdulbari,M,100,0,5,5
Abdulhalim,M,100,0,5,5
Abdulhameed,M,100,0,5,5
Abduljaleel,M,100,0,5,5
Abduljalil,M,100,0,5,5
Abdull,M,100,0,5,5
Abdulmalek,M,100,0,5,5
Abdulnasir,M,100,0,5,5
Abdulsamad,M,100,0,5,5
Abdulwadud,M,100,0,5,5
Abdurrahmaan,M,100,0,5,5
Abeal,M,100,0,5,5
Abegale,F,100,5,0,5
Abell,M,100,0,5,5
Aber,F,100,5,0,5
Abhinay,M,100,0,5,5
Abhinaya,F,100,5,0,5
Abianna,F,100,5,0,5
Abilio,M,100,0,5,5
Abilyn,F,100,5,0,5
Abinadab,M,100,0,5,5
Abraar,M,100,0,5,5
Abranda,F,100,5,0,5
Abreya,F,100,5,0,5
Abriam,M,100,0,5,5
Abriele,F,100,5,0,5
Abrihet,F,100,5,0,5
Acein,M,100,0,5,5
Achan,F,100,5,0,5
Achanti,F,100,5,0,5
Achilleus,M,100,0,5,5
Aciano,M,100,0,5,5
Acob,M,100,0,5,5
Adacia,F,100,5,0,5
Adae,M,100,0,5,5
Adairis,F,100,5,0,5
Adalade,F,100,5,0,5
Adale,F,100,5,0,5
Adalhi,F,100,5,0,5
Adalisse,F,100,5,0,5
Adaliyah,F,100,5,0,5
Adamma,F,100,5,0,5
Adannaya,F,100,5,0,5
Adari,M,100,0,5,5
Adavia,F,100,5,0,5
Adbeel,M,100,0,5,5
Addalina,F,100,5,0,5
Addelyne,F,100,5,0,5
Addicus,M,100,0,5,5
Addieson,F,100,5,0,5
Addiline,F,100,5,0,5
Addington,F,100,5,0,5
Addiston,F,100,5,0,5
Addix,M,100,0,5,5
Addlee,F,100,5,0,5
Addonis,M,100,0,5,5
Addriana,F,100,5,0,5
Addsion,F,100,5,0,5
Addylan,F,100,5,0,5
Adeanna,F,100,5,0,5
Adedotun,M,100,0,5,5
Adeem,M,100,0,5,5
Adeen,M,100,0,5,5
Adekemi,F,100,5,0,5
Adelah,F,100,5,0,5
Adelane,F,100,5,0,5
Adeleke,M,100,0,5,5
Adelice,F,100,5,0,5
Adelino,M,100,0,5,5
Adellia,F,100,5,0,5
Adelya,F,100,5,0,5
Adelys,F,100,5,0,5
Adera,F,100,5,0,5
Adero,F,100,5,0,5
Adesha,F,100,5,0,5
Adesina,F,100,5,0,5
Adetola,M,100,0,5,5
Adeva,F,100,5,0,5
Adger,M,100,0,5,5
Adheesh,M,100,0,5,5
Adikus,M,100,0,5,5
Adiley,F,100,5,0,5
Adirah,F,100,5,0,5
Adji,F,100,5,0,5
Adjua,F,100,5,0,5
Adlan,M,100,0,5,5
Adlar,M,100,0,5,5
Adlea,F,100,5,0,5
Adlean,F,100,5,0,5
Adlene,F,100,5,0,5
Adlina,F,100,5,0,5
Adn,F,100,5,0,5
Adnel,M,100,0,5,5
Adnrea,F,100,5,0,5
Adolphe,M,100,0,5,5
Adoncia,F,100,5,0,5
Adones,M,100,0,5,5
Adoniz,M,100,0,5,5
Adorae,F,100,5,0,5
Adorn,F,100,5,0,5
Adreauna,F,100,5,0,5
Adrell,M,100,0,5,5
Adreyona,F,100,5,0,5
Adriam,M,100,0,5,5
Adriennie,F,100,5,0,5
Adrieonna,F,100,5,0,5
Adrihana,F,100,5,0,5
Adris,M,100,0,5,5
Adriunna,F,100,5,0,5
Adry,F,100,5,0,5
Adryanah,F,100,5,0,5
Adryann,F,100,5,0,5
Adryauna,F,100,5,0,5
Adryonna,F,100,5,0,5
Adulfo,M,100,0,5,5
Adwaith,M,100,0,5,5
Adwitiya,F,100,5,0,5
Adylenne,F,100,5,0,5
Adylina,F,100,5,0,5
Adylinn,F,100,5,0,5
Adym,M,100,0,5,5
Adysun,F,100,5,0,5
Aelisa,F,100,5,0,5
Aelish,F,100,5,0,5
Aeri,F,100,5,0,5
Aerian,M,100,0,5,5
Aericka,F,100,5,0,5
Aeryona,F,100,5,0,5
Aevry,F,100,5,0,5
Affaan,M,100,0,5,5
Affie,F,100,5,0,5
Affinity,F,100,5,0,5
Afonso,M,100,0,5,5
Africia,F,100,5,0,5
Agel,M,100,0,5,5
Agent,M,100,0,5,5
Aggeliki,F,100,5,0,5
Agnesa,F,100,5,0,5
Agnese,F,100,5,0,5
Agnew,M,100,0,5,5
Agusta,F,100,5,0,5
Aharshi,M,100,0,5,5
Ahaziah,M,100,0,5,5
Aheli,F,100,5,0,5
Ahir,M,100,0,5,5
Ahjahnae,F,100,5,0,5
Ahkil,M,100,0,5,5
Ahlai,F,100,5,0,5
Ahlanie,F,100,5,0,5
Ahleeyah,F,100,5,0,5
Ahlona,F,100,5,0,5
Ahlyana,F,100,5,0,5
Ahlyvia,F,100,5,0,5
Ahmarria,F,100,5,0,5
Ahmonie,F,100,5,0,5
Ahnah,F,100,5,0,5
Ahnaleigh,F,100,5,0,5
Ahnari,F,100,5,0,5
Ahnyia,F,100,5,0,5
Ahona,F,100,5,0,5
Ahreanna,F,100,5,0,5
Ahshanti,F,100,5,0,5
Ahsoka,F,100,5,0,5
Ahtyana,F,100,5,0,5
Ahvianna,F,100,5,0,5
Ahyonna,F,100,5,0,5
Ahzhane,F,100,5,0,5
Aian,M,100,0,5,5
Aicen,M,100,0,5,5
Aidanjohn,M,100,0,5,5
Aidar,M,100,0,5,5
Aidenjoseph,M,100,0,5,5
Aidenmatthew,M,100,0,5,5
Aidenmichael,M,100,0,5,5
Aidet,F,100,5,0,5
Aidien,M,100,0,5,5
Aidrianna,F,100,5,0,5
Aidyen,M,100,0,5,5
Aiedan,M,100,0,5,5
Aieshia,F,100,5,0,5
Aiham,M,100,0,5,5
Aijahlon,M,100,0,5,5
Aijha,F,100,5,0,5
Aileigh,F,100,5,0,5
Aileny,F,100,5,0,5
Ailiana,F,100,5,0,5
Aimani,F,100,5,0,5
Aini,F,100,5,0,5
Aiona,F,100,5,0,5
Airan,M,100,0,5,5
Aireka,F,100,5,0,5
Airian,F,100,5,0,5
Airiona,F,100,5,0,5
Airius,M,100,0,5,5
Airron,M,100,0,5,5
Airyona,F,100,5,0,5
Airys,F,100,5,0,5
Aishatu,F,100,5,0,5
Aishe,F,100,5,0,5
Aishlin,F,100,5,0,5
Aishlyn,F,100,5,0,5
Aisja,F,100,5,0,5
Aisleigh,F,100,5,0,5
Aisya,F,100,5,0,5
Aivley,F,100,5,0,5
Aivry,F,100,5,0,5
Aizeah,M,100,0,5,5
Aizel,M,100,0,5,5
Aizleigh,F,100,5,0,5
Ajacia,F,100,5,0,5
Ajahnay,F,100,5,0,5
Ajayah,F,100,5,0,5
Ajaye,M,100,0,5,5
Ajhane,F,100,5,0,5
Ajhani,M,100,0,5,5
Ajiya,F,100,5,0,5
Ajsha,F,100,5,0,5
Ajua,F,100,5,0,5
Akachi,M,100,0,5,5
Akadian,M,100,0,5,5
Akaja,F,100,5,0,5
Akam,M,100,0,5,5
Akaycia,F,100,5,0,5
Akayden,M,100,0,5,5
Akaysia,F,100,5,0,5
Akeam,M,100,0,5,5
Akeiya,F,100,5,0,5
Akem,M,100,0,5,5
Aken,M,100,0,5,5
Akendra,F,100,5,0,5
Akeriah,F,100,5,0,5
Aketzalli,F,100,5,0,5
Akeyra,F,100,5,0,5
Akhi,M,100,0,5,5
Akhiya,F,100,5,0,5
Akie,M,100,0,5,5
Akilesh,M,100,0,5,5
Akilia,F,100,5,0,5
Akiylah,F,100,5,0,5
Akiyra,F,100,5,0,5
Akos,M,100,0,5,5
Akosha,F,100,5,0,5
Akosita,F,100,5,0,5
Akoya,F,100,5,0,5
Akria,F,100,5,0,5
Aksa,F,100,5,0,5
Akshan,M,100,0,5,5
Alaana,F,100,5,0,5
Alacyia,F,100,5,0,5
Aladrian,F,100,5,0,5
Alae,F,100,5,0,5
Alafia,F,100,5,0,5
Alah,F,100,5,0,5
Alaida,F,100,5,0,5
Alaiha,F,100,5,0,5
Alaizha,F,100,5,0,5
Alajhia,F,100,5,0,5
Alalah,F,100,5,0,5
Alander,M,100,0,5,5
Alanoud,F,100,5,0,5
Alaunah,F,100,5,0,5
Alaxis,F,100,5,0,5
Alaynia,F,100,5,0,5
Alazhia,F,100,5,0,5
Albano,M,100,0,5,5
Albee,F,100,5,0,5
Albertico,M,100,0,5,5
Albertjames,M,100,0,5,5
Albieris,M,100,0,5,5
Albria,F,100,5,0,5
Alcibiades,M,100,0,5,5
Alcina,F,100,5,0,5
Alcus,M,100,0,5,5
Aldayr,M,100,0,5,5
Aldemar,M,100,0,5,5
Aldrik,M,100,0,5,5
Aldrina,F,100,5,0,5
Aldus,M,100,0,5,5
Aleandra,F,100,5,0,5
Aleatra,F,100,5,0,5
Aleca,F,100,5,0,5
Alecander,M,100,0,5,5
Aleceia,F,100,5,0,5
Alecsis,F,100,5,0,5
Alecxia,F,100,5,0,5
Aledra,F,100,5,0,5
Aleeana,F,100,5,0,5
Aleecya,F,100,5,0,5
Aleeka,F,100,5,0,5
Alegacy,F,100,5,0,5
Alei,F,100,5,0,5
Aleighana,F,100,5,0,5
Aleighanna,F,100,5,0,5
Aleiha,F,100,5,0,5
Aleily,F,100,5,0,5
Aleita,F,100,5,0,5
Alejadro,M,100,0,5,5
Alekay,M,100,0,5,5
Alekos,M,100,0,5,5
Aleksah,F,100,5,0,5
Aleksandre,M,100,0,5,5
Aleksandrs,M,100,0,5,5
Alekzandra,F,100,5,0,5
Alela,F,100,5,0,5
Aleona,F,100,5,0,5
Aleq,M,100,0,5,5
Alerah,F,100,5,0,5
Alero,F,100,5,0,5
Alessand,M,100,0,5,5
Alexand,M,100,0,5,5
Alexandira,F,100,5,0,5
Alexandreia,F,100,5,0,5
Alexann,F,100,5,0,5
Alexanra,F,100,5,0,5
Alexaray,F,100,5,0,5
Alexavia,F,100,5,0,5
Alexeus,F,100,5,0,5
Alexian,M,100,0,5,5
Alexisjade,F,100,5,0,5
Alexisnicole,F,100,5,0,5
Alexous,F,100,5,0,5
Alexson,M,100,0,5,5
Alexsondra,F,100,5,0,5
Alexusia,F,100,5,0,5
Alexxes,F,100,5,0,5
Alexyanna,F,100,5,0,5
Alexzandyr,M,100,0,5,5
Alexzis,F,100,5,0,5
Alezandria,F,100,5,0,5
Alfanette,F,100,5,0,5
Alfonzie,M,100,0,5,5
Alfreada,F,100,5,0,5
Alfreeda,F,100,5,0,5
Alga,F,100,5,0,5
Algia,M,100,0,5,5
Alhakim,M,100,0,5,5
Alham,F,100,5,0,5
Alianne,F,100,5,0,5
Aliannie,F,100,5,0,5
Aliauna,F,100,5,0,5
Aliaz,M,100,0,5,5
Aliccia,F,100,5,0,5
Alidiya,F,100,5,0,5
Alieen,F,100,5,0,5
Alienna,F,100,5,0,5
Alieshia,F,100,5,0,5
Aliette,F,100,5,0,5
Aliisa,F,100,5,0,5
Alikhan,M,100,0,5,5
Aliliana,F,100,5,0,5
Alinea,F,100,5,0,5
Alirah,F,100,5,0,5
Alish,F,100,5,0,5
Alishaba,F,100,5,0,5
Alisiah,F,100,5,0,5
Aliska,F,100,5,0,5
Alissondra,F,100,5,0,5
Alista,F,100,5,0,5
Alisun,F,100,5,0,5
Alitia,F,100,5,0,5
Aliveya,F,100,5,0,5
Alixe,F,100,5,0,5
Alixia,F,100,5,0,5
Aliyia,F,100,5,0,5
Aliysha,F,100,5,0,5
Alizai,F,100,5,0,5
Alizet,F,100,5,0,5
Aliziah,F,100,5,0,5
Aljay,M,100,0,5,5
Aljoharah,F,100,5,0,5
Allam,M,100,0,5,5
Allanie,F,100,5,0,5
Allasia,F,100,5,0,5
Allateef,M,100,0,5,5
Allaynah,F,100,5,0,5
Allayne,F,100,5,0,5
Alleigha,F,100,5,0,5
Alleisha,F,100,5,0,5
Allenah,F,100,5,0,5
Allenna,F,100,5,0,5
Allese,F,100,5,0,5
Allesia,F,100,5,0,5
Allessa,F,100,5,0,5
Allexandria,F,100,5,0,5
Allimae,F,100,5,0,5
Allinah,F,100,5,0,5
Alliona,F,100,5,0,5
Allionna,F,100,5,0,5
Allisin,F,100,5,0,5
Alliyiah,F,100,5,0,5
Allizae,F,100,5,0,5
Allize,F,100,5,0,5
Allonah,F,100,5,0,5
Allonzo,M,100,0,5,5
Allson,F,100,5,0,5
Allya,F,100,5,0,5
Allyonna,F,100,5,0,5
Allysse,F,100,5,0,5
Allyza,F,100,5,0,5
Almaz,F,100,5,0,5
Almeater,F,100,5,0,5
Almetra,F,100,5,0,5
Almida,F,100,5,0,5
Almondo,M,100,0,5,5
Almonza,M,100,0,5,5
Almyra,F,100,5,0,5
Alnesha,F,100,5,0,5
Alohna,F,100,5,0,5
Alpesh,M,100,0,5,5
Alphea,F,100,5,0,5
Alphonce,M,100,0,5,5
Alrahman,M,100,0,5,5
Alray,M,100,0,5,5
Alsexander,M,100,0,5,5
Alshon,M,100,0,5,5
Altarik,M,100,0,5,5
Alterik,M,100,0,5,5
Althelia,F,100,5,0,5
Altonette,F,100,5,0,5
Altonya,F,100,5,0,5
Altoria,F,100,5,0,5
Altrice,F,100,5,0,5
Altrina,F,100,5,0,5
Alvania,F,100,5,0,5
Alvar,M,100,0,5,5
Alver,M,100,0,5,5
Alverda,F,100,5,0,5
Alvieri,M,100,0,5,5
Alvontae,M,100,0,5,5
Alxavier,M,100,0,5,5
Alycee,F,100,5,0,5
Alyceia,F,100,5,0,5
Alyessa,F,100,5,0,5
Alyias,M,100,0,5,5
Alyicia,F,100,5,0,5
Alympia,F,100,5,0,5
Alymuhammad,M,100,0,5,5
Alynia,F,100,5,0,5
Alyssarae,F,100,5,0,5
Alyssarose,F,100,5,0,5
Alysun,F,100,5,0,5
Alywin,M,100,0,5,5
Alyxus,F,100,5,0,5
Amaari,M,100,0,5,5
Amadita,F,100,5,0,5
Amagine,F,100,5,0,5
Amaijah,F,100,5,0,5
Amais,M,100,0,5,5
Amalyah,F,100,5,0,5
Amalyn,F,100,5,0,5
Amandaleigh,F,100,5,0,5
Amania,F,100,5,0,5
Amanita,F,100,5,0,5
Amanjit,M,100,0,5,5
Amanjot,M,100,0,5,5
Amarantha,F,100,5,0,5
Amareah,F,100,5,0,5
Amareona,F,100,5,0,5
Amareyon,M,100,0,5,5
Amarhi,F,100,5,0,5
Amariae,M,100,0,5,5
Amariani,F,100,5,0,5
Amariauna,F,100,5,0,5
Amarina,F,100,5,0,5
Amaron,M,100,0,5,5
Amarpreet,F,100,5,0,5
Amaryana,F,100,5,0,5
Amato,M,100,0,5,5
Amaylee,F,100,5,0,5
Ambee,F,100,5,0,5
Amberrae,F,100,5,0,5
Ambir,F,100,5,0,5
Ambreanna,F,100,5,0,5
Ameelia,F,100,5,0,5
Ameeya,F,100,5,0,5
Ameika,F,100,5,0,5
Ameil,M,100,0,5,5
Ameire,M,100,0,5,5
Ameiya,F,100,5,0,5
Amelah,F,100,5,0,5
Ameleah,F,100,5,0,5
Amelee,F,100,5,0,5
Amelita,F,100,5,0,5
Amenata,F,100,5,0,5
Ameriana,F,100,5,0,5
Amerissa,F,100,5,0,5
Amerius,F,100,5,0,5
Amerson,M,100,0,5,5
Ameryst,F,100,5,0,5
Amhad,M,100,0,5,5
Amiaha,F,100,5,0,5
Amicia,F,100,5,0,5
Amiia,F,100,5,0,5
Amiin,M,100,0,5,5
Amilie,F,100,5,0,5
Amilliona,F,100,5,0,5
Amilliyon,F,100,5,0,5
Aminna,F,100,5,0,5
Amino,F,100,5,0,5
Amirbek,M,100,0,5,5
Amirea,F,100,5,0,5
Amirh,F,100,5,0,5
Amirie,F,100,5,0,5
Amiryah,F,100,5,0,5
Amisaday,F,100,5,0,5
Amista,F,100,5,0,5
Amistad,M,100,0,5,5
Ammer,M,100,0,5,5
Amolika,F,100,5,0,5
Amone,F,100,5,0,5
Amonii,F,100,5,0,5
Amont,M,100,0,5,5
Amonta,M,100,0,5,5
Amorae,F,100,5,0,5
Amorra,F,100,5,0,5
Amrah,F,100,5,0,5
Amrith,M,100,0,5,5
Amruth,M,100,0,5,5
Amsey,F,100,5,0,5
Amukta,F,100,5,0,5
Amuri,M,100,0,5,5
Amvi,F,100,5,0,5
Amyrikal,F,100,5,0,5
Amythyst,F,100,5,0,5
Amyya,F,100,5,0,5
Amzee,F,100,5,0,5
Amzi,F,100,5,0,5
Anabele,F,100,5,0,5
Anabelli,F,100,5,0,5
Anaberta,F,100,5,0,5
Anacelis,F,100,5,0,5
Anacely,F,100,5,0,5
Anacia,F,100,5,0,5
Anaeja,F,100,5,0,5
Anaelise,F,100,5,0,5
Anagh,M,100,0,5,5
Anaisia,F,100,5,0,5
Anakah,F,100,5,0,5
Analexis,F,100,5,0,5
Analidia,F,100,5,0,5
Analiesa,F,100,5,0,5
Analiha,F,100,5,0,5
Analily,F,100,5,0,5
Analydia,F,100,5,0,5
Analyss,F,100,5,0,5
Analyssia,F,100,5,0,5
Anamar,F,100,5,0,5
Anamary,F,100,5,0,5
Anamia,F,100,5,0,5
Anamile,F,100,5,0,5
Anandita,F,100,5,0,5
Ananyaa,F,100,5,0,5
Anariya,F,100,5,0,5
Anashe,F,100,5,0,5
Anastajia,F,100,5,0,5
Anavay,F,100,5,0,5
Anavela,F,100,5,0,5
Anaviah,F,100,5,0,5
Anayelis,F,100,5,0,5
Anayis,F,100,5,0,5
Anberlynn,F,100,5,0,5
Ance,M,100,0,5,5
Ancika,F,100,5,0,5
Andaiye,F,100,5,0,5
Andalucia,F,100,5,0,5
Andea,F,100,5,0,5
Anderea,F,100,5,0,5
Andice,F,100,5,0,5
Andis,M,100,0,5,5
Andols,M,100,0,5,5
Andonia,F,100,5,0,5
Andrade,M,100,0,5,5
Andreca,F,100,5,0,5
Andreita,F,100,5,0,5
Andrek,M,100,0,5,5
Andrenae,F,100,5,0,5
Andress,M,100,0,5,5
Andricka,F,100,5,0,5
Andrienna,F,100,5,0,5
Andrietta,F,100,5,0,5
Androniki,F,100,5,0,5
Androw,M,100,0,5,5
Aneeya,F,100,5,0,5
Aneicia,F,100,5,0,5
Aneiyah,F,100,5,0,5
Aner,M,100,0,5,5
Aneria,F,100,5,0,5
Aneva,F,100,5,0,5
Aneyda,F,100,5,0,5
Aneysa,F,100,5,0,5
Aneysha,F,100,5,0,5
Anferne,M,100,0,5,5
Anferney,M,100,0,5,5
Angeal,M,100,0,5,5
Angelah,F,100,5,0,5
Angelamaria,F,100,5,0,5
Angeleca,F,100,5,0,5
Angelick,F,100,5,0,5
Angelike,F,100,5,0,5
Angeliqu,F,100,5,0,5
Angelite,F,100,5,0,5
Angelith,F,100,5,0,5
Angeliya,F,100,5,0,5
Angelleigh,F,100,5,0,5
Angellyna,F,100,5,0,5
Angelou,M,100,0,5,5
Angeluis,M,100,0,5,5
Angenie,F,100,5,0,5
Anges,F,100,5,0,5
Angil,F,100,5,0,5
Angilina,F,100,5,0,5
Anglene,F,100,5,0,5
Angler,M,100,0,5,5
Anhtuan,M,100,0,5,5
Aniaha,F,100,5,0,5
Anietra,F,100,5,0,5
Aniha,F,100,5,0,5
Anij,F,100,5,0,5
Anijae,F,100,5,0,5
Anijia,F,100,5,0,5
Anikia,F,100,5,0,5
Anilyn,F,100,5,0,5
Anime,F,100,5,0,5
Anirud,M,100,0,5,5
Anisette,F,100,5,0,5
Anisley,F,100,5,0,5
Anisse,F,100,5,0,5
Anitrea,F,100,5,0,5
Anivia,F,100,5,0,5
Aniyaha,F,100,5,0,5
Aniye,F,100,5,0,5
Aniysa,F,100,5,0,5
Anjalika,F,100,5,0,5
Anjaliyah,F,100,5,0,5
Anjanett,F,100,5,0,5
Anjelyka,F,100,5,0,5
Anjelyn,F,100,5,0,5
Anjennette,F,100,5,0,5
Anjola,F,100,5,0,5
Anjolena,F,100,5,0,5
Anjolique,F,100,5,0,5
Anjrue,M,100,0,5,5
Anke,F,100,5,0,5
Anker,M,100,0,5,5
Ankoor,M,100,0,5,5
Anley,F,100,5,0,5
Anlin,F,100,5,0,5
Anly,F,100,5,0,5
Annabellah,F,100,5,0,5
Annabellelee,F,100,5,0,5
Annahbella,F,100,5,0,5
Annaira,F,100,5,0,5
Annaise,F,100,5,0,5
Annajoy,F,100,5,0,5
Annakathryn,F,100,5,0,5
Annakiya,F,100,5,0,5
Annaleisa,F,100,5,0,5
Annalice,F,100,5,0,5
Annaliisa,F,100,5,0,5
Annaliya,F,100,5,0,5
Annaluisa,F,100,5,0,5
Annalyne,F,100,5,0,5
Annalyss,F,100,5,0,5
Annalyssia,F,100,5,0,5
Annanya,F,100,5,0,5
Annaruth,F,100,5,0,5
Annasha,F,100,5,0,5
Annastassia,F,100,5,0,5
Annea,F,100,5,0,5
Annelyn,F,100,5,0,5
Annelys,F,100,5,0,5
Annemargaret,F,100,5,0,5
Annemary,F,100,5,0,5
Annese,F,100,5,0,5
Anneshia,F,100,5,0,5
Annetha,F,100,5,0,5
Anniqua,F,100,5,0,5
Annjelica,F,100,5,0,5
Annmari,F,100,5,0,5
Annmaria,F,100,5,0,5
Annon,M,100,0,5,5
Annslie,F,100,5,0,5
Anoki,M,100,0,5,5
Anon,M,100,0,5,5
Anooj,M,100,0,5,5
Anousone,M,100,0,5,5
Anova,F,100,5,0,5
Anquavious,M,100,0,5,5
Anquetta,F,100,5,0,5
Anquinetta,F,100,5,0,5
Anre,M,100,0,5,5
Anri,M,100,0,5,5
Ansal,F,100,5,0,5
Ansara,M,100,0,5,5
Anshveer,M,100,0,5,5
Ansli,F,100,5,0,5
Ansony,M,100,0,5,5
Ansu,M,100,0,5,5
Antajuan,M,100,0,5,5
Antanea,F,100,5,0,5
Antaysia,F,100,5,0,5
Antea,F,100,5,0,5
Antesha,F,100,5,0,5
Anthani,M,100,0,5,5
Antheny,M,100,0,5,5
Anthoine,M,100,0,5,5
Anthory,M,100,0,5,5
Antianna,F,100,5,0,5
Antinisha,F,100,5,0,5
Antoinese,F,100,5,0,5
Antoinesha,F,100,5,0,5
Antojuan,M,100,0,5,5
Antolina,F,100,5,0,5
Antona,F,100,5,0,5
Antonese,F,100,5,0,5
Antoneyo,M,100,0,5,5
Antonial,M,100,0,5,5
Antonica,F,100,5,0,5
Antoniyo,M,100,0,5,5
Antonnia,F,100,5,0,5
Antonny,M,100,0,5,5
Antorria,F,100,5,0,5
Antowain,M,100,0,5,5
Antowne,M,100,0,5,5
Antravion,M,100,0,5,5
Antre,M,100,0,5,5
Antrea,F,100,5,0,5
Antrez,M,100,0,5,5
Antrione,M,100,0,5,5
Antroy,M,100,0,5,5
Anttwan,M,100,0,5,5
Antuwan,M,100,0,5,5
Antwanett,F,100,5,0,5
Antwin,M,100,0,5,5
Antwonn,M,100,0,5,5
Antyone,M,100,0,5,5
Anudeep,M,100,0,5,5
Anupriya,F,100,5,0,5
Anusri,F,100,5,0,5
Anwaar,F,100,5,0,5
Anwan,M,100,0,5,5
Anwon,M,100,0,5,5
Anyila,F,100,5,0,5
Anyjha,F,100,5,0,5
Anyree,F,100,5,0,5
Anyriah,F,100,5,0,5
Anze,M,100,0,5,5
Anzlie,F,100,5,0,5
Aonna,F,100,5,0,5
Aous,M,100,0,5,5
Apasra,F,100,5,0,5
Aphton,F,100,5,0,5
Apostolis,M,100,0,5,5
Aprecious,F,100,5,0,5
Apriel,F,100,5,0,5
Apriljoy,F,100,5,0,5
Aqilah,F,100,5,0,5
Aquaisha,F,100,5,0,5
Aquala,F,100,5,0,5
Aquanis,M,100,0,5,5
Aquasha,F,100,5,0,5
Aquavia,F,100,5,0,5
Aquavion,M,100,0,5,5
Aqueela,F,100,5,0,5
Aquera,F,100,5,0,5
Aquiel,F,100,5,0,5
Aquileo,M,100,0,5,5
Aquilina,F,100,5,0,5
Aquinas,M,100,0,5,5
Ar,M,100,0,5,5
Aracel,F,100,5,0,5
Aracelio,M,100,0,5,5
Araceliz,F,100,5,0,5
Aracellie,F,100,5,0,5
Araelynn,F,100,5,0,5
Arahbella,F,100,5,0,5
Arahi,F,100,5,0,5
Aralis,F,100,5,0,5
Aramie,F,100,5,0,5
Aramys,M,100,0,5,5
Arayeli,F,100,5,0,5
Araz,M,100,0,5,5
Arazeli,F,100,5,0,5
Arbrianna,F,100,5,0,5
Arcadian,M,100,0,5,5
Arcadius,M,100,0,5,5
Ardia,F,100,5,0,5
Ardina,F,100,5,0,5
Arean,M,100,0,5,5
Areecia,F,100,5,0,5
Areigha,F,100,5,0,5
Areionna,F,100,5,0,5
Argene,M,100,0,5,5
Argiro,F,100,5,0,5
Argyro,F,100,5,0,5
Ariaan,M,100,0,5,5
Ariadnne,F,100,5,0,5
Ariajade,F,100,5,0,5
Ariale,F,100,5,0,5
Arialle,F,100,5,0,5
Ariamarie,F,100,5,0,5
Arianamarie,F,100,5,0,5
Arielyn,F,100,5,0,5
Arienette,F,100,5,0,5
Arieus,M,100,0,5,5
Ariiana,F,100,5,0,5
Arijit,M,100,0,5,5
Arikah,F,100,5,0,5
Arim,F,100,5,0,5
Arinola,F,100,5,0,5
Arisleidy,F,100,5,0,5
Arismel,F,100,5,0,5
Arismendy,M,100,0,5,5
Aristedes,M,100,0,5,5
Aritra,M,100,0,5,5
Ariunna,F,100,5,0,5
Ariyauna,F,100,5,0,5
Ariyha,F,100,5,0,5
Arjae,M,100,0,5,5
Arjeta,F,100,5,0,5
Arkadian,M,100,0,5,5
Arkadiusz,M,100,0,5,5
Arkeba,F,100,5,0,5
Arkee,M,100,0,5,5
Arkita,F,100,5,0,5
Arko,M,100,0,5,5
Arlea,F,100,5,0,5
Arlease,F,100,5,0,5
Arlete,F,100,5,0,5
Arlex,M,100,0,5,5
Arliana,F,100,5,0,5
Arlice,F,100,5,0,5
Arliene,F,100,5,0,5
Arlynes,F,100,5,0,5
Arlyss,F,100,5,0,5
Armaad,M,100,0,5,5
Armana,F,100,5,0,5
Armann,M,100,0,5,5
Armenia,F,100,5,0,5
Armeta,F,100,5,0,5
Armetrice,F,100,5,0,5
Armilda,F,100,5,0,5
Armistead,M,100,0,5,5
Armonnie,F,100,5,0,5
Armonta,M,100,0,5,5
Arnae,F,100,5,0,5
Arnald,M,100,0,5,5
Arnardo,M,100,0,5,5
Arnedra,F,100,5,0,5
Arneice,F,100,5,0,5
Arnelia,F,100,5,0,5
Arner,M,100,0,5,5
Arnesto,M,100,0,5,5
Arnica,F,100,5,0,5
Arniece,F,100,5,0,5
Arniesha,F,100,5,0,5
Arnise,F,100,5,0,5
Arnitha,F,100,5,0,5
Arnob,M,100,0,5,5
Arnolfo,M,100,0,5,5
Arnon,M,100,0,5,5
Arny,M,100,0,5,5
Arpa,F,100,5,0,5
Arquan,M,100,0,5,5
Arquimedes,M,100,0,5,5
Arrabelle,F,100,5,0,5
Arriane,F,100,5,0,5
Arriannah,F,100,5,0,5
Arrik,M,100,0,5,5
Arrius,M,100,0,5,5
Arrya,F,100,5,0,5
Arryon,F,100,5,0,5
Arsene,M,100,0,5,5
Arseno,M,100,0,5,5
Arshanti,F,100,5,0,5
Arshon,M,100,0,5,5
Arshveer,M,100,0,5,5
Artadius,M,100,0,5,5
Artemia,F,100,5,0,5
Artemiy,M,100,0,5,5
Artemy,M,100,0,5,5
Artensia,F,100,5,0,5
Arthas,M,100,0,5,5
Arthell,M,100,0,5,5
Artherine,F,100,5,0,5
Arthuree,F,100,5,0,5
Artra,F,100,5,0,5
Artresha,F,100,5,0,5
Arundhati,F,100,5,0,5
Aruthur,M,100,0,5,5
Arvelle,M,100,0,5,5
Arvi,F,100,5,0,5
Arvia,F,100,5,0,5
Arvion,M,100,0,5,5
Arvydas,M,100,0,5,5
Arwilda,F,100,5,0,5
Aryela,F,100,5,0,5
Aryo,M,100,0,5,5
Arysta,F,100,5,0,5
Aryton,M,100,0,5,5
Arzetta,F,100,5,0,5
Arzie,M,100,0,5,5
Arzoo,F,100,5,0,5
Asacia,F,100,5,0,5
Asada,F,100,5,0,5
Asaiya,F,100,5,0,5
Asala,F,100,5,0,5
Asaria,F,100,5,0,5
Asasha,F,100,5,0,5
Asaya,M,100,0,5,5
Aschton,M,100,0,5,5
Asdrubal,M,100,0,5,5
Aseante,M,100,0,5,5
Aseda,M,100,0,5,5
Asela,F,100,5,0,5
Aselin,F,100,5,0,5
Asfia,F,100,5,0,5
Ashadieeyah,F,100,5,0,5
Ashalina,F,100,5,0,5
Ashane,F,100,5,0,5
Ashanee,F,100,5,0,5
Ashantey,F,100,5,0,5
Ashantiana,F,100,5,0,5
Asharri,F,100,5,0,5
Ashaud,M,100,0,5,5
Ashaunie,F,100,5,0,5
Ashaunta,F,100,5,0,5
Ashauntae,F,100,5,0,5
Ashawni,F,100,5,0,5
Ashburn,M,100,0,5,5
Ashee,F,100,5,0,5
Ashgan,F,100,5,0,5
Ashianna,F,100,5,0,5
Ashilee,F,100,5,0,5
Ashini,F,100,5,0,5
Ashlae,F,100,5,0,5
Ashleeann,F,100,5,0,5
Ashlely,F,100,5,0,5
Ashleykate,F,100,5,0,5
Ashleyrae,F,100,5,0,5
Ashliy,F,100,5,0,5
Ashney,F,100,5,0,5
Ashoka,M,100,0,5,5
Ashor,M,100,0,5,5
Ashriya,F,100,5,0,5
Ashuna,F,100,5,0,5
Ashura,F,100,5,0,5
Ashvi,F,100,5,0,5
Ashyiah,F,100,5,0,5
Ashyria,F,100,5,0,5
Asianah,F,100,5,0,5
Asianay,F,100,5,0,5
Asiane,F,100,5,0,5
Asiaonna,F,100,5,0,5
Asis,M,100,0,5,5
Aslam,M,100,0,5,5
Aslee,F,100,5,0,5
Asrar,F,100,5,0,5
Assandra,F,100,5,0,5
Assma,F,100,5,0,5
Astley,M,100,0,5,5
Asul,F,100,5,0,5
Asuna,F,100,5,0,5
Aswath,M,100,0,5,5
Asyana,F,100,5,0,5
Aszure,F,100,5,0,5
Atal,M,100,0,5,5
Atalanta,F,100,5,0,5
Ataly,F,100,5,0,5
Atem,M,100,0,5,5
Aten,M,100,0,5,5
Atena,F,100,5,0,5
Ater,M,100,0,5,5
Atesha,F,100,5,0,5
Atheer,F,100,5,0,5
Athenamarie,F,100,5,0,5
Athenna,F,100,5,0,5
Atie,F,100,5,0,5
Atifa,F,100,5,0,5
Atinuke,F,100,5,0,5
Atlean,F,100,5,0,5
Atoli,F,100,5,0,5
Atong,F,100,5,0,5
Atravion,M,100,0,5,5
Atreau,M,100,0,5,5
Atreo,M,100,0,5,5
Atreu,M,100,0,5,5
Atricia,F,100,5,0,5
Attie,F,100,5,0,5
Aubreah,F,100,5,0,5
Aubreauna,F,100,5,0,5
Aubreella,F,100,5,0,5
Aubrelle,F,100,5,0,5
Aubreona,F,100,5,0,5
Aubreyelle,F,100,5,0,5
Aubreyrose,F,100,5,0,5
Aubrilyn,F,100,5,0,5
Aubriyana,F,100,5,0,5
Aubryella,F,100,5,0,5
Aubryelle,F,100,5,0,5
Aude,F,100,5,0,5
Audelio,M,100,0,5,5
Audin,M,100,0,5,5
Audine,F,100,5,0,5
Audranna,F,100,5,0,5
Audray,F,100,5,0,5
Audreona,F,100,5,0,5
Audreyna,F,100,5,0,5
Audreyonna,F,100,5,0,5
Audreyrose,F,100,5,0,5
Audriaunna,F,100,5,0,5
Audrieana,F,100,5,0,5
Audrienne,F,100,5,0,5
Audrii,F,100,5,0,5
Audrone,F,100,5,0,5
Auggie,M,100,0,5,5
Auguster,M,100,0,5,5
Augustis,M,100,0,5,5
Augustyn,M,100,0,5,5
Aujanai,F,100,5,0,5
Aukeem,M,100,0,5,5
Aula,F,100,5,0,5
Aumi,M,100,0,5,5
Aumya,F,100,5,0,5
Aunaleigh,F,100,5,0,5
Aundreia,F,100,5,0,5
Auni,F,100,5,0,5
Aunjel,F,100,5,0,5
Aunnika,F,100,5,0,5
Auraya,F,100,5,0,5
Auree,F,100,5,0,5
Aureo,M,100,0,5,5
Aurey,F,100,5,0,5
Aurik,M,100,0,5,5
Auril,F,100,5,0,5
Aurilla,F,100,5,0,5
Aurin,M,100,0,5,5
Auriona,F,100,5,0,5
Auroralynn,F,100,5,0,5
Aurra,F,100,5,0,5
Ausia,F,100,5,0,5
Austa,F,100,5,0,5
Autavia,F,100,5,0,5
Auttum,F,100,5,0,5
Auttumn,F,100,5,0,5
Avaan,M,100,0,5,5
Avae,F,100,5,0,5
Avahlyn,F,100,5,0,5
Avala,F,100,5,0,5
Avali,F,100,5,0,5
Avalia,F,100,5,0,5
Avaliese,F,100,5,0,5
Avamay,F,100,5,0,5
Avamonroe,F,100,5,0,5
Avanah,F,100,5,0,5
Avangaline,F,100,5,0,5
Avangelene,F,100,5,0,5
Avanthi,F,100,5,0,5
Avayiah,F,100,5,0,5
Aveana,F,100,5,0,5
Aveda,F,100,5,0,5
Aveigha,F,100,5,0,5
Avelie,F,100,5,0,5
Avelinn,F,100,5,0,5
Avelle,F,100,5,0,5
Avellina,F,100,5,0,5
Avenn,M,100,0,5,5
Averick,M,100,0,5,5
Averiee,F,100,5,0,5
Averymarie,F,100,5,0,5
Averyn,M,100,0,5,5
Aviara,F,100,5,0,5
Avichai,M,100,0,5,5
Avighna,M,100,0,5,5
Avione,F,100,5,0,5
Avir,M,100,0,5,5
Aviral,M,100,0,5,5
Aviram,M,100,0,5,5
Avishek,M,100,0,5,5
Avivah,F,100,5,0,5
Aviyonna,F,100,5,0,5
Avo,M,100,0,5,5
Avraj,M,100,0,5,5
Avreet,F,100,5,0,5
Avreigh,F,100,5,0,5
Avriella,F,100,5,0,5
Avrik,M,100,0,5,5
Avrill,F,100,5,0,5
Avrilynn,F,100,5,0,5
Avrion,M,100,0,5,5
Avshalom,M,100,0,5,5
Awbrey,F,100,5,0,5
Awn,F,100,5,0,5
Awna,F,100,5,0,5
Axcell,M,100,0,5,5
Axeton,M,100,0,5,5
Axiry,F,100,5,0,5
Axwell,M,100,0,5,5
Ayaina,F,100,5,0,5
Ayaniah,F,100,5,0,5
Ayanne,F,100,5,0,5
Ayante,F,100,5,0,5
Aydali,F,100,5,0,5
Aydelis,F,100,5,0,5
Aydenne,F,100,5,0,5
Aydrie,F,100,5,0,5
Aydrik,M,100,0,5,5
Ayea,F,100,5,0,5
Ayeasha,F,100,5,0,5
Ayedan,M,100,0,5,5
Ayin,F,100,5,0,5
Aylamae,F,100,5,0,5
Aylanna,F,100,5,0,5
Ayleena,F,100,5,0,5
Aylenne,F,100,5,0,5
Aylianna,F,100,5,0,5
Aylon,M,100,0,5,5
Aymie,F,100,5,0,5
Ayoki,F,100,5,0,5
Ayondela,F,100,5,0,5
Ayoola,F,100,5,0,5
Ayres,M,100,0,5,5
Ayriah,F,100,5,0,5
Ayrial,F,100,5,0,5
Ayric,M,100,0,5,5
Ayrihanna,F,100,5,0,5
Aysenur,F,100,5,0,5
Ayslyn,F,100,5,0,5
Aysu,F,100,5,0,5
Ayunna,F,100,5,0,5
Ayvani,F,100,5,0,5
Ayviana,F,100,5,0,5
Ayzlin,F,100,5,0,5
Ayzlyn,F,100,5,0,5
Azah,F,100,5,0,5
Azaireyah,F,100,5,0,5
Azalaya,F,100,5,0,5
Azaleigh,F,100,5,0,5
Azaleigha,F,100,5,0,5
Azanae,F,100,5,0,5
Azante,M,100,0,5,5
Azarae,F,100,5,0,5
Azarael,M,100,0,5,5
Azaraya,F,100,5,0,5
Azareah,F,100,5,0,5
Azareeyah,F,100,5,0,5
Azareth,F,100,5,0,5
Azaryia,F,100,5,0,5
Azayleah,F,100,5,0,5
Azeeza,F,100,5,0,5
Azelya,F,100,5,0,5
Azer,M,100,0,5,5
Azerion,M,100,0,5,5
Azfar,M,100,0,5,5
Azhan,M,100,0,5,5
Azhanae,F,100,5,0,5
Azianna,F,100,5,0,5
Azilynn,F,100,5,0,5
Aziria,F,100,5,0,5
Azjon,M,100,0,5,5
Azlynne,F,100,5,0,5
Azmeer,M,100,0,5,5
Azmina,F,100,5,0,5
Azrien,M,100,0,5,5
Azryel,M,100,0,5,5
Azsa,F,100,5,0,5
Azsha,F,100,5,0,5
Azteca,F,100,5,0,5
Azurae,F,100,5,0,5
Azurah,F,100,5,0,5
Azurie,F,100,5,0,5
Azury,F,100,5,0,5
Azuzena,F,100,5,0,5
Baasil,M,100,0,5,5
Babbett,F,100,5,0,5
Bacarri,M,100,0,5,5
Baeden,M,100,0,5,5
Baela,F,100,5,0,5
Baelor,M,100,0,5,5
Baheerah,F,100,5,0,5
Baiba,F,100,5,0,5
Bailiegh,F,100,5,0,5
Baille,F,100,5,0,5
Bailye,F,100,5,0,5
Baja,F,100,5,0,5
Bakir,M,100,0,5,5
Bakr,M,100,0,5,5
Balaji,M,100,0,5,5
Ballarie,F,100,5,0,5
Balon,F,100,5,0,5
Balynda,F,100,5,0,5
Bamby,F,100,5,0,5
Banan,M,100,0,5,5
Bang,M,100,0,5,5
Bangaly,M,100,0,5,5
Banisha,F,100,5,0,5
Bansri,F,100,5,0,5
Banyon,M,100,0,5,5
Barakah,F,100,5,0,5
Barakat,F,100,5,0,5
Barbaraa,F,100,5,0,5
Barbarba,F,100,5,0,5
Barbare,F,100,5,0,5
Barbetta,F,100,5,0,5
Barbora,F,100,5,0,5
Bareerah,F,100,5,0,5
Barek,M,100,0,5,5
Baren,M,100,0,5,5
Barisha,F,100,5,0,5
Barny,M,100,0,5,5
Barrion,M,100,0,5,5
Barris,M,100,0,5,5
Bartly,M,100,0,5,5
Bartolomeo,M,100,0,5,5
Bartu,M,100,0,5,5
Baryn,M,100,0,5,5
Bas,F,100,5,0,5
Bash,M,100,0,5,5
Bashiri,M,100,0,5,5
Basilios,M,100,0,5,5
Basilisa,F,100,5,0,5
Basimah,F,100,5,0,5
Batel,F,100,5,0,5
Batrina,F,100,5,0,5
Batula,F,100,5,0,5
Bavan,F,100,5,0,5
Bayete,M,100,0,5,5
Baylaa,F,100,5,0,5
Bayleen,F,100,5,0,5
Bayliegh,F,100,5,0,5
Bayshawn,M,100,0,5,5
Beah,F,100,5,0,5
Bean,M,100,0,5,5
Beandon,M,100,0,5,5
Beaney,F,100,5,0,5
Beaonca,F,100,5,0,5
Beather,F,100,5,0,5
Beatrica,F,100,5,0,5
Beatty,M,100,0,5,5
Beaufort,M,100,0,5,5
Beckah,F,100,5,0,5
Bedar,F,100,5,0,5
Beenish,F,100,5,0,5
Begum,F,100,5,0,5
Bek,M,100,0,5,5
Bekett,M,100,0,5,5
Belany,F,100,5,0,5
Believe,F,100,5,0,5
Beliz,F,100,5,0,5
Bellamay,F,100,5,0,5
Bellani,F,100,5,0,5
Bellicia,F,100,5,0,5
Bellinda,F,100,5,0,5
Belverly,F,100,5,0,5
Bemjamin,M,100,0,5,5
Benardo,M,100,0,5,5
Benda,F,100,5,0,5
Bene,F,100,5,0,5
Benedek,M,100,0,5,5
Benedicte,F,100,5,0,5
Benessa,F,100,5,0,5
Beneva,F,100,5,0,5
Benilda,F,100,5,0,5
Benjaminjoseph,M,100,0,5,5
Benjammin,M,100,0,5,5
Benjamon,M,100,0,5,5
Benje,M,100,0,5,5
Benjermen,M,100,0,5,5
Benjiam,M,100,0,5,5
Benley,M,100,0,5,5
Bennard,M,100,0,5,5
Benner,M,100,0,5,5
Bennington,M,100,0,5,5
Beno,M,100,0,5,5
Bentz,M,100,0,5,5
Benzel,M,100,0,5,5
Beola,F,100,5,0,5
Berdell,M,100,0,5,5
Berek,M,100,0,5,5
Berend,M,100,0,5,5
Berenger,M,100,0,5,5
Beresford,M,100,0,5,5
Bergin,F,100,5,0,5
Beric,M,100,0,5,5
Beril,M,100,0,5,5
Berita,F,100,5,0,5
Berj,M,100,0,5,5
Berlene,F,100,5,0,5
Bernalee,F,100,5,0,5
Bernarr,M,100,0,5,5
Bernasia,F,100,5,0,5
Bernda,F,100,5,0,5
Berne,M,100,0,5,5
Bernesha,F,100,5,0,5
Bernessa,F,100,5,0,5
Bernistine,F,100,5,0,5
Berniya,F,100,5,0,5
Berrie,F,100,5,0,5
Bertil,M,100,0,5,5
Besiana,F,100,5,0,5
Bethanye,F,100,5,0,5
Bethellen,F,100,5,0,5
Bethenia,F,100,5,0,5
Bethie,F,100,5,0,5
Bethsheba,F,100,5,0,5
Bethyl,F,100,5,0,5
Bethzabeth,F,100,5,0,5
Bethzaira,F,100,5,0,5
Betim,M,100,0,5,5
Betsabet,F,100,5,0,5
Betsayda,F,100,5,0,5
Betsye,F,100,5,0,5
Bettejane,F,100,5,0,5
Bettejo,F,100,5,0,5
Bettine,F,100,5,0,5
Bettzy,F,100,5,0,5
Beuna,F,100,5,0,5
Beverlin,F,100,5,0,5
Beverlye,F,100,5,0,5
Bexleigh,F,100,5,0,5
Beyah,F,100,5,0,5
Beyoncee,F,100,5,0,5
Beyunka,F,100,5,0,5
Bezaleel,M,100,0,5,5
Bhargava,M,100,0,5,5
Bhoomika,F,100,5,0,5
Bhrianna,F,100,5,0,5
Bia,F,100,5,0,5
Biafra,F,100,5,0,5
Bianet,F,100,5,0,5
Biankah,F,100,5,0,5
Biaunca,F,100,5,0,5
Bibek,M,100,0,5,5
Bidal,M,100,0,5,5
Biddie,F,100,5,0,5
Biel,M,100,0,5,5
Biftu,F,100,5,0,5
Bikram,M,100,0,5,5
Bilguun,M,100,0,5,5
Biljana,F,100,5,0,5
Bille,F,100,5,0,5
Billion,M,100,0,5,5
Billison,M,100,0,5,5
Bilon,F,100,5,0,5
Bilqis,F,100,5,0,5
Bimbo,M,100,0,5,5
Binaca,F,100,5,0,5
Binca,F,100,5,0,5
Binita,F,100,5,0,5
Binky,F,100,5,0,5
Bionda,F,100,5,0,5
Birche,M,100,0,5,5
Birder,F,100,5,0,5
Birgitte,F,100,5,0,5
Birk,M,100,0,5,5
Birklee,F,100,5,0,5
Birney,M,100,0,5,5
Birtie,F,100,5,0,5
Birydiana,F,100,5,0,5
Bisola,F,100,5,0,5
Bithiah,F,100,5,0,5
Biyanca,F,100,5,0,5
Biyanka,F,100,5,0,5
Bla,F,100,5,0,5
Blaken,M,100,0,5,5
Blaklie,F,100,5,0,5
Blakney,F,100,5,0,5
Blancaestela,F,100,5,0,5
Blasa,F,100,5,0,5
Blass,M,100,0,5,5
Blayd,M,100,0,5,5
Blaz,M,100,0,5,5
Bleidy,F,100,5,0,5
Blerim,M,100,0,5,5
Blerina,F,100,5,0,5
Blessn,F,100,5,0,5
Blossie,F,100,5,0,5
Blynda,F,100,5,0,5
Blynn,M,100,0,5,5
Bobbee,F,100,5,0,5
Bobbilee,F,100,5,0,5
Bobbilynn,F,100,5,0,5
Bodan,M,100,0,5,5
Bodhan,M,100,0,5,5
Boede,M,100,0,5,5
Bohannon,M,100,0,5,5
Bohen,M,100,0,5,5
Boise,M,100,0,5,5
Bolanle,F,100,5,0,5
Bolivia,F,100,5,0,5
Bolling,M,100,0,5,5
Bonell,M,100,0,5,5
Boney,M,100,0,5,5
Bonifacia,F,100,5,0,5
Bonique,F,100,5,0,5
Bonitta,F,100,5,0,5
Bonnibel,F,100,5,0,5
Bonnielee,F,100,5,0,5
Boon,M,100,0,5,5
Born,M,100,0,5,5
Bosede,F,100,5,0,5
Boun,M,100,0,5,5
Bouvier,M,100,0,5,5
Bowdie,M,100,0,5,5
Boz,M,100,0,5,5
Bracelyn,F,100,5,0,5
Bracelynn,F,100,5,0,5
Braderick,M,100,0,5,5
Bradli,F,100,5,0,5
Bradney,M,100,0,5,5
Bradson,M,100,0,5,5
Braegan,M,100,0,5,5
Braelinn,F,100,5,0,5
Braesen,M,100,0,5,5
Braeya,F,100,5,0,5
Brage,M,100,0,5,5
Brahian,M,100,0,5,5
Braiya,F,100,5,0,5
Brandais,F,100,5,0,5
Brandea,F,100,5,0,5
Brandelynn,F,100,5,0,5
Brandenn,M,100,0,5,5
Brander,M,100,0,5,5
Brandessa,F,100,5,0,5
Brandiann,F,100,5,0,5
Brandisha,F,100,5,0,5
Brandonkyle,M,100,0,5,5
Brandonray,M,100,0,5,5
Brandyann,F,100,5,0,5
Branen,M,100,0,5,5
Brannick,M,100,0,5,5
Brashad,M,100,0,5,5
Braston,M,100,0,5,5
Bravon,M,100,0,5,5
Bravyn,M,100,0,5,5
Braxx,M,100,0,5,5
Brayle,F,100,5,0,5
Braylend,M,100,0,5,5
Braynt,M,100,0,5,5
Brayshaun,M,100,0,5,5
Brayston,M,100,0,5,5
Brayzen,M,100,0,5,5
Breara,F,100,5,0,5
Breayna,F,100,5,0,5
Brec,M,100,0,5,5
Brecia,F,100,5,0,5
Brecon,M,100,0,5,5
Bredyn,M,100,0,5,5
Breeannah,F,100,5,0,5
Breeaunna,F,100,5,0,5
Breegan,F,100,5,0,5
Breen,F,100,5,0,5
Breesa,F,100,5,0,5
Breese,F,100,5,0,5
Breeyah,F,100,5,0,5
Breeyanna,F,100,5,0,5
Breh,M,100,0,5,5
Brehea,F,100,5,0,5
Breidy,F,100,5,0,5
Breidyn,M,100,0,5,5
Breigha,F,100,5,0,5
Breighden,M,100,0,5,5
Breilynn,F,100,5,0,5
Brejon,M,100,0,5,5
Brekia,F,100,5,0,5
Brekka,F,100,5,0,5
Brekkyn,F,100,5,0,5
Brekon,M,100,0,5,5
Brelen,M,100,0,5,5
Brenai,F,100,5,0,5
Brenard,M,100,0,5,5
Brenaya,F,100,5,0,5
Brence,M,100,0,5,5
Brendaa,F,100,5,0,5
Brendasia,F,100,5,0,5
Brener,M,100,0,5,5
Breneshia,F,100,5,0,5
Brenicia,F,100,5,0,5
Brenika,F,100,5,0,5
Brennda,F,100,5,0,5
Brentten,M,100,0,5,5
Brentwood,M,100,0,5,5
Breondra,F,100,5,0,5
Brescia,F,100,5,0,5
Breshai,F,100,5,0,5
Breshayla,F,100,5,0,5
Breshuna,F,100,5,0,5
Brettlee,M,100,0,5,5
Brettnie,F,100,5,0,5
Breyanah,F,100,5,0,5
Breyell,F,100,5,0,5
Breyn,F,100,5,0,5
Breze,F,100,5,0,5
Brezzy,F,100,5,0,5
Brhett,M,100,0,5,5
Brianalee,F,100,5,0,5
Brianamarie,F,100,5,0,5
Briananthony,M,100,0,5,5
Briandra,F,100,5,0,5
Brianie,F,100,5,0,5
Brianka,F,100,5,0,5
Briannalee,F,100,5,0,5
Brianney,F,100,5,0,5
Briayan,M,100,0,5,5
Briazia,F,100,5,0,5
Briceston,M,100,0,5,5
Bricola,F,100,5,0,5
Bridan,M,100,0,5,5
Bridyn,M,100,0,5,5
Brieah,F,100,5,0,5
Brieon,F,100,5,0,5
Brierre,F,100,5,0,5
Brieya,F,100,5,0,5
Brighley,F,100,5,0,5
Brij,M,100,0,5,5
Brijet,F,100,5,0,5
Brilei,F,100,5,0,5
Brilen,M,100,0,5,5
Brilynne,F,100,5,0,5
Brinder,F,100,5,0,5
Brindin,M,100,0,5,5
Briney,F,100,5,0,5
Brink,M,100,0,5,5
Brinlea,F,100,5,0,5
Brinnly,F,100,5,0,5
Brintney,F,100,5,0,5
Brionica,F,100,5,0,5
Brisaida,F,100,5,0,5
Brishana,F,100,5,0,5
Brishaun,M,100,0,5,5
Brishauna,F,100,5,0,5
Brishon,F,100,5,0,5
Brisny,F,100,5,0,5
Brisseida,F,100,5,0,5
Britanna,F,100,5,0,5
Britnae,F,100,5,0,5
Britnai,F,100,5,0,5
Brittaini,F,100,5,0,5
Brittanii,F,100,5,0,5
Brittanymarie,F,100,5,0,5
Brittary,F,100,5,0,5
Brittiana,F,100,5,0,5
Brittna,F,100,5,0,5
Brittnii,F,100,5,0,5
Brizeth,F,100,5,0,5
Brizzia,F,100,5,0,5
Brodney,M,100,0,5,5
Brogyn,M,100,0,5,5
Brohdy,M,100,0,5,5
Bromley,M,100,0,5,5
Bronagh,F,100,5,0,5
Bronica,F,100,5,0,5
Brookeann,F,100,5,0,5
Brooker,M,100,0,5,5
Brooklenn,F,100,5,0,5
Brooklon,F,100,5,0,5
Brooklynrose,F,100,5,0,5
Brookyln,F,100,5,0,5
Browdy,M,100,0,5,5
Brucelee,M,100,0,5,5
Brunell,M,100,0,5,5
Brunna,F,100,5,0,5
Bryand,M,100,0,5,5
Bryasha,F,100,5,0,5
Brycenn,M,100,0,5,5
Brycn,M,100,0,5,5
Brycyn,M,100,0,5,5
Brydie,F,100,5,0,5
Bryell,F,100,5,0,5
Bryenna,F,100,5,0,5
Bryia,F,100,5,0,5
Bryiana,F,100,5,0,5
Bryice,M,100,0,5,5
Bryleah,F,100,5,0,5
Bryndis,F,100,5,0,5
Bryniah,F,100,5,0,5
Brynnlea,F,100,5,0,5
Brynsley,F,100,5,0,5
Bryshaun,M,100,0,5,5
Bryssia,F,100,5,0,5
Btittany,F,100,5,0,5
Bub,M,100,0,5,5
Bubber,M,100,0,5,5
Buckie,M,100,0,5,5
Buckner,M,100,0,5,5
Buenaventura,M,100,0,5,5
Bugra,M,100,0,5,5
Bula,F,100,5,0,5
Bunyan,M,100,0,5,5
Burel,M,100,0,5,5
Burgandie,F,100,5,0,5
Burnadine,F,100,5,0,5
Burness,M,100,0,5,5
Burnest,M,100,0,5,5
Burnestine,F,100,5,0,5
Burnham,M,100,0,5,5
Buruk,M,100,0,5,5
Buryl,M,100,0,5,5
Bwana,M,100,0,5,5
Byra,F,100,5,0,5
Byrdie,F,100,5,0,5
Caaden,M,100,0,5,5
Cabral,M,100,0,5,5
Cabren,M,100,0,5,5
Cada,F,100,5,0,5
Cadeisha,F,100,5,0,5
Cadet,M,100,0,5,5
Cadisha,F,100,5,0,5
Caelob,M,100,0,5,5
Caffey,F,100,5,0,5
Cahari,M,100,0,5,5
Cahlin,F,100,5,0,5
Cahya,F,100,5,0,5
Caida,F,100,5,0,5
Caidee,F,100,5,0,5
Caidy,F,100,5,0,5
Cailtin,F,100,5,0,5
Cailum,M,100,0,5,5
Caimon,M,100,0,5,5
Cairah,F,100,5,0,5
Cairn,F,100,5,0,5
Caitelyn,F,100,5,0,5
Caitilyn,F,100,5,0,5
Caitryn,F,100,5,0,5
Caityln,F,100,5,0,5
Caitylyn,F,100,5,0,5
Calanda,F,100,5,0,5
Calani,F,100,5,0,5
Calantha,F,100,5,0,5
Calasia,F,100,5,0,5
Caleal,M,100,0,5,5
Caleiah,F,100,5,0,5
Caletha,F,100,5,0,5
Calice,F,100,5,0,5
Caliee,F,100,5,0,5
Caliese,F,100,5,0,5
Calis,F,100,5,0,5
Calisto,M,100,0,5,5
Calita,F,100,5,0,5
Calixtro,M,100,0,5,5
Callah,F,100,5,0,5
Callalily,F,100,5,0,5
Callasandra,F,100,5,0,5
Calliemae,F,100,5,0,5
Callissa,F,100,5,0,5
Callister,M,100,0,5,5
Calvan,M,100,0,5,5
Calyce,F,100,5,0,5
Calynne,F,100,5,0,5
Cama,F,100,5,0,5
Camacho,M,100,0,5,5
Camaira,F,100,5,0,5
Camariah,F,100,5,0,5
Camarii,M,100,0,5,5
Camario,M,100,0,5,5
Camarri,M,100,0,5,5
Camaury,M,100,0,5,5
Cambel,F,100,5,0,5
Cambi,F,100,5,0,5
Camea,F,100,5,0,5
Cameika,F,100,5,0,5
Cameil,F,100,5,0,5
Camelo,M,100,0,5,5
Camely,F,100,5,0,5
Cameon,M,100,0,5,5
Camerson,M,100,0,5,5
Camiesha,F,100,5,0,5
Camillemarie,F,100,5,0,5
Camillie,F,100,5,0,5
Camillus,M,100,0,5,5
Camillya,F,100,5,0,5
Camishia,F,100,5,0,5
Camm,M,100,0,5,5
Campion,M,100,0,5,5
Campton,M,100,0,5,5
Camrion,M,100,0,5,5
Camryne,F,100,5,0,5
Camyrah,F,100,5,0,5
Camyri,F,100,5,0,5
Camyria,F,100,5,0,5
Canace,F,100,5,0,5
Candan,M,100,0,5,5
Candiece,F,100,5,0,5
Candys,F,100,5,0,5
Canen,M,100,0,5,5
Canessa,F,100,5,0,5
Cansu,F,100,5,0,5
Cante,F,100,5,0,5
Canyen,M,100,0,5,5
Canyla,F,100,5,0,5
Cap,M,100,0,5,5
Capp,M,100,0,5,5
Caprece,F,100,5,0,5
Carcyn,F,100,5,0,5
Cardiss,F,100,5,0,5
Carelle,F,100,5,0,5
Carelyn,F,100,5,0,5
Caresha,F,100,5,0,5
Caribbean,F,100,5,0,5
Carielle,F,100,5,0,5
Carig,M,100,0,5,5
Cario,M,100,0,5,5
Cariss,F,100,5,0,5
Carista,F,100,5,0,5
Carlana,F,100,5,0,5
Carlann,F,100,5,0,5
Carlanthony,M,100,0,5,5
Carlens,M,100,0,5,5
Carlese,F,100,5,0,5
Carlhenry,M,100,0,5,5
Carlishia,F,100,5,0,5
Carlissia,F,100,5,0,5
Carlitha,F,100,5,0,5
Carlitta,F,100,5,0,5
Carlleen,F,100,5,0,5
Carlosadrian,M,100,0,5,5
Carlosjavier,M,100,0,5,5
Carlosjr,M,100,0,5,5
Carlston,M,100,0,5,5
Carlvin,M,100,0,5,5
Carlysha,F,100,5,0,5
Carlyssia,F,100,5,0,5
Carmalena,F,100,5,0,5
Carmaletta,F,100,5,0,5
Carmecia,F,100,5,0,5
Carmeleta,F,100,5,0,5
Carmeline,F,100,5,0,5
Carmelito,M,100,0,5,5
Carmesia,F,100,5,0,5
Carmila,F,100,5,0,5
Carmino,M,100,0,5,5
Carna,F,100,5,0,5
Carneal,M,100,0,5,5
Carolita,F,100,5,0,5
Caroyn,F,100,5,0,5
Carragan,F,100,5,0,5
Carrena,F,100,5,0,5
Carrion,M,100,0,5,5
Carterjames,M,100,0,5,5
Cartha,F,100,5,0,5
Carthell,M,100,0,5,5
Cartisha,F,100,5,0,5
Cartrina,F,100,5,0,5
Carville,M,100,0,5,5
Carya,F,100,5,0,5
Casandr,F,100,5,0,5
Casaya,F,100,5,0,5
Casch,M,100,0,5,5
Casea,F,100,5,0,5
Caseylynn,F,100,5,0,5
Cashana,F,100,5,0,5
Cashmiere,M,100,0,5,5
Cashtin,M,100,0,5,5
Casina,F,100,5,0,5
Casiyah,F,100,5,0,5
Casmin,F,100,5,0,5
Casonja,F,100,5,0,5
Cassarah,F,100,5,0,5
Cassina,F,100,5,0,5
Casslyn,F,100,5,0,5
Cassonia,F,100,5,0,5
Casto,M,100,0,5,5
Castyn,M,100,0,5,5
Cataldo,M,100,0,5,5
Cataleena,F,100,5,0,5
Catalin,F,100,5,0,5
Cataliya,F,100,5,0,5
Catelynne,F,100,5,0,5
Cathalia,F,100,5,0,5
Cathaline,F,100,5,0,5
Catherne,F,100,5,0,5
Cathlean,F,100,5,0,5
Cathlina,F,100,5,0,5
Cathylee,F,100,5,0,5
Catilaya,F,100,5,0,5
Catileya,F,100,5,0,5
Catrease,F,100,5,0,5
Catressa,F,100,5,0,5
Catria,F,100,5,0,5
Catrinna,F,100,5,0,5
Cattalaya,F,100,5,0,5
Cavari,M,100,0,5,5
Cavett,M,100,0,5,5
Cayleeann,F,100,5,0,5
Cayler,M,100,0,5,5
Cayra,F,100,5,0,5
Caysey,M,100,0,5,5
Cayslee,F,100,5,0,5
Caytie,F,100,5,0,5
Caytlen,F,100,5,0,5
Cchristopher,M,100,0,5,5
Ceandre,M,100,0,5,5
Ceason,F,100,5,0,5
Cebria,F,100,5,0,5
Cecelio,M,100,0,5,5
Cederia,F,100,5,0,5
Ceianna,F,100,5,0,5
Ceila,F,100,5,0,5
Ceinna,F,100,5,0,5
Ceion,M,100,0,5,5
Ceionna,F,100,5,0,5
Cele,F,100,5,0,5
Celebrity,F,100,5,0,5
Celenne,F,100,5,0,5
Celess,F,100,5,0,5
Celesse,F,100,5,0,5
Celetha,F,100,5,0,5
Celinez,F,100,5,0,5
Celinna,F,100,5,0,5
Celisha,F,100,5,0,5
Cellia,F,100,5,0,5
Celsi,F,100,5,0,5
Cely,F,100,5,0,5
Cemre,F,100,5,0,5
Cemya,F,100,5,0,5
Cendi,F,100,5,0,5
Cengiz,M,100,0,5,5
Cennedy,F,100,5,0,5
Centwane,M,100,0,5,5
Cerdic,M,100,0,5,5
Cerisa,F,100,5,0,5
Cerjio,M,100,0,5,5
Cerri,F,100,5,0,5
Cerrisa,F,100,5,0,5
Cesiley,F,100,5,0,5
Cevanna,F,100,5,0,5
Ceyana,F,100,5,0,5
Ceyara,F,100,5,0,5
Ceylan,F,100,5,0,5
Ceyonce,F,100,5,0,5
Chaaya,F,100,5,0,5
Chabria,F,100,5,0,5
Chada,F,100,5,0,5
Chadlee,M,100,0,5,5
Chadman,M,100,0,5,5
Chaeden,M,100,0,5,5
Chailynn,F,100,5,0,5
Chain,M,100,0,5,5
Chaislyn,F,100,5,0,5
Chaisson,M,100,0,5,5
Chaiya,F,100,5,0,5
Chakela,F,100,5,0,5
Chakelia,F,100,5,0,5
Chakevia,F,100,5,0,5
Chakeya,F,100,5,0,5
Chalan,F,100,5,0,5
Chalis,F,100,5,0,5
Chalissa,F,100,5,0,5
Chalisse,F,100,5,0,5
Challie,F,100,5,0,5
Challise,F,100,5,0,5
Chaly,M,100,0,5,5
Chalynn,F,100,5,0,5
Chamarion,M,100,0,5,5
Chamarra,F,100,5,0,5
Chamaya,F,100,5,0,5
Chamelle,F,100,5,0,5
Chamise,F,100,5,0,5
Chamroeun,M,100,0,5,5
Chandace,F,100,5,0,5
Chandale,F,100,5,0,5
Chande,M,100,0,5,5
Chandee,F,100,5,0,5
Chandris,F,100,5,0,5
Chanelly,F,100,5,0,5
Chanet,F,100,5,0,5
Chanlee,F,100,5,0,5
Channce,M,100,0,5,5
Chanoa,F,100,5,0,5
Chansler,M,100,0,5,5
Chant,M,100,0,5,5
Chantai,F,100,5,0,5
Chantail,F,100,5,0,5
Chantez,F,100,5,0,5
Chanthy,M,100,0,5,5
Chantiel,F,100,5,0,5
Chantile,F,100,5,0,5
Chantily,F,100,5,0,5
Chantis,F,100,5,0,5
Chantler,M,100,0,5,5
Chanton,M,100,0,5,5
Chantoria,F,100,5,0,5
Chantrea,F,100,5,0,5
Chanyce,F,100,5,0,5
Chapelle,F,100,5,0,5
Chaquanna,F,100,5,0,5
Chaquilla,F,100,5,0,5
Charaine,F,100,5,0,5
Charanda,F,100,5,0,5
Chard,M,100,0,5,5
Chardarius,M,100,0,5,5
Chardey,F,100,5,0,5
Chare,F,100,5,0,5
Charetta,F,100,5,0,5
Charette,F,100,5,0,5
Charhonda,F,100,5,0,5
Chariel,F,100,5,0,5
Chariese,F,100,5,0,5
Charilyn,F,100,5,0,5
Charisha,F,100,5,0,5
Charitha,F,100,5,0,5
Charkita,F,100,5,0,5
Charlae,F,100,5,0,5
Charlain,F,100,5,0,5
Charlay,F,100,5,0,5
Charleah,F,100,5,0,5
Charlesedward,M,100,0,5,5
Charlesjoseph,M,100,0,5,5
Charlesten,M,100,0,5,5
Charliemae,F,100,5,0,5
Charlierae,F,100,5,0,5
Charlisia,F,100,5,0,5
Charlla,F,100,5,0,5
Charlona,F,100,5,0,5
Charlotterose,F,100,5,0,5
Charlottie,F,100,5,0,5
Charlottle,F,100,5,0,5
Charlsa,F,100,5,0,5
Charlyee,F,100,5,0,5
Charlynda,F,100,5,0,5
Charlz,M,100,0,5,5
Charmella,F,100,5,0,5
Charmia,F,100,5,0,5
Charmie,F,100,5,0,5
Charmisa,F,100,5,0,5
Charnaye,F,100,5,0,5
Charnece,F,100,5,0,5
Charneka,F,100,5,0,5
Charneshia,F,100,5,0,5
Charnesia,F,100,5,0,5
Charona,F,100,5,0,5
Charotte,F,100,5,0,5
Charta,F,100,5,0,5
Chartez,M,100,0,5,5
Charvey,F,100,5,0,5
Charvik,M,100,0,5,5
Charvon,F,100,5,0,5
Charylene,F,100,5,0,5
Chasetin,M,100,0,5,5
Chasia,F,100,5,0,5
Chassi,F,100,5,0,5
Chassica,F,100,5,0,5
Chassidi,F,100,5,0,5
Chassitty,F,100,5,0,5
Chastan,M,100,0,5,5
Chastie,F,100,5,0,5
Chastyn,M,100,0,5,5
Chaswick,M,100,0,5,5
Chat,M,100,0,5,5
Chatal,F,100,5,0,5
Chataqua,F,100,5,0,5
Chatina,F,100,5,0,5
Chatrice,F,100,5,0,5
Chattie,F,100,5,0,5
Chaunci,F,100,5,0,5
Chauntrice,F,100,5,0,5
Chaurice,F,100,5,0,5
Chavah,F,100,5,0,5
Chavas,M,100,0,5,5
Chave,F,100,5,0,5
Chavonte,F,100,5,0,5
Chawna,F,100,5,0,5
Chayane,M,100,0,5,5
Chaydon,M,100,0,5,5
Chaynee,F,100,5,0,5
Chayzen,M,100,0,5,5
Chazden,M,100,0,5,5
Chazten,M,100,0,5,5
Cheenue,M,100,0,5,5
Cheire,F,100,5,0,5
Chejuana,F,100,5,0,5
Chellsee,F,100,5,0,5
Chelon,F,100,5,0,5
Chelonda,F,100,5,0,5
Chelsealynn,F,100,5,0,5
Chelsen,F,100,5,0,5
Chelyn,F,100,5,0,5
Chemane,F,100,5,0,5
Chenele,F,100,5,0,5
Chennell,F,100,5,0,5
Chenxi,F,100,5,0,5
Chequetta,F,100,5,0,5
Cheretta,F,100,5,0,5
Cheriah,F,100,5,0,5
Cheriann,F,100,5,0,5
Cheridyn,F,100,5,0,5
Cherle,F,100,5,0,5
Cherlonda,F,100,5,0,5
Cherrilynn,F,100,5,0,5
Cherrisse,F,100,5,0,5
Cherronda,F,100,5,0,5
Cherryann,F,100,5,0,5
Cherryle,F,100,5,0,5
Cheryllynne,F,100,5,0,5
Chesica,F,100,5,0,5
Chesterfield,M,100,0,5,5
Chestley,M,100,0,5,5
Chethan,M,100,0,5,5
Cheyeene,F,100,5,0,5
Cheylin,F,100,5,0,5
Cheylyn,F,100,5,0,5
Chezaray,M,100,0,5,5
Chian,F,100,5,0,5
Chiani,F,100,5,0,5
Chiarra,F,100,5,0,5
Chibuzor,M,100,0,5,5
Chic,M,100,0,5,5
Chicora,F,100,5,0,5
Chidalu,M,100,0,5,5
Chidumebi,F,100,5,0,5
Chiedu,M,100,0,5,5
Chiemi,F,100,5,0,5
Chien,M,100,0,5,5
Chikamara,F,100,5,0,5
Chilyn,F,100,5,0,5
Chimaobim,M,100,0,5,5
Chineme,F,100,5,0,5
Chinesta,F,100,5,0,5
Chineta,F,100,5,0,5
Chineye,F,100,5,0,5
Chinitta,F,100,5,0,5
Chinomso,M,100,0,5,5
Chintan,M,100,0,5,5
Chiquia,F,100,5,0,5
Chiquitha,F,100,5,0,5
Chirelle,F,100,5,0,5
Chiriga,F,100,5,0,5
Chirley,F,100,5,0,5
Chisara,F,100,5,0,5
Chistie,F,100,5,0,5
Chisty,F,100,5,0,5
Chitina,F,100,5,0,5
Chiyoka,F,100,5,0,5
Chizitere,F,100,5,0,5
Cholena,F,100,5,0,5
Chontelle,F,100,5,0,5
Chquita,F,100,5,0,5
Chrisalynn,F,100,5,0,5
Chrisanthi,F,100,5,0,5
Chrisaun,M,100,0,5,5
Chrisel,F,100,5,0,5
Chrishad,M,100,0,5,5
Chrishaud,M,100,0,5,5
Chrishaunda,F,100,5,0,5
Chrishea,F,100,5,0,5
Chrishiya,F,100,5,0,5
Chrishna,F,100,5,0,5
Chrishona,F,100,5,0,5
Chrishya,F,100,5,0,5
Chrisinda,F,100,5,0,5
Chrisitne,F,100,5,0,5
Chrisiyah,F,100,5,0,5
Chrisly,F,100,5,0,5
Christale,F,100,5,0,5
Christasha,F,100,5,0,5
Christenia,F,100,5,0,5
Christer,M,100,0,5,5
Christiam,M,100,0,5,5
Christianalexan,M,100,0,5,5
Christianjoshua,M,100,0,5,5
Christianson,M,100,0,5,5
Christielee,F,100,5,0,5
Christineanne,F,100,5,0,5
Christing,F,100,5,0,5
Christopherdavi,M,100,0,5,5
Christopherjr,M,100,0,5,5
Christopherpaul,M,100,0,5,5
Christylee,F,100,5,0,5
Chrysoula,F,100,5,0,5
Chrystalyn,F,100,5,0,5
Chrystyan,M,100,0,5,5
Chubasco,M,100,0,5,5
Chubbie,M,100,0,5,5
Chuefeng,M,100,0,5,5
Chukwudubem,M,100,0,5,5
Chuma,M,100,0,5,5
Chuna,M,100,0,5,5
Chunta,F,100,5,0,5
Chyene,F,100,5,0,5
Chyenna,F,100,5,0,5
Chylynn,F,100,5,0,5
Chynthia,F,100,5,0,5
Ciah,F,100,5,0,5
Cianah,F,100,5,0,5
Cianie,F,100,5,0,5
Ciboney,F,100,5,0,5
Cidni,F,100,5,0,5
Cidnie,F,100,5,0,5
Cieana,F,100,5,0,5
Ciley,F,100,5,0,5
Cilla,F,100,5,0,5
Cimara,F,100,5,0,5
Cin,M,100,0,5,5
Cind,F,100,5,0,5
Cindell,F,100,5,0,5
Cindya,F,100,5,0,5
Cintra,F,100,5,0,5
Ciprianna,F,100,5,0,5
Ciree,M,100,0,5,5
Cirildo,M,100,0,5,5
Cirino,M,100,0,5,5
Cirra,F,100,5,0,5
Cisely,F,100,5,0,5
Cissie,F,100,5,0,5
Citally,F,100,5,0,5
Citialli,F,100,5,0,5
Citori,F,100,5,0,5
Civona,F,100,5,0,5
Ciyah,F,100,5,0,5
Ciyana,F,100,5,0,5
Clae,M,100,0,5,5
Clairece,F,100,5,0,5
Clairemarie,F,100,5,0,5
Clairene,F,100,5,0,5
Clancie,F,100,5,0,5
Clarah,F,100,5,0,5
Claranne,F,100,5,0,5
Clareese,F,100,5,0,5
Clarena,F,100,5,0,5
Clarencia,F,100,5,0,5
Clariece,F,100,5,0,5
Claritsa,F,100,5,0,5
Clarixa,F,100,5,0,5
Claron,M,100,0,5,5
Claudea,F,100,5,0,5
Claudya,F,100,5,0,5
Claven,M,100,0,5,5
Clavon,M,100,0,5,5
Clayne,M,100,0,5,5
Cleatrice,F,100,5,0,5
Cleaveland,M,100,0,5,5
Clela,F,100,5,0,5
Clellan,M,100,0,5,5
Clellon,M,100,0,5,5
Clemma,F,100,5,0,5
Clemont,M,100,0,5,5
Cleodis,M,100,0,5,5
Cleonte,M,100,0,5,5
Cleothis,M,100,0,5,5
Clerance,M,100,0,5,5
Cleste,F,100,5,0,5
Clevland,M,100,0,5,5
Cliftina,F,100,5,0,5
Clinetta,F,100,5,0,5
Cloi,F,100,5,0,5
Clorine,F,100,5,0,5
Clorise,F,100,5,0,5
Clotee,F,100,5,0,5
Clothilda,F,100,5,0,5
Cloyde,M,100,0,5,5
Clu,M,100,0,5,5
Cludia,F,100,5,0,5
Clydeen,F,100,5,0,5
Clynt,M,100,0,5,5
Cmone,F,100,5,0,5
Coalson,M,100,0,5,5
Cobb,M,100,0,5,5
Codell,M,100,0,5,5
Codera,M,100,0,5,5
Coderro,M,100,0,5,5
Cohutta,M,100,0,5,5
Colanda,F,100,5,0,5
Coldin,M,100,0,5,5
Coledon,M,100,0,5,5
Coleeta,F,100,5,0,5
Coleon,M,100,0,5,5
Coleone,M,100,0,5,5
Colesha,F,100,5,0,5
Colicia,F,100,5,0,5
Colisa,F,100,5,0,5
Collenn,F,100,5,0,5
Collynn,M,100,0,5,5
Comesha,F,100,5,0,5
Common,M,100,0,5,5
Concepsion,F,100,5,0,5
Concheta,F,100,5,0,5
Condace,F,100,5,0,5
Condol,F,100,5,0,5
Condoleezza,F,100,5,0,5
Condredge,M,100,0,5,5
Connal,M,100,0,5,5
Connan,M,100,0,5,5
Conney,M,100,0,5,5
Connice,F,100,5,0,5
Connstance,F,100,5,0,5
Constandina,F,100,5,0,5
Constandinos,M,100,0,5,5
Constence,F,100,5,0,5
Constina,F,100,5,0,5
Content,F,100,5,0,5
Continia,F,100,5,0,5
Contrena,F,100,5,0,5
Converse,M,100,0,5,5
Conwell,M,100,0,5,5
Cooley,M,100,0,5,5
Coralai,F,100,5,0,5
Coralito,F,100,5,0,5
Coralynne,F,100,5,0,5
Coralys,F,100,5,0,5
Coramae,F,100,5,0,5
Corbi,F,100,5,0,5
Corbon,M,100,0,5,5
Cordaris,M,100,0,5,5
Corddaryl,M,100,0,5,5
Cordea,M,100,0,5,5
Cordeja,F,100,5,0,5
Corderall,M,100,0,5,5
Corderial,M,100,0,5,5
Corderick,M,100,0,5,5
Corderious,M,100,0,5,5
Cordeshia,F,100,5,0,5
Coreene,F,100,5,0,5
Corelle,F,100,5,0,5
Corentin,M,100,0,5,5
Coreyonna,F,100,5,0,5
Coriah,F,100,5,0,5
Corienne,F,100,5,0,5
Corii,F,100,5,0,5
Corinth,F,100,5,0,5
Corintha,F,100,5,0,5
Cornia,F,100,5,0,5
Corraine,F,100,5,0,5
Corree,F,100,5,0,5
Correena,F,100,5,0,5
Corrice,M,100,0,5,5
Corsandra,F,100,5,0,5
Cortavia,F,100,5,0,5
Cortell,M,100,0,5,5
Corutney,F,100,5,0,5
Corvina,F,100,5,0,5
Corwynn,M,100,0,5,5
Coryann,F,100,5,0,5
Cottie,F,100,5,0,5
Coulette,F,100,5,0,5
Coulten,M,100,0,5,5
Count,M,100,0,5,5
Couri,F,100,5,0,5
Courtnye,F,100,5,0,5
Covy,M,100,0,5,5
Cowana,F,100,5,0,5
Cozmo,M,100,0,5,5
Crag,M,100,0,5,5
Cragi,M,100,0,5,5
Cramon,M,100,0,5,5
Crane,M,100,0,5,5
Creasie,F,100,5,0,5
Creedan,M,100,0,5,5
Creigh,M,100,0,5,5
Creo,M,100,0,5,5
Cress,M,100,0,5,5
Crisann,F,100,5,0,5
Crisinda,F,100,5,0,5
Crissangel,M,100,0,5,5
Crisslyn,F,100,5,0,5
Crisstopher,M,100,0,5,5
Cristaly,F,100,5,0,5
Cristalyn,F,100,5,0,5
Cristeen,F,100,5,0,5
Cristia,F,100,5,0,5
Cristoffer,M,100,0,5,5
Cristyle,F,100,5,0,5
Cristyna,F,100,5,0,5
Criztian,M,100,0,5,5
Crmen,F,100,5,0,5
Cromwell,M,100,0,5,5
Crossley,M,100,0,5,5
Crosslyn,F,100,5,0,5
Crstal,F,100,5,0,5
Crus,M,100,0,5,5
Crystabel,F,100,5,0,5
Crystalgayle,F,100,5,0,5
Crystell,F,100,5,0,5
Crystofer,M,100,0,5,5
Crystyle,F,100,5,0,5
Csilla,F,100,5,0,5
Cuahtemoc,M,100,0,5,5
Culleen,F,100,5,0,5
Currin,M,100,0,5,5
Curron,M,100,0,5,5
Curstyn,F,100,5,0,5
Curteria,F,100,5,0,5
Curtesha,F,100,5,0,5
Curtney,F,100,5,0,5
Custer,M,100,0,5,5
Cya,F,100,5,0,5
Cyanthia,F,100,5,0,5
Cydny,F,100,5,0,5
Cyerah,F,100,5,0,5
Cymbre,F,100,5,0,5
Cynii,F,100,5,0,5
Cynthiaa,F,100,5,0,5
Cynthiaann,F,100,5,0,5
Cyntrell,F,100,5,0,5
Cyrelle,F,100,5,0,5
Cyrita,F,100,5,0,5
Cytlalli,F,100,5,0,5
Cytnhia,F,100,5,0,5
Daandre,M,100,0,5,5
Dabin,M,100,0,5,5
Dabrielle,F,100,5,0,5
Dacee,F,100,5,0,5
Dacio,M,100,0,5,5
Dadne,F,100,5,0,5
Dadra,F,100,5,0,5
Dadrianna,F,100,5,0,5
Daebreona,F,100,5,0,5
Daeisha,F,100,5,0,5
Daejaun,M,100,0,5,5
Daejion,M,100,0,5,5
Daekwan,M,100,0,5,5
Daenna,F,100,5,0,5
Daesy,F,100,5,0,5
Dafni,F,100,5,0,5
Dagger,M,100,0,5,5
Dagney,F,100,5,0,5
Dahianna,F,100,5,0,5
Dahlin,M,100,0,5,5
Dahlon,M,100,0,5,5
Dahquan,M,100,0,5,5
Daian,M,100,0,5,5
Daianera,F,100,5,0,5
Daiceon,M,100,0,5,5
Daidra,F,100,5,0,5
Daidre,F,100,5,0,5
Daigon,M,100,0,5,5
Daiguan,M,100,0,5,5
Daijanay,F,100,5,0,5
Daijaun,M,100,0,5,5
Daijiah,F,100,5,0,5
Daijohn,M,100,0,5,5
Daijour,M,100,0,5,5
Daikwon,M,100,0,5,5
Daimond,F,100,5,0,5
Dainan,M,100,0,5,5
Dainna,F,100,5,0,5
Dairen,M,100,0,5,5
Daise,F,100,5,0,5
Daishae,F,100,5,0,5
Daisymarie,F,100,5,0,5
Daivid,M,100,0,5,5
Daivyon,M,100,0,5,5
Dajahn,M,100,0,5,5
Dajahnay,F,100,5,0,5
Dajavette,F,100,5,0,5
Dajhia,F,100,5,0,5
Dajoure,M,100,0,5,5
Dajshia,F,100,5,0,5
Dajuon,M,100,0,5,5
Dajza,F,100,5,0,5
Dakarion,M,100,0,5,5
Dake,M,100,0,5,5
Dakobe,M,100,0,5,5
Dakotajames,M,100,0,5,5
Daktari,M,100,0,5,5
Dakuan,M,100,0,5,5
Dakyah,F,100,5,0,5
Dakyrah,F,100,5,0,5
Dalai,F,100,5,0,5
Dalainey,F,100,5,0,5
Dalane,F,100,5,0,5
Dalanee,F,100,5,0,5
Dalany,F,100,5,0,5
Dalasha,F,100,5,0,5
Dalayjah,F,100,5,0,5
Dalaylah,F,100,5,0,5
Dalayshia,F,100,5,0,5
Daleila,F,100,5,0,5
Dalesa,F,100,5,0,5
Daleshia,F,100,5,0,5
Dalesia,F,100,5,0,5
Dalevon,M,100,0,5,5
Dalexia,F,100,5,0,5
Daleysi,F,100,5,0,5
Dalianna,F,100,5,0,5
Dalibor,M,100,0,5,5
Dalil,M,100,0,5,5
Dalisia,F,100,5,0,5
Daliyla,F,100,5,0,5
Dallton,M,100,0,5,5
Dalonna,F,100,5,0,5
Dalonzo,M,100,0,5,5
Dalshawn,M,100,0,5,5
Dalva,F,100,5,0,5
Damaiah,F,100,5,0,5
Damaire,M,100,0,5,5
Damal,M,100,0,5,5
Damarae,M,100,0,5,5
Damareion,M,100,0,5,5
Damariye,M,100,0,5,5
Damarlo,M,100,0,5,5
Damarquez,M,100,0,5,5
Damarrea,M,100,0,5,5
Damarte,M,100,0,5,5
Dameika,F,100,5,0,5
Damekia,F,100,5,0,5
Damell,M,100,0,5,5
Damera,F,100,5,0,5
Dameta,F,100,5,0,5
Dametre,M,100,0,5,5
Dametrice,F,100,5,0,5
Dametrious,M,100,0,5,5
Damiam,M,100,0,5,5
Damiani,M,100,0,5,5
Damielle,F,100,5,0,5
Damiene,M,100,0,5,5
Damilare,M,100,0,5,5
Damina,F,100,5,0,5
Damionna,F,100,5,0,5
Damirah,F,100,5,0,5
Damishia,F,100,5,0,5
Damiun,M,100,0,5,5
Damonni,M,100,0,5,5
Damonnie,M,100,0,5,5
Damori,M,100,0,5,5
Damyrion,M,100,0,5,5
Damyron,M,100,0,5,5
Danaia,F,100,5,0,5
Danaira,F,100,5,0,5
Danaiyah,F,100,5,0,5
Danald,M,100,0,5,5
Danariah,F,100,5,0,5
Danautica,F,100,5,0,5
Danayia,F,100,5,0,5
Danayjah,F,100,5,0,5
Danazha,F,100,5,0,5
Dancia,F,100,5,0,5
Dandrell,M,100,0,5,5
Dandrick,M,100,0,5,5
Daneca,F,100,5,0,5
Daneila,F,100,5,0,5
Danera,F,100,5,0,5
Danery,F,100,5,0,5
Daneyah,F,100,5,0,5
Daneysha,F,100,5,0,5
Dangkhoa,M,100,0,5,5
Daniana,F,100,5,0,5
Daniaya,F,100,5,0,5
Danield,M,100,0,5,5
Danielee,F,100,5,0,5
Danielia,F,100,5,0,5
Danielson,M,100,0,5,5
Daniette,F,100,5,0,5
Danilla,F,100,5,0,5
Danion,M,100,0,5,5
Daniza,F,100,5,0,5
Danja,F,100,5,0,5
Danka,F,100,5,0,5
Danl,M,100,0,5,5
Dannalyn,F,100,5,0,5
Dannay,F,100,5,0,5
Dannea,F,100,5,0,5
Dannee,F,100,5,0,5
Dannen,M,100,0,5,5
Dannicka,F,100,5,0,5
Dannilyn,F,100,5,0,5
Dannylynn,F,100,5,0,5
Dantee,M,100,0,5,5
Dantel,M,100,0,5,5
Danterrius,M,100,0,5,5
Dantley,M,100,0,5,5
Danual,M,100,0,5,5
Danyae,F,100,5,0,5
Danyea,F,100,5,0,5
Danykah,F,100,5,0,5
Danyll,F,100,5,0,5
Danziel,M,100,0,5,5
Daquanda,F,100,5,0,5
Daquavius,M,100,0,5,5
Daquel,M,100,0,5,5
Daquian,M,100,0,5,5
Daquinn,M,100,0,5,5
Daqwane,M,100,0,5,5
Darbee,F,100,5,0,5
Darco,M,100,0,5,5
Darea,F,100,5,0,5
Dareece,M,100,0,5,5
Dareese,F,100,5,0,5
Dareian,M,100,0,5,5
Dareona,F,100,5,0,5
Darese,M,100,0,5,5
Daretha,F,100,5,0,5
Dariean,F,100,5,0,5
Dariely,F,100,5,0,5
Darionne,M,100,0,5,5
Darique,M,100,0,5,5
Darisley,F,100,5,0,5
Dariyelle,F,100,5,0,5
Darleena,F,100,5,0,5
Darleni,F,100,5,0,5
Darlenis,F,100,5,0,5
Darleta,F,100,5,0,5
Darleth,F,100,5,0,5
Darlita,F,100,5,0,5
Darlo,M,100,0,5,5
Darlynda,F,100,5,0,5
Darma,F,100,5,0,5
Darmarcus,M,100,0,5,5
Darnaja,F,100,5,0,5
Darnee,M,100,0,5,5
Darnese,F,100,5,0,5
Darney,M,100,0,5,5
Darone,M,100,0,5,5
Daronta,M,100,0,5,5
Darquisha,F,100,5,0,5
Darrellyn,F,100,5,0,5
Darries,M,100,0,5,5
Darrione,M,100,0,5,5
Darro,M,100,0,5,5
Darshea,F,100,5,0,5
Darshelle,F,100,5,0,5
Darshi,F,100,5,0,5
Darson,M,100,0,5,5
Dartez,M,100,0,5,5
Darthy,F,100,5,0,5
Dartisha,F,100,5,0,5
Darvens,M,100,0,5,5
Darwing,M,100,0,5,5
Darwuin,M,100,0,5,5
Daryann,F,100,5,0,5
Darynne,F,100,5,0,5
Darzell,M,100,0,5,5
Dasai,M,100,0,5,5
Dasanii,F,100,5,0,5
Dascha,F,100,5,0,5
Dashaan,M,100,0,5,5
Dashall,M,100,0,5,5
Dashari,F,100,5,0,5
Dasharia,F,100,5,0,5
Dasheika,F,100,5,0,5
Dashiah,F,100,5,0,5
Dashima,F,100,5,0,5
Dashna,F,100,5,0,5
Dashonte,F,100,5,0,5
Dashown,M,100,0,5,5
Dashyra,F,100,5,0,5
Dasjia,F,100,5,0,5
Dastyn,M,100,0,5,5
Datari,M,100,0,5,5
Datavian,M,100,0,5,5
Datavius,M,100,0,5,5
Datia,F,100,5,0,5
Datid,M,100,0,5,5
Datreon,M,100,0,5,5
Datrice,F,100,5,0,5
Daughn,F,100,5,0,5
Daundra,F,100,5,0,5
Daunta,M,100,0,5,5
Dauntay,M,100,0,5,5
Dauri,F,100,5,0,5
Dav,M,100,0,5,5
Davada,F,100,5,0,5
Davahn,M,100,0,5,5
Davaney,F,100,5,0,5
Davani,F,100,5,0,5
Davantay,M,100,0,5,5
Davares,M,100,0,5,5
Davarous,M,100,0,5,5
Davarrio,M,100,0,5,5
Davarus,M,100,0,5,5
Davasha,F,100,5,0,5
Davaunte,M,100,0,5,5
Davens,M,100,0,5,5
Daveonna,F,100,5,0,5
Daviaun,M,100,0,5,5
Davidallen,M,100,0,5,5
Davidjeremiah,M,100,0,5,5
Davidjoseph,M,100,0,5,5
Davidpaul,M,100,0,5,5
Davindra,M,100,0,5,5
Daviyana,F,100,5,0,5
Davlyn,F,100,5,0,5
Davod,M,100,0,5,5
Davontea,M,100,0,5,5
Davuan,M,100,0,5,5
Davyeon,M,100,0,5,5
Dawann,M,100,0,5,5
Dawm,F,100,5,0,5
Dawndee,F,100,5,0,5
Dawndi,F,100,5,0,5
Dawndria,F,100,5,0,5
Dawneisha,F,100,5,0,5
Dawnett,F,100,5,0,5
Dawnica,F,100,5,0,5
Dawnta,F,100,5,0,5
Daxyn,M,100,0,5,5
Dayamir,F,100,5,0,5
Dayamit,F,100,5,0,5
Dayanie,F,100,5,0,5
Dayesha,F,100,5,0,5
Daygoro,M,100,0,5,5
Dayiana,F,100,5,0,5
Dayion,M,100,0,5,5
Dayland,M,100,0,5,5
Daylanie,F,100,5,0,5
Dayline,F,100,5,0,5
Dayo,F,100,5,0,5
Dayonte,M,100,0,5,5
Dayqwan,M,100,0,5,5
Dayri,F,100,5,0,5
Daysan,M,100,0,5,5
Dayshana,F,100,5,0,5
Dayshanay,F,100,5,0,5
Dayva,F,100,5,0,5
Dayvanee,F,100,5,0,5
Dayveion,M,100,0,5,5
Dayvonna,F,100,5,0,5
Dayvonne,M,100,0,5,5
Dazavion,M,100,0,5,5
Dazhan,M,100,0,5,5
Dazmond,M,100,0,5,5
Dcarlo,M,100,0,5,5
Deajon,M,100,0,5,5
Dealva,F,100,5,0,5
Deaneen,F,100,5,0,5
Deanesha,F,100,5,0,5
Deanjelo,M,100,0,5,5
Deannea,F,100,5,0,5
Deannette,F,100,5,0,5
Deantony,M,100,0,5,5
Deantwon,M,100,0,5,5
Deareon,M,100,0,5,5
Deariah,F,100,5,0,5
Dearious,M,100,0,5,5
Deasja,F,100,5,0,5
Deatta,F,100,5,0,5
Deautre,M,100,0,5,5
Deavante,M,100,0,5,5
Deavyn,F,100,5,0,5
Debarh,F,100,5,0,5
Debbee,F,100,5,0,5
Debbey,F,100,5,0,5
Debor,F,100,5,0,5
Deboraah,F,100,5,0,5
Deboral,F,100,5,0,5
Debralyn,F,100,5,0,5
Debraoh,F,100,5,0,5
Debrea,F,100,5,0,5
Debrha,F,100,5,0,5
Debrisha,F,100,5,0,5
Debroa,F,100,5,0,5
Debrra,F,100,5,0,5
Decara,F,100,5,0,5
Decca,F,100,5,0,5
Dechanel,F,100,5,0,5
Dechaun,M,100,0,5,5
Decima,F,100,5,0,5
Decody,M,100,0,5,5
Decole,F,100,5,0,5
Deda,F,100,5,0,5
Dedrah,F,100,5,0,5
Dedrek,M,100,0,5,5
Dedriana,F,100,5,0,5
Deeandre,M,100,0,5,5
Deeda,F,100,5,0,5
Deeken,M,100,0,5,5
Deekshitha,F,100,5,0,5
Deelilah,F,100,5,0,5
Deella,F,100,5,0,5
Deelynn,F,100,5,0,5
Deepesh,M,100,0,5,5
Deeqa,F,100,5,0,5
Deera,F,100,5,0,5
Deeva,F,100,5,0,5
Degen,M,100,0,5,5
Deiah,F,100,5,0,5
Deiara,F,100,5,0,5
Deiby,M,100,0,5,5
Deidri,F,100,5,0,5
Deilani,F,100,5,0,5
Deimy,F,100,5,0,5
Dein,M,100,0,5,5
Deirore,F,100,5,0,5
Deisree,F,100,5,0,5
Deiveon,M,100,0,5,5
Dejaa,F,100,5,0,5
Dejahnique,F,100,5,0,5
Dejanaye,F,100,5,0,5
Dejaneira,F,100,5,0,5
Dejania,F,100,5,0,5
Dejavion,M,100,0,5,5
Dejhana,F,100,5,0,5
Dejhanae,F,100,5,0,5
Dejontae,M,100,0,5,5
Dejun,M,100,0,5,5
Dekanye,M,100,0,5,5
Dekendra,F,100,5,0,5
Deking,M,100,0,5,5
Dekita,F,100,5,0,5
Dekorion,M,100,0,5,5
Dekoven,M,100,0,5,5
Delainah,F,100,5,0,5
Delandre,M,100,0,5,5
Delanea,F,100,5,0,5
Delanei,F,100,5,0,5
Delanne,F,100,5,0,5
Delanor,M,100,0,5,5
Delanta,M,100,0,5,5
Delantae,M,100,0,5,5
Delanya,F,100,5,0,5
Delasha,F,100,5,0,5
Delaun,M,100,0,5,5
Delauren,F,100,5,0,5
Delaya,F,100,5,0,5
Delaysha,F,100,5,0,5
Delba,F,100,5,0,5
Delborah,F,100,5,0,5
Delbreco,M,100,0,5,5
Delcan,M,100,0,5,5
Delea,F,100,5,0,5
Delean,F,100,5,0,5
Deleatrice,F,100,5,0,5
Delenia,F,100,5,0,5
Delenna,F,100,5,0,5
Deleno,M,100,0,5,5
Delephine,F,100,5,0,5
Deletta,F,100,5,0,5
Delexis,F,100,5,0,5
Delianna,F,100,5,0,5
Deliany,F,100,5,0,5
Delianys,F,100,5,0,5
Delilahrose,F,100,5,0,5
Delissia,F,100,5,0,5
Dellan,M,100,0,5,5
Dellana,F,100,5,0,5
Dellanie,F,100,5,0,5
Dellis,M,100,0,5,5
Delloyd,M,100,0,5,5
Delmond,M,100,0,5,5
Delmonta,M,100,0,5,5
Delno,M,100,0,5,5
Deloice,F,100,5,0,5
Deloma,F,100,5,0,5
Delondo,M,100,0,5,5
Deloni,M,100,0,5,5
Delonia,F,100,5,0,5
Delore,F,100,5,0,5
Deloss,M,100,0,5,5
Delrose,F,100,5,0,5
Delsean,M,100,0,5,5
Delsen,M,100,0,5,5
Delsha,F,100,5,0,5
Deltrick,M,100,0,5,5
Delwayne,M,100,0,5,5
Delwood,M,100,0,5,5
Dely,F,100,5,0,5
Delya,F,100,5,0,5
Delyle,M,100,0,5,5
Delysa,F,100,5,0,5
Demandre,M,100,0,5,5
Demanuel,M,100,0,5,5
Demarean,M,100,0,5,5
Demariana,F,100,5,0,5
Demariea,M,100,0,5,5
Demariona,F,100,5,0,5
Demarkio,M,100,0,5,5
Demaro,M,100,0,5,5
Demarque,M,100,0,5,5
Demarreon,M,100,0,5,5
Demartez,M,100,0,5,5
Demas,M,100,0,5,5
Demaurea,M,100,0,5,5
Demaurio,M,100,0,5,5
Demeatra,F,100,5,0,5
Demeatrius,M,100,0,5,5
Demedrick,M,100,0,5,5
Demeree,F,100,5,0,5
Demeris,M,100,0,5,5
Demerrick,M,100,0,5,5
Demetia,F,100,5,0,5
Demetras,F,100,5,0,5
Demetrial,F,100,5,0,5
Demetrianna,F,100,5,0,5
Demetrices,M,100,0,5,5
Demetricia,F,100,5,0,5
Demetrish,F,100,5,0,5
Demicah,M,100,0,5,5
Demid,M,100,0,5,5
Demier,M,100,0,5,5
Demiracle,F,100,5,0,5
Demitrio,M,100,0,5,5
Demmie,F,100,5,0,5
Demonde,M,100,0,5,5
Demonei,M,100,0,5,5
Demontreal,M,100,0,5,5
Demoris,M,100,0,5,5
Den,M,100,0,5,5
Denaiya,F,100,5,0,5
Denalia,F,100,5,0,5
Denarrius,M,100,0,5,5
Denautica,F,100,5,0,5
Deneco,M,100,0,5,5
Deneem,F,100,5,0,5
Deneesha,F,100,5,0,5
Deneishia,F,100,5,0,5
Denena,F,100,5,0,5
Denes,M,100,0,5,5
Denetia,F,100,5,0,5
Denetris,F,100,5,0,5
Deneva,F,100,5,0,5
Denford,M,100,0,5,5
Denicka,F,100,5,0,5
Deniecia,F,100,5,0,5
Deniella,F,100,5,0,5
Denilzon,M,100,0,5,5
Denin,M,100,0,5,5
Denitta,F,100,5,0,5
Denmark,M,100,0,5,5
Dennae,F,100,5,0,5
Denne,F,100,5,0,5
Dennese,F,100,5,0,5
Dennishia,F,100,5,0,5
Denoris,M,100,0,5,5
Denyah,F,100,5,0,5
Denzyl,M,100,0,5,5
Deonda,F,100,5,0,5
Deonie,F,100,5,0,5
Deonnie,F,100,5,0,5
Deontia,M,100,0,5,5
Deotis,M,100,0,5,5
Deovian,F,100,5,0,5
Deqa,F,100,5,0,5
Dequanda,F,100,5,0,5
Dequantez,M,100,0,5,5
Dequasha,F,100,5,0,5
Dequaveon,M,100,0,5,5
Dequay,M,100,0,5,5
Dequilla,F,100,5,0,5
Dequone,M,100,0,5,5
Deralyn,F,100,5,0,5
Derean,M,100,0,5,5
Dereginald,M,100,0,5,5
Deremy,M,100,0,5,5
Derique,M,100,0,5,5
Derlis,M,100,0,5,5
Dermarr,M,100,0,5,5
Derna,F,100,5,0,5
Deroderick,M,100,0,5,5
Deronna,F,100,5,0,5
Derquan,M,100,0,5,5
Derriah,F,100,5,0,5
Derrice,M,100,0,5,5
Derrione,M,100,0,5,5
Derrol,M,100,0,5,5
Derrold,M,100,0,5,5
Derryon,M,100,0,5,5
Deryon,M,100,0,5,5
Desandra,F,100,5,0,5
Desara,F,100,5,0,5
Desari,F,100,5,0,5
Deseria,F,100,5,0,5
Deshaila,F,100,5,0,5
Deshanon,M,100,0,5,5
Deshaunte,M,100,0,5,5
Deshawndre,M,100,0,5,5
Deshaya,F,100,5,0,5
Desheena,F,100,5,0,5
Deshion,M,100,0,5,5
Deshonia,F,100,5,0,5
Deshuna,F,100,5,0,5
Desinae,F,100,5,0,5
Desitny,F,100,5,0,5
Desjon,M,100,0,5,5
Desriee,F,100,5,0,5
Destainy,F,100,5,0,5
Destiany,F,100,5,0,5
Destinique,F,100,5,0,5
Destinnie,F,100,5,0,5
Destinyann,F,100,5,0,5
Desuan,M,100,0,5,5
Deterrio,M,100,0,5,5
Detisha,F,100,5,0,5
Detrez,M,100,0,5,5
Detri,F,100,5,0,5
Detrica,F,100,5,0,5
Dettrick,M,100,0,5,5
Deundria,F,100,5,0,5
Devanae,F,100,5,0,5
Devance,M,100,0,5,5
Devanhi,F,100,5,0,5
Devannie,F,100,5,0,5
Devanti,M,100,0,5,5
Devaugh,M,100,0,5,5
Devayah,F,100,5,0,5
Devel,M,100,0,5,5
Deveni,F,100,5,0,5
Deverie,F,100,5,0,5
Deverly,F,100,5,0,5
Deveshi,F,100,5,0,5
Deveta,F,100,5,0,5
Devinlee,M,100,0,5,5
Deviontae,M,100,0,5,5
Devito,M,100,0,5,5
Deviyon,M,100,0,5,5
Devn,M,100,0,5,5
Devonae,F,100,5,0,5
Devoni,F,100,5,0,5
Devonnte,M,100,0,5,5
Devontavius,M,100,0,5,5
Devontra,M,100,0,5,5
Devontrae,M,100,0,5,5
Devontrey,M,100,0,5,5
Devunte,M,100,0,5,5
Devven,M,100,0,5,5
Dewetta,F,100,5,0,5
Dewi,F,100,5,0,5
Dewy,M,100,0,5,5
Dewyne,M,100,0,5,5
Dextyn,M,100,0,5,5
Deyannah,F,100,5,0,5
Deyante,M,100,0,5,5
Deymi,F,100,5,0,5
Deymian,M,100,0,5,5
Deyvin,M,100,0,5,5
Dezani,F,100,5,0,5
Dezavion,M,100,0,5,5
Dezden,M,100,0,5,5
Dezere,F,100,5,0,5
Dezhan,M,100,0,5,5
Dezhaun,M,100,0,5,5
Dezmand,M,100,0,5,5
Deztany,F,100,5,0,5
Deztiney,F,100,5,0,5
Dezzarae,F,100,5,0,5
Dhakirah,F,100,5,0,5
Dhamani,M,100,0,5,5
Dhananjay,M,100,0,5,5
Dhanna,F,100,5,0,5
Dharshini,F,100,5,0,5
Dhati,M,100,0,5,5
Dheera,M,100,0,5,5
Dhiago,M,100,0,5,5
Diablo,M,100,0,5,5
Diamoni,F,100,5,0,5
Diamonta,M,100,0,5,5
Dianalee,F,100,5,0,5
Dianalys,F,100,5,0,5
Dianamarie,F,100,5,0,5
Dianeli,F,100,5,0,5
Dianet,F,100,5,0,5
Dianita,F,100,5,0,5
Dianni,F,100,5,0,5
Dianthia,F,100,5,0,5
Diaquan,M,100,0,5,5
Diaundra,F,100,5,0,5
Dicki,F,100,5,0,5
Didra,F,100,5,0,5
Dienne,F,100,5,0,5
Dieudonne,F,100,5,0,5
Dilann,M,100,0,5,5
Dilany,F,100,5,0,5
Dilek,F,100,5,0,5
Dillonger,M,100,0,5,5
Dilver,M,100,0,5,5
Dimarion,M,100,0,5,5
Dimia,F,100,5,0,5
Diminic,M,100,0,5,5
Dindi,F,100,5,0,5
Dinean,F,100,5,0,5
Dinise,F,100,5,0,5
Dink,M,100,0,5,5
Dinnah,F,100,5,0,5
Dinneen,F,100,5,0,5
Dinos,M,100,0,5,5
Diny,F,100,5,0,5
Dionah,F,100,5,0,5
Dionn,M,100,0,5,5
Dionnah,F,100,5,0,5
Diontaye,M,100,0,5,5
Diontray,M,100,0,5,5
Dioseline,F,100,5,0,5
Dipak,M,100,0,5,5
Diquon,M,100,0,5,5
Dishaun,M,100,0,5,5
Disheka,F,100,5,0,5
Distin,M,100,0,5,5
Divan,M,100,0,5,5
Diven,M,100,0,5,5
Diviana,F,100,5,0,5
Divid,M,100,0,5,5
Divij,M,100,0,5,5
Divin,M,100,0,5,5
Divontae,M,100,0,5,5
Divyam,M,100,0,5,5
Dix,M,100,0,5,5
Dixy,F,100,5,0,5
Diyanna,F,100,5,0,5
Diyon,M,100,0,5,5
Diyonna,F,100,5,0,5
Djamila,F,100,5,0,5
Djanae,F,100,5,0,5
Djavon,M,100,0,5,5
Djene,F,100,5,0,5
Dkaiden,M,100,0,5,5
Dkota,M,100,0,5,5
Dlana,F,100,5,0,5
Dlayna,F,100,5,0,5
Dlinda,F,100,5,0,5
Dmar,M,100,0,5,5
Dmareon,M,100,0,5,5
Dmarian,M,100,0,5,5
Dmarko,M,100,0,5,5
Dmarquis,M,100,0,5,5
Dmaurion,M,100,0,5,5
Dmir,M,100,0,5,5
Dmiracle,F,100,5,0,5
Dmitris,M,100,0,5,5
Dneisha,F,100,5,0,5
Dnesha,F,100,5,0,5
Dniah,F,100,5,0,5
Dnielle,F,100,5,0,5
Dnyia,F,100,5,0,5
Do,M,100,0,5,5
Dobby,M,100,0,5,5
Dodson,M,100,0,5,5
Dois,F,100,5,0,5
Dokken,M,100,0,5,5
Dolene,F,100,5,0,5
Dolleen,F,100,5,0,5
Dollena,F,100,5,0,5
Dolli,F,100,5,0,5
Dolphine,F,100,5,0,5
Domari,M,100,0,5,5
Domian,M,100,0,5,5
Domica,F,100,5,0,5
Dominant,M,100,0,5,5
Dominee,F,100,5,0,5
Dominicka,F,100,5,0,5
Dominio,M,100,0,5,5
Dominoe,F,100,5,0,5
Domitilo,M,100,0,5,5
Dommonique,F,100,5,0,5
Domoni,M,100,0,5,5
Domonque,F,100,5,0,5
Domunique,M,100,0,5,5
Domynick,M,100,0,5,5
Donail,M,100,0,5,5
Donall,M,100,0,5,5
Donalynn,F,100,5,0,5
Donamarie,F,100,5,0,5
Donashia,F,100,5,0,5
Dondie,F,100,5,0,5
Dondrey,M,100,0,5,5
Doniell,F,100,5,0,5
Donjanae,F,100,5,0,5
Donminique,M,100,0,5,5
Donnas,F,100,5,0,5
Donneta,F,100,5,0,5
Donnye,M,100,0,5,5
Donoban,M,100,0,5,5
Donquavious,M,100,0,5,5
Dontajah,F,100,5,0,5
Dontarrius,M,100,0,5,5
Dontavias,M,100,0,5,5
Dontaysha,F,100,5,0,5
Dontevion,M,100,0,5,5
Dontrea,M,100,0,5,5
Donyai,M,100,0,5,5
Dooley,M,100,0,5,5
Dorae,F,100,5,0,5
Doraliz,F,100,5,0,5
Doranda,F,100,5,0,5
Dorane,F,100,5,0,5
Doratha,F,100,5,0,5
Doray,F,100,5,0,5
Dorether,F,100,5,0,5
Dorica,F,100,5,0,5
Dorielle,F,100,5,0,5
Dories,F,100,5,0,5
Dorlan,M,100,0,5,5
Dorothye,F,100,5,0,5
Dorra,F,100,5,0,5
Dorrel,M,100,0,5,5
Dorretta,F,100,5,0,5
Dorron,M,100,0,5,5
Dorsha,F,100,5,0,5
Dorsi,F,100,5,0,5
Dotsie,F,100,5,0,5
Douaa,F,100,5,0,5
Douglus,M,100,0,5,5
Doyl,M,100,0,5,5
Doyt,M,100,0,5,5
Dozie,M,100,0,5,5
Dquarious,M,100,0,5,5
Dquavion,M,100,0,5,5
Dragen,M,100,0,5,5
Draike,M,100,0,5,5
Drapper,M,100,0,5,5
Draquan,M,100,0,5,5
Dravid,M,100,0,5,5
Dravion,M,100,0,5,5
Draylee,F,100,5,0,5
Dreauna,F,100,5,0,5
Dreighton,M,100,0,5,5
Dreion,M,100,0,5,5
Drelen,M,100,0,5,5
Dremon,M,100,0,5,5
Dremond,M,100,0,5,5
Dreniyah,F,100,5,0,5
Drennen,M,100,0,5,5
Dresdyn,M,100,0,5,5
Dresha,F,100,5,0,5
Drevian,M,100,0,5,5
Drewry,M,100,0,5,5
Dreylin,M,100,0,5,5
Dreyten,M,100,0,5,5
Dreyven,M,100,0,5,5
Dreyvin,M,100,0,5,5
Driscilla,F,100,5,0,5
Driscoll,M,100,0,5,5
Dritan,M,100,0,5,5
Driyah,F,100,5,0,5
Druce,M,100,0,5,5
Drusella,F,100,5,0,5
Dshae,F,100,5,0,5
Dshayla,F,100,5,0,5
Dshun,M,100,0,5,5
Duann,F,100,5,0,5
Dublyn,F,100,5,0,5
Ducati,M,100,0,5,5
Dude,M,100,0,5,5
Duey,M,100,0,5,5
Duice,F,100,5,0,5
Dujon,M,100,0,5,5
Dukens,M,100,0,5,5
Dulan,M,100,0,5,5
Dulio,M,100,0,5,5
Dulton,M,100,0,5,5
Dumaka,M,100,0,5,5
Dumont,M,100,0,5,5
Dundre,M,100,0,5,5
Duniya,F,100,5,0,5
Dunstan,M,100,0,5,5
Duntae,M,100,0,5,5
Durango,M,100,0,5,5
Duriyah,F,100,5,0,5
Durva,F,100,5,0,5
Durville,M,100,0,5,5
Dushane,M,100,0,5,5
Dusharme,F,100,5,0,5
Dusin,M,100,0,5,5
Duskin,M,100,0,5,5
Dustinjames,M,100,0,5,5
Dustion,M,100,0,5,5
Dut,M,100,0,5,5
Dwaina,F,100,5,0,5
Dwania,F,100,5,0,5
Dwen,M,100,0,5,5
Dwyer,M,100,0,5,5
Dwyn,F,100,5,0,5
Dyanira,F,100,5,0,5
Dyisha,F,100,5,0,5
Dykeria,F,100,5,0,5
Dylane,F,100,5,0,5
Dylanjacob,M,100,0,5,5
Dylanthomas,M,100,0,5,5
Dylenn,M,100,0,5,5
Dyllian,M,100,0,5,5
Dynalee,F,100,5,0,5
Dynasha,F,100,5,0,5
Dynesti,F,100,5,0,5
Dynita,F,100,5,0,5
Dyondre,M,100,0,5,5
Dyontae,M,100,0,5,5
Dysan,M,100,0,5,5
Dysean,M,100,0,5,5
Dystini,F,100,5,0,5
Dyuti,F,100,5,0,5
Dyvion,M,100,0,5,5
Dyvonne,F,100,5,0,5
Dzejla,F,100,5,0,5
Dzeneta,F,100,5,0,5
Dzenita,F,100,5,0,5
Dziah,F,100,5,0,5
Dzya,F,100,5,0,5
Eadyn,F,100,5,0,5
Eaen,M,100,0,5,5
Earin,M,100,0,5,5
Earlesha,F,100,5,0,5
Earlin,M,100,0,5,5
Earlisa,F,100,5,0,5
Earlynn,F,100,5,0,5
Earna,F,100,5,0,5
Earnestene,F,100,5,0,5
Earney,M,100,0,5,5
Earsel,M,100,0,5,5
Earskin,M,100,0,5,5
Earstine,F,100,5,0,5
Eashaan,M,100,0,5,5
Ebaad,M,100,0,5,5
Ebaristo,M,100,0,5,5
Ebben,M,100,0,5,5
Ebrahima,M,100,0,5,5
Ecequiel,M,100,0,5,5
Edalia,F,100,5,0,5
Eddica,F,100,5,0,5
Eddyson,M,100,0,5,5
Edenrose,F,100,5,0,5
Ederick,M,100,0,5,5
Edgareduardo,M,100,0,5,5
Edica,F,100,5,0,5
Edier,M,100,0,5,5
Edika,F,100,5,0,5
Edir,M,100,0,5,5
Edisha,F,100,5,0,5
Edlynn,F,100,5,0,5
Edmondo,M,100,0,5,5
Edmound,M,100,0,5,5
Edony,F,100,5,0,5
Edroy,M,100,0,5,5
Edsson,M,100,0,5,5
Eduan,M,100,0,5,5
Edvard,M,100,0,5,5
Edwardd,M,100,0,5,5
Edweina,F,100,5,0,5
Edwidge,M,100,0,5,5
Edwind,M,100,0,5,5
Edwon,M,100,0,5,5
Edzon,M,100,0,5,5
Eelijah,M,100,0,5,5
Eeliyah,F,100,5,0,5
Effren,M,100,0,5,5
Efigenia,F,100,5,0,5
Efrian,M,100,0,5,5
Efthymia,F,100,5,0,5
Egidio,M,100,0,5,5
Egina,F,100,5,0,5
Ehlijah,M,100,0,5,5
Ehud,M,100,0,5,5
Ehvan,M,100,0,5,5
Eidel,F,100,5,0,5
Eijah,M,100,0,5,5
Eiko,F,100,5,0,5
Eilijah,M,100,0,5,5
Eilise,F,100,5,0,5
Eillie,F,100,5,0,5
Eilon,M,100,0,5,5
Eimear,F,100,5,0,5
Eimly,F,100,5,0,5
Einav,F,100,5,0,5
Einstein,M,100,0,5,5
Eireen,F,100,5,0,5
Eirian,F,100,5,0,5
Eisenhower,M,100,0,5,5
Eithne,F,100,5,0,5
Eiva,F,100,5,0,5
Eiven,M,100,0,5,5
Eiyanna,F,100,5,0,5
Ekambir,M,100,0,5,5
Ekamjit,M,100,0,5,5
Eko,M,100,0,5,5
Ekow,M,100,0,5,5
Elaheh,F,100,5,0,5
Elahna,F,100,5,0,5
Elaida,F,100,5,0,5
Elaiya,F,100,5,0,5
Elander,F,100,5,0,5
Elanny,F,100,5,0,5
Elanur,F,100,5,0,5
Elario,M,100,0,5,5
Elayiah,F,100,5,0,5
Elayla,F,100,5,0,5
Elazia,F,100,5,0,5
Elbie,M,100,0,5,5
Elbis,M,100,0,5,5
Elbonie,F,100,5,0,5
Elcid,M,100,0,5,5
Eldad,M,100,0,5,5
Eldion,M,100,0,5,5
Eldrich,M,100,0,5,5
Eldrige,M,100,0,5,5
Ele,F,100,5,0,5
Eleasa,F,100,5,0,5
Eleasah,F,100,5,0,5
Elecktra,F,100,5,0,5
Eleecia,F,100,5,0,5
Eleigh,F,100,5,0,5
Eleigha,F,100,5,0,5
Elemer,M,100,0,5,5
Elexes,F,100,5,0,5
Elexi,F,100,5,0,5
Eleya,F,100,5,0,5
Eleyana,F,100,5,0,5
Elezabeth,F,100,5,0,5
Elfa,F,100,5,0,5
Elfago,M,100,0,5,5
Elford,M,100,0,5,5
Elgina,F,100,5,0,5
Elhana,F,100,5,0,5
Elianagrace,F,100,5,0,5
Eliandra,F,100,5,0,5
Eliara,F,100,5,0,5
Eliase,M,100,0,5,5
Eliasib,M,100,0,5,5
Eliborio,M,100,0,5,5
Eliciana,F,100,5,0,5
Elick,M,100,0,5,5
Elidet,F,100,5,0,5
Elieana,F,100,5,0,5
Elijahray,M,100,0,5,5
Elijawon,M,100,0,5,5
Elijay,M,100,0,5,5
Elijhah,M,100,0,5,5
Elikai,M,100,0,5,5
Elikem,M,100,0,5,5
Elioth,M,100,0,5,5
Elisabeta,F,100,5,0,5
Elisabethe,F,100,5,0,5
Elisbeth,F,100,5,0,5
Elisei,M,100,0,5,5
Elisianna,F,100,5,0,5
Elisjah,M,100,0,5,5
Elissar,F,100,5,0,5
Elissha,F,100,5,0,5
Elisya,F,100,5,0,5
Elithia,F,100,5,0,5
Eliverto,M,100,0,5,5
Elixander,M,100,0,5,5
Elixis,F,100,5,0,5
Eliyahna,F,100,5,0,5
Elizabeath,F,100,5,0,5
Elizaberh,F,100,5,0,5
Elizabethgrace,F,100,5,0,5
Elizabith,F,100,5,0,5
Elizajane,F,100,5,0,5
Elizander,M,100,0,5,5
Ellajo,F,100,5,0,5
Ellamaria,F,100,5,0,5
Ellanah,F,100,5,0,5
Ellasandra,F,100,5,0,5
Ellasia,F,100,5,0,5
Ellasophia,F,100,5,0,5
Ellayah,F,100,5,0,5
Ellean,F,100,5,0,5
Elleanora,F,100,5,0,5
Elleny,F,100,5,0,5
Elleora,F,100,5,0,5
Ellesha,F,100,5,0,5
Ellette,F,100,5,0,5
Elliena,F,100,5,0,5
Elliora,F,100,5,0,5
Elliyanna,F,100,5,0,5
Ellon,F,100,5,0,5
Ellycia,F,100,5,0,5
Ellymae,F,100,5,0,5
Ellynn,F,100,5,0,5
Ellyot,F,100,5,0,5
Ellyza,F,100,5,0,5
Elmi,M,100,0,5,5
Elner,F,100,5,0,5
Eloyce,F,100,5,0,5
Elrita,F,100,5,0,5
Elroi,M,100,0,5,5
Elron,M,100,0,5,5
Elsabeth,F,100,5,0,5
Elvester,M,100,0,5,5
Elworth,M,100,0,5,5
Elyahna,F,100,5,0,5
Elyda,F,100,5,0,5
Elyijah,M,100,0,5,5
Elynna,F,100,5,0,5
Elynore,F,100,5,0,5
Elysian,F,100,5,0,5
Elyus,M,100,0,5,5
Elyze,F,100,5,0,5
Emagin,F,100,5,0,5
Emaje,M,100,0,5,5
Emalei,F,100,5,0,5
Emalena,F,100,5,0,5
Emaliya,F,100,5,0,5
Emane,F,100,5,0,5
Emareon,M,100,0,5,5
Emarii,M,100,0,5,5
Emayah,F,100,5,0,5
Emeilia,F,100,5,0,5
Emelye,F,100,5,0,5
Emem,F,100,5,0,5
Emeralda,F,100,5,0,5
Emeria,F,100,5,0,5
Emerich,M,100,0,5,5
Emeris,M,100,0,5,5
Emeryk,M,100,0,5,5
Emier,M,100,0,5,5
Emilda,F,100,5,0,5
Emiliann,F,100,5,0,5
Emiliee,F,100,5,0,5
Emille,F,100,5,0,5
Emilyjane,F,100,5,0,5
Emilymae,F,100,5,0,5
Emilyna,F,100,5,0,5
Emirra,F,100,5,0,5
Emiry,F,100,5,0,5
Emiterio,M,100,0,5,5
Emly,F,100,5,0,5
Emmabella,F,100,5,0,5
Emmabeth,F,100,5,0,5
Emmagene,F,100,5,0,5
Emmanel,M,100,0,5,5
Emmaneul,M,100,0,5,5
Emmanul,M,100,0,5,5
Emmasue,F,100,5,0,5
Emmelee,F,100,5,0,5
Emmelene,F,100,5,0,5
Emmeric,M,100,0,5,5
Emmey,F,100,5,0,5
Emmiliano,M,100,0,5,5
Emmilie,F,100,5,0,5
Emmilou,F,100,5,0,5
Emmon,M,100,0,5,5
Emmorie,F,100,5,0,5
Emmye,F,100,5,0,5
Emora,F,100,5,0,5
Emperess,F,100,5,0,5
Emryck,M,100,0,5,5
Emyri,F,100,5,0,5
Emyrie,F,100,5,0,5
Emytt,M,100,0,5,5
Emzley,F,100,5,0,5
Enaja,F,100,5,0,5
Enari,F,100,5,0,5
Enaysia,F,100,5,0,5
Endra,F,100,5,0,5
Endrew,M,100,0,5,5
Endyah,F,100,5,0,5
Endyia,F,100,5,0,5
Enemencio,M,100,0,5,5
Ener,M,100,0,5,5
Enesa,F,100,5,0,5
Enesha,F,100,5,0,5
Enette,F,100,5,0,5
Engelberto,M,100,0,5,5
Enika,F,100,5,0,5
Enissa,F,100,5,0,5
Eniylah,F,100,5,0,5
Ennette,F,100,5,0,5
Enoe,M,100,0,5,5
Enolia,F,100,5,0,5
Enrick,M,100,0,5,5
Ensign,M,100,0,5,5
Ensleigh,F,100,5,0,5
Enyssa,F,100,5,0,5
Ephrim,M,100,0,5,5
Ephron,M,100,0,5,5
Equasha,F,100,5,0,5
Equasia,F,100,5,0,5
Erastus,M,100,0,5,5
Erbie,M,100,0,5,5
Erbin,M,100,0,5,5
Erblin,M,100,0,5,5
Ereca,F,100,5,0,5
Erenest,M,100,0,5,5
Erenst,M,100,0,5,5
Eresmia,F,100,5,0,5
Erhan,M,100,0,5,5
Eriani,F,100,5,0,5
Eriann,F,100,5,0,5
Eriannah,F,100,5,0,5
Ericamarie,F,100,5,0,5
Ericanicole,F,100,5,0,5
Ericanthony,M,100,0,5,5
Ericdaniel,M,100,0,5,5
Ericjames,M,100,0,5,5
Erickia,F,100,5,0,5
Eridani,F,100,5,0,5
Erien,F,100,5,0,5
Erieonna,F,100,5,0,5
Erihanna,F,100,5,0,5
Erim,F,100,5,0,5
Erinisha,F,100,5,0,5
Erionne,F,100,5,0,5
Erison,M,100,0,5,5
Eritrea,F,100,5,0,5
Erivan,M,100,0,5,5
Erkan,M,100,0,5,5
Erlan,M,100,0,5,5
Ermalene,F,100,5,0,5
Ermel,M,100,0,5,5
Ermie,M,100,0,5,5
Ermilo,M,100,0,5,5
Ermon,M,100,0,5,5
Ernel,M,100,0,5,5
Ernestene,F,100,5,0,5
Ernestor,M,100,0,5,5
Erniest,M,100,0,5,5
Ersilia,F,100,5,0,5
Ertis,M,100,0,5,5
Erwan,M,100,0,5,5
Esaie,M,100,0,5,5
Esain,M,100,0,5,5
Esat,M,100,0,5,5
Eschelle,F,100,5,0,5
Esekiel,M,100,0,5,5
Esenia,F,100,5,0,5
Esey,M,100,0,5,5
Eshawna,F,100,5,0,5
Eshell,F,100,5,0,5
Esiquiel,M,100,0,5,5
Eslem,F,100,5,0,5
Esmeraida,F,100,5,0,5
Esohe,F,100,5,0,5
Essined,F,100,5,0,5
Estarlin,M,100,0,5,5
Estavon,M,100,0,5,5
Estefanya,F,100,5,0,5
Estellar,F,100,5,0,5
Estellise,F,100,5,0,5
Esteysi,F,100,5,0,5
Estivalis,F,100,5,0,5
Estrada,M,100,0,5,5
Esven,M,100,0,5,5
Eszter,F,100,5,0,5
Etash,M,100,0,5,5
Eternal,M,100,0,5,5
Ethaen,M,100,0,5,5
Ethaneal,M,100,0,5,5
Ethanjay,M,100,0,5,5
Ethelbert,M,100,0,5,5
Ethelle,F,100,5,0,5
Ethelrene,F,100,5,0,5
Ethny,F,100,5,0,5
Ethynn,M,100,0,5,5
Etinosa,M,100,0,5,5
Etnie,F,100,5,0,5
Etolia,F,100,5,0,5
Etonya,F,100,5,0,5
Etsub,F,100,5,0,5
Ettalyn,F,100,5,0,5
Eudell,M,100,0,5,5
Eudy,M,100,0,5,5
Eugine,M,100,0,5,5
Euginia,F,100,5,0,5
Eulala,F,100,5,0,5
Eular,F,100,5,0,5
Eules,M,100,0,5,5
Eunji,F,100,5,0,5
Eurasia,F,100,5,0,5
Eureeka,F,100,5,0,5
Euretha,F,100,5,0,5
Euricka,F,100,5,0,5
Euriel,M,100,0,5,5
Eutiquio,M,100,0,5,5
Evaeh,F,100,5,0,5
Evaine,F,100,5,0,5
Evalen,F,100,5,0,5
Evalia,F,100,5,0,5
Evalisa,F,100,5,0,5
Evanell,F,100,5,0,5
Evangalene,F,100,5,0,5
Evangelena,F,100,5,0,5
Evangelita,F,100,5,0,5
Evangely,F,100,5,0,5
Evanjames,M,100,0,5,5
Evannah,F,100,5,0,5
Evanni,F,100,5,0,5
Evanyelin,F,100,5,0,5
Evart,M,100,0,5,5
Evdoxia,F,100,5,0,5
Eveana,F,100,5,0,5
Evelinn,F,100,5,0,5
Evelyon,F,100,5,0,5
Evennie,F,100,5,0,5
Evera,F,100,5,0,5
Everlei,F,100,5,0,5
Eversyn,F,100,5,0,5
Every,M,100,0,5,5
Evilin,F,100,5,0,5
Evilynn,F,100,5,0,5
Evins,M,100,0,5,5
Evionna,F,100,5,0,5
Evo,M,100,0,5,5
Evola,F,100,5,0,5
Evonn,F,100,5,0,5
Evontae,M,100,0,5,5
Evorn,F,100,5,0,5
Evra,F,100,5,0,5
Evran,M,100,0,5,5
Evyan,F,100,5,0,5
Evyana,F,100,5,0,5
Evylin,F,100,5,0,5
Ewanda,F,100,5,0,5
Ewart,M,100,0,5,5
Ewin,M,100,0,5,5
Exar,M,100,0,5,5
Exzander,M,100,0,5,5
Eydi,F,100,5,0,5
Eygpt,F,100,5,0,5
Eyra,F,100,5,0,5
Eyram,F,100,5,0,5
Eythen,M,100,0,5,5
Eyvan,M,100,0,5,5
Eyvin,M,100,0,5,5
Ezabel,F,100,5,0,5
Ezael,M,100,0,5,5
Ezayah,M,100,0,5,5
Ezekeal,M,100,0,5,5
Ezekyel,M,100,0,5,5
Ezequil,M,100,0,5,5
Ezera,M,100,0,5,5
Eziquel,M,100,0,5,5
Eziquiel,M,100,0,5,5
Eziquio,M,100,0,5,5
Eziya,F,100,5,0,5
Eziyah,F,100,5,0,5
Ezlynn,F,100,5,0,5
Ezquiel,M,100,0,5,5
Fabiene,F,100,5,0,5
Fabriana,F,100,5,0,5
Fadeelah,F,100,5,0,5
Fahm,F,100,5,0,5
Fairley,M,100,0,5,5
Fairyn,F,100,5,0,5
Faizal,M,100,0,5,5
Faleisha,F,100,5,0,5
Falynne,F,100,5,0,5
Faneisha,F,100,5,0,5
Fanon,M,100,0,5,5
Fantaisa,F,100,5,0,5
Fantaysia,F,100,5,0,5
Fardosa,F,100,5,0,5
Farica,F,100,5,0,5
Fariz,M,100,0,5,5
Farrow,M,100,0,5,5
Farrukh,M,100,0,5,5
Farshid,M,100,0,5,5
Faryl,F,100,5,0,5
Farynn,F,100,5,0,5
Farzin,M,100,0,5,5
Fatai,M,100,0,5,5
Fateemah,F,100,5,0,5
Fathma,F,100,5,0,5
Fatimat,F,100,5,0,5
Fatmire,F,100,5,0,5
Fattima,F,100,5,0,5
Fatumo,F,100,5,0,5
Fawkes,M,100,0,5,5
Fawnna,F,100,5,0,5
Fawzan,M,100,0,5,5
Fayaz,M,100,0,5,5
Fayleen,F,100,5,0,5
Febbie,F,100,5,0,5
Febie,F,100,5,0,5
Feda,F,100,5,0,5
Fedel,M,100,0,5,5
Feleisha,F,100,5,0,5
Felinda,F,100,5,0,5
Felissia,F,100,5,0,5
Felizardo,M,100,0,5,5
Fellicia,F,100,5,0,5
Fellipe,M,100,0,5,5
Felty,M,100,0,5,5
Felyx,M,100,0,5,5
Femke,F,100,5,0,5
Fenley,F,100,5,0,5
Fennell,M,100,0,5,5
Feodor,M,100,0,5,5
Feodora,F,100,5,0,5
Ferdinan,M,100,0,5,5
Ferid,M,100,0,5,5
Feride,F,100,5,0,5
Fernande,F,100,5,0,5
Fernandeo,M,100,0,5,5
Ferra,F,100,5,0,5
Ferrante,M,100,0,5,5
Ferras,M,100,0,5,5
Ferren,F,100,5,0,5
Fetina,F,100,5,0,5
Feyisayo,F,100,5,0,5
Feysal,M,100,0,5,5
Fhernando,M,100,0,5,5
Fiifi,M,100,0,5,5
Fili,M,100,0,5,5
Filicity,F,100,5,0,5
Filipa,F,100,5,0,5
Filisha,F,100,5,0,5
Filiz,F,100,5,0,5
Finbarr,M,100,0,5,5
Finessa,F,100,5,0,5
Finest,M,100,0,5,5
Finlea,F,100,5,0,5
Finnlay,M,100,0,5,5
Finus,M,100,0,5,5
Fiorenza,F,100,5,0,5
Firdous,F,100,5,0,5
Firyal,F,100,5,0,5
Fjolla,F,100,5,0,5
Flame,F,100,5,0,5
Flavian,M,100,0,5,5
Flavius,M,100,0,5,5
Flay,M,100,0,5,5
Flechia,F,100,5,0,5
Fleda,F,100,5,0,5
Flerida,F,100,5,0,5
Flicia,F,100,5,0,5
Flip,M,100,0,5,5
Florastine,F,100,5,0,5
Flordemaria,F,100,5,0,5
Florena,F,100,5,0,5
Floriberto,M,100,0,5,5
Florisel,F,100,5,0,5
Floyda,F,100,5,0,5
Floye,F,100,5,0,5
Floyed,M,100,0,5,5
Flozell,M,100,0,5,5
Foluke,F,100,5,0,5
Fonnie,F,100,5,0,5
Fontane,M,100,0,5,5
Fontilla,F,100,5,0,5
Foram,F,100,5,0,5
Forde,M,100,0,5,5
Forestt,M,100,0,5,5
Forman,M,100,0,5,5
Fortunata,F,100,5,0,5
Forum,F,100,5,0,5
Fouzia,F,100,5,0,5
Foxy,F,100,5,0,5
Fracine,F,100,5,0,5
Fraidel,F,100,5,0,5
Francel,F,100,5,0,5
Franciscojr,M,100,0,5,5
Franciscus,M,100,0,5,5
Franclin,M,100,0,5,5
Francsico,M,100,0,5,5
Franda,F,100,5,0,5
Frankly,M,100,0,5,5
Franne,F,100,5,0,5
Frantisek,M,100,0,5,5
Franyelis,F,100,5,0,5
Fread,M,100,0,5,5
Freddye,F,100,5,0,5
Fredeline,F,100,5,0,5
Fredina,F,100,5,0,5
Fredine,F,100,5,0,5
Fredo,M,100,0,5,5
Freedia,F,100,5,0,5
Frezell,M,100,0,5,5
Friend,M,100,0,5,5
Frika,F,100,5,0,5
Frimmy,F,100,5,0,5
Frita,F,100,5,0,5
Fritha,F,100,5,0,5
Fronia,F,100,5,0,5
Fronie,F,100,5,0,5
Fronnie,F,100,5,0,5
Frutoso,M,100,0,5,5
Furaha,F,100,5,0,5
Furney,M,100,0,5,5
Fury,F,100,5,0,5
Fuzail,M,100,0,5,5
Fynnleigh,F,100,5,0,5
Gaber,M,100,0,5,5
Gaberille,F,100,5,0,5
Gabie,F,100,5,0,5
Gabirelle,F,100,5,0,5
Gabrail,M,100,0,5,5
Gabreella,F,100,5,0,5
Gabreial,F,100,5,0,5
Gabria,F,100,5,0,5
Gabriala,F,100,5,0,5
Gabrielah,F,100,5,0,5
Gabrielangelo,M,100,0,5,5
Gabrieljohn,M,100,0,5,5
Gabriellamarie,F,100,5,0,5
Gabrionna,F,100,5,0,5
Gabryell,F,100,5,0,5
Gabrylle,F,100,5,0,5
Gadeer,F,100,5,0,5
Gaela,F,100,5,0,5
Gaeton,M,100,0,5,5
Gahan,M,100,0,5,5
Gailanne,F,100,5,0,5
Gaileen,F,100,5,0,5
Gailon,M,100,0,5,5
Gailynn,F,100,5,0,5
Galathia,F,100,5,0,5
Galatia,F,100,5,0,5
Galicia,F,100,5,0,5
Gallagher,M,100,0,5,5
Galloway,M,100,0,5,5
Galon,M,100,0,5,5
Galvester,M,100,0,5,5
Gamila,F,100,5,0,5
Gamir,M,100,0,5,5
Gamya,F,100,5,0,5
Ganae,F,100,5,0,5
Gandalf,M,100,0,5,5
Ganell,F,100,5,0,5
Ganelle,F,100,5,0,5
Gani,M,100,0,5,5
Gannicus,M,100,0,5,5
Gantt,M,100,0,5,5
Gaolee,F,100,5,0,5
Gaoussou,M,100,0,5,5
Gaquan,M,100,0,5,5
Garak,M,100,0,5,5
Gardina,F,100,5,0,5
Garine,F,100,5,0,5
Garitt,M,100,0,5,5
Garius,M,100,0,5,5
Garrad,M,100,0,5,5
Garratt,M,100,0,5,5
Garrek,M,100,0,5,5
Garrel,M,100,0,5,5
Garri,F,100,5,0,5
Garryn,F,100,5,0,5
Gartrell,M,100,0,5,5
Garwood,M,100,0,5,5
Garyl,M,100,0,5,5
Garytt,M,100,0,5,5
Gasia,F,100,5,0,5
Gatlen,M,100,0,5,5
Gattis,M,100,0,5,5
Gaurika,F,100,5,0,5
Gavian,M,100,0,5,5
Gavien,M,100,0,5,5
Gavy,F,100,5,0,5
Gavyne,M,100,0,5,5
Gawaine,M,100,0,5,5
Gaylor,M,100,0,5,5
Gazella,F,100,5,0,5
Gecenia,F,100,5,0,5
Gehad,F,100,5,0,5
Geidi,F,100,5,0,5
Gelen,F,100,5,0,5
Gella,F,100,5,0,5
Gelsomina,F,100,5,0,5
Gemar,M,100,0,5,5
Gemelli,F,100,5,0,5
Genavecia,F,100,5,0,5
Geneine,F,100,5,0,5
Genele,F,100,5,0,5
Genelia,F,100,5,0,5
Genendy,F,100,5,0,5
Genessi,F,100,5,0,5
Geniel,F,100,5,0,5
Geniffer,F,100,5,0,5
Genissa,F,100,5,0,5
Genki,M,100,0,5,5
Genner,M,100,0,5,5
Gennessy,F,100,5,0,5
Gennevieve,F,100,5,0,5
Genovevo,M,100,0,5,5
Genovieve,F,100,5,0,5
Genvieve,F,100,5,0,5
Geona,F,100,5,0,5
Geonte,M,100,0,5,5
Georden,M,100,0,5,5
Georgiane,F,100,5,0,5
Geovan,M,100,0,5,5
Geovonie,M,100,0,5,5
Geraldinne,F,100,5,0,5
Gerall,M,100,0,5,5
Gerame,M,100,0,5,5
Gerardina,F,100,5,0,5
Gerardojr,M,100,0,5,5
Gereld,M,100,0,5,5
Geremie,M,100,0,5,5
Geriel,M,100,0,5,5
Gerin,M,100,0,5,5
Gerita,F,100,5,0,5
Gerlisa,F,100,5,0,5
Germari,M,100,0,5,5
Germarion,M,100,0,5,5
Germayne,M,100,0,5,5
Germell,M,100,0,5,5
Germey,M,100,0,5,5
Germya,F,100,5,0,5
Gerniya,F,100,5,0,5
Gero,M,100,0,5,5
Gerolyn,F,100,5,0,5
Gerret,M,100,0,5,5
Gerrold,M,100,0,5,5
Gervase,M,100,0,5,5
Gesel,F,100,5,0,5
Geshia,F,100,5,0,5
Gesica,F,100,5,0,5
Gesina,F,100,5,0,5
Gessell,F,100,5,0,5
Getsemany,F,100,5,0,5
Getty,M,100,0,5,5
Gevalia,F,100,5,0,5
Gewel,F,100,5,0,5
Ghais,M,100,0,5,5
Ghanem,M,100,0,5,5
Ghavin,M,100,0,5,5
Ghenet,F,100,5,0,5
Gi,F,100,5,0,5
Giacinto,M,100,0,5,5
Giahan,F,100,5,0,5
Gianessa,F,100,5,0,5
Giannarose,F,100,5,0,5
Giany,F,100,5,0,5
Giavonnie,F,100,5,0,5
Gibert,M,100,0,5,5
Giget,F,100,5,0,5
Gigette,F,100,5,0,5
Gildo,M,100,0,5,5
Gile,M,100,0,5,5
Gillan,F,100,5,0,5
Gillen,M,100,0,5,5
Gillette,M,100,0,5,5
Ginae,F,100,5,0,5
Gineva,F,100,5,0,5
Ging,F,100,5,0,5
Ginney,F,100,5,0,5
Gioanna,F,100,5,0,5
Giobani,M,100,0,5,5
Giobany,M,100,0,5,5
Gioconda,F,100,5,0,5
Giovannii,M,100,0,5,5
Giovonie,M,100,0,5,5
Gipson,M,100,0,5,5
Girtie,F,100,5,0,5
Gisely,F,100,5,0,5
Gittle,F,100,5,0,5
Givonna,F,100,5,0,5
Giyana,F,100,5,0,5
Gladie,F,100,5,0,5
Glendalee,F,100,5,0,5
Glendean,F,100,5,0,5
Glenese,F,100,5,0,5
Gleneva,F,100,5,0,5
Glennard,M,100,0,5,5
Glenndora,F,100,5,0,5
Glenne,F,100,5,0,5
Glennell,F,100,5,0,5
Glennice,F,100,5,0,5
Glenston,M,100,0,5,5
Glenville,M,100,0,5,5
Gleny,F,100,5,0,5
Glo,F,100,5,0,5
Gloretha,F,100,5,0,5
Glorius,F,100,5,0,5
Glossie,F,100,5,0,5
Glyndia,F,100,5,0,5
Glyndora,F,100,5,0,5
Goble,M,100,0,5,5
Godiva,F,100,5,0,5
Gola,F,100,5,0,5
Goldi,F,100,5,0,5
Gomez,M,100,0,5,5
Gonzella,F,100,5,0,5
Goodman,M,100,0,5,5
Gopika,F,100,5,0,5
Gorete,F,100,5,0,5
Gorkem,M,100,0,5,5
Goshen,M,100,0,5,5
Gospel,M,100,0,5,5
Gottlob,M,100,0,5,5
Gouri,F,100,5,0,5
Govanna,F,100,5,0,5
Gracean,F,100,5,0,5
Graceelizabeth,F,100,5,0,5
Gracelan,F,100,5,0,5
Gracelynd,F,100,5,0,5
Gracian,M,100,0,5,5
Gracilynn,F,100,5,0,5
Gradys,F,100,5,0,5
Graecen,M,100,0,5,5
Graedy,M,100,0,5,5
Graeham,M,100,0,5,5
Graer,M,100,0,5,5
Graicen,M,100,0,5,5
Graicyn,F,100,5,0,5
Grantlee,M,100,0,5,5
Grasha,F,100,5,0,5
Graven,M,100,0,5,5
Graylynn,F,100,5,0,5
Graysie,F,100,5,0,5
Graziana,F,100,5,0,5
Greagory,M,100,0,5,5
Grechen,F,100,5,0,5
Greda,F,100,5,0,5
Gregorg,M,100,0,5,5
Gregorios,M,100,0,5,5
Gregrory,M,100,0,5,5
Gregson,M,100,0,5,5
Greidi,F,100,5,0,5
Gretal,F,100,5,0,5
Greyce,F,100,5,0,5
Greylynn,F,100,5,0,5
Grieg,M,100,0,5,5
Griffinn,M,100,0,5,5
Grifin,M,100,0,5,5
Grigory,M,100,0,5,5
Grinda,F,100,5,0,5
Griscelda,F,100,5,0,5
Gristian,M,100,0,5,5
Gryffon,M,100,0,5,5
Guadulupe,F,100,5,0,5
Guardian,M,100,0,5,5
Guarionex,M,100,0,5,5
Guendalina,F,100,5,0,5
Guendolyn,F,100,5,0,5
Guenter,M,100,0,5,5
Guenther,M,100,0,5,5
Guess,M,100,0,5,5
Guilbert,M,100,0,5,5
Guilmar,M,100,0,5,5
Guisel,F,100,5,0,5
Guisell,F,100,5,0,5
Guisselle,F,100,5,0,5
Gul,F,100,5,0,5
Gullermo,M,100,0,5,5
Gurjeet,M,100,0,5,5
Gurkamal,M,100,0,5,5
Gurley,M,100,0,5,5
Gurnaaz,F,100,5,0,5
Gurpal,M,100,0,5,5
Gurseerat,F,100,5,0,5
Guru,M,100,0,5,5
Gurveen,F,100,5,0,5
Gurvis,M,100,0,5,5
Gustauo,M,100,0,5,5
Guston,M,100,0,5,5
Guyann,F,100,5,0,5
Guyanne,F,100,5,0,5
Guymon,M,100,0,5,5
Guyneth,F,100,5,0,5
Gwain,M,100,0,5,5
Gwan,F,100,5,0,5
Gwenaelle,F,100,5,0,5
Gwendelynn,F,100,5,0,5
Gwender,F,100,5,0,5
Gwendia,F,100,5,0,5
Gwenell,F,100,5,0,5
Gweneva,F,100,5,0,5
Gwennan,F,100,5,0,5
Gwennetta,F,100,5,0,5
Gwenyvere,F,100,5,0,5
Gwilym,M,100,0,5,5
Gwinn,F,100,5,0,5
Gwydion,M,100,0,5,5
Gwynavere,F,100,5,0,5
Gwynetta,F,100,5,0,5
Gy,M,100,0,5,5
Gyanni,F,100,5,0,5
Gyna,F,100,5,0,5
Gynesis,F,100,5,0,5
Gyra,F,100,5,0,5
Gzim,M,100,0,5,5
Haadiyah,F,100,5,0,5
Haala,F,100,5,0,5
Haania,F,100,5,0,5
Haasan,M,100,0,5,5
Habibatou,F,100,5,0,5
Habil,M,100,0,5,5
Had,M,100,0,5,5
Hada,F,100,5,0,5
Hadan,M,100,0,5,5
Haddasah,F,100,5,0,5
Hadeer,F,100,5,0,5
Hadiah,F,100,5,0,5
Hadilyn,F,100,5,0,5
Hadji,M,100,0,5,5
Hadleyann,F,100,5,0,5
Haedon,M,100,0,5,5
Haein,F,100,5,0,5
Hael,M,100,0,5,5
Haevynn,F,100,5,0,5
Hafso,F,100,5,0,5
Hageo,M,100,0,5,5
Haggai,M,100,0,5,5
Haileah,F,100,5,0,5
Haileen,F,100,5,0,5
Haileyjo,F,100,5,0,5
Hailiey,F,100,5,0,5
Haisten,M,100,0,5,5
Haiylee,F,100,5,0,5
Hajara,F,100,5,0,5
Hajime,M,100,0,5,5
Hajin,M,100,0,5,5
Hajirah,F,100,5,0,5
Halane,F,100,5,0,5
Haldrin,M,100,0,5,5
Haleia,F,100,5,0,5
Halene,F,100,5,0,5
Haleyjo,F,100,5,0,5
Halleh,F,100,5,0,5
Halleli,F,100,5,0,5
Hallema,F,100,5,0,5
Halye,F,100,5,0,5
Halyna,F,100,5,0,5
Hamaad,M,100,0,5,5
Hamidah,F,100,5,0,5
Hamlin,M,100,0,5,5
Hanai,F,100,5,0,5
Hanalee,F,100,5,0,5
Hanane,F,100,5,0,5
Hanlee,F,100,5,0,5
Hannabella,F,100,5,0,5
Hannahelizabeth,F,100,5,0,5
Hannahlynn,F,100,5,0,5
Hannahrae,F,100,5,0,5
Hannalise,F,100,5,0,5
Hannha,F,100,5,0,5
Hanniah,F,100,5,0,5
Hanns,M,100,0,5,5
Hansley,M,100,0,5,5
Hantz,M,100,0,5,5
Haochen,M,100,0,5,5
Haoyang,M,100,0,5,5
Haralabos,M,100,0,5,5
Hardison,M,100,0,5,5
Hardwick,M,100,0,5,5
Harilaos,M,100,0,5,5
Haripriya,F,100,5,0,5
Harita,F,100,5,0,5
Harjaap,M,100,0,5,5
Harjap,F,100,5,0,5
Harle,M,100,0,5,5
Harlean,F,100,5,0,5
Harliee,F,100,5,0,5
Haroutun,M,100,0,5,5
Haroutyun,M,100,0,5,5
Harpar,F,100,5,0,5
Harpyr,F,100,5,0,5
Harrisson,M,100,0,5,5
Harron,M,100,0,5,5
Harshi,F,100,5,0,5
Harshveer,M,100,0,5,5
Harsimar,M,100,0,5,5
Harsimrat,F,100,5,0,5
Hartli,F,100,5,0,5
Haruko,F,100,5,0,5
Hasanah,F,100,5,0,5
Hasanat,F,100,5,0,5
Haseebullah,M,100,0,5,5
Haseem,M,100,0,5,5
Hashley,F,100,5,0,5
Hasiel,M,100,0,5,5
Hasin,M,100,0,5,5
Hasir,M,100,0,5,5
Hasitha,F,100,5,0,5
Hassiel,M,100,0,5,5
Hassiem,M,100,0,5,5
Hastiin,M,100,0,5,5
Hatsumi,F,100,5,0,5
Hatziry,F,100,5,0,5
Havard,M,100,0,5,5
Havery,M,100,0,5,5
Hawah,F,100,5,0,5
Hawanatu,F,100,5,0,5
Haward,M,100,0,5,5
Haxton,M,100,0,5,5
Hayaa,F,100,5,0,5
Hayam,F,100,5,0,5
Haygan,M,100,0,5,5
Haylah,F,100,5,0,5
Hayliee,F,100,5,0,5
Haymond,M,100,0,5,5
Hayoon,F,100,5,0,5
Hayson,M,100,0,5,5
Hayz,M,100,0,5,5
Hayzlie,F,100,5,0,5
Hazelann,F,100,5,0,5
Hazelmarie,F,100,5,0,5
Haziq,M,100,0,5,5
Hazir,M,100,0,5,5
Hazy,F,100,5,0,5
Hazyn,M,100,0,5,5
Healey,F,100,5,0,5
Hearl,M,100,0,5,5
Hearold,M,100,0,5,5
Heartley,F,100,5,0,5
Heatherlynn,F,100,5,0,5
Heathyr,F,100,5,0,5
Heavenor,F,100,5,0,5
Heberth,M,100,0,5,5
Hec,M,100,0,5,5
Hedie,F,100,5,0,5
Hedieh,F,100,5,0,5
Hedit,F,100,5,0,5
Hedrick,M,100,0,5,5
Heeba,F,100,5,0,5
Heet,M,100,0,5,5
Heidiann,F,100,5,0,5
Heidimarie,F,100,5,0,5
Heili,F,100,5,0,5
Helal,M,100,0,5,5
Helam,M,100,0,5,5
Helan,F,100,5,0,5
Heleina,F,100,5,0,5
Helenmarie,F,100,5,0,5
Helissa,F,100,5,0,5
Helius,M,100,0,5,5
Heller,F,100,5,0,5
Helly,F,100,5,0,5
Helma,F,100,5,0,5
Heloisa,F,100,5,0,5
Heman,M,100,0,5,5
Hemza,M,100,0,5,5
Hendley,F,100,5,0,5
Henerietta,F,100,5,0,5
Hennesie,F,100,5,0,5
Henon,M,100,0,5,5
Henrene,F,100,5,0,5
Henrey,M,100,0,5,5
Herbey,M,100,0,5,5
Herculano,M,100,0,5,5
Herick,M,100,0,5,5
Herika,F,100,5,0,5
Herlaine,F,100,5,0,5
Hermena,F,100,5,0,5
Hermilinda,F,100,5,0,5
Hermino,M,100,0,5,5
Herney,M,100,0,5,5
Herod,M,100,0,5,5
Hervy,M,100,0,5,5
Hery,M,100,0,5,5
Hewlett,M,100,0,5,5
Heylen,F,100,5,0,5
Heylie,F,100,5,0,5
Hickory,M,100,0,5,5
Hicks,M,100,0,5,5
Hilarion,M,100,0,5,5
Hildebrando,M,100,0,5,5
Hilmer,M,100,0,5,5
Himari,F,100,5,0,5
Hinal,F,100,5,0,5
Hinson,M,100,0,5,5
Hirah,F,100,5,0,5
Hirma,F,100,5,0,5
Hisela,F,100,5,0,5
Hishaam,M,100,0,5,5
Hitha,F,100,5,0,5
Hla,F,100,5,0,5
Hobbie,M,100,0,5,5
Hoku,M,100,0,5,5
Holder,M,100,0,5,5
Holdin,M,100,0,5,5
Hollylynn,F,100,5,0,5
Hollymarie,F,100,5,0,5
Holsten,M,100,0,5,5
Hongan,F,100,5,0,5
Hongyu,M,100,0,5,5
Honorae,F,100,5,0,5
Hopi,F,100,5,0,5
Horald,M,100,0,5,5
Horeb,M,100,0,5,5
Horus,M,100,0,5,5
Hoscar,M,100,0,5,5
Hosia,M,100,0,5,5
Houghton,M,100,0,5,5
Houstin,M,100,0,5,5
Hoyte,M,100,0,5,5
Hridya,F,100,5,0,5
Hripsime,F,100,5,0,5
Hritika,F,100,5,0,5
Hriyaan,M,100,0,5,5
Huascar,M,100,0,5,5
Hubbert,M,100,0,5,5
Hudayfa,M,100,0,5,5
Hudes,F,100,5,0,5
Hudeyfa,M,100,0,5,5
Hudhayfah,M,100,0,5,5
Hudsynn,F,100,5,0,5
Hudy,F,100,5,0,5
Hufsa,F,100,5,0,5
Huguette,F,100,5,0,5
Hulali,F,100,5,0,5
Hurston,M,100,0,5,5
Husai,M,100,0,5,5
Hutchins,M,100,0,5,5
Huxlee,F,100,5,0,5
Hydiyah,F,100,5,0,5
Hykeim,M,100,0,5,5
Hylie,F,100,5,0,5
Hyon,M,100,0,5,5
Hyson,M,100,0,5,5
Hytham,M,100,0,5,5
Hyung,M,100,0,5,5
Iah,F,100,5,0,5
Ianah,F,100,5,0,5
Iassac,M,100,0,5,5
Iba,F,100,5,0,5
Ibiza,F,100,5,0,5
Ibon,F,100,5,0,5
Ibraaheem,M,100,0,5,5
Ibraheim,M,100,0,5,5
Ibtihaj,F,100,5,0,5
Ibtihal,F,100,5,0,5
Iceland,F,100,5,0,5
Icely,F,100,5,0,5
Iceola,F,100,5,0,5
Icesys,F,100,5,0,5
Ichigo,M,100,0,5,5
Idalina,F,100,5,0,5
Idalynn,F,100,5,0,5
Idasia,F,100,5,0,5
Idaya,F,100,5,0,5
Idean,M,100,0,5,5
Idel,M,100,0,5,5
Idelfonso,M,100,0,5,5
Idelisa,F,100,5,0,5
Idessa,F,100,5,0,5
Idia,F,100,5,0,5
Idonna,F,100,5,0,5
Idrena,F,100,5,0,5
Iean,M,100,0,5,5
Iesa,M,100,0,5,5
Iestyn,M,100,0,5,5
Ieuan,M,100,0,5,5
Ieysha,F,100,5,0,5
Iftu,F,100,5,0,5
Iggy,M,100,0,5,5
Ihuoma,F,100,5,0,5
Ii,M,100,0,5,5
Iishia,F,100,5,0,5
Iiyana,F,100,5,0,5
Ijana,F,100,5,0,5
Ikeam,M,100,0,5,5
Ikeda,F,100,5,0,5
Ikee,M,100,0,5,5
Ikem,M,100,0,5,5
Ikponmwosa,M,100,0,5,5
Ikra,F,100,5,0,5
Ilanny,F,100,5,0,5
Ilcia,F,100,5,0,5
Ilenna,F,100,5,0,5
Ilhana,F,100,5,0,5
Ilianie,F,100,5,0,5
Ilianne,F,100,5,0,5
Ilianny,F,100,5,0,5
Ilihia,F,100,5,0,5
Ilirian,M,100,0,5,5
Ilirida,F,100,5,0,5
Ilithia,F,100,5,0,5
Iliyaas,M,100,0,5,5
Illia,F,100,5,0,5
Illidan,M,100,0,5,5
Illissa,F,100,5,0,5
Illyas,M,100,0,5,5
Illythia,F,100,5,0,5
Ilori,F,100,5,0,5
Ilsi,F,100,5,0,5
Ilythia,F,100,5,0,5
Ilyza,F,100,5,0,5
Imajean,F,100,5,0,5
Imajen,F,100,5,0,5
Imalai,F,100,5,0,5
Imamu,M,100,0,5,5
Imauri,M,100,0,5,5
Imia,F,100,5,0,5
Imira,F,100,5,0,5
Imisioluwa,F,100,5,0,5
Imogin,F,100,5,0,5
Imron,M,100,0,5,5
Imyah,F,100,5,0,5
Inaayah,F,100,5,0,5
Inarah,F,100,5,0,5
Inass,F,100,5,0,5
Inayat,F,100,5,0,5
Inchara,F,100,5,0,5
Indasha,F,100,5,0,5
Independence,F,100,5,0,5
Indhira,F,100,5,0,5
Indian,F,100,5,0,5
Inelda,F,100,5,0,5
Inesa,F,100,5,0,5
Inett,F,100,5,0,5
Infantfemale,F,100,5,0,5
Infboy,M,100,0,5,5
Inikki,F,100,5,0,5
Inya,F,100,5,0,5
Inza,F,100,5,0,5
Iory,M,100,0,5,5
Iovanna,F,100,5,0,5
Ipolito,M,100,0,5,5
Ipsa,F,100,5,0,5
Iqlas,F,100,5,0,5
Irael,M,100,0,5,5
Iralynn,F,100,5,0,5
Irandy,F,100,5,0,5
Irani,F,100,5,0,5
Ire,M,100,0,5,5
Ireal,F,100,5,0,5
Ireatha,F,100,5,0,5
Irfaan,M,100,0,5,5
Iriee,F,100,5,0,5
Irit,F,100,5,0,5
Irita,F,100,5,0,5
Iriyana,F,100,5,0,5
Irmuun,M,100,0,5,5
Irna,F,100,5,0,5
Irshad,M,100,0,5,5
Iryss,F,100,5,0,5
Isaabella,F,100,5,0,5
Isabeli,F,100,5,0,5
Isabellasophia,F,100,5,0,5
Isabellemarie,F,100,5,0,5
Isabeth,F,100,5,0,5
Isabeya,F,100,5,0,5
Isahbella,F,100,5,0,5
Isahiah,M,100,0,5,5
Isaiahmichael,M,100,0,5,5
Isaian,M,100,0,5,5
Isairis,F,100,5,0,5
Isajah,M,100,0,5,5
Isalei,F,100,5,0,5
Isalena,F,100,5,0,5
Isaque,M,100,0,5,5
Isara,F,100,5,0,5
Isarael,M,100,0,5,5
Isayana,F,100,5,0,5
Iselin,F,100,5,0,5
Ises,F,100,5,0,5
Ish,M,100,0,5,5
Ishaun,M,100,0,5,5
Ishbel,F,100,5,0,5
Ishmam,M,100,0,5,5
Ishmeet,F,100,5,0,5
Ishta,F,100,5,0,5
Ishwaq,F,100,5,0,5
Iskandar,M,100,0,5,5
Islarose,F,100,5,0,5
Ismaaeel,M,100,0,5,5
Ismaela,F,100,5,0,5
Ismah,F,100,5,0,5
Ismat,F,100,5,0,5
Isoken,F,100,5,0,5
Israe,F,100,5,0,5
Isriel,M,100,0,5,5
Issay,M,100,0,5,5
Issela,F,100,5,0,5
Issiaka,M,100,0,5,5
Itan,M,100,0,5,5
Ithalia,F,100,5,0,5
Itia,F,100,5,0,5
Itohan,F,100,5,0,5
Itsamari,F,100,5,0,5
Itzabelle,F,100,5,0,5
Itzany,F,100,5,0,5
Itzary,F,100,5,0,5
Itzely,F,100,5,0,5
Ivanah,F,100,5,0,5
Ivandejesus,M,100,0,5,5
Ivani,F,100,5,0,5
Ivano,M,100,0,5,5
Ivany,F,100,5,0,5
Ivary,F,100,5,0,5
Ivia,F,100,5,0,5
Ivian,F,100,5,0,5
Iviannah,F,100,5,0,5
Ivoryana,F,100,5,0,5
Ivyanne,F,100,5,0,5
Ivye,F,100,5,0,5
Ivymarie,F,100,5,0,5
Iwan,M,100,0,5,5
Ixsel,F,100,5,0,5
Iyaunna,F,100,5,0,5
Iycess,F,100,5,0,5
Iyeisha,F,100,5,0,5
Iylan,F,100,5,0,5
Iyoni,F,100,5,0,5
Iyshia,F,100,5,0,5
Iysiss,F,100,5,0,5
Izah,M,100,0,5,5
Izalea,F,100,5,0,5
Izamara,F,100,5,0,5
Izara,F,100,5,0,5
Izayuh,M,100,0,5,5
Izeal,M,100,0,5,5
Izriel,M,100,0,5,5
Izyah,M,100,0,5,5
Izzik,M,100,0,5,5
Izzybella,F,100,5,0,5
Jaabir,M,100,0,5,5
Jaad,M,100,0,5,5
Jaada,F,100,5,0,5
Jaade,F,100,5,0,5
Jaavon,M,100,0,5,5
Jabarrie,M,100,0,5,5
Jabbaar,M,100,0,5,5
Jabora,F,100,5,0,5
Jabrae,M,100,0,5,5
Jabrandon,M,100,0,5,5
Jabrayden,M,100,0,5,5
Jabrel,M,100,0,5,5
Jabreya,F,100,5,0,5
Jacaranda,F,100,5,0,5
Jacarla,F,100,5,0,5
Jacarr,M,100,0,5,5
Jacarria,F,100,5,0,5
Jacarter,M,100,0,5,5
Jacaryous,M,100,0,5,5
Jacauri,M,100,0,5,5
Jacaury,M,100,0,5,5
Jacavion,M,100,0,5,5
Jacbo,M,100,0,5,5
Jaceline,F,100,5,0,5
Jacely,F,100,5,0,5
Jacenia,F,100,5,0,5
Jaciah,F,100,5,0,5
Jacilynn,F,100,5,0,5
Jacine,F,100,5,0,5
Jacione,M,100,0,5,5
Jaciya,F,100,5,0,5
Jaciyon,M,100,0,5,5
Jackalin,F,100,5,0,5
Jacklen,F,100,5,0,5
Jackueline,F,100,5,0,5
Jacobdaniel,M,100,0,5,5
Jacobjames,M,100,0,5,5
Jacobmatthew,M,100,0,5,5
Jacobryan,M,100,0,5,5
Jacobthomas,M,100,0,5,5
Jacodi,M,100,0,5,5
Jacore,M,100,0,5,5
Jacoree,M,100,0,5,5
Jacorrion,M,100,0,5,5
Jacoub,M,100,0,5,5
Jacqelyn,F,100,5,0,5
Jacqual,M,100,0,5,5
Jacqualyne,F,100,5,0,5
Jacquane,M,100,0,5,5
Jacquanna,F,100,5,0,5
Jacquari,M,100,0,5,5
Jacquece,F,100,5,0,5
Jacqueling,F,100,5,0,5
Jacqueze,M,100,0,5,5
Jacquil,M,100,0,5,5
Jaculine,F,100,5,0,5
Jacynth,F,100,5,0,5
Jacynthia,F,100,5,0,5
Jadaiah,F,100,5,0,5
Jadaija,F,100,5,0,5
Jadali,F,100,5,0,5
Jadarrien,M,100,0,5,5
Jadarrious,M,100,0,5,5
Jaddan,M,100,0,5,5
Jaddiel,M,100,0,5,5
Jadereon,M,100,0,5,5
Jaderious,M,100,0,5,5
Jadesha,F,100,5,0,5
Jadeth,F,100,5,0,5
Jadha,F,100,5,0,5
Jadhiel,M,100,0,5,5
Jadiamond,F,100,5,0,5
Jadiana,F,100,5,0,5
Jadielys,F,100,5,0,5
Jadlynn,F,100,5,0,5
Jadonte,M,100,0,5,5
Jadynce,F,100,5,0,5
Jadziah,F,100,5,0,5
Jaeceion,M,100,0,5,5
Jaecia,F,100,5,0,5
Jaedalyn,F,100,5,0,5
Jaede,F,100,5,0,5
Jaelanie,F,100,5,0,5
Jaelea,F,100,5,0,5
Jaelei,F,100,5,0,5
Jaeliah,F,100,5,0,5
Jaelithe,F,100,5,0,5
Jaell,M,100,0,5,5
Jaes,M,100,0,5,5
Jaevaughn,M,100,0,5,5
Jaevier,M,100,0,5,5
Jaewoo,M,100,0,5,5
Jaeyon,M,100,0,5,5
Jafer,M,100,0,5,5
Jaggyr,M,100,0,5,5
Jahairy,F,100,5,0,5
Jahare,M,100,0,5,5
Jaharee,M,100,0,5,5
Jahaud,M,100,0,5,5
Jahdari,M,100,0,5,5
Jahdir,M,100,0,5,5
Jaheen,M,100,0,5,5
Jahidi,M,100,0,5,5
Jahime,M,100,0,5,5
Jahin,M,100,0,5,5
Jahkir,M,100,0,5,5
Jahleal,M,100,0,5,5
Jahliah,F,100,5,0,5
Jahlique,M,100,0,5,5
Jahlynn,F,100,5,0,5
Jahmall,M,100,0,5,5
Jahmaree,M,100,0,5,5
Jahmela,F,100,5,0,5
Jahmelia,F,100,5,0,5
Jahmira,F,100,5,0,5
Jahmyia,F,100,5,0,5
Jahneil,M,100,0,5,5
Jahque,M,100,0,5,5
Jahray,M,100,0,5,5
Jahria,F,100,5,0,5
Jahriel,M,100,0,5,5
Jahseem,M,100,0,5,5
Jahseer,M,100,0,5,5
Jahseim,M,100,0,5,5
Jahvonte,M,100,0,5,5
Jahwan,M,100,0,5,5
Jahyda,F,100,5,0,5
Jahyr,M,100,0,5,5
Jahzair,M,100,0,5,5
Jahzari,F,100,5,0,5
Jahzlynn,F,100,5,0,5
Jahzon,M,100,0,5,5
Jaicen,M,100,0,5,5
Jaidel,M,100,0,5,5
Jaidi,F,100,5,0,5
Jaidn,M,100,0,5,5
Jaiheem,M,100,0,5,5
Jaikub,M,100,0,5,5
Jailei,F,100,5,0,5
Jaimal,M,100,0,5,5
Jaiman,M,100,0,5,5
Jaimari,M,100,0,5,5
Jainah,F,100,5,0,5
Jainee,F,100,5,0,5
Jainie,F,100,5,0,5
Jainiyah,F,100,5,0,5
Jainy,F,100,5,0,5
Jaiquez,M,100,0,5,5
Jaisley,F,100,5,0,5
Jaithen,M,100,0,5,5
Jaiton,M,100,0,5,5
Jaival,M,100,0,5,5
Jajuane,M,100,0,5,5
Jakada,F,100,5,0,5
Jakalah,F,100,5,0,5
Jakalynn,F,100,5,0,5
Jakameron,M,100,0,5,5
Jakarious,M,100,0,5,5
Jakaris,M,100,0,5,5
Jakashia,F,100,5,0,5
Jakayle,F,100,5,0,5
Jakeal,M,100,0,5,5
Jakeara,F,100,5,0,5
Jakeitha,F,100,5,0,5
Jakelia,F,100,5,0,5
Jakelle,F,100,5,0,5
Jakelynn,F,100,5,0,5
Jakerion,M,100,0,5,5
Jakeriya,F,100,5,0,5
Jaketa,F,100,5,0,5
Jakevis,M,100,0,5,5
Jakhira,F,100,5,0,5
Jakhye,M,100,0,5,5
Jakhyia,F,100,5,0,5
Jakiel,M,100,0,5,5
Jakirrah,F,100,5,0,5
Jakirria,F,100,5,0,5
Jakius,M,100,0,5,5
Jakiylah,F,100,5,0,5
Jakkob,M,100,0,5,5
Jakkson,M,100,0,5,5
Jakodi,M,100,0,5,5
Jakolbe,M,100,0,5,5
Jakolbi,M,100,0,5,5
Jaks,M,100,0,5,5
Jakwaun,M,100,0,5,5
Jakyan,M,100,0,5,5
Jakylia,F,100,5,0,5
Jakyre,M,100,0,5,5
Jakyrion,M,100,0,5,5
Jalaa,F,100,5,0,5
Jalanna,F,100,5,0,5
Jalayha,F,100,5,0,5
Jalaylah,F,100,5,0,5
Jaleela,F,100,5,0,5
Jalem,M,100,0,5,5
Jaleny,F,100,5,0,5
Jalesse,F,100,5,0,5
Jalexie,F,100,5,0,5
Jalica,F,100,5,0,5
Jalieah,F,100,5,0,5
Jalonni,M,100,0,5,5
Jalpa,F,100,5,0,5
Jalyce,F,100,5,0,5
Jalyia,F,100,5,0,5
Jamaad,M,100,0,5,5
Jamaah,M,100,0,5,5
Jamahd,M,100,0,5,5
Jamaile,M,100,0,5,5
Jamalachi,M,100,0,5,5
Jamantha,F,100,5,0,5
Jamariun,M,100,0,5,5
Jamaro,M,100,0,5,5
Jamarris,M,100,0,5,5
Jamarvion,M,100,0,5,5
Jamasia,F,100,5,0,5
Jamayca,F,100,5,0,5
Jamecca,F,100,5,0,5
Jamece,F,100,5,0,5
Jameece,F,100,5,0,5
Jameen,M,100,0,5,5
Jamelvin,M,100,0,5,5
Jamena,F,100,5,0,5
Jamene,F,100,5,0,5
Jamerial,F,100,5,0,5
Jameris,M,100,0,5,5
Jamerra,F,100,5,0,5
Jamesdaniel,M,100,0,5,5
Jamesson,M,100,0,5,5
Jameta,F,100,5,0,5
Jametrice,F,100,5,0,5
Jamhal,M,100,0,5,5
Jamial,M,100,0,5,5
Jamielle,F,100,5,0,5
Jamii,F,100,5,0,5
Jamikka,F,100,5,0,5
Jamilka,F,100,5,0,5
Jamirya,F,100,5,0,5
Jamod,M,100,0,5,5
Jamontez,M,100,0,5,5
Jamson,M,100,0,5,5
Jamykal,M,100,0,5,5
Jamyle,M,100,0,5,5
Jamylex,F,100,5,0,5
Janael,F,100,5,0,5
Janaesha,F,100,5,0,5
Janahi,F,100,5,0,5
Janaina,F,100,5,0,5
Janaka,M,100,0,5,5
Janalis,F,100,5,0,5
Janalise,F,100,5,0,5
Janalle,F,100,5,0,5
Janalyse,F,100,5,0,5
Jananne,F,100,5,0,5
Janaris,M,100,0,5,5
Janathean,M,100,0,5,5
Jandery,F,100,5,0,5
Janeel,F,100,5,0,5
Janeicia,F,100,5,0,5
Janeida,F,100,5,0,5
Janeidy,F,100,5,0,5
Janeisa,F,100,5,0,5
Janeise,F,100,5,0,5
Janekia,F,100,5,0,5
Janela,F,100,5,0,5
Janelyz,F,100,5,0,5
Janerica,F,100,5,0,5
Janetha,F,100,5,0,5
Janetra,F,100,5,0,5
Janetzi,F,100,5,0,5
Jangelo,M,100,0,5,5
Janic,F,100,5,0,5
Janick,M,100,0,5,5
Janiely,F,100,5,0,5
Janiia,F,100,5,0,5
Janikqua,F,100,5,0,5
Janisia,F,100,5,0,5
Janitha,F,100,5,0,5
Janivea,F,100,5,0,5
Janiyaa,F,100,5,0,5
Janiyyah,F,100,5,0,5
Janiza,F,100,5,0,5
Janko,M,100,0,5,5
Jannan,F,100,5,0,5
Jannea,F,100,5,0,5
Janneli,F,100,5,0,5
Jannesa,F,100,5,0,5
Janniah,F,100,5,0,5
Jannita,F,100,5,0,5
Janniyah,F,100,5,0,5
Jantel,F,100,5,0,5
Jantsen,M,100,0,5,5
Janusz,M,100,0,5,5
Janyha,F,100,5,0,5
Janyhia,F,100,5,0,5
Janyriah,F,100,5,0,5
Janyse,F,100,5,0,5
Janyus,M,100,0,5,5
Jaosn,M,100,0,5,5
Japhy,M,100,0,5,5
Japnoor,F,100,5,0,5
Japree,M,100,0,5,5
Japria,F,100,5,0,5
Japrice,F,100,5,0,5
Jaquantae,M,100,0,5,5
Jaquavien,M,100,0,5,5
Jaquaylin,M,100,0,5,5
Jaquaze,M,100,0,5,5
Jaquelene,F,100,5,0,5
Jaquest,M,100,0,5,5
Jaquilyn,F,100,5,0,5
Jaquinta,F,100,5,0,5
Jaqulynn,F,100,5,0,5
Jaquory,M,100,0,5,5
Jarade,M,100,0,5,5
Jarai,M,100,0,5,5
Jarail,M,100,0,5,5
Jarald,M,100,0,5,5
Jarayah,F,100,5,0,5
Jardan,M,100,0,5,5
Jareny,F,100,5,0,5
Jaresha,F,100,5,0,5
Jaretsi,F,100,5,0,5
Jarexi,F,100,5,0,5
Jarhia,F,100,5,0,5
Jaricka,F,100,5,0,5
Jarico,M,100,0,5,5
Jarimiah,M,100,0,5,5
Jarique,M,100,0,5,5
Jarison,M,100,0,5,5
Jarit,M,100,0,5,5
Jaritzi,F,100,5,0,5
Jarline,F,100,5,0,5
Jarmaris,M,100,0,5,5
Jarmen,M,100,0,5,5
Jaronte,M,100,0,5,5
Jarran,M,100,0,5,5
Jarrek,M,100,0,5,5
Jarriah,F,100,5,0,5
Jarrian,M,100,0,5,5
Jarriet,M,100,0,5,5
Jarrison,M,100,0,5,5
Jarritt,M,100,0,5,5
Jarrott,M,100,0,5,5
Jarryl,M,100,0,5,5
Jartavis,M,100,0,5,5
Jarus,M,100,0,5,5
Jarvais,M,100,0,5,5
Jaryel,M,100,0,5,5
Jasana,F,100,5,0,5
Jasee,F,100,5,0,5
Jaseem,M,100,0,5,5
Jaseer,M,100,0,5,5
Jaseir,M,100,0,5,5
Jasera,F,100,5,0,5
Jasere,M,100,0,5,5
Jashanpreet,M,100,0,5,5
Jashea,F,100,5,0,5
Jashod,M,100,0,5,5
Jashone,M,100,0,5,5
Jashyia,F,100,5,0,5
Jasiana,F,100,5,0,5
Jasianna,F,100,5,0,5
Jasibe,F,100,5,0,5
Jasik,M,100,0,5,5
Jasine,F,100,5,0,5
Jaslean,F,100,5,0,5
Jaslena,F,100,5,0,5
Jaslinn,F,100,5,0,5
Jasmijn,F,100,5,0,5
Jasmil,F,100,5,0,5
Jasmire,F,100,5,0,5
Jasona,F,100,5,0,5
Jasonanthony,M,100,0,5,5
Jasonjr,M,100,0,5,5
Jasonpaul,M,100,0,5,5
Jasontyler,M,100,0,5,5
Jaspyr,M,100,0,5,5
Jassan,M,100,0,5,5
Jasselle,F,100,5,0,5
Jassem,M,100,0,5,5
Jassie,F,100,5,0,5
Jasslynn,F,100,5,0,5
Jasuan,M,100,0,5,5
Jaswinder,M,100,0,5,5
Jasy,F,100,5,0,5
Jasye,M,100,0,5,5
Jaszlyn,F,100,5,0,5
Jata,F,100,5,0,5
Jataiya,F,100,5,0,5
Jatari,M,100,0,5,5
Jataurus,M,100,0,5,5
Jatavien,M,100,0,5,5
Jaterica,F,100,5,0,5
Jaterious,M,100,0,5,5
Jaterius,M,100,0,5,5
Jatisha,F,100,5,0,5
Jatonya,F,100,5,0,5
Jatyler,M,100,0,5,5
Jaudiel,M,100,0,5,5
Jauier,M,100,0,5,5
Jaunna,F,100,5,0,5
Jaunte,M,100,0,5,5
Javanta,M,100,0,5,5
Javantay,M,100,0,5,5
Javareon,M,100,0,5,5
Javarrie,M,100,0,5,5
Javawn,M,100,0,5,5
Jave,M,100,0,5,5
Javea,F,100,5,0,5
Javeed,M,100,0,5,5
Javelyn,F,100,5,0,5
Javeya,F,100,5,0,5
Javiair,M,100,0,5,5
Javierjr,M,100,0,5,5
Javina,F,100,5,0,5
Javionte,M,100,0,5,5
Javonia,F,100,5,0,5
Javontaye,M,100,0,5,5
Javonti,M,100,0,5,5
Javor,M,100,0,5,5
Jawane,M,100,0,5,5
Jawarren,M,100,0,5,5
Jawaski,M,100,0,5,5
Jawdat,M,100,0,5,5
Jawonna,F,100,5,0,5
Jawvan,M,100,0,5,5
Jaxel,M,100,0,5,5
Jaxlyn,F,100,5,0,5
Jaxonjames,M,100,0,5,5
Jaxper,M,100,0,5,5
Jaxxin,M,100,0,5,5
Jaxxyn,M,100,0,5,5
Jaxzyn,M,100,0,5,5
Jayahna,F,100,5,0,5
Jayanne,F,100,5,0,5
Jayar,M,100,0,5,5
Jayaun,M,100,0,5,5
Jayben,M,100,0,5,5
Jaybin,M,100,0,5,5
Jaybree,F,100,5,0,5
Jaycon,M,100,0,5,5
Jaydann,F,100,5,0,5
Jaydehn,M,100,0,5,5
Jaydenalexander,M,100,0,5,5
Jaydenjames,M,100,0,5,5
Jaydenmatthew,M,100,0,5,5
Jaydenmichael,M,100,0,5,5
Jayeda,F,100,5,0,5
Jayelin,M,100,0,5,5
Jayetta,F,100,5,0,5
Jayhden,M,100,0,5,5
Jayiden,M,100,0,5,5
Jaykin,M,100,0,5,5
Jaykon,M,100,0,5,5
Jaykwan,M,100,0,5,5
Jaylaan,F,100,5,0,5
Jaylece,F,100,5,0,5
Jaylian,M,100,0,5,5
Jaylianiz,F,100,5,0,5
Jaylicia,F,100,5,0,5
Jaylisse,F,100,5,0,5
Jayliz,F,100,5,0,5
Jayloni,M,100,0,5,5
Jaylonn,M,100,0,5,5
Jayly,F,100,5,0,5
Jaymion,M,100,0,5,5
Jaymis,M,100,0,5,5
Jaymiya,F,100,5,0,5
Jaymya,F,100,5,0,5
Jaynalis,F,100,5,0,5
Jayquin,M,100,0,5,5
Jayrin,M,100,0,5,5
Jaysan,M,100,0,5,5
Jayvaun,M,100,0,5,5
Jayveer,M,100,0,5,5
Jayvein,M,100,0,5,5
Jayviona,F,100,5,0,5
Jayvonna,F,100,5,0,5
Jayza,F,100,5,0,5
Jayziel,M,100,0,5,5
Jayzier,M,100,0,5,5
Jazai,M,100,0,5,5
Jazaih,M,100,0,5,5
Jazaiya,F,100,5,0,5
Jazalin,F,100,5,0,5
Jazaniah,F,100,5,0,5
Jazarian,M,100,0,5,5
Jazavian,M,100,0,5,5
Jazayvion,M,100,0,5,5
Jazeera,F,100,5,0,5
Jazella,F,100,5,0,5
Jazette,F,100,5,0,5
Jazharia,F,100,5,0,5
Jazin,M,100,0,5,5
Jazlena,F,100,5,0,5
Jazmany,M,100,0,5,5
Jazmein,F,100,5,0,5
Jazmenn,F,100,5,0,5
Jazmone,F,100,5,0,5
Jazzae,F,100,5,0,5
Jazzanae,F,100,5,0,5
Jazzarae,F,100,5,0,5
Jazzariah,F,100,5,0,5
Jazzia,F,100,5,0,5
Jazzmaine,F,100,5,0,5
Jazzmarie,F,100,5,0,5
Jazzmene,F,100,5,0,5
Jazzminn,F,100,5,0,5
Jazzmond,F,100,5,0,5
Jcorey,M,100,0,5,5
Jdah,F,100,5,0,5
Jdan,M,100,0,5,5
Jdon,M,100,0,5,5
Jdynn,M,100,0,5,5
Jeaden,M,100,0,5,5
Jeadon,M,100,0,5,5
Jeanbaptiste,M,100,0,5,5
Jeaniece,F,100,5,0,5
Jeanitta,F,100,5,0,5
Jeaniyah,F,100,5,0,5
Jeanjacques,M,100,0,5,5
Jeanluca,M,100,0,5,5
Jeanmarco,M,100,0,5,5
Jeannea,F,100,5,0,5
Jeannell,F,100,5,0,5
Jeannice,F,100,5,0,5
Jeannicole,F,100,5,0,5
Jearold,M,100,0,5,5
Jebreel,M,100,0,5,5
Jedah,F,100,5,0,5
Jeddie,M,100,0,5,5
Jeden,M,100,0,5,5
Jeenifer,F,100,5,0,5
Jeesica,F,100,5,0,5
Jeeva,M,100,0,5,5
Jeeyoung,F,100,5,0,5
Jefforey,M,100,0,5,5
Jeffrery,M,100,0,5,5
Jeffreyjames,M,100,0,5,5
Jefrin,M,100,0,5,5
Jeg,M,100,0,5,5
Jehlani,M,100,0,5,5
Jehovany,M,100,0,5,5
Jehremy,M,100,0,5,5
Jehron,M,100,0,5,5
Jeidan,M,100,0,5,5
Jeidyn,M,100,0,5,5
Jeiner,M,100,0,5,5
Jeira,F,100,5,0,5
Jeiri,F,100,5,0,5
Jekeria,F,100,5,0,5
Jekhari,M,100,0,5,5
Jekori,M,100,0,5,5
Jelaina,F,100,5,0,5
Jelanie,F,100,5,0,5
Jelany,F,100,5,0,5
Jelaya,F,100,5,0,5
Jelayne,F,100,5,0,5
Jelise,F,100,5,0,5
Jemauri,M,100,0,5,5
Jemaya,F,100,5,0,5
Jemekia,F,100,5,0,5
Jemelia,F,100,5,0,5
Jemely,F,100,5,0,5
Jemerrio,M,100,0,5,5
Jemier,M,100,0,5,5
Jemon,M,100,0,5,5
Jemond,M,100,0,5,5
Jenaia,F,100,5,0,5
Jenaiah,F,100,5,0,5
Jenanne,F,100,5,0,5
Jenave,F,100,5,0,5
Jenci,F,100,5,0,5
Jencyn,F,100,5,0,5
Jendry,M,100,0,5,5
Jeneba,F,100,5,0,5
Jenedy,F,100,5,0,5
Jeneine,F,100,5,0,5
Jenele,F,100,5,0,5
Jenelee,F,100,5,0,5
Jenera,F,100,5,0,5
Jenesi,F,100,5,0,5
Jeness,F,100,5,0,5
Jenesse,F,100,5,0,5
Jenessia,F,100,5,0,5
Jenesy,F,100,5,0,5
Jenevive,F,100,5,0,5
Jenibelle,F,100,5,0,5
Jenis,F,100,5,0,5
Jenish,M,100,0,5,5
Jenitha,F,100,5,0,5
Jeniveve,F,100,5,0,5
Jenkarlo,M,100,0,5,5
Jennabel,F,100,5,0,5
Jennabella,F,100,5,0,5
Jennaliz,F,100,5,0,5
Jennalyse,F,100,5,0,5
Jennavee,F,100,5,0,5
Jennavi,F,100,5,0,5
Jennevie,F,100,5,0,5
Jennevy,F,100,5,0,5
Jennieke,F,100,5,0,5
Jenniper,F,100,5,0,5
Jennya,F,100,5,0,5
Jenora,F,100,5,0,5
Jenssy,M,100,0,5,5
Jenyiah,F,100,5,0,5
Jenyka,F,100,5,0,5
Jenyssa,F,100,5,0,5
Jeon,M,100,0,5,5
Jeong,M,100,0,5,5
Jeorgina,F,100,5,0,5
Jeovan,M,100,0,5,5
Jeppie,M,100,0,5,5
Jerail,M,100,0,5,5
Jeraldean,F,100,5,0,5
Jeraldene,F,100,5,0,5
Jeramiyah,M,100,0,5,5
Jerdean,F,100,5,0,5
Jereal,M,100,0,5,5
Jereimah,M,100,0,5,5
Jeremah,M,100,0,5,5
Jeremery,M,100,0,5,5
Jeremiahs,M,100,0,5,5
Jeremyh,M,100,0,5,5
Jeresa,F,100,5,0,5
Jerey,M,100,0,5,5
Jericia,F,100,5,0,5
Jeries,M,100,0,5,5
Jerimee,M,100,0,5,5
Jerimiha,M,100,0,5,5
Jeriod,M,100,0,5,5
Jerious,M,100,0,5,5
Jerkayla,F,100,5,0,5
Jerkiya,F,100,5,0,5
Jermanee,F,100,5,0,5
Jermaul,M,100,0,5,5
Jermira,F,100,5,0,5
Jerneshia,F,100,5,0,5
Jernice,F,100,5,0,5
Jernika,F,100,5,0,5
Jerolene,F,100,5,0,5
Jerrae,F,100,5,0,5
Jerremiah,M,100,0,5,5
Jerrianna,F,100,5,0,5
Jerrime,M,100,0,5,5
Jerrina,F,100,5,0,5
Jerriona,F,100,5,0,5
Jerrious,M,100,0,5,5
Jerrlyn,F,100,5,0,5
Jerroll,M,100,0,5,5
Jerrolyn,F,100,5,0,5
Jertavious,M,100,0,5,5
Jervaughn,M,100,0,5,5
Jeryiah,F,100,5,0,5
Jeryka,F,100,5,0,5
Jesaias,M,100,0,5,5
Jesalee,F,100,5,0,5
Jesara,F,100,5,0,5
Jescenia,F,100,5,0,5
Jescie,F,100,5,0,5
Jeshwa,M,100,0,5,5
Jesicah,F,100,5,0,5
Jeslee,F,100,5,0,5
Jessamarie,F,100,5,0,5
Jessca,F,100,5,0,5
Jesseica,F,100,5,0,5
Jessianna,F,100,5,0,5
Jessican,F,100,5,0,5
Jessicanicole,F,100,5,0,5
Jessiejames,M,100,0,5,5
Jessimar,F,100,5,0,5
Jessiqua,F,100,5,0,5
Jesslene,F,100,5,0,5
Jessten,M,100,0,5,5
Jesstine,F,100,5,0,5
Jestyn,M,100,0,5,5
Jesualdo,M,100,0,5,5
Jesuan,M,100,0,5,5
Jesusdaniel,M,100,0,5,5
Jete,F,100,5,0,5
Jetlyn,F,100,5,0,5
Jetmir,M,100,0,5,5
Jetoi,F,100,5,0,5
Jettsen,M,100,0,5,5
Jevette,F,100,5,0,5
Jevita,F,100,5,0,5
Jevonda,F,100,5,0,5
Jevontay,M,100,0,5,5
Jeweleah,F,100,5,0,5
Jewellee,F,100,5,0,5
Jewely,F,100,5,0,5
Jewelyn,F,100,5,0,5
Jewlz,F,100,5,0,5
Jeyceon,M,100,0,5,5
Jeylanie,F,100,5,0,5
Jezebell,F,100,5,0,5
Jezeniah,F,100,5,0,5
Jezlin,F,100,5,0,5
Jezzelle,F,100,5,0,5
Jhaeda,F,100,5,0,5
Jhaki,M,100,0,5,5
Jhalia,F,100,5,0,5
Jhamel,M,100,0,5,5
Jhamere,M,100,0,5,5
Jhamilet,F,100,5,0,5
Jhanai,F,100,5,0,5
Jhanel,F,100,5,0,5
Jhanet,F,100,5,0,5
Jhaniah,F,100,5,0,5
Jhasir,M,100,0,5,5
Jhavier,M,100,0,5,5
Jhena,F,100,5,0,5
Jhenifer,F,100,5,0,5
Jhiya,F,100,5,0,5
Jhobany,M,100,0,5,5
Jhonae,F,100,5,0,5
Jhoniel,M,100,0,5,5
Jhonna,F,100,5,0,5
Jhori,F,100,5,0,5
Jhoselyne,F,100,5,0,5
Jhosselyn,F,100,5,0,5
Jhovan,M,100,0,5,5
Jiacheng,M,100,0,5,5
Jiahna,F,100,5,0,5
Jialin,F,100,5,0,5
Jianne,F,100,5,0,5
Jianny,M,100,0,5,5
Jiar,M,100,0,5,5
Jiara,F,100,5,0,5
Jiavanna,F,100,5,0,5
Jibria,F,100,5,0,5
Jicela,F,100,5,0,5
Jiesha,F,100,5,0,5
Jigme,M,100,0,5,5
Jihae,F,100,5,0,5
Jihyun,F,100,5,0,5
Jikayla,F,100,5,0,5
Jileen,F,100,5,0,5
Jillanna,F,100,5,0,5
Jilliene,F,100,5,0,5
Jillissa,F,100,5,0,5
Jilma,F,100,5,0,5
Jilyan,F,100,5,0,5
Jimalee,F,100,5,0,5
Jimiah,F,100,5,0,5
Jimica,F,100,5,0,5
Jimique,M,100,0,5,5
Jimiyah,F,100,5,0,5
Jimmeka,F,100,5,0,5
Jimmica,F,100,5,0,5
Jinah,F,100,5,0,5
Jinaya,F,100,5,0,5
Jinayah,F,100,5,0,5
Jinessa,F,100,5,0,5
Jinette,F,100,5,0,5
Jinhee,F,100,5,0,5
Jiniyah,F,100,5,0,5
Jinjer,F,100,5,0,5
Jinni,F,100,5,0,5
Jioni,M,100,0,5,5
Jiovannie,M,100,0,5,5
Jiquez,M,100,0,5,5
Jira,F,100,5,0,5
Jireth,F,100,5,0,5
Jissie,M,100,0,5,5
Jiyanna,F,100,5,0,5
Jiyoung,F,100,5,0,5
Jkia,F,100,5,0,5
Jkobi,M,100,0,5,5
Jlea,F,100,5,0,5
Jleah,F,100,5,0,5
Jliana,F,100,5,0,5
Jm,M,100,0,5,5
Jme,F,100,5,0,5
Jmere,M,100,0,5,5
Jmyra,F,100,5,0,5
Jnaiya,F,100,5,0,5
Jnasia,F,100,5,0,5
Jnay,F,100,5,0,5
Jniaya,F,100,5,0,5
Joahua,M,100,0,5,5
Joangela,F,100,5,0,5
Joanthon,M,100,0,5,5
Joaovitor,M,100,0,5,5
Joason,M,100,0,5,5
Jobari,M,100,0,5,5
Jocabeth,F,100,5,0,5
Joceleen,F,100,5,0,5
Jocelle,F,100,5,0,5
Jocelynmarie,F,100,5,0,5
Jociel,M,100,0,5,5
Jocko,M,100,0,5,5
Jocqua,M,100,0,5,5
Jodana,F,100,5,0,5
Jodarius,M,100,0,5,5
Jodena,F,100,5,0,5
Jodiel,M,100,0,5,5
Jodyann,F,100,5,0,5
Jodyne,F,100,5,0,5
Joean,F,100,5,0,5
Joeen,F,100,5,0,5
Joelaine,F,100,5,0,5
Joelan,M,100,0,5,5
Joeliel,M,100,0,5,5
Joelissa,F,100,5,0,5
Joelouis,M,100,0,5,5
Joelyne,F,100,5,0,5
Joes,M,100,0,5,5
Joevan,M,100,0,5,5
Joezette,F,100,5,0,5
Jogina,F,100,5,0,5
Johanah,F,100,5,0,5
Johandry,M,100,0,5,5
Johannie,F,100,5,0,5
Johanson,M,100,0,5,5
Johar,M,100,0,5,5
Johary,M,100,0,5,5
Johnadam,M,100,0,5,5
Johnalbert,M,100,0,5,5
Johnalexander,M,100,0,5,5
Johnalyn,F,100,5,0,5
Johncarter,M,100,0,5,5
Johneice,F,100,5,0,5
Johnessa,F,100,5,0,5
Johnicia,F,100,5,0,5
Johnitta,F,100,5,0,5
Johnjack,M,100,0,5,5
Johnlloyd,M,100,0,5,5
Johnluis,M,100,0,5,5
Johnmarco,M,100,0,5,5
Johnmorgan,M,100,0,5,5
Johnneisha,F,100,5,0,5
Johnnia,F,100,5,0,5
Johnnice,F,100,5,0,5
Johnniqua,F,100,5,0,5
Johnnyjoe,M,100,0,5,5
Johnscott,M,100,0,5,5
Johntavia,F,100,5,0,5
Johnthon,M,100,0,5,5
Johnye,F,100,5,0,5
Johrdan,M,100,0,5,5
Johusa,M,100,0,5,5
Johvanna,F,100,5,0,5
Joilyn,F,100,5,0,5
Jokari,M,100,0,5,5
Jolecia,F,100,5,0,5
Jolian,M,100,0,5,5
Jolieann,F,100,5,0,5
Jollette,F,100,5,0,5
Jolysa,F,100,5,0,5
Jomei,M,100,0,5,5
Jomiah,F,100,5,0,5
Jonalee,F,100,5,0,5
Jonathaon,M,100,0,5,5
Jonathna,M,100,0,5,5
Jondra,F,100,5,0,5
Joneer,F,100,5,0,5
Jonene,F,100,5,0,5
Jonhathan,M,100,0,5,5
Joniell,M,100,0,5,5
Jonilee,F,100,5,0,5
Jonluca,M,100,0,5,5
Jonlucas,M,100,0,5,5
Jonlyn,F,100,5,0,5
Jonmatthew,M,100,0,5,5
Jonney,M,100,0,5,5
Jonnique,F,100,5,0,5
Jonrobert,M,100,0,5,5
Jonross,M,100,0,5,5
Jontaya,F,100,5,0,5
Jontaye,M,100,0,5,5
Jontelle,F,100,5,0,5
Jonwesley,M,100,0,5,5
Jooyoung,M,100,0,5,5
Joquavious,M,100,0,5,5
Joray,M,100,0,5,5
Jordae,F,100,5,0,5
Jordahn,F,100,5,0,5
Jordanalexander,M,100,0,5,5
Jordanchristoph,M,100,0,5,5
Jordanmarie,F,100,5,0,5
Jorde,M,100,0,5,5
Jordee,F,100,5,0,5
Jordun,M,100,0,5,5
Jorelys,F,100,5,0,5
Jorgealberto,M,100,0,5,5
Jorgedavid,M,100,0,5,5
Jorgejr,M,100,0,5,5
Joriann,F,100,5,0,5
Jorianna,F,100,5,0,5
Jorleny,F,100,5,0,5
Jorome,M,100,0,5,5
Jorrie,F,100,5,0,5
Josabet,F,100,5,0,5
Josael,M,100,0,5,5
Josaia,M,100,0,5,5
Josalina,F,100,5,0,5
Josbel,M,100,0,5,5
Joseadrian,M,100,0,5,5
Joseduardo,M,100,0,5,5
Josegabriel,M,100,0,5,5
Josei,F,100,5,0,5
Joseiah,M,100,0,5,5
Joselen,F,100,5,0,5
Josephallen,M,100,0,5,5
Josephandrew,M,100,0,5,5
Josephin,F,100,5,0,5
Josephjohn,M,100,0,5,5
Josephpatrick,M,100,0,5,5
Josephpaul,M,100,0,5,5
Josephthomas,M,100,0,5,5
Josera,F,100,5,0,5
Joshanae,F,100,5,0,5
Joshep,M,100,0,5,5
Joshika,F,100,5,0,5
Joshuaa,M,100,0,5,5
Joshuaalexander,M,100,0,5,5
Joshuajay,M,100,0,5,5
Joshuajohn,M,100,0,5,5
Joshuajoseph,M,100,0,5,5
Joshuar,M,100,0,5,5
Joshuaray,M,100,0,5,5
Joshuarobert,M,100,0,5,5
Joshula,M,100,0,5,5
Josilyne,F,100,5,0,5
Josine,F,100,5,0,5
Josjeph,M,100,0,5,5
Josmel,M,100,0,5,5
Josphe,M,100,0,5,5
Josphua,M,100,0,5,5
Jossica,F,100,5,0,5
Jossilynn,F,100,5,0,5
Jossimar,M,100,0,5,5
Josslynne,F,100,5,0,5
Jossy,F,100,5,0,5
Josuhe,M,100,0,5,5
Josylin,F,100,5,0,5
Jouan,M,100,0,5,5
Journeigh,F,100,5,0,5
Jouse,M,100,0,5,5
Jovaan,M,100,0,5,5
Jovahny,M,100,0,5,5
Jovanah,F,100,5,0,5
Jovania,F,100,5,0,5
Jovaniel,M,100,0,5,5
Jovari,M,100,0,5,5
Jovial,F,100,5,0,5
Jovienne,F,100,5,0,5
Jovohn,M,100,0,5,5
Jovone,M,100,0,5,5
Jovonny,M,100,0,5,5
Jowharah,F,100,5,0,5
Joyee,F,100,5,0,5
Joylynne,F,100,5,0,5
Joynae,F,100,5,0,5
Joynell,F,100,5,0,5
Joyner,M,100,0,5,5
Joyse,F,100,5,0,5
Jozett,F,100,5,0,5
Jozlyne,F,100,5,0,5
Jqwon,M,100,0,5,5
Jraya,F,100,5,0,5
Jsai,M,100,0,5,5
Jshin,M,100,0,5,5
Jshun,M,100,0,5,5
Juaita,F,100,5,0,5
Juancarlo,M,100,0,5,5
Juanenrique,M,100,0,5,5
Juanfernando,M,100,0,5,5
Juanjr,M,100,0,5,5
Juante,M,100,0,5,5
Juany,F,100,5,0,5
Juanyae,M,100,0,5,5
Juaria,F,100,5,0,5
Juddie,F,100,5,0,5
Judeah,F,100,5,0,5
Judell,F,100,5,0,5
Judey,F,100,5,0,5
Judilynn,F,100,5,0,5
Judite,F,100,5,0,5
Judon,M,100,0,5,5
Judylynn,F,100,5,0,5
Juelian,M,100,0,5,5
Juella,F,100,5,0,5
Juelze,M,100,0,5,5
Juilianna,F,100,5,0,5
Juilo,M,100,0,5,5
Juleeanna,F,100,5,0,5
Juleimy,F,100,5,0,5
Julenny,F,100,5,0,5
Julep,F,100,5,0,5
Julette,F,100,5,0,5
Juliaette,F,100,5,0,5
Juliahnna,F,100,5,0,5
Juliam,M,100,0,5,5
Juliamae,F,100,5,0,5
Juliannamarie,F,100,5,0,5
Julianno,M,100,0,5,5
Julibeth,F,100,5,0,5
Julica,F,100,5,0,5
Juliella,F,100,5,0,5
Julieza,F,100,5,0,5
Julin,F,100,5,0,5
Julinda,F,100,5,0,5
Julioalberto,M,100,0,5,5
Julitta,F,100,5,0,5
Julivette,F,100,5,0,5
Julixa,F,100,5,0,5
Juliyanna,F,100,5,0,5
Julonda,F,100,5,0,5
Jumarcus,M,100,0,5,5
Junea,F,100,5,0,5
Jungwoo,M,100,0,5,5
Junho,M,100,0,5,5
Juniah,F,100,5,0,5
Junito,M,100,0,5,5
Junjie,M,100,0,5,5
Juny,M,100,0,5,5
Junya,F,100,5,0,5
Juquana,F,100,5,0,5
Jura,F,100,5,0,5
Juriana,F,100,5,0,5
Jurita,F,100,5,0,5
Juritza,F,100,5,0,5
Jurlean,F,100,5,0,5
Jurnii,F,100,5,0,5
Jussiah,M,100,0,5,5
Justas,M,100,0,5,5
Justhin,M,100,0,5,5
Justinanthony,M,100,0,5,5
Justinia,F,100,5,0,5
Justiniano,M,100,0,5,5
Justinrobert,M,100,0,5,5
Justys,M,100,0,5,5
Juventina,F,100,5,0,5
Juwahn,M,100,0,5,5
Juwairiyah,F,100,5,0,5
Juwell,M,100,0,5,5
Juwelz,M,100,0,5,5
Juztin,M,100,0,5,5
Jven,M,100,0,5,5
Jvier,M,100,0,5,5
Jvonn,M,100,0,5,5
Jwon,M,100,0,5,5
Jyena,F,100,5,0,5
Jyhiem,M,100,0,5,5
Jyia,F,100,5,0,5
Jyiah,F,100,5,0,5
Jyion,M,100,0,5,5
Jylissa,F,100,5,0,5
Jymon,M,100,0,5,5
Jyonna,F,100,5,0,5
Jyquavious,M,100,0,5,5
Jyrelle,M,100,0,5,5
Jyshon,M,100,0,5,5
Jyvon,M,100,0,5,5
Jywon,M,100,0,5,5
Jyzaiah,M,100,0,5,5
Kaajal,F,100,5,0,5
Kaaron,F,100,5,0,5
Kaaya,F,100,5,0,5
Kabree,F,100,5,0,5
Kabriel,M,100,0,5,5
Kabryn,M,100,0,5,5
Kaceson,M,100,0,5,5
Kaceyon,M,100,0,5,5
Kachelle,F,100,5,0,5
Kadavion,M,100,0,5,5
Kadaysia,F,100,5,0,5
Kadel,M,100,0,5,5
Kadenze,F,100,5,0,5
Kadera,F,100,5,0,5
Kaderius,M,100,0,5,5
Kadetria,F,100,5,0,5
Kadezha,F,100,5,0,5
Kadren,M,100,0,5,5
Kadri,F,100,5,0,5
Kadria,F,100,5,0,5
Kaecyn,M,100,0,5,5
Kaedn,M,100,0,5,5
Kaeisha,F,100,5,0,5
Kaelia,F,100,5,0,5
Kaelyne,F,100,5,0,5
Kaeman,M,100,0,5,5
Kaen,M,100,0,5,5
Kaery,F,100,5,0,5
Kaeshon,M,100,0,5,5
Kager,M,100,0,5,5
Kahala,F,100,5,0,5
Kahanuola,M,100,0,5,5
Kahea,F,100,5,0,5
Kahiem,M,100,0,5,5
Kahila,F,100,5,0,5
Kahlaya,F,100,5,0,5
Kahleia,F,100,5,0,5
Kahleya,F,100,5,0,5
Kahlill,M,100,0,5,5
Kahlis,F,100,5,0,5
Kahlo,M,100,0,5,5
Kahmar,M,100,0,5,5
Kahmir,M,100,0,5,5
Kahmyah,F,100,5,0,5
Kahmyra,F,100,5,0,5
Kahreem,M,100,0,5,5
Kahrin,F,100,5,0,5
Kahryn,F,100,5,0,5
Kahtai,M,100,0,5,5
Kaicy,F,100,5,0,5
Kaidenn,M,100,0,5,5
Kaido,M,100,0,5,5
Kaidra,F,100,5,0,5
Kaie,M,100,0,5,5
Kaiky,M,100,0,5,5
Kailar,M,100,0,5,5
Kaileemarie,F,100,5,0,5
Kaileo,M,100,0,5,5
Kailiah,F,100,5,0,5
Kailib,M,100,0,5,5
Kaimalu,M,100,0,5,5
Kaiman,M,100,0,5,5
Kaimere,M,100,0,5,5
Kaimilani,F,100,5,0,5
Kaique,M,100,0,5,5
Kaishon,M,100,0,5,5
Kaisin,M,100,0,5,5
Kaiston,M,100,0,5,5
Kaitey,F,100,5,0,5
Kaithlin,F,100,5,0,5
Kaithlynn,F,100,5,0,5
Kaitin,F,100,5,0,5
Kaitlynmarie,F,100,5,0,5
Kaivan,M,100,0,5,5
Kaiyonna,F,100,5,0,5
Kaiza,F,100,5,0,5
Kaizleigh,F,100,5,0,5
Kajana,M,100,0,5,5
Kajun,F,100,5,0,5
Kalaijah,F,100,5,0,5
Kalanii,F,100,5,0,5
Kalanni,F,100,5,0,5
Kalean,F,100,5,0,5
Kaleece,F,100,5,0,5
Kaleela,F,100,5,0,5
Kaleemah,F,100,5,0,5
Kaleina,F,100,5,0,5
Kaleis,F,100,5,0,5
Kalek,M,100,0,5,5
Kalesa,F,100,5,0,5
Kalesia,F,100,5,0,5
Kalexy,F,100,5,0,5
Kaliece,F,100,5,0,5
Kaliey,F,100,5,0,5
Kalifah,F,100,5,0,5
Kalill,M,100,0,5,5
Kaliona,F,100,5,0,5
Kalionna,F,100,5,0,5
Kalisee,F,100,5,0,5
Kaliyanna,F,100,5,0,5
Kallea,F,100,5,0,5
Kallye,F,100,5,0,5
Kalona,F,100,5,0,5
Kalonie,F,100,5,0,5
Kalp,M,100,0,5,5
Kaltrina,F,100,5,0,5
Kalun,M,100,0,5,5
Kalyann,F,100,5,0,5
Kamaar,M,100,0,5,5
Kamahl,M,100,0,5,5
Kamaiah,F,100,5,0,5
Kamaire,M,100,0,5,5
Kamarionna,F,100,5,0,5
Kamarious,M,100,0,5,5
Kamarre,M,100,0,5,5
Kambelle,F,100,5,0,5
Kamberly,F,100,5,0,5
Kameal,F,100,5,0,5
Kameera,F,100,5,0,5
Kamelo,M,100,0,5,5
Kamelya,F,100,5,0,5
Kameon,M,100,0,5,5
Kamion,M,100,0,5,5
Kamiria,F,100,5,0,5
Kamm,M,100,0,5,5
Kamor,F,100,5,0,5
Kamraan,M,100,0,5,5
Kamryne,F,100,5,0,5
Kamrynne,F,100,5,0,5
Kamsiyochi,F,100,5,0,5
Kamyjah,F,100,5,0,5
Kamyle,F,100,5,0,5
Kanaiyah,F,100,5,0,5
Kanaja,F,100,5,0,5
Kaname,F,100,5,0,5
Kandle,F,100,5,0,5
Kandys,F,100,5,0,5
Kaneidra,F,100,5,0,5
Kaneil,M,100,0,5,5
Kanella,F,100,5,0,5
Kanette,F,100,5,0,5
Kaniala,M,100,0,5,5
Kanijha,F,100,5,0,5
Kanila,F,100,5,0,5
Kanissa,F,100,5,0,5
Kaniylah,F,100,5,0,5
Kanoi,F,100,5,0,5
Kanora,F,100,5,0,5
Kantrice,F,100,5,0,5
Kanyan,M,100,0,5,5
Kanyatta,F,100,5,0,5
Kanyra,F,100,5,0,5
Kaolin,F,100,5,0,5
Kaon,M,100,0,5,5
Kaonou,F,100,5,0,5
Kapish,M,100,0,5,5
Kapricia,F,100,5,0,5
Karadyn,F,100,5,0,5
Karalin,F,100,5,0,5
Karamo,M,100,0,5,5
Karamvir,M,100,0,5,5
Karanbir,M,100,0,5,5
Karaya,F,100,5,0,5
Karcher,M,100,0,5,5
Kardale,M,100,0,5,5
Kareana,F,100,5,0,5
Kareese,F,100,5,0,5
Kareesha,F,100,5,0,5
Karelie,F,100,5,0,5
Kareme,M,100,0,5,5
Karenlee,F,100,5,0,5
Karese,F,100,5,0,5
Karibe,M,100,0,5,5
Karieliz,F,100,5,0,5
Karielys,F,100,5,0,5
Karimen,F,100,5,0,5
Kariona,F,100,5,0,5
Karismah,F,100,5,0,5
Kariyana,F,100,5,0,5
Karlise,F,100,5,0,5
Karliyah,F,100,5,0,5
Karlson,M,100,0,5,5
Karlyee,F,100,5,0,5
Karmani,F,100,5,0,5
Karmari,M,100,0,5,5
Karmindy,F,100,5,0,5
Karmisha,F,100,5,0,5
Karnecia,F,100,5,0,5
Karnel,M,100,0,5,5
Karola,F,100,5,0,5
Karoleigh,F,100,5,0,5
Karoll,F,100,5,0,5
Karrick,M,100,0,5,5
Karrien,M,100,0,5,5
Karroll,M,100,0,5,5
Kartez,M,100,0,5,5
Kartrina,F,100,5,0,5
Karyana,F,100,5,0,5
Kas,M,100,0,5,5
Kasa,F,100,5,0,5
Kasadie,F,100,5,0,5
Kasahn,M,100,0,5,5
Kaser,M,100,0,5,5
Kashandra,F,100,5,0,5
Kashanta,F,100,5,0,5
Kashaunda,F,100,5,0,5
Kasheen,M,100,0,5,5
Kashema,F,100,5,0,5
Kashes,M,100,0,5,5
Kashmira,F,100,5,0,5
Kashtian,M,100,0,5,5
Kasimu,M,100,0,5,5
Kassandrea,F,100,5,0,5
Kassara,F,100,5,0,5
Kasside,F,100,5,0,5
Kastriot,M,100,0,5,5
Kastyn,M,100,0,5,5
Kasydi,F,100,5,0,5
Kasye,F,100,5,0,5
Kataria,F,100,5,0,5
Katavion,M,100,0,5,5
Kateara,F,100,5,0,5
Katelon,F,100,5,0,5
Katelund,F,100,5,0,5
Katerena,F,100,5,0,5
Kathleenann,F,100,5,0,5
Kathran,F,100,5,0,5
Kathrynann,F,100,5,0,5
Kathrynanne,F,100,5,0,5
Kathyern,F,100,5,0,5
Kathyy,F,100,5,0,5
Katierra,F,100,5,0,5
Katija,F,100,5,0,5
Katishia,F,100,5,0,5
Katiuscia,F,100,5,0,5
Katlain,F,100,5,0,5
Katonna,F,100,5,0,5
Katrea,F,100,5,0,5
Katreina,F,100,5,0,5
Katrenna,F,100,5,0,5
Katriece,F,100,5,0,5
Katrisa,F,100,5,0,5
Katsumi,F,100,5,0,5
Katyln,F,100,5,0,5
Kauai,M,100,0,5,5
Kauner,M,100,0,5,5
Kausha,F,100,5,0,5
Kavanaugh,M,100,0,5,5
Kavayah,F,100,5,0,5
Kaveen,M,100,0,5,5
Kaveesh,M,100,0,5,5
Kaveona,F,100,5,0,5
Kavik,M,100,0,5,5
Kaviona,F,100,5,0,5
Kaviyon,M,100,0,5,5
Kavy,M,100,0,5,5
Kawaiola,M,100,0,5,5
Kawayne,M,100,0,5,5
Kawona,F,100,5,0,5
Kayannah,F,100,5,0,5
Kaybre,F,100,5,0,5
Kaydens,F,100,5,0,5
Kaydia,F,100,5,0,5
Kaydnce,F,100,5,0,5
Kaydynn,F,100,5,0,5
Kayelle,F,100,5,0,5
Kayetta,F,100,5,0,5
Kayjuan,M,100,0,5,5
Kaylab,M,100,0,5,5
Kaylalynn,F,100,5,0,5
Kaylamae,F,100,5,0,5
Kaylanne,F,100,5,0,5
Kaylarae,F,100,5,0,5
Kayleeh,F,100,5,0,5
Kayleemae,F,100,5,0,5
Kayleene,F,100,5,0,5
Kayleeonna,F,100,5,0,5
Kayleh,F,100,5,0,5
Kaylian,F,100,5,0,5
Kaylianne,F,100,5,0,5
Kaylieann,F,100,5,0,5
Kaylien,F,100,5,0,5
Kaylisa,F,100,5,0,5
Kaylix,F,100,5,0,5
Kaylle,F,100,5,0,5
Kaylo,M,100,0,5,5
Kayme,F,100,5,0,5
Kaymi,F,100,5,0,5
Kaymoni,F,100,5,0,5
Kayoni,F,100,5,0,5
Kayonia,F,100,5,0,5
Kaysaan,M,100,0,5,5
Kaysaun,M,100,0,5,5
Kayta,F,100,5,0,5
Kaytlyne,F,100,5,0,5
Kayto,M,100,0,5,5
Kayvonna,F,100,5,0,5
Kaywin,F,100,5,0,5
Kayzlie,F,100,5,0,5
Kazir,M,100,0,5,5
Kazu,M,100,0,5,5
Kazuhiro,M,100,0,5,5
Kazz,M,100,0,5,5
Kcee,F,100,5,0,5
Kdrian,M,100,0,5,5
Keadrian,M,100,0,5,5
Keadyn,M,100,0,5,5
Keajia,F,100,5,0,5
Kealana,F,100,5,0,5
Keally,F,100,5,0,5
Kealohi,F,100,5,0,5
Keantay,M,100,0,5,5
Keanua,F,100,5,0,5
Kearea,F,100,5,0,5
Kearius,M,100,0,5,5
Kearn,F,100,5,0,5
Kearson,F,100,5,0,5
Kearstan,F,100,5,0,5
Keasya,F,100,5,0,5
Keathan,M,100,0,5,5
Keayon,M,100,0,5,5
Keaysia,F,100,5,0,5
Keb,M,100,0,5,5
Kebbie,F,100,5,0,5
Kedarian,M,100,0,5,5
Kedeshia,F,100,5,0,5
Kedran,M,100,0,5,5
Keduse,M,100,0,5,5
Keedah,F,100,5,0,5
Keedon,M,100,0,5,5
Keeisha,F,100,5,0,5
Keekee,F,100,5,0,5
Keemia,F,100,5,0,5
Keemon,M,100,0,5,5
Keemora,F,100,5,0,5
Keenin,M,100,0,5,5
Keenyn,M,100,0,5,5
Keerthan,M,100,0,5,5
Keeshan,F,100,5,0,5
Keeson,M,100,0,5,5
Keeston,M,100,0,5,5
Keethan,M,100,0,5,5
Keevis,M,100,0,5,5
Kefentse,M,100,0,5,5
Kefira,F,100,5,0,5
Kehara,F,100,5,0,5
Keiah,F,100,5,0,5
Keiairra,F,100,5,0,5
Keiaja,F,100,5,0,5
Keiann,F,100,5,0,5
Keiari,F,100,5,0,5
Keiarriyen,M,100,0,5,5
Keichia,F,100,5,0,5
Keida,F,100,5,0,5
Keighton,M,100,0,5,5
Keikilani,F,100,5,0,5
Keilia,F,100,5,0,5
Keiliana,F,100,5,0,5
Keimy,F,100,5,0,5
Keiner,M,100,0,5,5
Keiontay,M,100,0,5,5
Keiralee,F,100,5,0,5
Keirslyn,F,100,5,0,5
Keirya,F,100,5,0,5
Keischa,F,100,5,0,5
Keisel,M,100,0,5,5
Keishanda,F,100,5,0,5
Keithin,M,100,0,5,5
Keito,M,100,0,5,5
Keitric,M,100,0,5,5
Keitrick,M,100,0,5,5
Keiuna,F,100,5,0,5
Keivn,M,100,0,5,5
Keiyona,F,100,5,0,5
Kejohn,M,100,0,5,5
Kelab,M,100,0,5,5
Kelany,F,100,5,0,5
Kelbe,F,100,5,0,5
Kelcei,F,100,5,0,5
Keldrin,M,100,0,5,5
Kelecia,F,100,5,0,5
Kelesha,F,100,5,0,5
Keliann,F,100,5,0,5
Kelik,M,100,0,5,5
Kellei,F,100,5,0,5
Kelleyann,F,100,5,0,5
Kellia,F,100,5,0,5
Kellisa,F,100,5,0,5
Kellissa,F,100,5,0,5
Kelman,M,100,0,5,5
Kelseyanne,F,100,5,0,5
Kelsyn,F,100,5,0,5
Keltan,M,100,0,5,5
Kelveon,M,100,0,5,5
Kelvy,M,100,0,5,5
Kemaj,M,100,0,5,5
Kemanie,F,100,5,0,5
Kemarii,F,100,5,0,5
Kemarley,M,100,0,5,5
Kemarui,M,100,0,5,5
Kemauria,F,100,5,0,5
Kemaurie,M,100,0,5,5
Kemberlyn,F,100,5,0,5
Kemeisha,F,100,5,0,5
Kemeshia,F,100,5,0,5
Kemmie,F,100,5,0,5
Kemone,M,100,0,5,5
Kemontez,M,100,0,5,5
Kemran,M,100,0,5,5
Kemry,F,100,5,0,5
Kemyatta,F,100,5,0,5
Kenadey,F,100,5,0,5
Kenaja,F,100,5,0,5
Kenajah,F,100,5,0,5
Kenalee,F,100,5,0,5
Kenasha,F,100,5,0,5
Kendar,F,100,5,0,5
Kendarion,M,100,0,5,5
Kendasia,F,100,5,0,5
Kendayl,F,100,5,0,5
Kendera,F,100,5,0,5
Kenderek,M,100,0,5,5
Kendley,F,100,5,0,5
Kendly,M,100,0,5,5
Kendol,M,100,0,5,5
Kendree,F,100,5,0,5
Kendrel,M,100,0,5,5
Kendrica,F,100,5,0,5
Kendron,M,100,0,5,5
Kendrya,F,100,5,0,5
Kenenth,M,100,0,5,5
Kenessa,F,100,5,0,5
Kenette,F,100,5,0,5
Kengi,M,100,0,5,5
Kenil,M,100,0,5,5
Keniqua,F,100,5,0,5
Keniyha,F,100,5,0,5
Kenjanae,F,100,5,0,5
Kenlin,M,100,0,5,5
Kennay,F,100,5,0,5
Kennika,F,100,5,0,5
Kennydi,F,100,5,0,5
Kenrie,M,100,0,5,5
Kenron,M,100,0,5,5
Kenshayla,F,100,5,0,5
Kenshia,F,100,5,0,5
Kensyn,M,100,0,5,5
Kentarious,M,100,0,5,5
Kenterious,M,100,0,5,5
Kently,F,100,5,0,5
Kentreal,M,100,0,5,5
Kentrevious,M,100,0,5,5
Kentron,M,100,0,5,5
Kentwan,M,100,0,5,5
Kenyara,F,100,5,0,5
Kenyce,F,100,5,0,5
Kenyea,M,100,0,5,5
Kenyel,F,100,5,0,5
Kenyjah,F,100,5,0,5
Kenylah,F,100,5,0,5
Kenz,F,100,5,0,5
Kenzia,F,100,5,0,5
Kenzingtyn,F,100,5,0,5
Kenzlea,F,100,5,0,5
Kenzye,F,100,5,0,5
Keolani,F,100,5,0,5
Keondray,M,100,0,5,5
Keondrea,F,100,5,0,5
Keonie,F,100,5,0,5
Keonnie,F,100,5,0,5
Keori,F,100,5,0,5
Keoria,F,100,5,0,5
Keorra,F,100,5,0,5
Kerala,F,100,5,0,5
Kerani,F,100,5,0,5
Keree,F,100,5,0,5
Kerica,F,100,5,0,5
Kerma,F,100,5,0,5
Kernie,M,100,0,5,5
Kerrell,M,100,0,5,5
Kerrisa,F,100,5,0,5
Kershaw,M,100,0,5,5
Keshante,F,100,5,0,5
Kesharia,F,100,5,0,5
Keshaunna,F,100,5,0,5
Keshawndra,F,100,5,0,5
Keshera,F,100,5,0,5
Kesiha,F,100,5,0,5
Kesly,F,100,5,0,5
Kessley,F,100,5,0,5
Keteria,F,100,5,0,5
Ketherine,F,100,5,0,5
Kethia,F,100,5,0,5
Ketta,F,100,5,0,5
Ketzalli,F,100,5,0,5
Ketziah,F,100,5,0,5
Keunta,M,100,0,5,5
Kevaris,M,100,0,5,5
Keveen,M,100,0,5,5
Kever,M,100,0,5,5
Kevinanthony,M,100,0,5,5
Kevinchristophe,M,100,0,5,5
Kevinmatthew,M,100,0,5,5
Kevious,M,100,0,5,5
Kevlin,M,100,0,5,5
Kevonda,F,100,5,0,5
Kevondra,F,100,5,0,5
Kevontre,M,100,0,5,5
Kevrick,M,100,0,5,5
Kewania,F,100,5,0,5
Keyair,M,100,0,5,5
Keyajah,F,100,5,0,5
Keyandrea,F,100,5,0,5
Keyania,F,100,5,0,5
Keye,M,100,0,5,5
Keyerah,F,100,5,0,5
Keylea,F,100,5,0,5
Keyliana,F,100,5,0,5
Keylianis,F,100,5,0,5
Keymara,F,100,5,0,5
Keymi,F,100,5,0,5
Keymiyah,F,100,5,0,5
Keymonie,M,100,0,5,5
Keynu,F,100,5,0,5
Keyontai,M,100,0,5,5
Keyren,F,100,5,0,5
Keyria,F,100,5,0,5
Keysan,M,100,0,5,5
Keyshana,F,100,5,0,5
Keysia,F,100,5,0,5
Keyuanna,F,100,5,0,5
Keyva,F,100,5,0,5
Keyveon,M,100,0,5,5
Keywaun,M,100,0,5,5
Kezion,M,100,0,5,5
Keziya,F,100,5,0,5
Kezzie,F,100,5,0,5
Kfir,M,100,0,5,5
Khadarius,M,100,0,5,5
Khadence,F,100,5,0,5
Khadijiah,F,100,5,0,5
Khadisah,F,100,5,0,5
Khadiyah,F,100,5,0,5
Khaelynn,F,100,5,0,5
Khafre,M,100,0,5,5
Khairy,M,100,0,5,5
Khaleesy,F,100,5,0,5
Khalema,F,100,5,0,5
Khalial,M,100,0,5,5
Khaliek,M,100,0,5,5
Khalimah,F,100,5,0,5
Khalli,F,100,5,0,5
Khallil,M,100,0,5,5
Khamel,M,100,0,5,5
Khamilah,F,100,5,0,5
Khamisi,M,100,0,5,5
Khamon,M,100,0,5,5
Khamyla,F,100,5,0,5
Khandis,F,100,5,0,5
Khandra,F,100,5,0,5
Kharan,M,100,0,5,5
Khare,M,100,0,5,5
Kharley,F,100,5,0,5
Kharsyn,F,100,5,0,5
Khase,M,100,0,5,5
Khash,M,100,0,5,5
Khatia,F,100,5,0,5
Khattab,M,100,0,5,5
Khawla,F,100,5,0,5
Khawlah,F,100,5,0,5
Khaydence,F,100,5,0,5
Khayir,M,100,0,5,5
Khaylani,F,100,5,0,5
Khaylie,F,100,5,0,5
Khea,F,100,5,0,5
Kheira,F,100,5,0,5
Khelen,M,100,0,5,5
Kheli,F,100,5,0,5
Khemari,M,100,0,5,5
Khendal,F,100,5,0,5
Kheng,M,100,0,5,5
Khepri,F,100,5,0,5
Kheyla,F,100,5,0,5
Khiandra,F,100,5,0,5
Khimora,F,100,5,0,5
Khiron,M,100,0,5,5
Khloemae,F,100,5,0,5
Khloii,F,100,5,0,5
Khmya,F,100,5,0,5
Kholette,F,100,5,0,5
Kholie,F,100,5,0,5
Kholten,M,100,0,5,5
Khrishna,F,100,5,0,5
Khrissa,F,100,5,0,5
Khristan,M,100,0,5,5
Khriston,M,100,0,5,5
Khylar,M,100,0,5,5
Khylige,M,100,0,5,5
Kialani,F,100,5,0,5
Kiamara,F,100,5,0,5
Kiambu,M,100,0,5,5
Kiania,F,100,5,0,5
Kianta,F,100,5,0,5
Kiaralyn,F,100,5,0,5
Kiaron,M,100,0,5,5
Kiarri,F,100,5,0,5
Kiary,F,100,5,0,5
Kias,M,100,0,5,5
Kiava,F,100,5,0,5
Kiawna,F,100,5,0,5
Kiayah,F,100,5,0,5
Kiayanna,F,100,5,0,5
Kibbie,F,100,5,0,5
Kichelle,F,100,5,0,5
Kidata,F,100,5,0,5
Kiean,M,100,0,5,5
Kieandra,F,100,5,0,5
Kieasha,F,100,5,0,5
Kieisha,F,100,5,0,5
Kielin,M,100,0,5,5
Kieralyn,F,100,5,0,5
Kierica,F,100,5,0,5
Kierron,M,100,0,5,5
Kiersa,F,100,5,0,5
Kierslyn,F,100,5,0,5
Kierson,M,100,0,5,5
Kiesel,F,100,5,0,5
Kiffin,F,100,5,0,5
Kiheem,M,100,0,5,5
Kiirsten,F,100,5,0,5
Kilana,F,100,5,0,5
Kilburn,M,100,0,5,5
Kiler,M,100,0,5,5
Kiliyah,F,100,5,0,5
Kimaada,F,100,5,0,5
Kimarri,F,100,5,0,5
Kimatha,F,100,5,0,5
Kimauri,F,100,5,0,5
Kimbala,F,100,5,0,5
Kimberlyy,F,100,5,0,5
Kimberyl,F,100,5,0,5
Kimbie,F,100,5,0,5
Kimbla,F,100,5,0,5
Kimbrley,F,100,5,0,5
Kimchi,F,100,5,0,5
Kimella,F,100,5,0,5
Kimmesha,F,100,5,0,5
Kimone,F,100,5,0,5
Kimonie,F,100,5,0,5
Kimonte,M,100,0,5,5
Kimoya,F,100,5,0,5
Kimura,F,100,5,0,5
Kimverly,F,100,5,0,5
Kinady,F,100,5,0,5
Kindrea,F,100,5,0,5
Kindric,M,100,0,5,5
Kindsay,F,100,5,0,5
Kinganthony,M,100,0,5,5
Kingdon,M,100,0,5,5
Kingjoseph,M,100,0,5,5
Kingstan,M,100,0,5,5
Kini,F,100,5,0,5
Kiniah,F,100,5,0,5
Kiniesha,F,100,5,0,5
Kinnard,M,100,0,5,5
Kinneret,F,100,5,0,5
Kinsasha,F,100,5,0,5
Kinsely,F,100,5,0,5
Kinshasha,F,100,5,0,5
Kintrell,M,100,0,5,5
Kinverli,F,100,5,0,5
Kinverlin,F,100,5,0,5
Kio,M,100,0,5,5
Kioko,F,100,5,0,5
Kiomi,F,100,5,0,5
Kionia,F,100,5,0,5
Kipenie,F,100,5,0,5
Kiplin,M,100,0,5,5
Kiranjot,F,100,5,0,5
Kirbee,F,100,5,0,5
Kirina,F,100,5,0,5
Kirisa,F,100,5,0,5
Kirsey,F,100,5,0,5
Kirstey,F,100,5,0,5
Kirwin,M,100,0,5,5
Kirynn,F,100,5,0,5
Kisan,M,100,0,5,5
Kishanna,F,100,5,0,5
Kisher,F,100,5,0,5
Kishla,F,100,5,0,5
Kishma,F,100,5,0,5
Kishonna,F,100,5,0,5
Kisia,F,100,5,0,5
Kissha,F,100,5,0,5
Kistina,F,100,5,0,5
Kiswanna,F,100,5,0,5
Kitsy,F,100,5,0,5
Kitza,F,100,5,0,5
Kiwon,M,100,0,5,5
Kiyami,F,100,5,0,5
Kiyarah,F,100,5,0,5
Kiyel,M,100,0,5,5
Kiyelle,F,100,5,0,5
Kiylan,M,100,0,5,5
Kiyo,F,100,5,0,5
Kizuwanda,F,100,5,0,5
Kizze,F,100,5,0,5
Kleb,M,100,0,5,5
Kleopatra,F,100,5,0,5
Klifton,M,100,0,5,5
Kloeigh,F,100,5,0,5
Klowey,F,100,5,0,5
Kmauri,M,100,0,5,5
Kmaya,F,100,5,0,5
Kmiya,F,100,5,0,5
Kneisha,F,100,5,0,5
Knicole,F,100,5,0,5
Knova,F,100,5,0,5
Knoxville,M,100,0,5,5
Kobei,M,100,0,5,5
Kodjo,M,100,0,5,5
Kodyn,M,100,0,5,5
Koedy,M,100,0,5,5
Koesha,F,100,5,0,5
Kohlee,F,100,5,0,5
Kohlston,M,100,0,5,5
Kokeeta,F,100,5,0,5
Kokomi,F,100,5,0,5
Kokou,M,100,0,5,5
Koleigh,F,100,5,0,5
Kolia,F,100,5,0,5
Kollier,M,100,0,5,5
Koltynn,M,100,0,5,5
Komora,F,100,5,0,5
Konika,F,100,5,0,5
Konley,M,100,0,5,5
Konny,F,100,5,0,5
Kontrina,F,100,5,0,5
Kookie,F,100,5,0,5
Koorosh,M,100,0,5,5
Koosha,M,100,0,5,5
Kor,M,100,0,5,5
Koraleigh,F,100,5,0,5
Koralie,F,100,5,0,5
Kordan,M,100,0,5,5
Korden,M,100,0,5,5
Koreem,M,100,0,5,5
Koreon,M,100,0,5,5
Korilyn,F,100,5,0,5
Korilynn,F,100,5,0,5
Korionna,F,100,5,0,5
Kornel,M,100,0,5,5
Kortana,F,100,5,0,5
Korvyn,M,100,0,5,5
Kosisochi,F,100,5,0,5
Kosten,M,100,0,5,5
Kother,F,100,5,0,5
Koti,F,100,5,0,5
Kotomi,F,100,5,0,5
Kotryna,F,100,5,0,5
Kouhei,M,100,0,5,5
Kouri,F,100,5,0,5
Kourtne,F,100,5,0,5
Kousuke,M,100,0,5,5
Kovan,M,100,0,5,5
Kovi,M,100,0,5,5
Kovid,M,100,0,5,5
Kowanna,F,100,5,0,5
Krayson,M,100,0,5,5
Krea,F,100,5,0,5
Kreelynn,F,100,5,0,5
Kreena,F,100,5,0,5
Krenar,M,100,0,5,5
Kreshnik,M,100,0,5,5
Kresten,M,100,0,5,5
Krillin,M,100,0,5,5
Krishal,M,100,0,5,5
Krishani,F,100,5,0,5
Krishara,F,100,5,0,5
Krishell,F,100,5,0,5
Krishen,M,100,0,5,5
Krishil,M,100,0,5,5
Krishina,F,100,5,0,5
Krishona,F,100,5,0,5
Krishtian,M,100,0,5,5
Krishunna,F,100,5,0,5
Krisit,F,100,5,0,5
Krisley,F,100,5,0,5
Krisopher,M,100,0,5,5
Krispin,M,100,0,5,5
Kristalle,F,100,5,0,5
Kristepher,M,100,0,5,5
Kristieann,F,100,5,0,5
Kristiena,F,100,5,0,5
Kristijo,F,100,5,0,5
Kristinejoy,F,100,5,0,5
Kristinn,F,100,5,0,5
Kristlynn,F,100,5,0,5
Kristopfer,M,100,0,5,5
Kristupas,M,100,0,5,5
Kristyanne,F,100,5,0,5
Kritina,F,100,5,0,5
Kriyansh,M,100,0,5,5
Kriztian,M,100,0,5,5
Kros,M,100,0,5,5
Kruize,M,100,0,5,5
Krush,M,100,0,5,5
Krya,F,100,5,0,5
Krystabella,F,100,5,0,5
Krystaline,F,100,5,0,5
Krystallee,F,100,5,0,5
Krystalmae,F,100,5,0,5
Krystalmarie,F,100,5,0,5
Krystalrose,F,100,5,0,5
Krystalynne,F,100,5,0,5
Krysteen,F,100,5,0,5
Krystoffer,M,100,0,5,5
Kryton,M,100,0,5,5
Kryztal,F,100,5,0,5
Ksandra,F,100,5,0,5
Ktherine,F,100,5,0,5
Kubrick,M,100,0,5,5
Kudura,M,100,0,5,5
Kuhu,F,100,5,0,5
Kullyn,M,100,0,5,5
Kumani,F,100,5,0,5
Kumi,F,100,5,0,5
Kundana,F,100,5,0,5
Kuno,M,100,0,5,5
Kunsh,M,100,0,5,5
Kupaa,M,100,0,5,5
Kurby,M,100,0,5,5
Kurie,F,100,5,0,5
Kursti,F,100,5,0,5
Kurtina,F,100,5,0,5
Kurtlin,M,100,0,5,5
Kurtlyn,F,100,5,0,5
Kuwan,M,100,0,5,5
Kuwana,F,100,5,0,5
Kuwanda,F,100,5,0,5
Kuwanna,F,100,5,0,5
Kwamae,M,100,0,5,5
Kwamayne,M,100,0,5,5
Kwamin,M,100,0,5,5
Kwang,M,100,0,5,5
Kwaniqua,F,100,5,0,5
Kwanze,M,100,0,5,5
Kwashawn,M,100,0,5,5
Kwaun,M,100,0,5,5
Kwayera,F,100,5,0,5
Kwinn,F,100,5,0,5
Kwok,M,100,0,5,5
Kwuan,M,100,0,5,5
Kyairra,F,100,5,0,5
Kyalee,F,100,5,0,5
Kyalo,M,100,0,5,5
Kycia,F,100,5,0,5
Kyelar,M,100,0,5,5
Kyer,M,100,0,5,5
Kyerstin,F,100,5,0,5
Kyeson,M,100,0,5,5
Kyhiem,M,100,0,5,5
Kyhlee,F,100,5,0,5
Kyiren,M,100,0,5,5
Kylamarie,F,100,5,0,5
Kylealexander,M,100,0,5,5
Kyleek,M,100,0,5,5
Kyleemarie,F,100,5,0,5
Kylem,M,100,0,5,5
Kylese,F,100,5,0,5
Kylesha,F,100,5,0,5
Kylicia,F,100,5,0,5
Kylis,F,100,5,0,5
Kylun,M,100,0,5,5
Kymanie,M,100,0,5,5
Kymar,M,100,0,5,5
Kymarley,M,100,0,5,5
Kymauri,M,100,0,5,5
Kymaya,F,100,5,0,5
Kymbella,F,100,5,0,5
Kymberle,F,100,5,0,5
Kymeir,M,100,0,5,5
Kymeshia,F,100,5,0,5
Kyndi,F,100,5,0,5
Kyndyl,F,100,5,0,5
Kyneisha,F,100,5,0,5
Kynnady,F,100,5,0,5
Kyntrell,M,100,0,5,5
Kyonne,M,100,0,5,5
Kyosuke,M,100,0,5,5
Kypten,M,100,0,5,5
Kyptin,M,100,0,5,5
Kyralynn,F,100,5,0,5
Kyrea,F,100,5,0,5
Kyrek,M,100,0,5,5
Kyreon,M,100,0,5,5
Kyresha,F,100,5,0,5
Kyrha,F,100,5,0,5
Kyrien,M,100,0,5,5
Kyrsta,F,100,5,0,5
Kyse,M,100,0,5,5
Kyshana,F,100,5,0,5
Kysia,F,100,5,0,5
Kystin,M,100,0,5,5
Kytalin,F,100,5,0,5
Kyten,M,100,0,5,5
Kyuana,F,100,5,0,5
Kyvion,M,100,0,5,5
Kywanna,F,100,5,0,5
Laangela,F,100,5,0,5
Laanthony,M,100,0,5,5
Labraya,F,100,5,0,5
Labreya,F,100,5,0,5
Labreyah,F,100,5,0,5
Labritney,F,100,5,0,5
Lacalvin,M,100,0,5,5
Lacasha,F,100,5,0,5
Lacci,F,100,5,0,5
Lacelyn,F,100,5,0,5
Lacen,M,100,0,5,5
Lachara,F,100,5,0,5
Lachisa,F,100,5,0,5
Lachisha,F,100,5,0,5
Lachonne,F,100,5,0,5
Lachristy,F,100,5,0,5
Lachundra,F,100,5,0,5
Laciann,F,100,5,0,5
Lacondra,F,100,5,0,5
Lacorya,F,100,5,0,5
Ladanna,F,100,5,0,5
Ladara,F,100,5,0,5
Ladaveon,M,100,0,5,5
Ladavian,M,100,0,5,5
Ladavid,M,100,0,5,5
Ladayja,F,100,5,0,5
Ladaynian,M,100,0,5,5
Ladaysia,F,100,5,0,5
Ladeidre,F,100,5,0,5
Laderrian,M,100,0,5,5
Ladijah,F,100,5,0,5
Ladonda,F,100,5,0,5
Ladonja,F,100,5,0,5
Ladontay,M,100,0,5,5
Ladreama,F,100,5,0,5
Ladreka,F,100,5,0,5
Ladye,F,100,5,0,5
Laeken,F,100,5,0,5
Laella,F,100,5,0,5
Laeyah,F,100,5,0,5
Lafay,F,100,5,0,5
Lafeyette,M,100,0,5,5
Lafonzo,M,100,0,5,5
Lafran,F,100,5,0,5
Lafrancine,F,100,5,0,5
Lafrederick,M,100,0,5,5
Lagatha,F,100,5,0,5
Lah,F,100,5,0,5
Lahla,F,100,5,0,5
Lahni,F,100,5,0,5
Lahonda,F,100,5,0,5
Laici,F,100,5,0,5
Laidy,F,100,5,0,5
Laighton,F,100,5,0,5
Laike,M,100,0,5,5
Laileen,F,100,5,0,5
Laileigh,F,100,5,0,5
Lailiana,F,100,5,0,5
Lailonnie,F,100,5,0,5
Laiona,F,100,5,0,5
Lairen,F,100,5,0,5
Lajace,M,100,0,5,5
Lajauna,F,100,5,0,5
Lajayceon,M,100,0,5,5
Lakayden,M,100,0,5,5
Lakeah,F,100,5,0,5
Lakedrick,M,100,0,5,5
Lakeela,F,100,5,0,5
Lakeetha,F,100,5,0,5
Lakeida,F,100,5,0,5
Lakel,M,100,0,5,5
Lakelan,M,100,0,5,5
Lakeley,F,100,5,0,5
Lakell,M,100,0,5,5
Lakemia,F,100,5,0,5
Lakenzi,F,100,5,0,5
Lakersha,F,100,5,0,5
Lakeshea,F,100,5,0,5
Lakessha,F,100,5,0,5
Lakey,F,100,5,0,5
Lakeycha,F,100,5,0,5
Lakeydra,F,100,5,0,5
Laki,M,100,0,5,5
Lakiaya,F,100,5,0,5
Lakieshia,F,100,5,0,5
Lakinia,F,100,5,0,5
Lakista,F,100,5,0,5
Lakitia,F,100,5,0,5
Lakitra,F,100,5,0,5
Lakitsha,F,100,5,0,5
Lakley,F,100,5,0,5
Lakshmy,F,100,5,0,5
Laksmi,F,100,5,0,5
Lakwanzaa,F,100,5,0,5
Lakye,M,100,0,5,5
Lakyndra,F,100,5,0,5
Lakyrah,F,100,5,0,5
Lalainia,F,100,5,0,5
Laleah,F,100,5,0,5
Lalenia,F,100,5,0,5
Laleta,F,100,5,0,5
Lalicia,F,100,5,0,5
Lalit,M,100,0,5,5
Lalith,M,100,0,5,5
Lamanuel,M,100,0,5,5
Lamarqus,M,100,0,5,5
Lamarra,F,100,5,0,5
Lamarus,M,100,0,5,5
Lamea,F,100,5,0,5
Lameer,M,100,0,5,5
Lameir,M,100,0,5,5
Lamera,F,100,5,0,5
Lamerle,F,100,5,0,5
Lamese,F,100,5,0,5
Lameya,F,100,5,0,5
Lamiek,M,100,0,5,5
Lamirra,F,100,5,0,5
Lamontray,M,100,0,5,5
Lamoria,F,100,5,0,5
Lamoyne,M,100,0,5,5
Lamyla,F,100,5,0,5
Lanaea,F,100,5,0,5
Lanaija,F,100,5,0,5
Lanajia,F,100,5,0,5
Lanayja,F,100,5,0,5
Lanayshia,F,100,5,0,5
Lancing,M,100,0,5,5
Landdon,M,100,0,5,5
Landel,M,100,0,5,5
Landenn,M,100,0,5,5
Landris,M,100,0,5,5
Lanece,F,100,5,0,5
Laneise,F,100,5,0,5
Lanekia,F,100,5,0,5
Lanelda,F,100,5,0,5
Lanena,F,100,5,0,5
Lanesa,F,100,5,0,5
Laneva,F,100,5,0,5
Lange,M,100,0,5,5
Laniyia,F,100,5,0,5
Lank,M,100,0,5,5
Lannetta,F,100,5,0,5
Lanning,M,100,0,5,5
Lannon,M,100,0,5,5
Lantanya,F,100,5,0,5
Lanty,M,100,0,5,5
Lanvy,F,100,5,0,5
Lanyard,M,100,0,5,5
Lanye,F,100,5,0,5
Lanylah,F,100,5,0,5
Lanyra,F,100,5,0,5
Lapatra,F,100,5,0,5
Laphonso,M,100,0,5,5
Laporchea,F,100,5,0,5
Laquail,F,100,5,0,5
Laquain,M,100,0,5,5
Laquavion,M,100,0,5,5
Laquavius,M,100,0,5,5
Laquel,F,100,5,0,5
Laquesta,F,100,5,0,5
Laquetha,F,100,5,0,5
Laquicha,F,100,5,0,5
Laquietta,F,100,5,0,5
Laquil,F,100,5,0,5
Laquin,M,100,0,5,5
Laquinthia,F,100,5,0,5
Laquise,F,100,5,0,5
Laquite,F,100,5,0,5
Laqundra,F,100,5,0,5
Laqusha,F,100,5,0,5
Laraea,F,100,5,0,5
Laralyn,F,100,5,0,5
Laraye,F,100,5,0,5
Larea,F,100,5,0,5
Larecia,F,100,5,0,5
Lareco,M,100,0,5,5
Larey,M,100,0,5,5
Larez,M,100,0,5,5
Laricka,F,100,5,0,5
Lariesha,F,100,5,0,5
Larion,M,100,0,5,5
Larionna,F,100,5,0,5
Laritha,F,100,5,0,5
Larizza,F,100,5,0,5
Larnelle,M,100,0,5,5
Larnice,F,100,5,0,5
Larobert,M,100,0,5,5
Larodney,M,100,0,5,5
Laroi,M,100,0,5,5
Larosha,F,100,5,0,5
Larre,M,100,0,5,5
Larreon,M,100,0,5,5
Larriah,F,100,5,0,5
Larrica,F,100,5,0,5
Larriesha,F,100,5,0,5
Larrry,M,100,0,5,5
Larsa,F,100,5,0,5
Larsson,M,100,0,5,5
Lasara,F,100,5,0,5
Lasaunda,F,100,5,0,5
Lascelles,M,100,0,5,5
Lasedrick,M,100,0,5,5
Lashalle,F,100,5,0,5
Lasheia,F,100,5,0,5
Lashelia,F,100,5,0,5
Lasherrie,F,100,5,0,5
Lasheryl,F,100,5,0,5
Lasheta,F,100,5,0,5
Lashley,F,100,5,0,5
Lashown,F,100,5,0,5
Lashowna,F,100,5,0,5
Lashundia,F,100,5,0,5
Lashunti,F,100,5,0,5
Lashunya,F,100,5,0,5
Lashurn,F,100,5,0,5
Lastasia,F,100,5,0,5
Lata,F,100,5,0,5
Latae,F,100,5,0,5
Latai,F,100,5,0,5
Lataivia,F,100,5,0,5
Lataiya,F,100,5,0,5
Latangie,F,100,5,0,5
Latanisha,F,100,5,0,5
Latanyia,F,100,5,0,5
Latarah,F,100,5,0,5
Latari,F,100,5,0,5
Latarsia,F,100,5,0,5
Latassha,F,100,5,0,5
Latatia,F,100,5,0,5
Latavea,F,100,5,0,5
Lataveon,M,100,0,5,5
Latawn,F,100,5,0,5
Latayia,F,100,5,0,5
Lateaka,F,100,5,0,5
Latease,F,100,5,0,5
Lateashia,F,100,5,0,5
Lateela,F,100,5,0,5
Latefah,F,100,5,0,5
Lateika,F,100,5,0,5
Latela,F,100,5,0,5
Latenya,F,100,5,0,5
Laterian,M,100,0,5,5
Laterrell,M,100,0,5,5
Latevia,F,100,5,0,5
Lathena,F,100,5,0,5
Lathomas,M,100,0,5,5
Latiea,F,100,5,0,5
Latief,M,100,0,5,5
Latissia,F,100,5,0,5
Latissue,F,100,5,0,5
Latodd,M,100,0,5,5
Latoina,F,100,5,0,5
Latorrance,M,100,0,5,5
Latorri,F,100,5,0,5
Latoyla,F,100,5,0,5
Latoyra,F,100,5,0,5
Latracy,F,100,5,0,5
Latrasha,F,100,5,0,5
Latrayvion,M,100,0,5,5
Latreca,F,100,5,0,5
Latreena,F,100,5,0,5
Latreka,F,100,5,0,5
Latric,F,100,5,0,5
Latroyia,F,100,5,0,5
Latu,M,100,0,5,5
Latyia,F,100,5,0,5
Latyna,F,100,5,0,5
Lauana,F,100,5,0,5
Lauar,M,100,0,5,5
Lauchlin,M,100,0,5,5
Laudan,F,100,5,0,5
Launda,F,100,5,0,5
Laurabelle,F,100,5,0,5
Laurella,F,100,5,0,5
Laurenelizabeth,F,100,5,0,5
Laurett,F,100,5,0,5
Lauriane,F,100,5,0,5
Laurica,F,100,5,0,5
Laurrine,F,100,5,0,5
Lauryne,F,100,5,0,5
Lavall,M,100,0,5,5
Lavare,M,100,0,5,5
Laveeda,F,100,5,0,5
Laveen,F,100,5,0,5
Lavene,F,100,5,0,5
Lavenna,F,100,5,0,5
Lavere,M,100,0,5,5
Laverle,F,100,5,0,5
Lavia,F,100,5,0,5
Lavickie,F,100,5,0,5
Lavine,F,100,5,0,5
Lavinnia,F,100,5,0,5
Lavondia,F,100,5,0,5
Lawaia,M,100,0,5,5
Lawanika,F,100,5,0,5
Lawaun,M,100,0,5,5
Lawenda,F,100,5,0,5
Lawhitney,F,100,5,0,5
Layanie,F,100,5,0,5
Layanne,F,100,5,0,5
Layeska,F,100,5,0,5
Layland,M,100,0,5,5
Laylanna,F,100,5,0,5
Laylina,F,100,5,0,5
Laylyn,F,100,5,0,5
Layvonne,F,100,5,0,5
Lazare,M,100,0,5,5
Lazareth,M,100,0,5,5
Lazariyah,F,100,5,0,5
Lazell,M,100,0,5,5
Lazhane,F,100,5,0,5
Ld,M,100,0,5,5
Ldarius,M,100,0,5,5
Leacy,F,100,5,0,5
Leafy,F,100,5,0,5
Leagh,F,100,5,0,5
Leahgrace,F,100,5,0,5
Leahrose,F,100,5,0,5
Leaman,M,100,0,5,5
Leandrae,M,100,0,5,5
Leandros,M,100,0,5,5
Leanetta,F,100,5,0,5
Learon,M,100,0,5,5
Learta,F,100,5,0,5
Leathea,F,100,5,0,5
Leatricia,F,100,5,0,5
Leaysia,F,100,5,0,5
Lebria,F,100,5,0,5
Lech,M,100,0,5,5
Lecole,F,100,5,0,5
Lecory,M,100,0,5,5
Ledaniel,M,100,0,5,5
Ledeja,F,100,5,0,5
Ledel,M,100,0,5,5
Leeanah,F,100,5,0,5
Leeander,M,100,0,5,5
Leeannah,F,100,5,0,5
Leeara,F,100,5,0,5
Leeat,F,100,5,0,5
Leedward,M,100,0,5,5
Leejay,M,100,0,5,5
Leelani,F,100,5,0,5
Leemarie,F,100,5,0,5
Leeo,M,100,0,5,5
Leequan,M,100,0,5,5
Leeric,M,100,0,5,5
Leeshaun,M,100,0,5,5
Leetal,F,100,5,0,5
Leevan,M,100,0,5,5
Legendary,M,100,0,5,5
Legrant,M,100,0,5,5
Lehiwa,F,100,5,0,5
Lehna,F,100,5,0,5
Leiahna,F,100,5,0,5
Leicha,F,100,5,0,5
Leicia,F,100,5,0,5
Leighia,F,100,5,0,5
Leighlan,M,100,0,5,5
Leightan,F,100,5,0,5
Leihlani,F,100,5,0,5
Leilaann,F,100,5,0,5
Leilamarie,F,100,5,0,5
Leilauni,F,100,5,0,5
Leilena,F,100,5,0,5
Leilend,M,100,0,5,5
Leilonie,F,100,5,0,5
Leilonnie,F,100,5,0,5
Leilynd,M,100,0,5,5
Leini,F,100,5,0,5
Leionna,F,100,5,0,5
Leire,F,100,5,0,5
Leishla,F,100,5,0,5
Leithan,M,100,0,5,5
Leizel,F,100,5,0,5
Lejoyce,F,100,5,0,5
Lekai,M,100,0,5,5
Lekayla,F,100,5,0,5
Lekedia,F,100,5,0,5
Lekendric,M,100,0,5,5
Lekhi,M,100,0,5,5
Lelanya,F,100,5,0,5
Lelianna,F,100,5,0,5
Lelind,M,100,0,5,5
Lelita,F,100,5,0,5
Leloni,F,100,5,0,5
Lemarco,M,100,0,5,5
Lemari,M,100,0,5,5
Lemisha,F,100,5,0,5
Lemoine,M,100,0,5,5
Lemonica,F,100,5,0,5
Lemorris,M,100,0,5,5
Lenai,F,100,5,0,5
Lendra,F,100,5,0,5
Lenecia,F,100,5,0,5
Leneta,F,100,5,0,5
Lenett,F,100,5,0,5
Lenley,M,100,0,5,5
Lennel,M,100,0,5,5
Lenneth,M,100,0,5,5
Lennett,F,100,5,0,5
Lennia,F,100,5,0,5
Lenona,F,100,5,0,5
Lens,M,100,0,5,5
Lensa,F,100,5,0,5
Lenuel,M,100,0,5,5
Lenus,M,100,0,5,5
Lenvil,M,100,0,5,5
Lenz,M,100,0,5,5
Leocadia,F,100,5,0,5
Leonaldo,M,100,0,5,5
Leondrus,M,100,0,5,5
Leonhard,M,100,0,5,5
Leonice,F,100,5,0,5
Leonilda,F,100,5,0,5
Leonisha,F,100,5,0,5
Leonnah,F,100,5,0,5
Leontre,M,100,0,5,5
Leonydus,M,100,0,5,5
Leoul,M,100,0,5,5
Leovigildo,M,100,0,5,5
Lequinton,M,100,0,5,5
Lequitta,F,100,5,0,5
Lequon,M,100,0,5,5
Lerena,F,100,5,0,5
Leriah,F,100,5,0,5
Lerico,M,100,0,5,5
Lerita,F,100,5,0,5
Lerome,M,100,0,5,5
Leshanta,F,100,5,0,5
Leshauna,F,100,5,0,5
Leshaundra,F,100,5,0,5
Leshawnda,F,100,5,0,5
Lesheena,F,100,5,0,5
Lesheka,F,100,5,0,5
Leslly,F,100,5,0,5
Letrecia,F,100,5,0,5
Letrese,F,100,5,0,5
Letriana,F,100,5,0,5
Letrica,F,100,5,0,5
Letrina,F,100,5,0,5
Lettia,F,100,5,0,5
Letwan,M,100,0,5,5
Levani,F,100,5,0,5
Levant,M,100,0,5,5
Levearn,F,100,5,0,5
Levee,F,100,5,0,5
Leveon,M,100,0,5,5
Leverette,M,100,0,5,5
Leverna,F,100,5,0,5
Levertis,M,100,0,5,5
Levion,M,100,0,5,5
Levity,F,100,5,0,5
Levolia,F,100,5,0,5
Levonna,F,100,5,0,5
Levorne,M,100,0,5,5
Lewann,F,100,5,0,5
Leward,M,100,0,5,5
Lexandria,F,100,5,0,5
Lexandro,M,100,0,5,5
Lexanne,F,100,5,0,5
Lexcee,F,100,5,0,5
Lexcie,F,100,5,0,5
Lexe,F,100,5,0,5
Lexiee,F,100,5,0,5
Lexilynn,F,100,5,0,5
Lexsie,F,100,5,0,5
Lexsy,F,100,5,0,5
Leyat,F,100,5,0,5
Leylan,M,100,0,5,5
Leyre,F,100,5,0,5
Lezer,M,100,0,5,5
Lhea,F,100,5,0,5
Lialah,F,100,5,0,5
Liamalexander,M,100,0,5,5
Lianabel,F,100,5,0,5
Liberato,M,100,0,5,5
Libeth,F,100,5,0,5
Lica,F,100,5,0,5
Liczy,F,100,5,0,5
Lidea,F,100,5,0,5
Lidio,M,100,0,5,5
Liedson,M,100,0,5,5
Lienna,F,100,5,0,5
Lieselotte,F,100,5,0,5
Liette,F,100,5,0,5
Lieza,F,100,5,0,5
Ligeia,F,100,5,0,5
Ligita,F,100,5,0,5
Likhitha,F,100,5,0,5
Lilamae,F,100,5,0,5
Lilany,F,100,5,0,5
Lile,F,100,5,0,5
Liliano,F,100,5,0,5
Lilias,F,100,5,0,5
Lilica,F,100,5,0,5
Lilirose,F,100,5,0,5
Lilita,F,100,5,0,5
Liliyanna,F,100,5,0,5
Lill,F,100,5,0,5
Lilleeana,F,100,5,0,5
Lillianrose,F,100,5,0,5
Lillion,F,100,5,0,5
Lilliyn,F,100,5,0,5
Lillya,F,100,5,0,5
Lillyah,F,100,5,0,5
Lillyjo,F,100,5,0,5
Lillykate,F,100,5,0,5
Lillymay,F,100,5,0,5
Liloa,M,100,0,5,5
Lilyaunna,F,100,5,0,5
Lilylynn,F,100,5,0,5
Lilymay,F,100,5,0,5
Linay,F,100,5,0,5
Lindaa,F,100,5,0,5
Lindamaria,F,100,5,0,5
Lindella,F,100,5,0,5
Lindly,F,100,5,0,5
Lindo,M,100,0,5,5
Linen,F,100,5,0,5
Lingxi,F,100,5,0,5
Linhchi,F,100,5,0,5
Liniyah,F,100,5,0,5
Linly,F,100,5,0,5
Linnard,M,100,0,5,5
Linnda,F,100,5,0,5
Linneah,F,100,5,0,5
Linnis,M,100,0,5,5
Linsley,M,100,0,5,5
Linzell,M,100,0,5,5
Lirije,F,100,5,0,5
Lisah,F,100,5,0,5
Lisajean,F,100,5,0,5
Lised,F,100,5,0,5
Liseli,F,100,5,0,5
Lisetta,F,100,5,0,5
Lisiate,M,100,0,5,5
Lissbet,F,100,5,0,5
Lissianna,F,100,5,0,5
Lisvette,F,100,5,0,5
Litonia,F,100,5,0,5
Litza,F,100,5,0,5
Lius,M,100,0,5,5
Livana,F,100,5,0,5
Livea,F,100,5,0,5
Livee,F,100,5,0,5
Livija,F,100,5,0,5
Liyanah,F,100,5,0,5
Lizabelle,F,100,5,0,5
Lize,F,100,5,0,5
Lizeht,F,100,5,0,5
Lizethe,F,100,5,0,5
Lizhet,F,100,5,0,5
Lizneidy,F,100,5,0,5
Llanet,F,100,5,0,5
Llarely,F,100,5,0,5
Llayla,F,100,5,0,5
Llecenia,F,100,5,0,5
Lloana,F,100,5,0,5
Llovani,M,100,0,5,5
Lluvy,F,100,5,0,5
Loagen,M,100,0,5,5
Loai,M,100,0,5,5
Loal,M,100,0,5,5
Lobsang,M,100,0,5,5
Lochlainn,M,100,0,5,5
Lochlen,M,100,0,5,5
Lockie,F,100,5,0,5
Locksley,M,100,0,5,5
Logahn,M,100,0,5,5
Loganjames,M,100,0,5,5
Logunn,M,100,0,5,5
Lohan,M,100,0,5,5
Loid,M,100,0,5,5
Loleatta,F,100,5,0,5
Lolethia,F,100,5,0,5
Lomant,M,100,0,5,5
Lomax,M,100,0,5,5
Lonard,M,100,0,5,5
Londi,F,100,5,0,5
Londonn,F,100,5,0,5
Londonrose,F,100,5,0,5
Londrea,F,100,5,0,5
Lonesha,F,100,5,0,5
Lonika,F,100,5,0,5
Lonis,M,100,0,5,5
Lonnesha,F,100,5,0,5
Lonniesha,F,100,5,0,5
Lonnita,F,100,5,0,5
Lonyea,F,100,5,0,5
Lonzel,M,100,0,5,5
Lorde,F,100,5,0,5
Loreene,F,100,5,0,5
Lorenn,F,100,5,0,5
Lorenzia,M,100,0,5,5
Lorida,F,100,5,0,5
Loriell,F,100,5,0,5
Lorilai,F,100,5,0,5
Lorinne,F,100,5,0,5
Lorinza,M,100,0,5,5
Lorise,F,100,5,0,5
Lorrel,F,100,5,0,5
Lorrenda,F,100,5,0,5
Lorrenzo,M,100,0,5,5
Lorrian,F,100,5,0,5
Lorris,M,100,0,5,5
Lorrisa,F,100,5,0,5
Loryanna,F,100,5,0,5
Loryssa,F,100,5,0,5
Losie,F,100,5,0,5
Lotaya,F,100,5,0,5
Louaine,F,100,5,0,5
Louette,F,100,5,0,5
Louisia,F,100,5,0,5
Louka,M,100,0,5,5
Louna,F,100,5,0,5
Lourinda,F,100,5,0,5
Lourita,F,100,5,0,5
Lousia,F,100,5,0,5
Loutricia,F,100,5,0,5
Loveda,F,100,5,0,5
Lovel,M,100,0,5,5
Loveless,M,100,0,5,5
Loveya,F,100,5,0,5
Lovonda,F,100,5,0,5
Lovonia,F,100,5,0,5
Lowrey,M,100,0,5,5
Lowrie,M,100,0,5,5
Lrey,M,100,0,5,5
Luar,M,100,0,5,5
Lucais,M,100,0,5,5
Lucanus,M,100,0,5,5
Lucchese,F,100,5,0,5
Luce,F,100,5,0,5
Luceal,F,100,5,0,5
Lucertia,F,100,5,0,5
Luchanna,F,100,5,0,5
Luchia,F,100,5,0,5
Luchiana,F,100,5,0,5
Lucienna,F,100,5,0,5
Lucija,F,100,5,0,5
Lucinia,F,100,5,0,5
Lucja,F,100,5,0,5
Luck,M,100,0,5,5
Luckey,M,100,0,5,5
Lucya,F,100,5,0,5
Lucymarie,F,100,5,0,5
Lucyrose,F,100,5,0,5
Luelle,F,100,5,0,5
Luereatha,F,100,5,0,5
Lugman,M,100,0,5,5
Luigino,M,100,0,5,5
Luisandro,M,100,0,5,5
Luisarmando,M,100,0,5,5
Luisjavier,M,100,0,5,5
Lujack,M,100,0,5,5
Lujuan,F,100,5,0,5
Lukacs,M,100,0,5,5
Lukaus,M,100,0,5,5
Lukeanthony,M,100,0,5,5
Lulabelle,F,100,5,0,5
Luley,F,100,5,0,5
Lunetta,F,100,5,0,5
Luong,M,100,0,5,5
Luren,F,100,5,0,5
Lurenda,F,100,5,0,5
Lurlie,F,100,5,0,5
Lusana,F,100,5,0,5
Luserito,F,100,5,0,5
Lusha,F,100,5,0,5
Lushawn,F,100,5,0,5
Lushonda,F,100,5,0,5
Lushus,F,100,5,0,5
Lusvin,M,100,0,5,5
Lutina,F,100,5,0,5
Lutz,M,100,0,5,5
Luu,M,100,0,5,5
Luukas,M,100,0,5,5
Luvena,F,100,5,0,5
Luvonne,F,100,5,0,5
Luxanna,F,100,5,0,5
Luxton,M,100,0,5,5
Luxy,F,100,5,0,5
Luzdari,F,100,5,0,5
Luzette,F,100,5,0,5
Luzmila,F,100,5,0,5
Lyal,M,100,0,5,5
Lyanie,F,100,5,0,5
Lycinda,F,100,5,0,5
Lycrecia,F,100,5,0,5
Lydale,M,100,0,5,5
Lyddia,F,100,5,0,5
Lydianne,F,100,5,0,5
Lydya,F,100,5,0,5
Lyelah,F,100,5,0,5
Lyia,F,100,5,0,5
Lyjah,M,100,0,5,5
Lylarose,F,100,5,0,5
Lyles,M,100,0,5,5
Lyliann,F,100,5,0,5
Lyllyan,F,100,5,0,5
Lynder,F,100,5,0,5
Lyndsae,F,100,5,0,5
Lynis,F,100,5,0,5
Lynissa,F,100,5,0,5
Lyniya,F,100,5,0,5
Lynndsey,F,100,5,0,5
Lynneann,F,100,5,0,5
Lynnessa,F,100,5,0,5
Lynnete,F,100,5,0,5
Lynnlea,F,100,5,0,5
Lyron,M,100,0,5,5
Lyshon,F,100,5,0,5
Lytina,F,100,5,0,5
Lytzi,F,100,5,0,5
Lyzandra,F,100,5,0,5
Maaha,F,100,5,0,5
Maahika,F,100,5,0,5
Maahira,F,100,5,0,5
Maaseiah,M,100,0,5,5
Mabelin,F,100,5,0,5
Mabell,F,100,5,0,5
Mabil,F,100,5,0,5
Mabinty,F,100,5,0,5
Macailah,F,100,5,0,5
Macara,F,100,5,0,5
Macauly,M,100,0,5,5
Maceon,M,100,0,5,5
Mach,M,100,0,5,5
Machias,M,100,0,5,5
Machiavelli,M,100,0,5,5
Mackaela,F,100,5,0,5
Mackala,F,100,5,0,5
Mackaylah,F,100,5,0,5
Mackenley,F,100,5,0,5
Mackenlie,F,100,5,0,5
Mackensy,F,100,5,0,5
Maclovia,F,100,5,0,5
Maclyn,F,100,5,0,5
Maddielyn,F,100,5,0,5
Maddoux,M,100,0,5,5
Maddylynn,F,100,5,0,5
Madelane,F,100,5,0,5
Madella,F,100,5,0,5
Madellyne,F,100,5,0,5
Madelys,F,100,5,0,5
Madena,F,100,5,0,5
Madiba,M,100,0,5,5
Madicella,F,100,5,0,5
Madisongrace,F,100,5,0,5
Madiyson,F,100,5,0,5
Madrox,M,100,0,5,5
Maebri,F,100,5,0,5
Maeda,F,100,5,0,5
Maelana,F,100,5,0,5
Maelina,F,100,5,0,5
Maeliyah,F,100,5,0,5
Maelo,M,100,0,5,5
Maelynne,F,100,5,0,5
Maemi,F,100,5,0,5
Maeta,F,100,5,0,5
Maevry,F,100,5,0,5
Maezy,F,100,5,0,5
Magalena,F,100,5,0,5
Magavi,F,100,5,0,5
Magdali,F,100,5,0,5
Magdaly,F,100,5,0,5
Magdelina,F,100,5,0,5
Magena,F,100,5,0,5
Maggen,F,100,5,0,5
Magi,F,100,5,0,5
Mah,F,100,5,0,5
Mahadev,M,100,0,5,5
Mahalet,F,100,5,0,5
Mahaliah,F,100,5,0,5
Mahammad,M,100,0,5,5
Mahaylee,F,100,5,0,5
Mahaylia,F,100,5,0,5
Mahde,M,100,0,5,5
Mahely,F,100,5,0,5
Mahib,M,100,0,5,5
Mahie,F,100,5,0,5
Mahirah,F,100,5,0,5
Mahisha,F,100,5,0,5
Mahkhi,M,100,0,5,5
Mahkiya,F,100,5,0,5
Mahkyla,F,100,5,0,5
Mahlah,F,100,5,0,5
Mahlek,M,100,0,5,5
Mahlena,F,100,5,0,5
Mahoganee,F,100,5,0,5
Maialen,F,100,5,0,5
Maica,F,100,5,0,5
Maicyn,F,100,5,0,5
Maide,F,100,5,0,5
Maider,F,100,5,0,5
Maidson,F,100,5,0,5
Maier,M,100,0,5,5
Maigon,F,100,5,0,5
Maiha,F,100,5,0,5
Maiki,M,100,0,5,5
Mailea,F,100,5,0,5
Mailing,F,100,5,0,5
Maina,F,100,5,0,5
Mainou,F,100,5,0,5
Maireli,F,100,5,0,5
Maiti,F,100,5,0,5
Majeeda,F,100,5,0,5
Majestie,F,100,5,0,5
Majida,F,100,5,0,5
Majik,M,100,0,5,5
Majken,F,100,5,0,5
Majuma,F,100,5,0,5
Majur,M,100,0,5,5
Makada,F,100,5,0,5
Makaily,F,100,5,0,5
Makalani,M,100,0,5,5
Makalea,F,100,5,0,5
Makalei,F,100,5,0,5
Makanalei,F,100,5,0,5
Makanna,F,100,5,0,5
Makao,M,100,0,5,5
Makarah,F,100,5,0,5
Makarie,M,100,0,5,5
Makasia,F,100,5,0,5
Makauri,M,100,0,5,5
Makayiah,F,100,5,0,5
Makayliah,F,100,5,0,5
Makayln,F,100,5,0,5
Makelah,F,100,5,0,5
Makennzie,F,100,5,0,5
Makenzly,F,100,5,0,5
Makesia,F,100,5,0,5
Maketta,F,100,5,0,5
Makhaya,F,100,5,0,5
Makiala,F,100,5,0,5
Makieh,M,100,0,5,5
Makiel,M,100,0,5,5
Makiley,F,100,5,0,5
Makinnah,F,100,5,0,5
Makkiyah,F,100,5,0,5
Makston,M,100,0,5,5
Makynlei,F,100,5,0,5
Malacia,F,100,5,0,5
Malack,F,100,5,0,5
Malaena,F,100,5,0,5
Malaine,F,100,5,0,5
Malajia,F,100,5,0,5
Malakei,M,100,0,5,5
Malany,F,100,5,0,5
Malanya,F,100,5,0,5
Malav,M,100,0,5,5
Malchijah,M,100,0,5,5
Malcohm,M,100,0,5,5
Maleaya,F,100,5,0,5
Maleesa,F,100,5,0,5
Maleha,F,100,5,0,5
Malei,F,100,5,0,5
Malenna,F,100,5,0,5
Malesia,F,100,5,0,5
Malex,M,100,0,5,5
Malialani,F,100,5,0,5
Malicai,M,100,0,5,5
Malicka,F,100,5,0,5
Malieya,F,100,5,0,5
Malikaih,M,100,0,5,5
Malikiya,F,100,5,0,5
Malira,F,100,5,0,5
Malissie,F,100,5,0,5
Mallia,F,100,5,0,5
Mallina,F,100,5,0,5
Malonda,F,100,5,0,5
Malquan,M,100,0,5,5
Maluhia,F,100,5,0,5
Malulani,F,100,5,0,5
Malvenia,F,100,5,0,5
Malwina,F,100,5,0,5
Mamadu,M,100,0,5,5
Mamy,F,100,5,0,5
Manada,F,100,5,0,5
Manaure,M,100,0,5,5
Manavi,F,100,5,0,5
Mandala,F,100,5,0,5
Mandalin,F,100,5,0,5
Mandre,M,100,0,5,5
Mandye,F,100,5,0,5
Manee,F,100,5,0,5
Maneesha,F,100,5,0,5
Manfredo,M,100,0,5,5
Manijeh,F,100,5,0,5
Manisa,F,100,5,0,5
Manita,F,100,5,0,5
Manjinder,M,100,0,5,5
Mannon,F,100,5,0,5
Manogna,F,100,5,0,5
Manoy,F,100,5,0,5
Manshi,F,100,5,0,5
Manthan,M,100,0,5,5
Manton,M,100,0,5,5
Mantra,M,100,0,5,5
Manuell,M,100,0,5,5
Manwell,M,100,0,5,5
Manzell,M,100,0,5,5
Manzie,M,100,0,5,5
Maomi,F,100,5,0,5
Mapuana,F,100,5,0,5
Maquetta,F,100,5,0,5
Maraam,F,100,5,0,5
Maradee,F,100,5,0,5
Maradith,F,100,5,0,5
Marali,F,100,5,0,5
Marandia,F,100,5,0,5
Marbeya,F,100,5,0,5
Marceen,F,100,5,0,5
Marceleen,F,100,5,0,5
Marcelena,F,100,5,0,5
Marcelin,M,100,0,5,5
Marcetta,F,100,5,0,5
Marciel,M,100,0,5,5
Marcilene,F,100,5,0,5
Marcion,M,100,0,5,5
Marckel,M,100,0,5,5
Marckos,M,100,0,5,5
Marcoa,M,100,0,5,5
Marcopolo,M,100,0,5,5
Marctavious,M,100,0,5,5
Marcuse,M,100,0,5,5
Marcusjames,M,100,0,5,5
Mardean,F,100,5,0,5
Mardena,F,100,5,0,5
Mardine,F,100,5,0,5
Mardis,M,100,0,5,5
Mareck,M,100,0,5,5
Mareike,F,100,5,0,5
Mareily,F,100,5,0,5
Marel,F,100,5,0,5
Marelle,F,100,5,0,5
Mareme,F,100,5,0,5
Maressia,F,100,5,0,5
Mareyah,F,100,5,0,5
Margaet,F,100,5,0,5
Margaretanne,F,100,5,0,5
Margaretjo,F,100,5,0,5
Margarie,F,100,5,0,5
Margarit,F,100,5,0,5
Margaro,M,100,0,5,5
Margean,F,100,5,0,5
Margette,F,100,5,0,5
Marggie,F,100,5,0,5
Margreta,F,100,5,0,5
Marguel,M,100,0,5,5
Margulia,F,100,5,0,5
Marhia,F,100,5,0,5
Mariaann,F,100,5,0,5
Mariaantonia,F,100,5,0,5
Mariadelos,F,100,5,0,5
Mariae,F,100,5,0,5
Mariaelisa,F,100,5,0,5
Mariaemilia,F,100,5,0,5
Mariagrazia,F,100,5,0,5
Mariahna,F,100,5,0,5
Marialana,F,100,5,0,5
Marialicia,F,100,5,0,5
Marianely,F,100,5,0,5
Mariangeles,F,100,5,0,5
Mariannah,F,100,5,0,5
Mariasha,F,100,5,0,5
Mariaya,F,100,5,0,5
Maric,M,100,0,5,5
Maricely,F,100,5,0,5
Maricelys,F,100,5,0,5
Maricha,F,100,5,0,5
Marichuy,F,100,5,0,5
Maricrus,F,100,5,0,5
Marid,M,100,0,5,5
Marieana,F,100,5,0,5
Marieda,F,100,5,0,5
Marifrances,F,100,5,0,5
Marihelen,F,100,5,0,5
Marijana,F,100,5,0,5
Marijuana,F,100,5,0,5
Marike,F,100,5,0,5
Marilina,F,100,5,0,5
Marilinda,F,100,5,0,5
Marilis,F,100,5,0,5
Marinee,F,100,5,0,5
Marinel,F,100,5,0,5
Marinette,F,100,5,0,5
Marinez,F,100,5,0,5
Marini,F,100,5,0,5
Marinus,M,100,0,5,5
Mariolita,F,100,5,0,5
Mariques,M,100,0,5,5
Marisely,F,100,5,0,5
Marish,F,100,5,0,5
Marisleysi,F,100,5,0,5
Marista,F,100,5,0,5
Maritzabel,F,100,5,0,5
Mariuxi,F,100,5,0,5
Marivell,F,100,5,0,5
Mariyonna,F,100,5,0,5
Marje,F,100,5,0,5
Marjeanne,F,100,5,0,5
Markaysha,F,100,5,0,5
Markaysia,F,100,5,0,5
Markdavid,M,100,0,5,5
Markeas,M,100,0,5,5
Markease,M,100,0,5,5
Markeida,F,100,5,0,5
Markena,F,100,5,0,5
Markera,F,100,5,0,5
Markess,M,100,0,5,5
Markest,M,100,0,5,5
Markette,F,100,5,0,5
Markeveon,M,100,0,5,5
Markevus,M,100,0,5,5
Markeys,M,100,0,5,5
Markiee,M,100,0,5,5
Marking,M,100,0,5,5
Markishia,F,100,5,0,5
Markk,M,100,0,5,5
Markkevin,M,100,0,5,5
Markki,F,100,5,0,5
Markkus,M,100,0,5,5
Markquan,M,100,0,5,5
Markryan,M,100,0,5,5
Markwan,M,100,0,5,5
Markwilliam,M,100,0,5,5
Markyia,F,100,5,0,5
Marlanda,F,100,5,0,5
Marlaysha,F,100,5,0,5
Marlecia,F,100,5,0,5
Marleigha,F,100,5,0,5
Marleisha,F,100,5,0,5
Marlenny,F,100,5,0,5
Marletha,F,100,5,0,5
Marleyjane,F,100,5,0,5
Marlice,F,100,5,0,5
Marliee,F,100,5,0,5
Marliegh,F,100,5,0,5
Marlika,F,100,5,0,5
Marlvin,M,100,0,5,5
Marlynda,F,100,5,0,5
Marneshia,F,100,5,0,5
Marniqua,F,100,5,0,5
Marniyah,F,100,5,0,5
Marqell,M,100,0,5,5
Marqies,M,100,0,5,5
Marqis,M,100,0,5,5
Marquael,M,100,0,5,5
Marquas,M,100,0,5,5
Marqueal,M,100,0,5,5
Marqueeta,F,100,5,0,5
Marquettia,F,100,5,0,5
Marquevious,M,100,0,5,5
Marquian,M,100,0,5,5
Marquille,M,100,0,5,5
Marquina,F,100,5,0,5
Marquinta,F,100,5,0,5
Marquitha,F,100,5,0,5
Marqurita,F,100,5,0,5
Marreco,M,100,0,5,5
Marrick,M,100,0,5,5
Marrk,M,100,0,5,5
Marsadie,F,100,5,0,5
Marsea,F,100,5,0,5
Marselo,M,100,0,5,5
Marsenio,M,100,0,5,5
Marsetta,F,100,5,0,5
Marshalle,F,100,5,0,5
Marshonda,F,100,5,0,5
Marsinah,F,100,5,0,5
Marsue,F,100,5,0,5
Martaja,F,100,5,0,5
Martaveous,M,100,0,5,5
Martee,F,100,5,0,5
Marteeka,F,100,5,0,5
Marteisha,F,100,5,0,5
Martella,F,100,5,0,5
Marterius,M,100,0,5,5
Marterrion,M,100,0,5,5
Martes,M,100,0,5,5
Marthella,F,100,5,0,5
Marthena,F,100,5,0,5
Marthenia,F,100,5,0,5
Marthia,F,100,5,0,5
Martianna,F,100,5,0,5
Martijn,M,100,0,5,5
Martinis,M,100,0,5,5
Martique,M,100,0,5,5
Martrail,M,100,0,5,5
Martravius,M,100,0,5,5
Martrina,F,100,5,0,5
Martwan,M,100,0,5,5
Martwon,M,100,0,5,5
Marval,F,100,5,0,5
Marvalee,F,100,5,0,5
Marvan,M,100,0,5,5
Marve,M,100,0,5,5
Marveen,F,100,5,0,5
Marveon,M,100,0,5,5
Marvi,F,100,5,0,5
Marvic,M,100,0,5,5
Marvlene,F,100,5,0,5
Marycaroline,F,100,5,0,5
Marycela,F,100,5,0,5
Marychristina,F,100,5,0,5
Maryelaine,F,100,5,0,5
Maryellis,F,100,5,0,5
Maryellyn,F,100,5,0,5
Maryfaith,F,100,5,0,5
Maryha,F,100,5,0,5
Maryhannah,F,100,5,0,5
Maryjune,F,100,5,0,5
Maryka,F,100,5,0,5
Marylinn,F,100,5,0,5
Marysabel,F,100,5,0,5
Maryterese,F,100,5,0,5
Maryury,F,100,5,0,5
Maryvel,F,100,5,0,5
Marzavion,M,100,0,5,5
Masal,F,100,5,0,5
Masami,F,100,5,0,5
Masani,F,100,5,0,5
Masaru,M,100,0,5,5
Masataka,M,100,0,5,5
Mascen,M,100,0,5,5
Mashari,F,100,5,0,5
Mashauna,F,100,5,0,5
Mashaunda,F,100,5,0,5
Mashay,F,100,5,0,5
Mashea,F,100,5,0,5
Mashunda,F,100,5,0,5
Masia,F,100,5,0,5
Maslin,F,100,5,0,5
Masooma,F,100,5,0,5
Massie,F,100,5,0,5
Masuma,F,100,5,0,5
Masynn,F,100,5,0,5
Matelynn,F,100,5,0,5
Mateyo,M,100,0,5,5
Matheos,M,100,0,5,5
Mather,M,100,0,5,5
Mathiew,M,100,0,5,5
Mathijs,M,100,0,5,5
Mathyas,M,100,0,5,5
Mathyis,M,100,0,5,5
Matiah,F,100,5,0,5
Maticia,F,100,5,0,5
Matie,F,100,5,0,5
Matilee,F,100,5,0,5
Matiya,F,100,5,0,5
Matlock,M,100,0,5,5
Matney,F,100,5,0,5
Mattaniah,M,100,0,5,5
Mattaya,F,100,5,0,5
Matten,M,100,0,5,5
Matthea,F,100,5,0,5
Mattheq,M,100,0,5,5
Matthewdavid,M,100,0,5,5
Matthrew,M,100,0,5,5
Matus,M,100,0,5,5
Mau,M,100,0,5,5
Maudeen,F,100,5,0,5
Maulin,M,100,0,5,5
Maung,M,100,0,5,5
Maurece,M,100,0,5,5
Maureene,F,100,5,0,5
Maurey,M,100,0,5,5
Mauricus,M,100,0,5,5
Mauriella,F,100,5,0,5
Maurin,F,100,5,0,5
Maurus,M,100,0,5,5
Mavelyn,F,100,5,0,5
Maverix,M,100,0,5,5
Mavia,F,100,5,0,5
Mavie,F,100,5,0,5
Maxell,M,100,0,5,5
Maximili,M,100,0,5,5
Maximilion,M,100,0,5,5
Maxwill,M,100,0,5,5
Maxxamus,M,100,0,5,5
Maxxen,M,100,0,5,5
Maxymus,M,100,0,5,5
Maxyn,M,100,0,5,5
Mayalyn,F,100,5,0,5
Mayann,F,100,5,0,5
Mayble,F,100,5,0,5
Maybre,F,100,5,0,5
Mayghan,F,100,5,0,5
Mayha,F,100,5,0,5
Mayher,F,100,5,0,5
Mayisha,F,100,5,0,5
Maykaylee,F,100,5,0,5
Maykol,M,100,0,5,5
Mayly,F,100,5,0,5
Maymouna,F,100,5,0,5
Mayolo,M,100,0,5,5
Mayrel,F,100,5,0,5
Mayrelin,F,100,5,0,5
Mayrely,F,100,5,0,5
Mayreni,F,100,5,0,5
Mayron,M,100,0,5,5
Maysea,F,100,5,0,5
Mayzell,F,100,5,0,5
Maz,M,100,0,5,5
Mazani,F,100,5,0,5
Mazaria,F,100,5,0,5
Mazella,F,100,5,0,5
Mazhar,M,100,0,5,5
Mazyah,F,100,5,0,5
Mcalister,M,100,0,5,5
Mcauthur,M,100,0,5,5
Mccarty,M,100,0,5,5
Mcchael,M,100,0,5,5
Mcclinton,M,100,0,5,5
Mcconnell,M,100,0,5,5
Mchael,M,100,0,5,5
Mchenry,M,100,0,5,5
Mcihelle,F,100,5,0,5
Mckail,M,100,0,5,5
Mckailah,F,100,5,0,5
Mckaleb,M,100,0,5,5
Mckaleigh,F,100,5,0,5
Mckaye,F,100,5,0,5
Mckayli,F,100,5,0,5
Mckean,M,100,0,5,5
Mckee,M,100,0,5,5
Mckeena,F,100,5,0,5
Mckeever,M,100,0,5,5
Mckensley,F,100,5,0,5
Mckenziee,F,100,5,0,5
Mckinely,M,100,0,5,5
Mckinnly,F,100,5,0,5
Mckylie,F,100,5,0,5
Mckynze,F,100,5,0,5
Mcneal,M,100,0,5,5
Mcquade,M,100,0,5,5
Me,F,100,5,0,5
Meabh,F,100,5,0,5
Meagyn,F,100,5,0,5
Mecayla,F,100,5,0,5
Mechella,F,100,5,0,5
Medena,F,100,5,0,5
Medin,M,100,0,5,5
Medley,F,100,5,0,5
Medwin,M,100,0,5,5
Meenah,F,100,5,0,5
Meerub,F,100,5,0,5
Megale,M,100,0,5,5
Megam,F,100,5,0,5
Meghean,F,100,5,0,5
Meghon,F,100,5,0,5
Meghyn,F,100,5,0,5
Mehnaz,F,100,5,0,5
Mehrab,M,100,0,5,5
Mehret,F,100,5,0,5
Meilanie,F,100,5,0,5
Meile,F,100,5,0,5
Meiqi,F,100,5,0,5
Mekea,F,100,5,0,5
Mekeia,F,100,5,0,5
Mekela,F,100,5,0,5
Mekelle,F,100,5,0,5
Mekensie,F,100,5,0,5
Mekenzy,F,100,5,0,5
Mekeshia,F,100,5,0,5
Mekiel,M,100,0,5,5
Mekih,M,100,0,5,5
Mekyle,M,100,0,5,5
Melakhi,M,100,0,5,5
Melaku,M,100,0,5,5
Melan,F,100,5,0,5
Melanya,F,100,5,0,5
Melarie,F,100,5,0,5
Melaynie,F,100,5,0,5
Melbra,F,100,5,0,5
Meledy,F,100,5,0,5
Meleesa,F,100,5,0,5
Meleyah,F,100,5,0,5
Meliame,F,100,5,0,5
Melishia,F,100,5,0,5
Melky,M,100,0,5,5
Mellani,F,100,5,0,5
Mellisha,F,100,5,0,5
Mellodee,F,100,5,0,5
Mellodie,F,100,5,0,5
Mellssa,F,100,5,0,5
Mellyora,F,100,5,0,5
Melssia,F,100,5,0,5
Meltem,F,100,5,0,5
Melveen,F,100,5,0,5
Melvita,F,100,5,0,5
Melvonia,F,100,5,0,5
Menal,F,100,5,0,5
Menasha,M,100,0,5,5
Meoshi,F,100,5,0,5
Merald,M,100,0,5,5
Mercedas,F,100,5,0,5
Merchelle,F,100,5,0,5
Meredy,F,100,5,0,5
Merely,F,100,5,0,5
Meret,F,100,5,0,5
Merette,F,100,5,0,5
Mergeron,M,100,0,5,5
Merial,F,100,5,0,5
Meridth,F,100,5,0,5
Meritza,F,100,5,0,5
Meriwether,F,100,5,0,5
Merleah,F,100,5,0,5
Merlot,F,100,5,0,5
Merola,F,100,5,0,5
Merriel,M,100,0,5,5
Merrilu,F,100,5,0,5
Mersadees,F,100,5,0,5
Mersadiez,F,100,5,0,5
Merzedes,F,100,5,0,5
Mesan,F,100,5,0,5
Meshae,F,100,5,0,5
Meshay,F,100,5,0,5
Meshea,F,100,5,0,5
Meshel,F,100,5,0,5
Messias,M,100,0,5,5
Messyah,M,100,0,5,5
Metehan,M,100,0,5,5
Meti,F,100,5,0,5
Metzi,F,100,5,0,5
Mextli,F,100,5,0,5
Meyanna,F,100,5,0,5
Meyla,F,100,5,0,5
Meyly,F,100,5,0,5
Meyra,F,100,5,0,5
Meyson,M,100,0,5,5
Meztly,F,100,5,0,5
Mezziah,M,100,0,5,5
Mguadalupe,F,100,5,0,5
Mhairi,F,100,5,0,5
Mhari,F,100,5,0,5
Mhina,F,100,5,0,5
Mhya,F,100,5,0,5
Miakayla,F,100,5,0,5
Miakka,F,100,5,0,5
Miakota,F,100,5,0,5
Miamour,F,100,5,0,5
Miarah,F,100,5,0,5
Miavictoria,F,100,5,0,5
Micahia,F,100,5,0,5
Micahjoseph,M,100,0,5,5
Micaleb,M,100,0,5,5
Michaelallen,M,100,0,5,5
Michaelchristop,M,100,0,5,5
Michaelee,F,100,5,0,5
Michaelin,F,100,5,0,5
Michaeljr,M,100,0,5,5
Michaelpatrick,M,100,0,5,5
Michaels,M,100,0,5,5
Michaia,F,100,5,0,5
Michaylah,F,100,5,0,5
Michealanthony,M,100,0,5,5
Michealene,F,100,5,0,5
Micheleen,F,100,5,0,5
Michelleanne,F,100,5,0,5
Michellele,F,100,5,0,5
Michigan,M,100,0,5,5
Michio,M,100,0,5,5
Michuel,M,100,0,5,5
Mickail,M,100,0,5,5
Mickalla,F,100,5,0,5
Mickenzi,F,100,5,0,5
Mickiel,M,100,0,5,5
Mickinley,F,100,5,0,5
Mickinzie,F,100,5,0,5
Mickyle,M,100,0,5,5
Micquel,M,100,0,5,5
Midian,M,100,0,5,5
Mieya,F,100,5,0,5
Miichael,M,100,0,5,5
Miika,F,100,5,0,5
Miina,F,100,5,0,5
Mijoi,F,100,5,0,5
Mijoy,F,100,5,0,5
Mikaal,M,100,0,5,5
Mikaeli,F,100,5,0,5
Mikaeyla,F,100,5,0,5
Mikaiyah,F,100,5,0,5
Mikan,F,100,5,0,5
Mikayala,F,100,5,0,5
Mikayleigh,F,100,5,0,5
Mikaylen,F,100,5,0,5
Mikaylla,F,100,5,0,5
Mikaylynn,F,100,5,0,5
Mikeayla,F,100,5,0,5
Mikee,M,100,0,5,5
Mikei,M,100,0,5,5
Mikeil,M,100,0,5,5
Mikelia,F,100,5,0,5
Mikenya,F,100,5,0,5
Mikequan,M,100,0,5,5
Mikeyah,F,100,5,0,5
Mikhiya,F,100,5,0,5
Mikilah,F,100,5,0,5
Mikinlee,F,100,5,0,5
Mikylee,F,100,5,0,5
Mikylie,F,100,5,0,5
Milaniya,F,100,5,0,5
Milbrey,F,100,5,0,5
Mildre,F,100,5,0,5
Mileen,F,100,5,0,5
Mileke,M,100,0,5,5
Mileni,F,100,5,0,5
Milett,F,100,5,0,5
Mileva,F,100,5,0,5
Mileyna,F,100,5,0,5
Mileyshka,F,100,5,0,5
Milferd,M,100,0,5,5
Milisha,F,100,5,0,5
Milisia,F,100,5,0,5
Mille,F,100,5,0,5
Millenna,F,100,5,0,5
Millia,F,100,5,0,5
Millinia,F,100,5,0,5
Milliona,F,100,5,0,5
Milorad,M,100,0,5,5
Milosh,M,100,0,5,5
Milus,M,100,0,5,5
Mimose,F,100,5,0,5
Mims,M,100,0,5,5
Minard,M,100,0,5,5
Minelba,F,100,5,0,5
Minelva,F,100,5,0,5
Minely,F,100,5,0,5
Minga,F,100,5,0,5
Mingus,M,100,0,5,5
Minhanh,F,100,5,0,5
Minhtri,M,100,0,5,5
Minjoon,M,100,0,5,5
Minus,M,100,0,5,5
Miquella,F,100,5,0,5
Miquez,M,100,0,5,5
Miquisha,F,100,5,0,5
Mirabell,F,100,5,0,5
Miracal,F,100,5,0,5
Miraha,F,100,5,0,5
Mirajane,F,100,5,0,5
Mirei,F,100,5,0,5
Mireia,F,100,5,0,5
Miriama,F,100,5,0,5
Miriel,F,100,5,0,5
Mirlene,F,100,5,0,5
Mirlinda,F,100,5,0,5
Mirnes,M,100,0,5,5
Mirriah,F,100,5,0,5
Mirsab,M,100,0,5,5
Mirya,F,100,5,0,5
Misgana,F,100,5,0,5
Mishalay,F,100,5,0,5
Misheeta,F,100,5,0,5
Mishia,F,100,5,0,5
Misri,F,100,5,0,5
Missel,F,100,5,0,5
Mistala,F,100,5,0,5
Mistic,F,100,5,0,5
Mithila,F,100,5,0,5
Mitsie,F,100,5,0,5
Mitsuko,F,100,5,0,5
Mitza,F,100,5,0,5
Miura,F,100,5,0,5
Mixtly,F,100,5,0,5
Miyesha,F,100,5,0,5
Miyla,F,100,5,0,5
Mkaila,F,100,5,0,5
Mkaylah,F,100,5,0,5
Mleah,F,100,5,0,5
Mmary,F,100,5,0,5
Mmichael,M,100,0,5,5
Mobolaji,M,100,0,5,5
Mocha,F,100,5,0,5
Moctar,M,100,0,5,5
Modupeoluwa,F,100,5,0,5
Moez,M,100,0,5,5
Mofiyinfoluwa,F,100,5,0,5
Mohamedamiin,M,100,0,5,5
Mohamedamine,M,100,0,5,5
Moiya,F,100,5,0,5
Mojtaba,M,100,0,5,5
Mokshagna,M,100,0,5,5
Mokshitha,F,100,5,0,5
Molette,F,100,5,0,5
Molik,M,100,0,5,5
Molika,F,100,5,0,5
Molissa,F,100,5,0,5
Molloy,M,100,0,5,5
Mollyrose,F,100,5,0,5
Mon,M,100,0,5,5
Monah,F,100,5,0,5
Monajah,F,100,5,0,5
Moncerrad,F,100,5,0,5
Moncheri,F,100,5,0,5
Mondra,M,100,0,5,5
Moneeb,M,100,0,5,5
Moneer,M,100,0,5,5
Moneque,F,100,5,0,5
Monikah,F,100,5,0,5
Moniq,F,100,5,0,5
Monir,M,100,0,5,5
Monissa,F,100,5,0,5
Monquel,M,100,0,5,5
Monquita,F,100,5,0,5
Monreaux,F,100,5,0,5
Monsanto,M,100,0,5,5
Monsita,F,100,5,0,5
Montanah,F,100,5,0,5
Montanez,M,100,0,5,5
Montaye,M,100,0,5,5
Montaysia,F,100,5,0,5
Monterion,M,100,0,5,5
Monterra,F,100,5,0,5
Montese,M,100,0,5,5
Montevious,M,100,0,5,5
Montiara,F,100,5,0,5
Montico,M,100,0,5,5
Montiera,F,100,5,0,5
Montonio,M,100,0,5,5
Montoyia,F,100,5,0,5
Montravion,M,100,0,5,5
Montrevious,M,100,0,5,5
Montserrad,F,100,5,0,5
Mony,M,100,0,5,5
Monyka,F,100,5,0,5
Monzerrad,F,100,5,0,5
Moraes,M,100,0,5,5
Morah,F,100,5,0,5
Moran,F,100,5,0,5
Mordchai,M,100,0,5,5
Mordechi,M,100,0,5,5
Moreland,M,100,0,5,5
Moretta,F,100,5,0,5
Morgayne,F,100,5,0,5
Morghen,F,100,5,0,5
Moriana,F,100,5,0,5
Morion,M,100,0,5,5
Morisa,F,100,5,0,5
Morlon,M,100,0,5,5
Morolaoluwa,F,100,5,0,5
Morpheus,M,100,0,5,5
Morrow,M,100,0,5,5
Moshay,F,100,5,0,5
Motez,M,100,0,5,5
Motoki,M,100,0,5,5
Mott,M,100,0,5,5
Mouhammad,M,100,0,5,5
Mounia,F,100,5,0,5
Mourya,M,100,0,5,5
Moutaz,M,100,0,5,5
Mr,M,100,0,5,5
Mrinalini,F,100,5,0,5
Mtisha,F,100,5,0,5
Muammar,M,100,0,5,5
Mubin,M,100,0,5,5
Mueed,M,100,0,5,5
Mugen,M,100,0,5,5
Mugilan,M,100,0,5,5
Muhaimin,M,100,0,5,5
Muhammadamin,M,100,0,5,5
Muhmmad,M,100,0,5,5
Mui,F,100,5,0,5
Muireann,F,100,5,0,5
Mukarram,M,100,0,5,5
Mukesh,M,100,0,5,5
Mukil,M,100,0,5,5
Mumtahina,F,100,5,0,5
Munajj,M,100,0,5,5
Munha,F,100,5,0,5
Muniza,F,100,5,0,5
Murali,M,100,0,5,5
Murrey,M,100,0,5,5
Murrie,F,100,5,0,5
Murron,F,100,5,0,5
Musah,M,100,0,5,5
Musse,M,100,0,5,5
Mustafah,M,100,0,5,5
Muzna,F,100,5,0,5
Myair,F,100,5,0,5
Myairah,F,100,5,0,5
Myajah,F,100,5,0,5
Myalin,F,100,5,0,5
Myalyn,F,100,5,0,5
Myamarie,F,100,5,0,5
Myanh,F,100,5,0,5
Myann,F,100,5,0,5
Myanni,F,100,5,0,5
Myashia,F,100,5,0,5
Mychell,F,100,5,0,5
Mycol,M,100,0,5,5
Myesia,F,100,5,0,5
Myheir,M,100,0,5,5
Myjoy,F,100,5,0,5
Mykalla,F,100,5,0,5
Mykerria,F,100,5,0,5
Mykhala,F,100,5,0,5
Mykhel,M,100,0,5,5
Mykita,F,100,5,0,5
Mykl,M,100,0,5,5
Mykya,F,100,5,0,5
Mykyah,F,100,5,0,5
Mylaa,F,100,5,0,5
Mylana,F,100,5,0,5
Mylasha,F,100,5,0,5
Myleesha,F,100,5,0,5
Myleisha,F,100,5,0,5
Mylek,M,100,0,5,5
Myler,M,100,0,5,5
Mylicia,F,100,5,0,5
Myliegh,F,100,5,0,5
Mylii,F,100,5,0,5
Mylinn,F,100,5,0,5
Mylynda,F,100,5,0,5
Mynasia,F,100,5,0,5
Myneisha,F,100,5,0,5
Myphuong,F,100,5,0,5
Myquisha,F,100,5,0,5
Myrianna,F,100,5,0,5
Myrlande,F,100,5,0,5
Myrlin,F,100,5,0,5
Myrone,M,100,0,5,5
Myrra,F,100,5,0,5
Myster,M,100,0,5,5
Mytchell,M,100,0,5,5
Mythri,F,100,5,0,5
Mytisha,F,100,5,0,5
Myunique,F,100,5,0,5
Myyah,F,100,5,0,5
Naami,F,100,5,0,5
Nabhya,M,100,0,5,5
Nabi,M,100,0,5,5
Nabile,F,100,5,0,5
Nachaly,F,100,5,0,5
Nachel,F,100,5,0,5
Nachele,F,100,5,0,5
Nacirema,F,100,5,0,5
Nadaleigh,F,100,5,0,5
Nadalia,F,100,5,0,5
Nadar,M,100,0,5,5
Nadara,F,100,5,0,5
Nadasha,F,100,5,0,5
Nadie,F,100,5,0,5
Nadiv,M,100,0,5,5
Nadrea,F,100,5,0,5
Naeisha,F,100,5,0,5
Naeyli,F,100,5,0,5
Nafee,M,100,0,5,5
Nafiso,F,100,5,0,5
Nafissa,F,100,5,0,5
Nagela,F,100,5,0,5
Nahari,F,100,5,0,5
Nahel,M,100,0,5,5
Nahely,F,100,5,0,5
Nahide,F,100,5,0,5
Nahjay,F,100,5,0,5
Nahje,F,100,5,0,5
Nahrain,F,100,5,0,5
Nahyma,F,100,5,0,5
Naiana,F,100,5,0,5
Naiely,F,100,5,0,5
Naimo,F,100,5,0,5
Naiome,F,100,5,0,5
Nairy,F,100,5,0,5
Naisean,M,100,0,5,5
Naishaun,M,100,0,5,5
Naissa,F,100,5,0,5
Naithyn,M,100,0,5,5
Naiyanna,F,100,5,0,5
Naiym,M,100,0,5,5
Najala,F,100,5,0,5
Najam,M,100,0,5,5
Najelly,F,100,5,0,5
Najera,F,100,5,0,5
Najih,M,100,0,5,5
Najila,F,100,5,0,5
Najilah,F,100,5,0,5
Najirah,F,100,5,0,5
Najji,M,100,0,5,5
Najuan,M,100,0,5,5
Nakayia,F,100,5,0,5
Nakee,F,100,5,0,5
Nakeena,F,100,5,0,5
Nakel,F,100,5,0,5
Naketta,F,100,5,0,5
Nakevia,F,100,5,0,5
Nakeyta,F,100,5,0,5
Nakieya,F,100,5,0,5
Nakio,M,100,0,5,5
Nakiria,F,100,5,0,5
Nakish,F,100,5,0,5
Nakiyha,F,100,5,0,5
Nakiyla,F,100,5,0,5
Nalaiyah,F,100,5,0,5
Nalanee,F,100,5,0,5
Nalayiah,F,100,5,0,5
Naleea,F,100,5,0,5
Nalene,F,100,5,0,5
Nally,F,100,5,0,5
Nalyjah,F,100,5,0,5
Nalyn,F,100,5,0,5
Nalynn,F,100,5,0,5
Namath,M,100,0,5,5
Namaya,F,100,5,0,5
Nanaadwoa,F,100,5,0,5
Nancianne,F,100,5,0,5
Nandhan,M,100,0,5,5
Nandni,F,100,5,0,5
Naneka,F,100,5,0,5
Nanelle,F,100,5,0,5
Nanika,F,100,5,0,5
Nann,F,100,5,0,5
Nannett,F,100,5,0,5
Nanor,F,100,5,0,5
Naobi,F,100,5,0,5
Naohmi,F,100,5,0,5
Napat,M,100,0,5,5
Naquitta,F,100,5,0,5
Narae,F,100,5,0,5
Narasha,F,100,5,0,5
Narcisco,M,100,0,5,5
Narcisse,M,100,0,5,5
Narcizo,M,100,0,5,5
Nareli,F,100,5,0,5
Narell,M,100,0,5,5
Narielle,F,100,5,0,5
Nariman,F,100,5,0,5
Narquise,M,100,0,5,5
Naruto,M,100,0,5,5
Nasai,M,100,0,5,5
Nasar,M,100,0,5,5
Naseim,M,100,0,5,5
Nashaley,F,100,5,0,5
Nashally,F,100,5,0,5
Nashima,F,100,5,0,5
Nashlly,F,100,5,0,5
Nashmia,F,100,5,0,5
Nashrah,F,100,5,0,5
Nashyla,F,100,5,0,5
Nasiere,M,100,0,5,5
Nasrudin,M,100,0,5,5
Nassor,M,100,0,5,5
Nastazia,F,100,5,0,5
Nastia,F,100,5,0,5
Nataile,F,100,5,0,5
Natailia,F,100,5,0,5
Natalene,F,100,5,0,5
Nataliegh,F,100,5,0,5
Natalii,F,100,5,0,5
Natalis,F,100,5,0,5
Nataniah,F,100,5,0,5
Nataniela,F,100,5,0,5
Natarshia,F,100,5,0,5
Nataska,F,100,5,0,5
Natayja,F,100,5,0,5
Natayshia,F,100,5,0,5
Nateal,F,100,5,0,5
Natelege,F,100,5,0,5
Natelle,F,100,5,0,5
Naterra,F,100,5,0,5
Nateyah,F,100,5,0,5
Nathael,M,100,0,5,5
Nathain,M,100,0,5,5
Nathaniell,M,100,0,5,5
Nathanielle,M,100,0,5,5
Nathaya,F,100,5,0,5
Nathel,M,100,0,5,5
Naticha,F,100,5,0,5
Natileigh,F,100,5,0,5
Natorian,M,100,0,5,5
Natural,F,100,5,0,5
Naturell,F,100,5,0,5
Nau,M,100,0,5,5
Naul,M,100,0,5,5
Naura,F,100,5,0,5
Nautyca,F,100,5,0,5
Navaeha,F,100,5,0,5
Navan,M,100,0,5,5
Navario,M,100,0,5,5
Navarion,M,100,0,5,5
Navarius,M,100,0,5,5
Navay,F,100,5,0,5
Navdia,F,100,5,0,5
Nawar,F,100,5,0,5
Nawfal,M,100,0,5,5
Nayala,F,100,5,0,5
Nayalis,F,100,5,0,5
Nayami,F,100,5,0,5
Nayanah,F,100,5,0,5
Nayelys,F,100,5,0,5
Nayeri,F,100,5,0,5
Naylan,M,100,0,5,5
Naylie,F,100,5,0,5
Nayna,F,100,5,0,5
Nayona,F,100,5,0,5
Naysean,M,100,0,5,5
Naytasha,F,100,5,0,5
Nayvi,F,100,5,0,5
Nayvia,F,100,5,0,5
Nayya,F,100,5,0,5
Nayyirah,F,100,5,0,5
Nazarena,F,100,5,0,5
Nazaya,F,100,5,0,5
Nazhir,M,100,0,5,5
Nazih,M,100,0,5,5
Nazik,F,100,5,0,5
Nazmir,M,100,0,5,5
Nazneen,F,100,5,0,5
Nazr,M,100,0,5,5
Ncholas,M,100,0,5,5
Ncole,F,100,5,0,5
Ndey,F,100,5,0,5
Neajah,F,100,5,0,5
Neana,F,100,5,0,5
Neasa,F,100,5,0,5
Nebeyu,M,100,0,5,5
Nebil,M,100,0,5,5
Nebula,F,100,5,0,5
Nechemiah,M,100,0,5,5
Necko,M,100,0,5,5
Nedrick,M,100,0,5,5
Neelee,F,100,5,0,5
Neemah,F,100,5,0,5
Neeru,F,100,5,0,5
Nefateria,F,100,5,0,5
Nefeteria,F,100,5,0,5
Neghan,F,100,5,0,5
Nehki,M,100,0,5,5
Neicha,F,100,5,0,5
Neidelin,F,100,5,0,5
Neidelyn,F,100,5,0,5
Neilesh,M,100,0,5,5
Neili,F,100,5,0,5
Neilla,F,100,5,0,5
Neissa,F,100,5,0,5
Nekesia,F,100,5,0,5
Nekki,F,100,5,0,5
Nekol,F,100,5,0,5
Nekya,F,100,5,0,5
Nelba,F,100,5,0,5
Nelie,F,100,5,0,5
Nelita,F,100,5,0,5
Nelitza,F,100,5,0,5
Nellee,F,100,5,0,5
Nelliel,F,100,5,0,5
Nellwyn,F,100,5,0,5
Nelse,M,100,0,5,5
Nepoleon,M,100,0,5,5
Nequila,F,100,5,0,5
Nerely,F,100,5,0,5
Nerina,F,100,5,0,5
Neris,M,100,0,5,5
Neron,M,100,0,5,5
Nerva,F,100,5,0,5
Nerya,F,100,5,0,5
Nerys,F,100,5,0,5
Nesbit,M,100,0,5,5
Nesbitt,M,100,0,5,5
Nesby,M,100,0,5,5
Nesita,F,100,5,0,5
Nessie,F,100,5,0,5
Nestora,F,100,5,0,5
Nesya,F,100,5,0,5
Nethaniah,M,100,0,5,5
Netia,F,100,5,0,5
Nevach,F,100,5,0,5
Nevaehia,F,100,5,0,5
Nevaehtnes,F,100,5,0,5
Nevara,F,100,5,0,5
Nevil,M,100,0,5,5
Nevine,F,100,5,0,5
Ney,M,100,0,5,5
Neylah,F,100,5,0,5
Nezzie,F,100,5,0,5
Ngocanh,F,100,5,0,5
Ngozichukwu,F,100,5,0,5
Nha,M,100,0,5,5
Niaira,F,100,5,0,5
Niaje,F,100,5,0,5
Niakia,F,100,5,0,5
Niamarie,F,100,5,0,5
Nicara,F,100,5,0,5
Nicaya,F,100,5,0,5
Nicere,M,100,0,5,5
Nichaolas,M,100,0,5,5
Nichcole,F,100,5,0,5
Niche,F,100,5,0,5
Nichella,F,100,5,0,5
Nichet,F,100,5,0,5
Nicho,M,100,0,5,5
Nichoal,F,100,5,0,5
Nicholina,F,100,5,0,5
Niciah,F,100,5,0,5
Nicie,F,100,5,0,5
Nickcola,F,100,5,0,5
Nickhil,M,100,0,5,5
Nickloas,M,100,0,5,5
Nickohlas,M,100,0,5,5
Nickolie,M,100,0,5,5
Nickon,M,100,0,5,5
Nickyla,F,100,5,0,5
Nicoel,F,100,5,0,5
Nicoleann,F,100,5,0,5
Nicolete,F,100,5,0,5
Nicoly,F,100,5,0,5
Nicolyn,F,100,5,0,5
Nicomedes,M,100,0,5,5
Nicte,F,100,5,0,5
Nicteha,F,100,5,0,5
Nieja,F,100,5,0,5
Niekia,F,100,5,0,5
Nielsen,M,100,0,5,5
Niera,F,100,5,0,5
Nigee,M,100,0,5,5
Nigiel,M,100,0,5,5
Nihad,F,100,5,0,5
Nijiah,F,100,5,0,5
Nikara,F,100,5,0,5
Nikata,F,100,5,0,5
Nikayah,F,100,5,0,5
Nikaylah,F,100,5,0,5
Nikeea,F,100,5,0,5
Nikeem,M,100,0,5,5
Niketh,M,100,0,5,5
Nikeyia,F,100,5,0,5
Nikhaule,F,100,5,0,5
Nikhilesh,M,100,0,5,5
Nikitra,F,100,5,0,5
Nikkei,F,100,5,0,5
Nikkiah,F,100,5,0,5
Nikkiya,F,100,5,0,5
Nikkolai,M,100,0,5,5
Nikolia,M,100,0,5,5
Nikoma,F,100,5,0,5
Nilajah,F,100,5,0,5
Nilene,F,100,5,0,5
Nillie,F,100,5,0,5
Nilufar,F,100,5,0,5
Nilufer,F,100,5,0,5
Nilyn,F,100,5,0,5
Nimalan,M,100,0,5,5
Nimmy,F,100,5,0,5
Ninad,M,100,0,5,5
Ninasimone,F,100,5,0,5
Nincy,F,100,5,0,5
Ninia,F,100,5,0,5
Ninnette,F,100,5,0,5
Niola,F,100,5,0,5
Niosha,F,100,5,0,5
Niquel,F,100,5,0,5
Niquisha,F,100,5,0,5
Nirah,F,100,5,0,5
Niree,F,100,5,0,5
Nirek,M,100,0,5,5
Niriyah,F,100,5,0,5
Nirmeen,F,100,5,0,5
Nirva,F,100,5,0,5
Nisan,M,100,0,5,5
Nisean,M,100,0,5,5
Nishaun,M,100,0,5,5
Nishith,M,100,0,5,5
Nishon,M,100,0,5,5
Nissie,F,100,5,0,5
Nissy,F,100,5,0,5
Nitoya,F,100,5,0,5
Nitzy,F,100,5,0,5
Niurca,F,100,5,0,5
Nivetha,F,100,5,0,5
Nivin,M,100,0,5,5
Nixmary,F,100,5,0,5
Niyat,F,100,5,0,5
Niyel,F,100,5,0,5
Niyeli,F,100,5,0,5
Niyia,F,100,5,0,5
Niyon,M,100,0,5,5
Nizam,M,100,0,5,5
Nizear,M,100,0,5,5
Nizeria,F,100,5,0,5
Nkao,F,100,5,0,5
Nkara,F,100,5,0,5
Nkayla,F,100,5,0,5
Nkem,F,100,5,0,5
Nkemjika,M,100,0,5,5
Nkiyah,F,100,5,0,5
Nnanna,M,100,0,5,5
Noelany,F,100,5,0,5
Noelli,F,100,5,0,5
Noema,F,100,5,0,5
Nohelly,F,100,5,0,5
Nokia,F,100,5,0,5
Noleen,F,100,5,0,5
Nolton,M,100,0,5,5
Nonah,F,100,5,0,5
Nonda,F,100,5,0,5
Nong,M,100,0,5,5
Nonia,F,100,5,0,5
Noorhan,F,100,5,0,5
Nooria,F,100,5,0,5
Nooriya,F,100,5,0,5
Noorjahan,F,100,5,0,5
Noraleigh,F,100,5,0,5
Noralie,F,100,5,0,5
Noralva,F,100,5,0,5
Noranne,F,100,5,0,5
Norb,M,100,0,5,5
Norelia,F,100,5,0,5
Norelys,F,100,5,0,5
Noren,M,100,0,5,5
Noretha,F,100,5,0,5
Norian,M,100,0,5,5
Norika,F,100,5,0,5
Norland,M,100,0,5,5
Norlin,M,100,0,5,5
Normen,M,100,0,5,5
Normie,F,100,5,0,5
Norra,F,100,5,0,5
Norrah,F,100,5,0,5
Norrell,M,100,0,5,5
Norri,F,100,5,0,5
Northern,M,100,0,5,5
Norvelle,M,100,0,5,5
Norwin,M,100,0,5,5
Nosakhare,M,100,0,5,5
Noslen,M,100,0,5,5
Nouha,F,100,5,0,5
Nouvelle,F,100,5,0,5
Novis,F,100,5,0,5
Nowa,M,100,0,5,5
Nowah,M,100,0,5,5
Nthan,M,100,0,5,5
Nuradin,M,100,0,5,5
Nuran,F,100,5,0,5
Nurani,M,100,0,5,5
Nuray,F,100,5,0,5
Nuraz,M,100,0,5,5
Nureen,F,100,5,0,5
Nurit,F,100,5,0,5
Nuru,M,100,0,5,5
Nwamaka,F,100,5,0,5
Nyagoa,F,100,5,0,5
Nyahlee,F,100,5,0,5
Nyaijah,F,100,5,0,5
Nyailah,F,100,5,0,5
Nyajiah,F,100,5,0,5
Nyarai,F,100,5,0,5
Nyaziah,F,100,5,0,5
Nycia,F,100,5,0,5
Nyckolas,M,100,0,5,5
Nyda,F,100,5,0,5
Nydaisha,F,100,5,0,5
Nyderah,F,100,5,0,5
Nydir,M,100,0,5,5
Nyeasia,F,100,5,0,5
Nyeim,M,100,0,5,5
Nyeka,F,100,5,0,5
Nyele,F,100,5,0,5
Nyemia,F,100,5,0,5
Nyemiah,F,100,5,0,5
Nyhiem,M,100,0,5,5
Nyiana,F,100,5,0,5
Nykeesha,F,100,5,0,5
Nykeya,F,100,5,0,5
Nykiria,F,100,5,0,5
Nylae,F,100,5,0,5
Nylajah,F,100,5,0,5
Nyleve,F,100,5,0,5
Nymeria,F,100,5,0,5
Nyomee,F,100,5,0,5
Nyosha,F,100,5,0,5
Nyran,M,100,0,5,5
Nyrek,M,100,0,5,5
Nyrissa,F,100,5,0,5
Nyshae,F,100,5,0,5
Nyshay,F,100,5,0,5
Nyshon,M,100,0,5,5
Nyson,M,100,0,5,5
Nytavious,M,100,0,5,5
Nytrell,M,100,0,5,5
Nyvia,F,100,5,0,5
Nyzeth,F,100,5,0,5
Oakie,M,100,0,5,5
Obafemi,M,100,0,5,5
Obasi,M,100,0,5,5
Obehi,F,100,5,0,5
Obey,M,100,0,5,5
Obrain,M,100,0,5,5
Obsidian,M,100,0,5,5
Ocasio,M,100,0,5,5
Octaviana,F,100,5,0,5
Octavus,M,100,0,5,5
Odete,F,100,5,0,5
Odila,F,100,5,0,5
Oel,M,100,0,5,5
Oen,M,100,0,5,5
Oesha,F,100,5,0,5
Ogheneruno,M,100,0,5,5
Oghenetega,M,100,0,5,5
Oghosa,F,100,5,0,5
Ogle,M,100,0,5,5
Ogochukwu,F,100,5,0,5
Oguz,M,100,0,5,5
Oh,M,100,0,5,5
Ohan,M,100,0,5,5
Ohitika,M,100,0,5,5
Ohlin,M,100,0,5,5
Okairy,F,100,5,0,5
Okeema,F,100,5,0,5
Okeima,F,100,5,0,5
Okie,M,100,0,5,5
Okpara,M,100,0,5,5
Olabisi,F,100,5,0,5
Olabode,M,100,0,5,5
Oladele,M,100,0,5,5
Oladipo,M,100,0,5,5
Oladipupo,M,100,0,5,5
Oladis,F,100,5,0,5
Olamilekan,M,100,0,5,5
Olasunkanmi,M,100,0,5,5
Olav,M,100,0,5,5
Olbin,M,100,0,5,5
Oldair,M,100,0,5,5
Oleksiy,M,100,0,5,5
Olesha,F,100,5,0,5
Olethea,F,100,5,0,5
Olexus,F,100,5,0,5
Olianna,F,100,5,0,5
Olibia,F,100,5,0,5
Olivet,F,100,5,0,5
Olivija,F,100,5,0,5
Olivyah,F,100,5,0,5
Ollice,M,100,0,5,5
Olly,M,100,0,5,5
Olney,M,100,0,5,5
Olon,M,100,0,5,5
Olumuyiwa,M,100,0,5,5
Oluremi,F,100,5,0,5
Oluseun,M,100,0,5,5
Olutoyin,F,100,5,0,5
Oluwabukola,F,100,5,0,5
Oluwabusola,F,100,5,0,5
Oluwadabira,F,100,5,0,5
Oluwadunmininu,F,100,5,0,5
Oluwafisayo,F,100,5,0,5
Oluwafolahanmi,M,100,0,5,5
Oluwafolajimi,M,100,0,5,5
Oluwafunmilola,F,100,5,0,5
Oluwajoba,M,100,0,5,5
Oluwakayode,M,100,0,5,5
Oluwakorede,M,100,0,5,5
Oluwalonimi,F,100,5,0,5
Oluwamayomikun,M,100,0,5,5
Oluwatomilola,F,100,5,0,5
Oluwatoyosi,F,100,5,0,5
Oluwatumininu,F,100,5,0,5
Oluwayemisi,F,100,5,0,5
Oluyemi,M,100,0,5,5
Omarah,F,100,5,0,5
Omarionna,F,100,5,0,5
Omaru,M,100,0,5,5
Omary,M,100,0,5,5
Omaryon,M,100,0,5,5
Omed,M,100,0,5,5
Omeisha,F,100,5,0,5
Omeria,F,100,5,0,5
Omika,F,100,5,0,5
Omiya,F,100,5,0,5
Omon,M,100,0,5,5
Omorion,M,100,0,5,5
Onald,M,100,0,5,5
Onaya,F,100,5,0,5
Ondreya,F,100,5,0,5
Onnaleigh,F,100,5,0,5
Onorio,M,100,0,5,5
Ontaria,F,100,5,0,5
Onyka,F,100,5,0,5
Opaline,F,100,5,0,5
Optimus,M,100,0,5,5
Orantes,M,100,0,5,5
Orben,M,100,0,5,5
Ordan,M,100,0,5,5
Ordie,M,100,0,5,5
Orenthia,M,100,0,5,5
Orianne,F,100,5,0,5
Orise,M,100,0,5,5
Oriyana,F,100,5,0,5
Orlenda,F,100,5,0,5
Ornie,M,100,0,5,5
Orpah,F,100,5,0,5
Orrey,M,100,0,5,5
Orryn,M,100,0,5,5
Orsen,M,100,0,5,5
Orton,M,100,0,5,5
Orvan,M,100,0,5,5
Orvella,F,100,5,0,5
Orvetta,F,100,5,0,5
Orvill,M,100,0,5,5
Orya,F,100,5,0,5
Osanna,F,100,5,0,5
Oscardaniel,M,100,0,5,5
Oscarjr,M,100,0,5,5
Osciel,M,100,0,5,5
Ose,M,100,0,5,5
Osean,M,100,0,5,5
Oshanique,F,100,5,0,5
Oshanna,F,100,5,0,5
Oshun,F,100,5,0,5
Osia,F,100,5,0,5
Osiana,F,100,5,0,5
Osmon,M,100,0,5,5
Osnas,F,100,5,0,5
Ostap,M,100,0,5,5
Ostara,F,100,5,0,5
Osteen,M,100,0,5,5
Osyrus,M,100,0,5,5
Otavious,M,100,0,5,5
Otman,M,100,0,5,5
Ouinton,M,100,0,5,5
Ourtney,F,100,5,0,5
Ovee,F,100,5,0,5
Owetta,F,100,5,0,5
Ozara,F,100,5,0,5
Ozetta,F,100,5,0,5
Ozion,M,100,0,5,5
Ozkar,M,100,0,5,5
Packard,M,100,0,5,5
Pada,F,100,5,0,5
Padgett,F,100,5,0,5
Padmini,F,100,5,0,5
Padon,M,100,0,5,5
Padriac,M,100,0,5,5
Padrick,M,100,0,5,5
Padro,M,100,0,5,5
Padyn,F,100,5,0,5
Paeten,F,100,5,0,5
Paetin,F,100,5,0,5
Pageant,F,100,5,0,5
Pagen,F,100,5,0,5
Paig,F,100,5,0,5
Paili,F,100,5,0,5
Paisha,F,100,5,0,5
Pamalia,F,100,5,0,5
Pamalla,F,100,5,0,5
Pamara,F,100,5,0,5
Pameal,F,100,5,0,5
Pamilyn,F,100,5,0,5
Pamlia,F,100,5,0,5
Pamlyn,F,100,5,0,5
Pamma,F,100,5,0,5
Pammi,F,100,5,0,5
Panayotis,M,100,0,5,5
Panchita,F,100,5,0,5
Pandi,F,100,5,0,5
Pandoria,F,100,5,0,5
Pandra,F,100,5,0,5
Panela,F,100,5,0,5
Panth,M,100,0,5,5
Pany,F,100,5,0,5
Panyia,F,100,5,0,5
Paradyce,F,100,5,0,5
Paraskevas,M,100,0,5,5
Pardis,F,100,5,0,5
Parick,M,100,0,5,5
Parise,F,100,5,0,5
Parishay,F,100,5,0,5
Parita,F,100,5,0,5
Parleen,F,100,5,0,5
Parma,F,100,5,0,5
Parmanand,M,100,0,5,5
Parmeet,M,100,0,5,5
Parri,F,100,5,0,5
Parrie,F,100,5,0,5
Parvathi,F,100,5,0,5
Parvina,F,100,5,0,5
Parx,M,100,0,5,5
Pashience,F,100,5,0,5
Pashyn,F,100,5,0,5
Pasley,F,100,5,0,5
Pasqua,F,100,5,0,5
Pasquinel,M,100,0,5,5
Passionae,F,100,5,0,5
Passionate,F,100,5,0,5
Patch,M,100,0,5,5
Patrichia,F,100,5,0,5
Patriciaanne,F,100,5,0,5
Patrician,F,100,5,0,5
Patrickjoseph,M,100,0,5,5
Patrisa,F,100,5,0,5
Patrisio,M,100,0,5,5
Patrizio,M,100,0,5,5
Paty,F,100,5,0,5
Patyn,F,100,5,0,5
Paulean,F,100,5,0,5
Paulinda,F,100,5,0,5
Paull,M,100,0,5,5
Paullina,F,100,5,0,5
Paulyn,F,100,5,0,5
Paulyna,F,100,5,0,5
Pavelle,F,100,5,0,5
Pavin,M,100,0,5,5
Pavlina,F,100,5,0,5
Pavly,M,100,0,5,5
Pavneet,F,100,5,0,5
Pavni,F,100,5,0,5
Paxston,M,100,0,5,5
Paycie,F,100,5,0,5
Payman,M,100,0,5,5
Paytten,F,100,5,0,5
Pazley,F,100,5,0,5
Pearletha,F,100,5,0,5
Pedrojr,M,100,0,5,5
Pedrum,M,100,0,5,5
Pejman,M,100,0,5,5
Pelagia,F,100,5,0,5
Pellegrino,M,100,0,5,5
Pemela,F,100,5,0,5
Pene,F,100,5,0,5
Penella,F,100,5,0,5
Penelopea,F,100,5,0,5
Pennyann,F,100,5,0,5
Peola,F,100,5,0,5
Percel,M,100,0,5,5
Percious,F,100,5,0,5
Peregrina,F,100,5,0,5
Perfect,F,100,5,0,5
Peria,F,100,5,0,5
Perianne,F,100,5,0,5
Pernetta,F,100,5,0,5
Peron,M,100,0,5,5
Perrier,M,100,0,5,5
Persaya,F,100,5,0,5
Perscilla,F,100,5,0,5
Persey,M,100,0,5,5
Personna,F,100,5,0,5
Pertrina,F,100,5,0,5
Peshy,F,100,5,0,5
Pessi,F,100,5,0,5
Peteris,M,100,0,5,5
Petite,F,100,5,0,5
Petre,M,100,0,5,5
Petrick,M,100,0,5,5
Petrit,M,100,0,5,5
Petronila,F,100,5,0,5
Petrus,M,100,0,5,5
Petunia,F,100,5,0,5
Petyon,F,100,5,0,5
Peytonn,F,100,5,0,5
Phalicia,F,100,5,0,5
Phallen,F,100,5,0,5
Phalynn,F,100,5,0,5
Pharren,F,100,5,0,5
Pharyn,F,100,5,0,5
Phawn,F,100,5,0,5
Phazon,M,100,0,5,5
Phebee,F,100,5,0,5
Phebie,F,100,5,0,5
Phia,F,100,5,0,5
Phila,F,100,5,0,5
Philips,M,100,0,5,5
Philistine,F,100,5,0,5
Philix,M,100,0,5,5
Phillistine,F,100,5,0,5
Philly,M,100,0,5,5
Philmon,M,100,0,5,5
Philp,M,100,0,5,5
Philson,M,100,0,5,5
Phin,M,100,0,5,5
Phoebi,F,100,5,0,5
Phonesavanh,F,100,5,0,5
Phoung,F,100,5,0,5
Phuonganh,F,100,5,0,5
Phylisia,F,100,5,0,5
Picabo,F,100,5,0,5
Pierston,M,100,0,5,5
Piilani,F,100,5,0,5
Pixley,F,100,5,0,5
Placida,F,100,5,0,5
Platinum,F,100,5,0,5
Plinio,M,100,0,5,5
Plum,F,100,5,0,5
Pluma,F,100,5,0,5
Plutarco,M,100,0,5,5
Po,M,100,0,5,5
Poetri,F,100,5,0,5
Pol,M,100,0,5,5
Polaris,F,100,5,0,5
Policarpio,M,100,0,5,5
Polixeni,F,100,5,0,5
Polk,M,100,0,5,5
Pomposo,M,100,0,5,5
Poncho,M,100,0,5,5
Pondra,F,100,5,0,5
Poojan,M,100,0,5,5
Poorna,F,100,5,0,5
Pooya,M,100,0,5,5
Porsia,F,100,5,0,5
Portlyn,F,100,5,0,5
Portlynn,F,100,5,0,5
Pota,F,100,5,0,5
Potter,F,100,5,0,5
Prabhas,M,100,0,5,5
Prabin,M,100,0,5,5
Prabjot,M,100,0,5,5
Pracilla,F,100,5,0,5
Pradhyun,M,100,0,5,5
Pragathi,F,100,5,0,5
Praharsh,M,100,0,5,5
Prajin,M,100,0,5,5
Prakrit,M,100,0,5,5
Prakruti,F,100,5,0,5
Pramit,M,100,0,5,5
Pranil,M,100,0,5,5
Pranitha,F,100,5,0,5
Prasad,M,100,0,5,5
Pratyusha,F,100,5,0,5
Pravallika,F,100,5,0,5
Praveer,M,100,0,5,5
Praxedis,M,100,0,5,5
Prayash,M,100,0,5,5
Praylee,F,100,5,0,5
Preana,F,100,5,0,5
Preciliano,M,100,0,5,5
Preciousa,F,100,5,0,5
Precius,F,100,5,0,5
Precyous,F,100,5,0,5
Predrag,M,100,0,5,5
Preetam,M,100,0,5,5
Premier,M,100,0,5,5
Premiere,M,100,0,5,5
Prenella,F,100,5,0,5
Prenisha,F,100,5,0,5
Presiliano,M,100,0,5,5
Presilla,F,100,5,0,5
Prestine,F,100,5,0,5
Priansh,M,100,0,5,5
Pricsila,F,100,5,0,5
Priella,F,100,5,0,5
Princecharles,M,100,0,5,5
Princeten,M,100,0,5,5
Princewilliam,M,100,0,5,5
Princilla,F,100,5,0,5
Printess,M,100,0,5,5
Priyank,M,100,0,5,5
Promyss,F,100,5,0,5
Prospero,M,100,0,5,5
Prudance,F,100,5,0,5
Prutha,F,100,5,0,5
Prynn,F,100,5,0,5
Puaolena,F,100,5,0,5
Purab,M,100,0,5,5
Purnima,F,100,5,0,5
Purpose,F,100,5,0,5
Pypper,F,100,5,0,5
Qadeera,F,100,5,0,5
Qaiden,M,100,0,5,5
Qiarah,F,100,5,0,5
Qierra,F,100,5,0,5
Qing,F,100,5,0,5
Qiuana,F,100,5,0,5
Quacy,M,100,0,5,5
Quadarrious,M,100,0,5,5
Quadeshia,F,100,5,0,5
Quadier,M,100,0,5,5
Quadreka,F,100,5,0,5
Quaheem,M,100,0,5,5
Qualesha,F,100,5,0,5
Quameek,M,100,0,5,5
Quameir,M,100,0,5,5
Quamine,M,100,0,5,5
Quamire,M,100,0,5,5
Quamon,M,100,0,5,5
Quamya,F,100,5,0,5
Quanaisha,F,100,5,0,5
Quandarrius,M,100,0,5,5
Quaneeka,F,100,5,0,5
Quanessa,F,100,5,0,5
Quanetra,F,100,5,0,5
Quanice,F,100,5,0,5
Quanicia,F,100,5,0,5
Quanise,F,100,5,0,5
Quanishia,F,100,5,0,5
Quannah,F,100,5,0,5
Quannell,M,100,0,5,5
Quantasha,F,100,5,0,5
Quantiana,F,100,5,0,5
Quantis,M,100,0,5,5
Quantrez,M,100,0,5,5
Quanya,F,100,5,0,5
Quanza,F,100,5,0,5
Quanzell,M,100,0,5,5
Quanzie,M,100,0,5,5
Quartey,M,100,0,5,5
Quartterio,M,100,0,5,5
Quashan,M,100,0,5,5
Quashanda,F,100,5,0,5
Quashanna,F,100,5,0,5
Quasheema,F,100,5,0,5
Quatashia,F,100,5,0,5
Quaterius,M,100,0,5,5
Quaterrius,M,100,0,5,5
Quatravious,M,100,0,5,5
Quatrina,F,100,5,0,5
Quavius,M,100,0,5,5
Quaylan,M,100,0,5,5
Quazar,M,100,0,5,5
Quazi,M,100,0,5,5
Qubilah,F,100,5,0,5
Queency,F,100,5,0,5
Quendarious,M,100,0,5,5
Queneisha,F,100,5,0,5
Queneshia,F,100,5,0,5
Quenette,F,100,5,0,5
Quennell,M,100,0,5,5
Quentavia,F,100,5,0,5
Queren,F,100,5,0,5
Quesean,M,100,0,5,5
Quesha,F,100,5,0,5
Queshaun,M,100,0,5,5
Queshon,M,100,0,5,5
Quetzy,F,100,5,0,5
Quiandra,F,100,5,0,5
Quillon,M,100,0,5,5
Quimora,F,100,5,0,5
Quinaya,F,100,5,0,5
Quincella,F,100,5,0,5
Quineka,F,100,5,0,5
Quinessa,F,100,5,0,5
Quinleigh,F,100,5,0,5
Quinnel,M,100,0,5,5
Quinnell,M,100,0,5,5
Quinneshia,F,100,5,0,5
Quinnette,F,100,5,0,5
Quinnita,F,100,5,0,5
Quinnlee,F,100,5,0,5
Quinnshawn,M,100,0,5,5
Quinshon,M,100,0,5,5
Quintae,M,100,0,5,5
Quintashia,F,100,5,0,5
Quintesa,F,100,5,0,5
Quintine,M,100,0,5,5
Quintion,M,100,0,5,5
Quiriat,F,100,5,0,5
Quitin,M,100,0,5,5
Qujuan,M,100,0,5,5
Quora,F,100,5,0,5
Quortney,F,100,5,0,5
Quwan,M,100,0,5,5
Quynton,M,100,0,5,5
Qwen,M,100,0,5,5
Qwintin,M,100,0,5,5
Qynn,F,100,5,0,5
Raaed,M,100,0,5,5
Raahul,M,100,0,5,5
Raaid,M,100,0,5,5
Raana,F,100,5,0,5
Raashan,M,100,0,5,5
Raaziq,M,100,0,5,5
Rabekka,F,100,5,0,5
Rabihah,F,100,5,0,5
Rabun,M,100,0,5,5
Racelyn,F,100,5,0,5
Racen,M,100,0,5,5
Racey,F,100,5,0,5
Rachelleann,F,100,5,0,5
Rachelleanne,F,100,5,0,5
Rachely,F,100,5,0,5
Rachita,F,100,5,0,5
Rachmiel,M,100,0,5,5
Rachon,F,100,5,0,5
Racin,M,100,0,5,5
Rackel,F,100,5,0,5
Racqual,F,100,5,0,5
Radame,M,100,0,5,5
Radamel,M,100,0,5,5
Radee,M,100,0,5,5
Radeen,M,100,0,5,5
Rader,M,100,0,5,5
Radie,F,100,5,0,5
Radoika,F,100,5,0,5
Radoslav,M,100,0,5,5
Raeanah,F,100,5,0,5
Raedon,M,100,0,5,5
Raelah,F,100,5,0,5
Raelean,F,100,5,0,5
Raeliegh,F,100,5,0,5
Raemarie,F,100,5,0,5
Raemona,F,100,5,0,5
Raenada,F,100,5,0,5
Raenae,F,100,5,0,5
Raene,F,100,5,0,5
Raeniyah,F,100,5,0,5
Raeona,F,100,5,0,5
Raequel,F,100,5,0,5
Raeyana,F,100,5,0,5
Raeyanna,F,100,5,0,5
Rafee,M,100,0,5,5
Rafeek,M,100,0,5,5
Raffie,M,100,0,5,5
Raffiel,M,100,0,5,5
Raffy,M,100,0,5,5
Rafhael,M,100,0,5,5
Ragav,M,100,0,5,5
Ragenia,F,100,5,0,5
Raghavi,F,100,5,0,5
Rahasia,F,100,5,0,5
Rahjae,F,100,5,0,5
Rahkia,F,100,5,0,5
Rahmi,M,100,0,5,5
Rahmin,M,100,0,5,5
Rahna,F,100,5,0,5
Rahnasia,F,100,5,0,5
Rahshida,F,100,5,0,5
Raian,M,100,0,5,5
Raihaan,M,100,0,5,5
Raihaanah,F,100,5,0,5
Raika,F,100,5,0,5
Raileen,F,100,5,0,5
Railynne,F,100,5,0,5
Rainne,F,100,5,0,5
Raiqa,F,100,5,0,5
Rais,M,100,0,5,5
Raiyana,F,100,5,0,5
Rajani,F,100,5,0,5
Rajen,M,100,0,5,5
Rajkumar,M,100,0,5,5
Rakai,M,100,0,5,5
Rakee,M,100,0,5,5
Rakiesha,F,100,5,0,5
Rakshitha,F,100,5,0,5
Raksmey,F,100,5,0,5
Raleen,F,100,5,0,5
Ralon,M,100,0,5,5
Ralphell,M,100,0,5,5
Ramada,F,100,5,0,5
Ramatoulie,F,100,5,0,5
Ramatu,F,100,5,0,5
Rameel,M,100,0,5,5
Rameisha,F,100,5,0,5
Ramik,M,100,0,5,5
Ramoan,M,100,0,5,5
Ramsen,M,100,0,5,5
Ramsi,F,100,5,0,5
Ramson,M,100,0,5,5
Ramsy,M,100,0,5,5
Ramzes,M,100,0,5,5
Ramzie,F,100,5,0,5
Ranaa,F,100,5,0,5
Randalle,F,100,5,0,5
Randalynn,F,100,5,0,5
Randeen,F,100,5,0,5
Randeisha,F,100,5,0,5
Randene,F,100,5,0,5
Randesha,F,100,5,0,5
Randin,M,100,0,5,5
Randll,M,100,0,5,5
Randolfo,M,100,0,5,5
Ranecia,F,100,5,0,5
Ranjana,F,100,5,0,5
Ranndy,M,100,0,5,5
Ransen,M,100,0,5,5
Ranvijay,M,100,0,5,5
Ranylah,F,100,5,0,5
Ranzino,M,100,0,5,5
Ranzy,M,100,0,5,5
Raoof,M,100,0,5,5
Raqeeb,M,100,0,5,5
Raquael,F,100,5,0,5
Raquane,M,100,0,5,5
Raquia,F,100,5,0,5
Raquisha,F,100,5,0,5
Raschad,M,100,0,5,5
Rashade,M,100,0,5,5
Rashand,M,100,0,5,5
Rasheba,F,100,5,0,5
Rasheedat,F,100,5,0,5
Rasheeka,F,100,5,0,5
Rashene,M,100,0,5,5
Rashieka,F,100,5,0,5
Rashik,M,100,0,5,5
Rashim,M,100,0,5,5
Rashodd,M,100,0,5,5
Rashondra,F,100,5,0,5
Rasiyah,F,100,5,0,5
Rasmine,F,100,5,0,5
Rasun,M,100,0,5,5
Ratan,M,100,0,5,5
Ratesha,F,100,5,0,5
Rathany,F,100,5,0,5
Rauf,M,100,0,5,5
Raulie,M,100,0,5,5
Rauljr,M,100,0,5,5
Raunda,F,100,5,0,5
Raushaun,M,100,0,5,5
Rava,F,100,5,0,5
Ravien,F,100,5,0,5
Ravine,F,100,5,0,5
Ravonne,F,100,5,0,5
Ravy,M,100,0,5,5
Ravya,F,100,5,0,5
Rawa,F,100,5,0,5
Rawland,M,100,0,5,5
Raychael,F,100,5,0,5
Raycin,M,100,0,5,5
Raycine,F,100,5,0,5
Rayda,F,100,5,0,5
Rayea,F,100,5,0,5
Rayeanna,F,100,5,0,5
Rayegan,F,100,5,0,5
Rayfe,M,100,0,5,5
Raygine,F,100,5,0,5
Rayha,F,100,5,0,5
Rayhona,F,100,5,0,5
Raylah,F,100,5,0,5
Raylean,F,100,5,0,5
Raylend,M,100,0,5,5
Raylenn,F,100,5,0,5
Raymand,M,100,0,5,5
Raymeir,M,100,0,5,5
Raymesha,F,100,5,0,5
Raymiah,F,100,5,0,5
Raymoni,F,100,5,0,5
Raynae,F,100,5,0,5
Raynne,F,100,5,0,5
Rayonah,F,100,5,0,5
Rayonda,F,100,5,0,5
Rayonia,F,100,5,0,5
Rayquann,M,100,0,5,5
Rayshawnda,F,100,5,0,5
Rayshone,M,100,0,5,5
Raytheon,M,100,0,5,5
Rayva,F,100,5,0,5
Rayvyn,F,100,5,0,5
Razariah,F,100,5,0,5
Razel,F,100,5,0,5
Razhane,F,100,5,0,5
Razin,M,100,0,5,5
Rb,M,100,0,5,5
Rbecca,F,100,5,0,5
Rd,M,100,0,5,5
Reaford,M,100,0,5,5
Realyn,F,100,5,0,5
Rean,F,100,5,0,5
Reanda,F,100,5,0,5
Reberta,F,100,5,0,5
Rebie,F,100,5,0,5
Reche,M,100,0,5,5
Rechele,F,100,5,0,5
Rechetta,F,100,5,0,5
Recina,F,100,5,0,5
Rederick,M,100,0,5,5
Redith,F,100,5,0,5
Redwan,M,100,0,5,5
Reeana,F,100,5,0,5
Reeyan,M,100,0,5,5
Rege,M,100,0,5,5
Reggan,F,100,5,0,5
Reginamarie,F,100,5,0,5
Reginea,F,100,5,0,5
Reginique,F,100,5,0,5
Regnold,M,100,0,5,5
Rehmat,F,100,5,0,5
Reicher,M,100,0,5,5
Reidar,M,100,0,5,5
Reinald,M,100,0,5,5
Reinaliz,F,100,5,0,5
Reinardo,M,100,0,5,5
Reinna,F,100,5,0,5
Reiny,F,100,5,0,5
Reion,M,100,0,5,5
Reitha,F,100,5,0,5
Reiya,F,100,5,0,5
Rejanae,F,100,5,0,5
Rejeania,F,100,5,0,5
Rejetta,F,100,5,0,5
Rejine,F,100,5,0,5
Rekayla,F,100,5,0,5
Rela,F,100,5,0,5
Relic,M,100,0,5,5
Relynn,F,100,5,0,5
Rem,M,100,0,5,5
Rember,M,100,0,5,5
Remeka,F,100,5,0,5
Remel,F,100,5,0,5
Remelda,F,100,5,0,5
Remia,F,100,5,0,5
Remika,F,100,5,0,5
Renado,M,100,0,5,5
Renasha,F,100,5,0,5
Renauldo,M,100,0,5,5
Renegade,M,100,0,5,5
Reney,M,100,0,5,5
Renezme,F,100,5,0,5
Renfred,M,100,0,5,5
Renick,M,100,0,5,5
Renida,F,100,5,0,5
Reniece,F,100,5,0,5
Reniel,M,100,0,5,5
Renitha,F,100,5,0,5
Renitia,F,100,5,0,5
Rennan,M,100,0,5,5
Rennis,M,100,0,5,5
Reshae,F,100,5,0,5
Resham,F,100,5,0,5
Reshana,F,100,5,0,5
Reshaunda,F,100,5,0,5
Resheka,F,100,5,0,5
Reshia,F,100,5,0,5
Reshmi,F,100,5,0,5
Reshod,M,100,0,5,5
Resia,F,100,5,0,5
Retag,F,100,5,0,5
Rether,F,100,5,0,5
Retonya,F,100,5,0,5
Reus,M,100,0,5,5
Reut,F,100,5,0,5
Rev,M,100,0,5,5
Revati,F,100,5,0,5
Revea,F,100,5,0,5
Revelation,M,100,0,5,5
Revella,F,100,5,0,5
Rexie,M,100,0,5,5
Reyd,M,100,0,5,5
Reydon,M,100,0,5,5
Reyelle,F,100,5,0,5
Reymi,M,100,0,5,5
Reyner,M,100,0,5,5
Reyyan,F,100,5,0,5
Rezon,M,100,0,5,5
Rhaheem,M,100,0,5,5
Rhamir,M,100,0,5,5
Rhana,F,100,5,0,5
Rhanada,F,100,5,0,5
Rhavyn,F,100,5,0,5
Rheaann,F,100,5,0,5
Rheanon,F,100,5,0,5
Rheese,F,100,5,0,5
Rheia,F,100,5,0,5
Rheuben,M,100,0,5,5
Rheyanna,F,100,5,0,5
Rhiane,F,100,5,0,5
Rhileigh,F,100,5,0,5
Rhinda,F,100,5,0,5
Rhnea,F,100,5,0,5
Rhoads,M,100,0,5,5
Rhochelle,F,100,5,0,5
Rhode,F,100,5,0,5
Rhodella,F,100,5,0,5
Rhodena,F,100,5,0,5
Rhodonna,F,100,5,0,5
Rhoman,M,100,0,5,5
Rhond,F,100,5,0,5
Rhye,M,100,0,5,5
Rhyin,F,100,5,0,5
Rhylon,M,100,0,5,5
Rhyson,M,100,0,5,5
Rianon,F,100,5,0,5
Rianshi,F,100,5,0,5
Ribhi,M,100,0,5,5
Ricado,M,100,0,5,5
Ricari,M,100,0,5,5
Ricaria,F,100,5,0,5
Richaad,M,100,0,5,5
Richana,F,100,5,0,5
Richardjames,M,100,0,5,5
Richette,F,100,5,0,5
Richia,F,100,5,0,5
Richman,M,100,0,5,5
Rickeem,M,100,0,5,5
Rickeeta,F,100,5,0,5
Rickiesha,F,100,5,0,5
Rickki,F,100,5,0,5
Ricks,M,100,0,5,5
Rickyia,F,100,5,0,5
Rickyy,M,100,0,5,5
Ricquita,F,100,5,0,5
Rictavious,M,100,0,5,5
Rictoria,F,100,5,0,5
Riddic,M,100,0,5,5
Ridger,M,100,0,5,5
Ridlee,F,100,5,0,5
Ridwaan,M,100,0,5,5
Rieleigh,F,100,5,0,5
Rielley,F,100,5,0,5
Rieta,F,100,5,0,5
Righley,F,100,5,0,5
Rihab,F,100,5,0,5
Rihansh,M,100,0,5,5
Rikeisha,F,100,5,0,5
Rikelme,M,100,0,5,5
Riketa,F,100,5,0,5
Rikhia,F,100,5,0,5
Rikiah,F,100,5,0,5
Rikkilynn,F,100,5,0,5
Rikku,F,100,5,0,5
Rikky,M,100,0,5,5
Rikyah,F,100,5,0,5
Rilah,F,100,5,0,5
Riloh,F,100,5,0,5
Rinesa,F,100,5,0,5
Rinesha,F,100,5,0,5
Rinor,M,100,0,5,5
Rinya,F,100,5,0,5
Ripal,M,100,0,5,5
Ripsi,F,100,5,0,5
Rishaun,M,100,0,5,5
Ristin,F,100,5,0,5
Ritchy,M,100,0,5,5
Rith,M,100,0,5,5
Rithanya,F,100,5,0,5
Rithi,F,100,5,0,5
Rithu,F,100,5,0,5
Ritney,F,100,5,0,5
Rittal,F,100,5,0,5
Ritzy,F,100,5,0,5
Riuka,F,100,5,0,5
Riverlyn,F,100,5,0,5
Rix,M,100,0,5,5
Riyann,F,100,5,0,5
Riyaq,F,100,5,0,5
Rizal,M,100,0,5,5
Rizelle,F,100,5,0,5
Rmonie,F,100,5,0,5
Ro,F,100,5,0,5
Roandy,M,100,0,5,5
Roarie,F,100,5,0,5
Robbins,M,100,0,5,5
Robere,M,100,0,5,5
Roberick,M,100,0,5,5
Robertcharles,M,100,0,5,5
Roberte,M,100,0,5,5
Robinetta,F,100,5,0,5
Robinho,M,100,0,5,5
Robney,M,100,0,5,5
Robrick,M,100,0,5,5
Robt,M,100,0,5,5
Rochan,F,100,5,0,5
Rochard,M,100,0,5,5
Rochelly,F,100,5,0,5
Rocker,M,100,0,5,5
Rocki,M,100,0,5,5
Rockson,M,100,0,5,5
Rodaina,F,100,5,0,5
Rodaisha,F,100,5,0,5
Rodericus,M,100,0,5,5
Roderiquez,M,100,0,5,5
Rodick,M,100,0,5,5
Rodley,M,100,0,5,5
Rodne,M,100,0,5,5
Rodneysha,F,100,5,0,5
Rodonna,F,100,5,0,5
Rodre,M,100,0,5,5
Rodricas,M,100,0,5,5
Rodrion,M,100,0,5,5
Rodson,M,100,0,5,5
Rogar,M,100,0,5,5
Roget,M,100,0,5,5
Rogie,M,100,0,5,5
Rohma,F,100,5,0,5
Rohman,M,100,0,5,5
Roianne,F,100,5,0,5
Rojan,M,100,0,5,5
Rokeem,M,100,0,5,5
Rokiya,F,100,5,0,5
Rolaine,F,100,5,0,5
Rolandas,M,100,0,5,5
Rollene,F,100,5,0,5
Rolston,M,100,0,5,5
Romalis,M,100,0,5,5
Romer,M,100,0,5,5
Romia,F,100,5,0,5
Romit,M,100,0,5,5
Ronaya,F,100,5,0,5
Rondee,F,100,5,0,5
Ronderick,M,100,0,5,5
Rondez,M,100,0,5,5
Rondol,M,100,0,5,5
Roneal,M,100,0,5,5
Roneika,F,100,5,0,5
Roneil,M,100,0,5,5
Ronekia,F,100,5,0,5
Ronelda,F,100,5,0,5
Ronil,M,100,0,5,5
Ronke,F,100,5,0,5
Ronmel,M,100,0,5,5
Ronnay,F,100,5,0,5
Ronnella,F,100,5,0,5
Ronnet,F,100,5,0,5
Ronniece,F,100,5,0,5
Ronniel,M,100,0,5,5
Ronniya,F,100,5,0,5
Ronnye,F,100,5,0,5
Ronreco,M,100,0,5,5
Ronshay,F,100,5,0,5
Rontarius,M,100,0,5,5
Rontasia,F,100,5,0,5
Rontavia,F,100,5,0,5
Rontavis,M,100,0,5,5
Rooks,M,100,0,5,5
Roopal,F,100,5,0,5
Rooseve,M,100,0,5,5
Roqaya,F,100,5,0,5
Roric,M,100,0,5,5
Rosaire,M,100,0,5,5
Rosaliyah,F,100,5,0,5
Rosaliz,F,100,5,0,5
Rosandra,F,100,5,0,5
Rosarie,F,100,5,0,5
Roseangela,F,100,5,0,5
Roseellen,F,100,5,0,5
Rosenna,F,100,5,0,5
Rosh,M,100,0,5,5
Roshaad,M,100,0,5,5
Roshanta,F,100,5,0,5
Roshay,F,100,5,0,5
Roshina,F,100,5,0,5
Roshonna,F,100,5,0,5
Rosolino,M,100,0,5,5
Rosonda,F,100,5,0,5
Rossalind,F,100,5,0,5
Rossmary,F,100,5,0,5
Rostin,M,100,0,5,5
Rosylin,F,100,5,0,5
Roszella,F,100,5,0,5
Rotimi,M,100,0,5,5
Rotisha,F,100,5,0,5
Rotonia,F,100,5,0,5
Roua,F,100,5,0,5
Rouchelle,F,100,5,0,5
Rougui,F,100,5,0,5
Roul,M,100,0,5,5
Rovon,M,100,0,5,5
Rowden,M,100,0,5,5
Rowdie,M,100,0,5,5
Rowene,F,100,5,0,5
Roxen,M,100,0,5,5
Roxii,F,100,5,0,5
Roxsand,F,100,5,0,5
Roxton,M,100,0,5,5
Roxxane,F,100,5,0,5
Royall,M,100,0,5,5
Royaltee,F,100,5,0,5
Royanna,F,100,5,0,5
Rozalee,F,100,5,0,5
Rozario,M,100,0,5,5
Rozeta,F,100,5,0,5
Roziya,F,100,5,0,5
Rozzlyn,F,100,5,0,5
Rreanna,F,100,5,0,5
Rua,F,100,5,0,5
Ruann,F,100,5,0,5
Rubenia,F,100,5,0,5
Rubio,M,100,0,5,5
Rubyn,M,100,0,5,5
Rubyrose,F,100,5,0,5
Ruchita,F,100,5,0,5
Rudaina,F,100,5,0,5
Rudd,M,100,0,5,5
Ruddie,M,100,0,5,5
Rudeen,F,100,5,0,5
Ruey,F,100,5,0,5
Ruford,M,100,0,5,5
Rugayyah,F,100,5,0,5
Rugenia,F,100,5,0,5
Rugiatu,F,100,5,0,5
Ruhika,F,100,5,0,5
Ruiqi,F,100,5,0,5
Ruiz,M,100,0,5,5
Rujul,M,100,0,5,5
Rujuta,F,100,5,0,5
Rukaiyah,F,100,5,0,5
Rumalda,F,100,5,0,5
Ruman,F,100,5,0,5
Rumonda,F,100,5,0,5
Rundy,M,100,0,5,5
Ruot,M,100,0,5,5
Rupen,M,100,0,5,5
Rurik,M,100,0,5,5
Rushad,M,100,0,5,5
Rushank,M,100,0,5,5
Rushun,M,100,0,5,5
Ruskin,M,100,0,5,5
Russchell,F,100,5,0,5
Ruthel,F,100,5,0,5
Ruxton,M,100,0,5,5
Ruzanna,F,100,5,0,5
Ryahn,M,100,0,5,5
Ryanchristian,M,100,0,5,5
Ryanjay,M,100,0,5,5
Ryanmatthew,M,100,0,5,5
Ryanpatrick,M,100,0,5,5
Ryanpaul,M,100,0,5,5
Ryat,M,100,0,5,5
Rydel,M,100,0,5,5
Ryean,M,100,0,5,5
Ryeli,F,100,5,0,5
Rykki,F,100,5,0,5
Ryleeanne,F,100,5,0,5
Ryma,F,100,5,0,5
Rynette,F,100,5,0,5
Rynleigh,F,100,5,0,5
Ryou,M,100,0,5,5
Rythm,M,100,0,5,5
Ryton,M,100,0,5,5
Ryujin,M,100,0,5,5
Ryuki,M,100,0,5,5
Saada,F,100,5,0,5
Saadiyah,F,100,5,0,5
Saajida,F,100,5,0,5
Saanjh,F,100,5,0,5
Saavon,M,100,0,5,5
Sabarin,F,100,5,0,5
Sabha,F,100,5,0,5
Sabih,M,100,0,5,5
Sabit,M,100,0,5,5
Sabiya,F,100,5,0,5
Sabreea,F,100,5,0,5
Sabreya,F,100,5,0,5
Sabrielle,F,100,5,0,5
Sabriena,F,100,5,0,5
Sabriye,F,100,5,0,5
Sabriyyah,F,100,5,0,5
Sabrynn,F,100,5,0,5
Sabu,M,100,0,5,5
Sabur,M,100,0,5,5
Sachel,F,100,5,0,5
Sacorya,F,100,5,0,5
Sacoyia,F,100,5,0,5
Sadane,M,100,0,5,5
Sadaq,M,100,0,5,5
Sadarian,M,100,0,5,5
Sadarion,M,100,0,5,5
Sadavia,F,100,5,0,5
Saddiya,F,100,5,0,5
Sadea,F,100,5,0,5
Sadeeq,M,100,0,5,5
Sadeigh,F,100,5,0,5
Saderia,F,100,5,0,5
Sadhvi,F,100,5,0,5
Sadielee,F,100,5,0,5
Sadio,F,100,5,0,5
Sadique,M,100,0,5,5
Sadir,M,100,0,5,5
Sadiyya,F,100,5,0,5
Sadman,M,100,0,5,5
Sadonia,F,100,5,0,5
Saedie,F,100,5,0,5
Saela,F,100,5,0,5
Safeara,F,100,5,0,5
Safee,M,100,0,5,5
Safet,M,100,0,5,5
Saffa,F,100,5,0,5
Safiah,F,100,5,0,5
Sagine,F,100,5,0,5
Sahaan,M,100,0,5,5
Sahai,F,100,5,0,5
Saham,F,100,5,0,5
Saheb,M,100,0,5,5
Sahen,M,100,0,5,5
Sahishnu,M,100,0,5,5
Sahitya,F,100,5,0,5
Sahiyah,F,100,5,0,5
Sahmiya,F,100,5,0,5
Sahnya,F,100,5,0,5
Sahrai,F,100,5,0,5
Sahron,F,100,5,0,5
Sahrye,F,100,5,0,5
Saianish,M,100,0,5,5
Saiden,M,100,0,5,5
Saidou,M,100,0,5,5
Saifaldeen,M,100,0,5,5
Saiid,M,100,0,5,5
Saile,F,100,5,0,5
Saintjohn,M,100,0,5,5
Saion,M,100,0,5,5
Sajaad,M,100,0,5,5
Sajeda,F,100,5,0,5
Saji,M,100,0,5,5
Sakae,F,100,5,0,5
Sakaiya,F,100,5,0,5
Sakeef,M,100,0,5,5
Sakeya,F,100,5,0,5
Sakthi,F,100,5,0,5
Saku,M,100,0,5,5
Saladine,M,100,0,5,5
Salahaldeen,M,100,0,5,5
Salaheddine,M,100,0,5,5
Salamata,F,100,5,0,5
Salanda,F,100,5,0,5
Salandra,F,100,5,0,5
Salay,F,100,5,0,5
Salayna,F,100,5,0,5
Salazar,M,100,0,5,5
Saleigh,F,100,5,0,5
Salet,F,100,5,0,5
Salethia,F,100,5,0,5
Saleyah,F,100,5,0,5
Salida,F,100,5,0,5
Saliya,F,100,5,0,5
Saliym,M,100,0,5,5
Salomae,F,100,5,0,5
Salonda,F,100,5,0,5
Salone,F,100,5,0,5
Salonge,F,100,5,0,5
Salvado,M,100,0,5,5
Samaah,F,100,5,0,5
Samaara,F,100,5,0,5
Samahj,M,100,0,5,5
Samalia,F,100,5,0,5
Samana,F,100,5,0,5
Samandar,M,100,0,5,5
Samanthalynn,F,100,5,0,5
Samanthea,F,100,5,0,5
Samare,F,100,5,0,5
Samarea,F,100,5,0,5
Samarian,F,100,5,0,5
Samarjit,M,100,0,5,5
Samarpreet,M,100,0,5,5
Samata,F,100,5,0,5
Sameem,M,100,0,5,5
Samehesha,F,100,5,0,5
Sameia,F,100,5,0,5
Sameika,F,100,5,0,5
Samej,M,100,0,5,5
Samekia,F,100,5,0,5
Samerra,F,100,5,0,5
Samet,M,100,0,5,5
Samiera,F,100,5,0,5
Samija,F,100,5,0,5
Samita,F,100,5,0,5
Sammael,M,100,0,5,5
Sammeul,M,100,0,5,5
Sammiyah,F,100,5,0,5
Sammya,F,100,5,0,5
Samonie,F,100,5,0,5
Samontha,F,100,5,0,5
Samore,F,100,5,0,5
Sampath,M,100,0,5,5
Samraj,M,100,0,5,5
Samuael,M,100,0,5,5
Samuil,M,100,0,5,5
Samyr,M,100,0,5,5
Sanchit,M,100,0,5,5
Sanderson,M,100,0,5,5
Sandino,M,100,0,5,5
Sandora,F,100,5,0,5
Sandr,F,100,5,0,5
Sandreka,F,100,5,0,5
Sandricka,F,100,5,0,5
Sandry,F,100,5,0,5
Sandybell,F,100,5,0,5
Sandye,F,100,5,0,5
Saned,F,100,5,0,5
Saneya,F,100,5,0,5
Sanibel,F,100,5,0,5
Sanihya,F,100,5,0,5
Saniiya,F,100,5,0,5
Saniqua,F,100,5,0,5
Sanira,F,100,5,0,5
Sanitra,F,100,5,0,5
Saniye,F,100,5,0,5
Saniyia,F,100,5,0,5
Sanjan,M,100,0,5,5
Sankeerth,M,100,0,5,5
Sannai,F,100,5,0,5
Sannon,F,100,5,0,5
Sanskruti,F,100,5,0,5
Santanah,F,100,5,0,5
Santanya,F,100,5,0,5
Santavia,F,100,5,0,5
Santavious,M,100,0,5,5
Santoi,M,100,0,5,5
Santrez,M,100,0,5,5
Sanyra,F,100,5,0,5
Sapheria,F,100,5,0,5
Saphirah,F,100,5,0,5
Saquanna,F,100,5,0,5
Sarahbella,F,100,5,0,5
Sarahya,F,100,5,0,5
Saraina,F,100,5,0,5
Sarait,F,100,5,0,5
Sarani,F,100,5,0,5
Saraswati,F,100,5,0,5
Saratha,F,100,5,0,5
Sarbjot,M,100,0,5,5
Sardar,M,100,0,5,5
Sarell,F,100,5,0,5
Sareniti,F,100,5,0,5
Sariaha,F,100,5,0,5
Sarica,F,100,5,0,5
Sariha,F,100,5,0,5
Sarii,F,100,5,0,5
Sariyha,F,100,5,0,5
Sarn,M,100,0,5,5
Saroun,F,100,5,0,5
Sarri,F,100,5,0,5
Sarriyah,F,100,5,0,5
Sarsh,F,100,5,0,5
Sarvia,F,100,5,0,5
Saryan,M,100,0,5,5
Sasami,F,100,5,0,5
Sashalee,F,100,5,0,5
Sasharae,F,100,5,0,5
Sashya,F,100,5,0,5
Sathwik,M,100,0,5,5
Satnam,M,100,0,5,5
Satsha,F,100,5,0,5
Satyn,F,100,5,0,5
Sauannah,F,100,5,0,5
Sauna,F,100,5,0,5
Savannahgrace,F,100,5,0,5
Savannahjo,F,100,5,0,5
Saveliy,M,100,0,5,5
Savena,F,100,5,0,5
Saveria,F,100,5,0,5
Saveya,F,100,5,0,5
Saveyon,M,100,0,5,5
Savhannah,F,100,5,0,5
Saviah,F,100,5,0,5
Saviana,F,100,5,0,5
Savin,M,100,0,5,5
Savit,M,100,0,5,5
Savoeun,F,100,5,0,5
Savonya,F,100,5,0,5
Sawdah,F,100,5,0,5
Sayanna,F,100,5,0,5
Saybree,F,100,5,0,5
Sayen,F,100,5,0,5
Sayona,F,100,5,0,5
Sayonna,F,100,5,0,5
Sbeidy,F,100,5,0,5
Sbrina,F,100,5,0,5
Scarlytt,F,100,5,0,5
Schaffer,M,100,0,5,5
Schanelle,F,100,5,0,5
Schannon,F,100,5,0,5
Schmika,F,100,5,0,5
Scholar,M,100,0,5,5
Schrie,F,100,5,0,5
Scottia,F,100,5,0,5
Seaanna,F,100,5,0,5
Seabrook,M,100,0,5,5
Seairah,F,100,5,0,5
Sealtiel,M,100,0,5,5
Seamon,M,100,0,5,5
Seandouglas,M,100,0,5,5
Seandre,M,100,0,5,5
Seandrea,F,100,5,0,5
Seangabriel,M,100,0,5,5
Seanjohn,M,100,0,5,5
Seanta,F,100,5,0,5
Seanthomas,M,100,0,5,5
Seantyler,M,100,0,5,5
Searah,F,100,5,0,5
Searia,F,100,5,0,5
Seasons,F,100,5,0,5
Sebastean,M,100,0,5,5
Sebestian,M,100,0,5,5
Sebria,F,100,5,0,5
Sebrinia,F,100,5,0,5
Sedney,F,100,5,0,5
Sedwick,M,100,0,5,5
Sefton,M,100,0,5,5
Sehajpreet,F,100,5,0,5
Sehana,F,100,5,0,5
Seianna,F,100,5,0,5
Seid,M,100,0,5,5
Seidina,F,100,5,0,5
Seigo,M,100,0,5,5
Seitu,M,100,0,5,5
Seja,F,100,5,0,5
Sekayi,F,100,5,0,5
Sekia,F,100,5,0,5
Sekura,F,100,5,0,5
Selasi,M,100,0,5,5
Selebrity,F,100,5,0,5
Seliah,F,100,5,0,5
Seliyah,F,100,5,0,5
Sella,F,100,5,0,5
Selmer,M,100,0,5,5
Selphie,F,100,5,0,5
Selven,M,100,0,5,5
Selyn,F,100,5,0,5
Semajai,M,100,0,5,5
Semarias,M,100,0,5,5
Semayah,F,100,5,0,5
Semere,M,100,0,5,5
Semon,F,100,5,0,5
Senaiya,F,100,5,0,5
Seneque,F,100,5,0,5
Senetria,F,100,5,0,5
Senida,F,100,5,0,5
Sensi,F,100,5,0,5
Senteria,F,100,5,0,5
Sentrell,M,100,0,5,5
Seoyeon,F,100,5,0,5
Seoyoon,F,100,5,0,5
Sepia,F,100,5,0,5
Sepp,M,100,0,5,5
Sequeena,F,100,5,0,5
Sequina,F,100,5,0,5
Sequoyia,F,100,5,0,5
Serach,F,100,5,0,5
Serae,F,100,5,0,5
Serafima,F,100,5,0,5
Seraphin,F,100,5,0,5
Seras,F,100,5,0,5
Seray,F,100,5,0,5
Serdar,M,100,0,5,5
Sereina,F,100,5,0,5
Serennity,F,100,5,0,5
Sergie,M,100,0,5,5
Serguio,M,100,0,5,5
Serhat,M,100,0,5,5
Seriena,F,100,5,0,5
Seriniti,F,100,5,0,5
Serissa,F,100,5,0,5
Seritta,F,100,5,0,5
Seryniti,F,100,5,0,5
Sesalie,F,100,5,0,5
Sesario,M,100,0,5,5
Setara,F,100,5,0,5
Seumas,M,100,0,5,5
Sevena,F,100,5,0,5
Seveon,M,100,0,5,5
Severen,M,100,0,5,5
Severyn,M,100,0,5,5
Sevi,F,100,5,0,5
Seviah,F,100,5,0,5
Sewit,F,100,5,0,5
Sexton,M,100,0,5,5
Seya,F,100,5,0,5
Seyha,M,100,0,5,5
Shaad,M,100,0,5,5
Shaaliyah,F,100,5,0,5
Shaba,M,100,0,5,5
Shabina,F,100,5,0,5
Shabriana,F,100,5,0,5
Shabriel,F,100,5,0,5
Shabrittany,F,100,5,0,5
Shacaria,F,100,5,0,5
Shachi,F,100,5,0,5
Shacondra,F,100,5,0,5
Shacourtney,F,100,5,0,5
Shadarian,M,100,0,5,5
Shadayah,F,100,5,0,5
Shaddy,M,100,0,5,5
Shadeen,F,100,5,0,5
Shadejah,F,100,5,0,5
Shadiqua,F,100,5,0,5
Shadira,F,100,5,0,5
Shadona,F,100,5,0,5
Shaeann,F,100,5,0,5
Shaelea,F,100,5,0,5
Shafon,F,100,5,0,5
Shaguanna,F,100,5,0,5
Shahaan,M,100,0,5,5
Shahanna,F,100,5,0,5
Shaheedah,F,100,5,0,5
Shahirah,F,100,5,0,5
Shahnawaz,M,100,0,5,5
Shahrazad,F,100,5,0,5
Shahreen,F,100,5,0,5
Shahzoda,F,100,5,0,5
Shaid,M,100,0,5,5
Shaienne,F,100,5,0,5
Shaik,M,100,0,5,5
Shaikeem,M,100,0,5,5
Shaikha,F,100,5,0,5
Shailie,F,100,5,0,5
Shailynne,F,100,5,0,5
Shairon,F,100,5,0,5
Shaisha,F,100,5,0,5
Shaiyan,F,100,5,0,5
Shakaiya,F,100,5,0,5
Shakalia,F,100,5,0,5
Shakayia,F,100,5,0,5
Shakeah,F,100,5,0,5
Shakeidra,F,100,5,0,5
Shakemmia,F,100,5,0,5
Shakeyda,F,100,5,0,5
Shaking,M,100,0,5,5
Shakiva,F,100,5,0,5
Shakka,F,100,5,0,5
Shakoria,F,100,5,0,5
Shakria,F,100,5,0,5
Shakwan,M,100,0,5,5
Shakye,M,100,0,5,5
Shakyiah,F,100,5,0,5
Shalaka,F,100,5,0,5
Shalanna,F,100,5,0,5
Shalanta,F,100,5,0,5
Shalante,F,100,5,0,5
Shalaundra,F,100,5,0,5
Shaleshia,F,100,5,0,5
Shalica,F,100,5,0,5
Shaliese,F,100,5,0,5
Shalima,F,100,5,0,5
Shaliqua,F,100,5,0,5
Shalisia,F,100,5,0,5
Shalliyah,F,100,5,0,5
Shalo,F,100,5,0,5
Shalonte,F,100,5,0,5
Shalymar,F,100,5,0,5
Shalyric,F,100,5,0,5
Shalyssa,F,100,5,0,5
Shamada,F,100,5,0,5
Shamaia,F,100,5,0,5
Shamaila,F,100,5,0,5
Shamain,F,100,5,0,5
Shamakia,F,100,5,0,5
Shamanique,F,100,5,0,5
Shamay,F,100,5,0,5
Shambrea,F,100,5,0,5
Shameik,M,100,0,5,5
Shamek,M,100,0,5,5
Shameki,F,100,5,0,5
Shametrice,F,100,5,0,5
Shamiek,M,100,0,5,5
Shamill,F,100,5,0,5
Shamillia,F,100,5,0,5
Shamise,F,100,5,0,5
Shamma,F,100,5,0,5
Shammie,F,100,5,0,5
Shamonia,F,100,5,0,5
Shamori,M,100,0,5,5
Shampagne,F,100,5,0,5
Shamso,F,100,5,0,5
Shamuel,M,100,0,5,5
Shanaih,F,100,5,0,5
Shanail,F,100,5,0,5
Shanaisha,F,100,5,0,5
Shanarra,F,100,5,0,5
Shanasha,F,100,5,0,5
Shanchez,M,100,0,5,5
Shandara,F,100,5,0,5
Shandella,F,100,5,0,5
Shandera,F,100,5,0,5
Shandreika,F,100,5,0,5
Shanecka,F,100,5,0,5
Shaneesa,F,100,5,0,5
Shanekqa,F,100,5,0,5
Shanely,F,100,5,0,5
Shanequea,F,100,5,0,5
Shanesa,F,100,5,0,5
Shaneshia,F,100,5,0,5
Shanesse,F,100,5,0,5
Shanez,F,100,5,0,5
Shangaleza,F,100,5,0,5
Shanieca,F,100,5,0,5
Shanii,F,100,5,0,5
Shaniki,F,100,5,0,5
Shaniquwa,F,100,5,0,5
Shaniyia,F,100,5,0,5
Shanli,F,100,5,0,5
Shanmukh,M,100,0,5,5
Shannalee,F,100,5,0,5
Shannee,F,100,5,0,5
Shanneka,F,100,5,0,5
Shanniya,F,100,5,0,5
Shannya,F,100,5,0,5
Shanobia,F,100,5,0,5
Shanona,F,100,5,0,5
Shanonn,F,100,5,0,5
Shanqua,F,100,5,0,5
Shanqual,F,100,5,0,5
Shanquan,M,100,0,5,5
Shanquil,F,100,5,0,5
Shanrica,F,100,5,0,5
Shantala,F,100,5,0,5
Shantanae,F,100,5,0,5
Shantela,F,100,5,0,5
Shanterika,F,100,5,0,5
Shanterri,F,100,5,0,5
Shantesha,F,100,5,0,5
Shanteya,F,100,5,0,5
Shantie,F,100,5,0,5
Shantiece,F,100,5,0,5
Shantiel,F,100,5,0,5
Shantih,F,100,5,0,5
Shantle,F,100,5,0,5
Shantrail,F,100,5,0,5
Shantwana,F,100,5,0,5
Shantya,F,100,5,0,5
Shanye,F,100,5,0,5
Shanyel,F,100,5,0,5
Shanyse,F,100,5,0,5
Shapria,F,100,5,0,5
Shaqil,M,100,0,5,5
Shaquaila,F,100,5,0,5
Shaquale,F,100,5,0,5
Shaquarius,F,100,5,0,5
Shaqueda,F,100,5,0,5
Shaqueel,M,100,0,5,5
Shaqueeta,F,100,5,0,5
Shaquelia,F,100,5,0,5
Shaquerra,F,100,5,0,5
Shaquillie,M,100,0,5,5
Shaquin,F,100,5,0,5
Shaquinn,F,100,5,0,5
Shaquirra,F,100,5,0,5
Shaquone,M,100,0,5,5
Shaquor,M,100,0,5,5
Shaqwanna,F,100,5,0,5
Sharail,F,100,5,0,5
Sharalynn,F,100,5,0,5
Sharat,M,100,0,5,5
Sharaven,F,100,5,0,5
Sharayu,F,100,5,0,5
Shardonay,F,100,5,0,5
Shardul,M,100,0,5,5
Shareek,M,100,0,5,5
Shareem,M,100,0,5,5
Sharees,F,100,5,0,5
Shareif,M,100,0,5,5
Shareny,F,100,5,0,5
Shareva,F,100,5,0,5
Sharey,F,100,5,0,5
Shariden,F,100,5,0,5
Sharielle,F,100,5,0,5
Sharikka,F,100,5,0,5
Sharimar,F,100,5,0,5
Sharinda,F,100,5,0,5
Sharini,F,100,5,0,5
Sharinna,F,100,5,0,5
Shariyka,F,100,5,0,5
Sharlanda,F,100,5,0,5
Sharletha,F,100,5,0,5
Sharly,F,100,5,0,5
Sharmae,F,100,5,0,5
Sharmake,M,100,0,5,5
Sharmia,F,100,5,0,5
Sharmilla,F,100,5,0,5
Sharnele,F,100,5,0,5
Sharnet,F,100,5,0,5
Sharney,F,100,5,0,5
Sharnisha,F,100,5,0,5
Sharocka,F,100,5,0,5
Sharoll,F,100,5,0,5
Sharome,M,100,0,5,5
Sharonette,F,100,5,0,5
Sharrae,F,100,5,0,5
Sharray,F,100,5,0,5
Sharre,F,100,5,0,5
Sharrika,F,100,5,0,5
Sharrita,F,100,5,0,5
Sharryn,F,100,5,0,5
Sharva,M,100,0,5,5
Sharyia,F,100,5,0,5
Shasa,F,100,5,0,5
Shashanth,M,100,0,5,5
Shashawn,F,100,5,0,5
Shashi,M,100,0,5,5
Shastelin,F,100,5,0,5
Shataka,F,100,5,0,5
Shatarah,F,100,5,0,5
Shataura,F,100,5,0,5
Shatay,F,100,5,0,5
Shatel,F,100,5,0,5
Shatell,F,100,5,0,5
Shateya,F,100,5,0,5
Shatiah,F,100,5,0,5
Shatiek,M,100,0,5,5
Shatierra,F,100,5,0,5
Shatoni,F,100,5,0,5
Shatory,F,100,5,0,5
Shatorya,F,100,5,0,5
Shaunacy,F,100,5,0,5
Shaunay,F,100,5,0,5
Shaundale,M,100,0,5,5
Shaundel,F,100,5,0,5
Shaundreka,F,100,5,0,5
Shaundrika,F,100,5,0,5
Shauneille,F,100,5,0,5
Shaunel,F,100,5,0,5
Shaunielle,F,100,5,0,5
Shauniya,F,100,5,0,5
Shauntavious,M,100,0,5,5
Shauntaya,F,100,5,0,5
Shauntaye,F,100,5,0,5
Shauntele,F,100,5,0,5
Shauntiana,F,100,5,0,5
Shauntoria,F,100,5,0,5
Shavada,F,100,5,0,5
Shavan,F,100,5,0,5
Shavaria,F,100,5,0,5
Shavera,F,100,5,0,5
Shavion,F,100,5,0,5
Shawhin,M,100,0,5,5
Shawki,M,100,0,5,5
Shawnacy,F,100,5,0,5
Shawndelle,F,100,5,0,5
Shawndi,F,100,5,0,5
Shawneeque,F,100,5,0,5
Shawneka,F,100,5,0,5
Shawnesha,F,100,5,0,5
Shawnon,F,100,5,0,5
Shawntale,F,100,5,0,5
Shawntane,F,100,5,0,5
Shawntey,F,100,5,0,5
Shawntika,F,100,5,0,5
Shawun,M,100,0,5,5
Shawyn,F,100,5,0,5
Shaydin,M,100,0,5,5
Shayleah,F,100,5,0,5
Shaylla,F,100,5,0,5
Shaylonda,F,100,5,0,5
Shayndel,F,100,5,0,5
Shaynelle,F,100,5,0,5
She,F,100,5,0,5
Sheaira,F,100,5,0,5
Shealan,F,100,5,0,5
Sheali,F,100,5,0,5
Sheandra,F,100,5,0,5
Sheary,F,100,5,0,5
Shebria,F,100,5,0,5
Shed,M,100,0,5,5
Shedonna,F,100,5,0,5
Shedrich,M,100,0,5,5
Shedricka,F,100,5,0,5
Sheeneeka,F,100,5,0,5
Sheharyar,M,100,0,5,5
Shehroz,M,100,0,5,5
Sheikha,F,100,5,0,5
Sheil,F,100,5,0,5
Sheili,F,100,5,0,5
Sheiva,F,100,5,0,5
Shekeia,F,100,5,0,5
Shekeila,F,100,5,0,5
Shekhinah,F,100,5,0,5
Shekitha,F,100,5,0,5
Shelan,F,100,5,0,5
Shelaya,F,100,5,0,5
Shelayne,F,100,5,0,5
Shelbert,M,100,0,5,5
Shelbia,F,100,5,0,5
Shelbra,F,100,5,0,5
Shelbyjo,F,100,5,0,5
Sheldia,F,100,5,0,5
Shele,F,100,5,0,5
Sheleena,F,100,5,0,5
Shelette,F,100,5,0,5
Shelica,F,100,5,0,5
Sheliya,F,100,5,0,5
Sheliza,F,100,5,0,5
Shellaine,F,100,5,0,5
Shellbe,F,100,5,0,5
Shellisa,F,100,5,0,5
Shelyn,F,100,5,0,5
Shemaine,F,100,5,0,5
Shemaka,F,100,5,0,5
Shemara,F,100,5,0,5
Shemera,F,100,5,0,5
Shemita,F,100,5,0,5
Sheneaka,F,100,5,0,5
Sheneda,F,100,5,0,5
Sheneil,F,100,5,0,5
Sheneshia,F,100,5,0,5
Shengyeng,F,100,5,0,5
Shenikia,F,100,5,0,5
Shenina,F,100,5,0,5
Shennan,F,100,5,0,5
Shennel,F,100,5,0,5
Shenya,F,100,5,0,5
Shenyah,F,100,5,0,5
Sheperd,M,100,0,5,5
Shequanda,F,100,5,0,5
Shequanna,F,100,5,0,5
Shequira,F,100,5,0,5
Sheraldine,F,100,5,0,5
Sherall,F,100,5,0,5
Sheraton,M,100,0,5,5
Shereika,F,100,5,0,5
Sherelene,F,100,5,0,5
Sheren,F,100,5,0,5
Sheriel,F,100,5,0,5
Sherifat,F,100,5,0,5
Sherile,F,100,5,0,5
Sherinda,F,100,5,0,5
Sherkita,F,100,5,0,5
Sherlly,F,100,5,0,5
Shermona,F,100,5,0,5
Sherneice,F,100,5,0,5
Shernette,F,100,5,0,5
Sherokee,F,100,5,0,5
Sherome,M,100,0,5,5
Sherquita,F,100,5,0,5
Sherr,F,100,5,0,5
Sherrea,F,100,5,0,5
Sherreka,F,100,5,0,5
Sherrene,F,100,5,0,5
Sherretta,F,100,5,0,5
Sherris,F,100,5,0,5
Shertia,F,100,5,0,5
Sherunda,F,100,5,0,5
Shervonda,F,100,5,0,5
Sheshe,F,100,5,0,5
Shetarra,F,100,5,0,5
Sheterica,F,100,5,0,5
Sheterrica,F,100,5,0,5
Shevella,F,100,5,0,5
Shevetta,F,100,5,0,5
Shevi,F,100,5,0,5
Sheylyn,F,100,5,0,5
Sheylynn,F,100,5,0,5
Shiala,F,100,5,0,5
Shielah,F,100,5,0,5
Shields,M,100,0,5,5
Shierra,F,100,5,0,5
Shikema,F,100,5,0,5
Shikeria,F,100,5,0,5
Shiketa,F,100,5,0,5
Shikeyla,F,100,5,0,5
Shillae,F,100,5,0,5
Shimeek,M,100,0,5,5
Shimeeka,F,100,5,0,5
Shimekia,F,100,5,0,5
Shinda,F,100,5,0,5
Shinee,F,100,5,0,5
Shinesha,F,100,5,0,5
Shiniah,F,100,5,0,5
Shinobi,M,100,0,5,5
Shioban,F,100,5,0,5
Shirae,F,100,5,0,5
Shiretta,F,100,5,0,5
Shirlane,F,100,5,0,5
Shirleeta,F,100,5,0,5
Shirletha,F,100,5,0,5
Shirli,F,100,5,0,5
Shirlina,F,100,5,0,5
Shirret,F,100,5,0,5
Shirron,F,100,5,0,5
Shivaansh,M,100,0,5,5
Shivany,F,100,5,0,5
Shiyann,F,100,5,0,5
Shiyanna,F,100,5,0,5
Shiye,M,100,0,5,5
Shlomit,F,100,5,0,5
Shmeil,M,100,0,5,5
Shnea,F,100,5,0,5
Shneor,M,100,0,5,5
Shnita,F,100,5,0,5
Shniyah,F,100,5,0,5
Shondalyn,F,100,5,0,5
Shondolyn,F,100,5,0,5
Shondre,M,100,0,5,5
Shondrick,M,100,0,5,5
Shoneka,F,100,5,0,5
Shonett,F,100,5,0,5
Shong,M,100,0,5,5
Shonnetta,F,100,5,0,5
Shonni,F,100,5,0,5
Shonnita,F,100,5,0,5
Shonski,M,100,0,5,5
Shontavius,M,100,0,5,5
Shontisha,F,100,5,0,5
Shorn,M,100,0,5,5
Shoshona,F,100,5,0,5
Shovon,F,100,5,0,5
Shrea,F,100,5,0,5
Shreehan,M,100,0,5,5
Shreyasi,F,100,5,0,5
Shrhonda,F,100,5,0,5
Shrishti,F,100,5,0,5
Shrivas,M,100,0,5,5
Shriyaan,M,100,0,5,5
Shubha,F,100,5,0,5
Shuchi,F,100,5,0,5
Shulamite,F,100,5,0,5
Shulamith,F,100,5,0,5
Shumel,M,100,0,5,5
Shunashi,F,100,5,0,5
Shunell,F,100,5,0,5
Shuntana,F,100,5,0,5
Shunterria,F,100,5,0,5
Shuntina,F,100,5,0,5
Shunya,F,100,5,0,5
Shuraim,M,100,0,5,5
Shurhonda,F,100,5,0,5
Shuri,F,100,5,0,5
Shurie,F,100,5,0,5
Shushan,F,100,5,0,5
Shuvonne,F,100,5,0,5
Shuwanna,F,100,5,0,5
Shyauna,F,100,5,0,5
Shyda,F,100,5,0,5
Shydia,F,100,5,0,5
Shyhem,M,100,0,5,5
Shykerria,F,100,5,0,5
Shyleah,F,100,5,0,5
Shylei,F,100,5,0,5
Shylla,F,100,5,0,5
Shylon,M,100,0,5,5
Shylow,F,100,5,0,5
Shyma,F,100,5,0,5
Shymel,M,100,0,5,5
Shyneka,F,100,5,0,5
Shynesha,F,100,5,0,5
Shynita,F,100,5,0,5
Shyrene,F,100,5,0,5
Sias,M,100,0,5,5
Sibelle,F,100,5,0,5
Sibi,M,100,0,5,5
Sibil,F,100,5,0,5
Sibilla,F,100,5,0,5
Sibrina,F,100,5,0,5
Sidahmed,M,100,0,5,5
Siddhesh,M,100,0,5,5
Sidhartha,M,100,0,5,5
Sidora,F,100,5,0,5
Sidratul,F,100,5,0,5
Sienne,F,100,5,0,5
Sier,M,100,0,5,5
Sieria,F,100,5,0,5
Sierraleone,F,100,5,0,5
Sierralynn,F,100,5,0,5
Sierramarie,F,100,5,0,5
Sierrea,F,100,5,0,5
Siesta,F,100,5,0,5
Sifat,M,100,0,5,5
Sigfrido,M,100,0,5,5
Sihara,F,100,5,0,5
Sikander,M,100,0,5,5
Silberio,M,100,0,5,5
Silvi,F,100,5,0,5
Simbarashe,M,100,0,5,5
Sime,M,100,0,5,5
Simia,F,100,5,0,5
Simin,F,100,5,0,5
Simione,M,100,0,5,5
Simitrio,M,100,0,5,5
Simms,M,100,0,5,5
Simoni,F,100,5,0,5
Simote,M,100,0,5,5
Simplicio,M,100,0,5,5
Simrandeep,F,100,5,0,5
Simreet,F,100,5,0,5
Simron,F,100,5,0,5
Sinaiya,F,100,5,0,5
Sinath,F,100,5,0,5
Sinchana,F,100,5,0,5
Sindey,M,100,0,5,5
Singleton,M,100,0,5,5
Sinjon,M,100,0,5,5
Sinnamon,F,100,5,0,5
Siobhon,F,100,5,0,5
Sioeli,M,100,0,5,5
Siohban,F,100,5,0,5
Siovhan,F,100,5,0,5
Siqi,F,100,5,0,5
Siraaj,M,100,0,5,5
Siraya,F,100,5,0,5
Sirayah,F,100,5,0,5
Sirchristopher,M,100,0,5,5
Sirgio,M,100,0,5,5
Siriya,F,100,5,0,5
Sirrah,F,100,5,0,5
Sirvon,M,100,0,5,5
Siryah,F,100,5,0,5
Sistine,F,100,5,0,5
Sitey,F,100,5,0,5
Siwar,F,100,5,0,5
Siwoo,M,100,0,5,5
Siyam,F,100,5,0,5
Siyuri,F,100,5,0,5
Sjana,F,100,5,0,5
Skieler,F,100,5,0,5
Skilee,F,100,5,0,5
Skyana,F,100,5,0,5
Skyasia,F,100,5,0,5
Skyelee,F,100,5,0,5
Skylarmarie,F,100,5,0,5
Skylarrae,F,100,5,0,5
Skyle,F,100,5,0,5
Skylit,F,100,5,0,5
Skyshun,M,100,0,5,5
Skyyler,M,100,0,5,5
Slavica,F,100,5,0,5
Smiya,F,100,5,0,5
Smyrna,F,100,5,0,5
Sneyder,M,100,0,5,5
Snowy,F,100,5,0,5
Soana,F,100,5,0,5
Soda,F,100,5,0,5
Sodbileg,M,100,0,5,5
Soffie,F,100,5,0,5
Sohany,F,100,5,0,5
Sohela,F,100,5,0,5
Sohna,F,100,5,0,5
Sokol,M,100,0,5,5
Sokoya,F,100,5,0,5
Solach,F,100,5,0,5
Solaine,F,100,5,0,5
Solarah,F,100,5,0,5
Solenn,F,100,5,0,5
Soleya,F,100,5,0,5
Solly,M,100,0,5,5
Solmary,F,100,5,0,5
Solmon,M,100,0,5,5
Solomona,M,100,0,5,5
Somarah,F,100,5,0,5
Somiah,F,100,5,0,5
Somil,M,100,0,5,5
Somona,F,100,5,0,5
Sonceria,F,100,5,0,5
Sone,F,100,5,0,5
Sonequa,F,100,5,0,5
Sonic,M,100,0,5,5
Sonica,F,100,5,0,5
Soniqua,F,100,5,0,5
Sonjay,M,100,0,5,5
Sonnett,F,100,5,0,5
Sonovia,F,100,5,0,5
Sonum,F,100,5,0,5
Sonza,F,100,5,0,5
Soobin,F,100,5,0,5
Soomin,F,100,5,0,5
Sopath,M,100,0,5,5
Sopaul,M,100,0,5,5
Sophiaisabella,F,100,5,0,5
Sophiaisabelle,F,100,5,0,5
Sophialauren,F,100,5,0,5
Sophiamae,F,100,5,0,5
Sophiemarie,F,100,5,0,5
Sophilia,F,100,5,0,5
Sopia,F,100,5,0,5
Soraide,F,100,5,0,5
Soran,M,100,0,5,5
Sorella,F,100,5,0,5
Soreya,F,100,5,0,5
Soria,F,100,5,0,5
Soroya,F,100,5,0,5
Sorraya,F,100,5,0,5
Sory,M,100,0,5,5
Soterios,M,100,0,5,5
Sotiris,M,100,0,5,5
Soufiane,M,100,0,5,5
Soukaina,F,100,5,0,5
Soula,F,100,5,0,5
Souren,M,100,0,5,5
Sowsan,F,100,5,0,5
Soyer,M,100,0,5,5
Spandan,M,100,0,5,5
Sparky,M,100,0,5,5
Spartan,M,100,0,5,5
Spiridoula,F,100,5,0,5
Spivey,M,100,0,5,5
Sraavya,F,100,5,0,5
Sragvi,F,100,5,0,5
Srihaan,M,100,0,5,5
Srika,F,100,5,0,5
Srikrithi,F,100,5,0,5
Srilaasya,F,100,5,0,5
Srimayi,F,100,5,0,5
Srimedha,F,100,5,0,5
Srinija,F,100,5,0,5
Sriniketh,M,100,0,5,5
Srinithya,F,100,5,0,5
Srisai,M,100,0,5,5
Sritan,M,100,0,5,5
Srivaishnavi,F,100,5,0,5
Srivar,M,100,0,5,5
Sriyansh,M,100,0,5,5
Ssirley,F,100,5,0,5
Sstephanie,F,100,5,0,5
Staciann,F,100,5,0,5
Stafan,M,100,0,5,5
Stafon,M,100,0,5,5
Stamatina,F,100,5,0,5
Stancy,F,100,5,0,5
Staney,M,100,0,5,5
Stann,M,100,0,5,5
Stanson,M,100,0,5,5
Stara,F,100,5,0,5
Starcia,F,100,5,0,5
Stardust,F,100,5,0,5
Starkey,M,100,0,5,5
Starlah,F,100,5,0,5
Starlisa,F,100,5,0,5
Starlita,F,100,5,0,5
Starri,F,100,5,0,5
Starshemah,F,100,5,0,5
Startasia,F,100,5,0,5
Stash,M,100,0,5,5
Stathan,M,100,0,5,5
Statia,F,100,5,0,5
Statton,M,100,0,5,5
Stazia,F,100,5,0,5
Stcy,F,100,5,0,5
Steelie,F,100,5,0,5
Steevie,F,100,5,0,5
Stefanni,F,100,5,0,5
Stefhon,M,100,0,5,5
Stefphon,M,100,0,5,5
Stehpen,M,100,0,5,5
Steicy,F,100,5,0,5
Stephanic,F,100,5,0,5
Stephanni,F,100,5,0,5
Stephennie,F,100,5,0,5
Stepheon,M,100,0,5,5
Stephfan,M,100,0,5,5
Stephun,M,100,0,5,5
Stephvon,M,100,0,5,5
Stepphanie,F,100,5,0,5
Stevani,F,100,5,0,5
Stevena,F,100,5,0,5
Stevierae,F,100,5,0,5
Stevion,M,100,0,5,5
Steysi,F,100,5,0,5
Sthefani,F,100,5,0,5
Sthepanie,F,100,5,0,5
Stover,M,100,0,5,5
Stowe,M,100,0,5,5
Stratos,M,100,0,5,5
Strauss,M,100,0,5,5
Streeter,M,100,0,5,5
Strickland,M,100,0,5,5
Strother,M,100,0,5,5
Stven,M,100,0,5,5
Styler,M,100,0,5,5
Subaru,M,100,0,5,5
Subria,F,100,5,0,5
Sucdi,F,100,5,0,5
Sudeeksha,F,100,5,0,5
Sudhanva,M,100,0,5,5
Sudip,M,100,0,5,5
Suejin,F,100,5,0,5
Suelyn,F,100,5,0,5
Suen,M,100,0,5,5
Sufi,F,100,5,0,5
Sugeily,F,100,5,0,5
Sugeiri,F,100,5,0,5
Suhailey,F,100,5,0,5
Suhaily,F,100,5,0,5
Suhanee,F,100,5,0,5
Suheib,M,100,0,5,5
Suhrit,M,100,0,5,5
Suhur,F,100,5,0,5
Sujatha,F,100,5,0,5
Sujood,F,100,5,0,5
Sulai,F,100,5,0,5
Sulaymaan,M,100,0,5,5
Sule,F,100,5,0,5
Sulekha,F,100,5,0,5
Suleymi,F,100,5,0,5
Sulia,F,100,5,0,5
Sulin,F,100,5,0,5
Sulynn,F,100,5,0,5
Sumair,M,100,0,5,5
Sumaiyya,F,100,5,0,5
Sumalee,F,100,5,0,5
Sumia,F,100,5,0,5
Summa,F,100,5,0,5
Summayah,F,100,5,0,5
Summerrain,F,100,5,0,5
Sumpter,M,100,0,5,5
Sumra,F,100,5,0,5
Sunasia,F,100,5,0,5
Sunde,F,100,5,0,5
Sundos,F,100,5,0,5
Sunitha,F,100,5,0,5
Sunnee,F,100,5,0,5
Suparna,F,100,5,0,5
Supraja,F,100,5,0,5
Suprenia,F,100,5,0,5
Suraiyah,F,100,5,0,5
Surayya,F,100,5,0,5
Suree,F,100,5,0,5
Surianna,F,100,5,0,5
Surraya,F,100,5,0,5
Sushma,F,100,5,0,5
Susin,F,100,5,0,5
Suvilla,F,100,5,0,5
Suyai,F,100,5,0,5
Suzzie,F,100,5,0,5
Sveva,F,100,5,0,5
Swanda,F,100,5,0,5
Swayne,M,100,0,5,5
Swecha,F,100,5,0,5
Sweetie,F,100,5,0,5
Swift,M,100,0,5,5
Swindell,M,100,0,5,5
Syaira,F,100,5,0,5
Sybrena,F,100,5,0,5
Sydalee,F,100,5,0,5
Sydra,F,100,5,0,5
Syedah,F,100,5,0,5
Syeisha,F,100,5,0,5
Syere,M,100,0,5,5
Syheem,M,100,0,5,5
Syid,M,100,0,5,5
Syiere,M,100,0,5,5
Sykeria,F,100,5,0,5
Syl,M,100,0,5,5
Syliss,M,100,0,5,5
Sylvannah,F,100,5,0,5
Sylvonia,F,100,5,0,5
Symarah,F,100,5,0,5
Symaya,F,100,5,0,5
Symeir,M,100,0,5,5
Symona,F,100,5,0,5
Synaia,F,100,5,0,5
Synceir,M,100,0,5,5
Syndia,F,100,5,0,5
Synithia,F,100,5,0,5
Synneva,F,100,5,0,5
Syr,M,100,0,5,5
Syrene,F,100,5,0,5
Syrenna,F,100,5,0,5
Syrette,F,100,5,0,5
Syritta,F,100,5,0,5
Syrius,M,100,0,5,5
Syron,M,100,0,5,5
Syvester,M,100,0,5,5
Syvia,F,100,5,0,5
Szander,M,100,0,5,5
Szofia,F,100,5,0,5
Taalor,F,100,5,0,5
Taarna,F,100,5,0,5
Taba,F,100,5,0,5
Tabathe,F,100,5,0,5
Tabbytha,F,100,5,0,5
Tabious,M,100,0,5,5
Taborah,F,100,5,0,5
Tabori,M,100,0,5,5
Tabu,M,100,0,5,5
Tace,M,100,0,5,5
Tachara,F,100,5,0,5
Tachiana,F,100,5,0,5
Tachic,F,100,5,0,5
Taciana,F,100,5,0,5
Tacory,M,100,0,5,5
Tadajah,F,100,5,0,5
Tadarian,M,100,0,5,5
Taddeo,M,100,0,5,5
Tadeja,F,100,5,0,5
Tadesha,F,100,5,0,5
Taegyn,F,100,5,0,5
Taeh,F,100,5,0,5
Taehyun,M,100,0,5,5
Taejuan,M,100,0,5,5
Taelan,M,100,0,5,5
Taelee,F,100,5,0,5
Taelour,F,100,5,0,5
Taeryn,F,100,5,0,5
Taeshia,F,100,5,0,5
Taeson,M,100,0,5,5
Taetym,F,100,5,0,5
Taeyah,F,100,5,0,5
Taeyang,M,100,0,5,5
Taffeta,F,100,5,0,5
Tahesia,F,100,5,0,5
Tahi,M,100,0,5,5
Tahitha,F,100,5,0,5
Tahitoa,M,100,0,5,5
Tahiyah,F,100,5,0,5
Tahjanee,F,100,5,0,5
Tahlaya,F,100,5,0,5
Tahleek,M,100,0,5,5
Tahlib,M,100,0,5,5
Tahlya,F,100,5,0,5
Tahmia,F,100,5,0,5
Tahna,F,100,5,0,5
Tahnesha,F,100,5,0,5
Tahnisha,F,100,5,0,5
Tahriq,M,100,0,5,5
Tahshawn,M,100,0,5,5
Taig,M,100,0,5,5
Taighlor,F,100,5,0,5
Taigon,M,100,0,5,5
Taihlor,F,100,5,0,5
Taijarae,F,100,5,0,5
Tailen,M,100,0,5,5
Tailon,M,100,0,5,5
Taimani,F,100,5,0,5
Taimoor,M,100,0,5,5
Tairen,F,100,5,0,5
Tairik,M,100,0,5,5
Taitianna,F,100,5,0,5
Taityana,F,100,5,0,5
Taityanna,F,100,5,0,5
Taiwon,M,100,0,5,5
Taiyler,F,100,5,0,5
Taizha,F,100,5,0,5
Taizley,F,100,5,0,5
Tajahn,M,100,0,5,5
Tajahne,F,100,5,0,5
Tajhanae,F,100,5,0,5
Tajianna,F,100,5,0,5
Tajinae,F,100,5,0,5
Tajmalik,M,100,0,5,5
Tajmere,M,100,0,5,5
Tajudeen,M,100,0,5,5
Tajveer,M,100,0,5,5
Takako,F,100,5,0,5
Takashia,F,100,5,0,5
Takeara,F,100,5,0,5
Takeasha,F,100,5,0,5
Takedra,F,100,5,0,5
Takeeta,F,100,5,0,5
Takeidra,F,100,5,0,5
Takella,F,100,5,0,5
Takemia,F,100,5,0,5
Takijah,F,100,5,0,5
Takisa,F,100,5,0,5
Takiyla,F,100,5,0,5
Takori,M,100,0,5,5
Takye,M,100,0,5,5
Takylia,F,100,5,0,5
Talae,F,100,5,0,5
Talaija,F,100,5,0,5
Talajha,F,100,5,0,5
Talajiah,F,100,5,0,5
Talat,M,100,0,5,5
Talayasia,F,100,5,0,5
Taleisa,F,100,5,0,5
Taliba,F,100,5,0,5
Taliha,F,100,5,0,5
Talissia,F,100,5,0,5
Talmon,M,100,0,5,5
Talsha,F,100,5,0,5
Taly,F,100,5,0,5
Talyor,F,100,5,0,5
Tamaiah,F,100,5,0,5
Tamajah,F,100,5,0,5
Tamalia,F,100,5,0,5
Tamarae,F,100,5,0,5
Tamarik,M,100,0,5,5
Tamaro,F,100,5,0,5
Tamaron,F,100,5,0,5
Tamarrah,F,100,5,0,5
Tamasine,F,100,5,0,5
Tamaurice,M,100,0,5,5
Tamayia,F,100,5,0,5
Tambresha,F,100,5,0,5
Tambry,F,100,5,0,5
Tameera,F,100,5,0,5
Tameira,F,100,5,0,5
Tameke,F,100,5,0,5
Tamekea,F,100,5,0,5
Tamell,M,100,0,5,5
Tameyka,F,100,5,0,5
Tamhra,F,100,5,0,5
Tamiaya,F,100,5,0,5
Tamicko,F,100,5,0,5
Tamieko,F,100,5,0,5
Tamiika,F,100,5,0,5
Tamikca,F,100,5,0,5
Tamillia,F,100,5,0,5
Tammetha,F,100,5,0,5
Tammila,F,100,5,0,5
Tammmy,F,100,5,0,5
Tammora,F,100,5,0,5
Tammylee,F,100,5,0,5
Tammyra,F,100,5,0,5
Tamorion,M,100,0,5,5
Tamyria,F,100,5,0,5
Tanaa,F,100,5,0,5
Tanard,M,100,0,5,5
Tanayshia,F,100,5,0,5
Tanayzia,F,100,5,0,5
Tandice,F,100,5,0,5
Tandis,F,100,5,0,5
Tanedra,F,100,5,0,5
Taneesh,M,100,0,5,5
Taneice,F,100,5,0,5
Taneicia,F,100,5,0,5
Taneille,F,100,5,0,5
Taneiqua,F,100,5,0,5
Taneiya,F,100,5,0,5
Tanek,M,100,0,5,5
Tanekqua,F,100,5,0,5
Taneysha,F,100,5,0,5
Tangelo,M,100,0,5,5
Tangenika,F,100,5,0,5
Tanglia,F,100,5,0,5
Tangular,F,100,5,0,5
Taniayah,F,100,5,0,5
Tanicha,F,100,5,0,5
Tanida,F,100,5,0,5
Tanin,M,100,0,5,5
Tanjanae,F,100,5,0,5
Tanjie,F,100,5,0,5
Tanneshia,F,100,5,0,5
Tannim,M,100,0,5,5
Tannyr,M,100,0,5,5
Tansi,F,100,5,0,5
Tantra,F,100,5,0,5
Tanuja,F,100,5,0,5
Tanusha,F,100,5,0,5
Tanushka,F,100,5,0,5
Tanyha,F,100,5,0,5
Taonna,F,100,5,0,5
Tapasya,F,100,5,0,5
Taqiyyah,F,100,5,0,5
Taquanta,F,100,5,0,5
Taquella,F,100,5,0,5
Taquez,M,100,0,5,5
Taquisa,F,100,5,0,5
Taquoya,F,100,5,0,5
Taqwan,M,100,0,5,5
Tar,F,100,5,0,5
Taraf,F,100,5,0,5
Taranique,F,100,5,0,5
Tarcia,F,100,5,0,5
Tareia,F,100,5,0,5
Tareyn,F,100,5,0,5
Tarha,F,100,5,0,5
Taric,M,100,0,5,5
Taritha,F,100,5,0,5
Tarkeshia,F,100,5,0,5
Tarkisha,F,100,5,0,5
Tarlton,M,100,0,5,5
Tarneisha,F,100,5,0,5
Tarnya,F,100,5,0,5
Taronza,F,100,5,0,5
Tarralyn,F,100,5,0,5
Tarrius,M,100,0,5,5
Tarrod,M,100,0,5,5
Tarsheka,F,100,5,0,5
Tarvin,M,100,0,5,5
Taryl,M,100,0,5,5
Tarzan,M,100,0,5,5
Tasani,F,100,5,0,5
Tashalee,F,100,5,0,5
Tashanika,F,100,5,0,5
Tashante,F,100,5,0,5
Tashaunti,F,100,5,0,5
Tasheeka,F,100,5,0,5
Tashel,F,100,5,0,5
Tasheyana,F,100,5,0,5
Tashfia,F,100,5,0,5
Tashiona,F,100,5,0,5
Tashionna,F,100,5,0,5
Tashiyana,F,100,5,0,5
Tasina,F,100,5,0,5
Taslin,F,100,5,0,5
Tasma,F,100,5,0,5
Tatanishia,F,100,5,0,5
Tatiayana,F,100,5,0,5
Tatiyonna,F,100,5,0,5
Tatom,F,100,5,0,5
Tatrina,F,100,5,0,5
Tatsiana,F,100,5,0,5
Tatsu,M,100,0,5,5
Tatton,M,100,0,5,5
Tauhid,M,100,0,5,5
Taumi,F,100,5,0,5
Taunie,F,100,5,0,5
Taurance,M,100,0,5,5
Taurasi,F,100,5,0,5
Taurius,M,100,0,5,5
Taushia,F,100,5,0,5
Tavain,M,100,0,5,5
Tavalas,M,100,0,5,5
Tavanna,F,100,5,0,5
Tavarian,M,100,0,5,5
Tavario,M,100,0,5,5
Tavean,M,100,0,5,5
Tavera,F,100,5,0,5
Tavern,M,100,0,5,5
Tavette,F,100,5,0,5
Tavey,F,100,5,0,5
Tavonda,F,100,5,0,5
Tavonn,M,100,0,5,5
Tavontae,M,100,0,5,5
Tavores,M,100,0,5,5
Tavy,F,100,5,0,5
Tawanica,F,100,5,0,5
Tawann,F,100,5,0,5
Tawanne,F,100,5,0,5
Tawfeeq,M,100,0,5,5
Tawheed,M,100,0,5,5
Tawiana,F,100,5,0,5
Tawne,F,100,5,0,5
Tawnjai,F,100,5,0,5
Tayani,F,100,5,0,5
Taybor,M,100,0,5,5
Tayce,M,100,0,5,5
Taydum,M,100,0,5,5
Tayea,F,100,5,0,5
Tayesha,F,100,5,0,5
Tayeshawn,M,100,0,5,5
Tayhlor,F,100,5,0,5
Tayisha,F,100,5,0,5
Tayleah,F,100,5,0,5
Taylene,F,100,5,0,5
Taylenn,F,100,5,0,5
Taylorgrace,F,100,5,0,5
Taylorjames,M,100,0,5,5
Taymour,M,100,0,5,5
Tayonia,F,100,5,0,5
Tayvan,M,100,0,5,5
Tayvianna,F,100,5,0,5
Tayviona,F,100,5,0,5
Tayvionna,F,100,5,0,5
Tayvone,M,100,0,5,5
Tayvonne,M,100,0,5,5
Tayyaba,F,100,5,0,5
Tayyibah,F,100,5,0,5
Tayzen,M,100,0,5,5
Tazaya,F,100,5,0,5
Tchanavian,F,100,5,0,5
Teaerra,F,100,5,0,5
Teahna,F,100,5,0,5
Teaisha,F,100,5,0,5
Teandria,F,100,5,0,5
Teangela,F,100,5,0,5
Teanisha,F,100,5,0,5
Teann,F,100,5,0,5
Tecola,F,100,5,0,5
Tedros,M,100,0,5,5
Teeana,F,100,5,0,5
Teenia,F,100,5,0,5
Teerra,F,100,5,0,5
Teffani,F,100,5,0,5
Teghveer,M,100,0,5,5
Tegon,M,100,0,5,5
Teha,F,100,5,0,5
Tehesha,F,100,5,0,5
Teiarra,F,100,5,0,5
Teidra,F,100,5,0,5
Tein,M,100,0,5,5
Tekeira,F,100,5,0,5
Tekenya,F,100,5,0,5
Tekita,F,100,5,0,5
Tekiya,F,100,5,0,5
Tekulve,M,100,0,5,5
Tekyra,F,100,5,0,5
Telaya,F,100,5,0,5
Telaysia,F,100,5,0,5
Telica,F,100,5,0,5
Telise,F,100,5,0,5
Telsha,F,100,5,0,5
Teman,M,100,0,5,5
Temeeka,F,100,5,0,5
Temeko,F,100,5,0,5
Temesa,F,100,5,0,5
Temetria,F,100,5,0,5
Temetrius,F,100,5,0,5
Temkia,F,100,5,0,5
Temon,M,100,0,5,5
Tempesst,F,100,5,0,5
Temprince,F,100,5,0,5
Tempsett,F,100,5,0,5
Tempy,F,100,5,0,5
Temuujin,M,100,0,5,5
Tenara,F,100,5,0,5
Tenayah,F,100,5,0,5
Tendai,M,100,0,5,5
Tendra,F,100,5,0,5
Tendria,F,100,5,0,5
Teneasha,F,100,5,0,5
Teneca,F,100,5,0,5
Teneeka,F,100,5,0,5
Teneesha,F,100,5,0,5
Teneia,F,100,5,0,5
Teneile,F,100,5,0,5
Teneke,F,100,5,0,5
Tenicha,F,100,5,0,5
Teniel,F,100,5,0,5
Tenijah,F,100,5,0,5
Tenneh,F,100,5,0,5
Tenneill,F,100,5,0,5
Tenneille,F,100,5,0,5
Tennesia,F,100,5,0,5
Tennill,F,100,5,0,5
Tensie,F,100,5,0,5
Tenyce,F,100,5,0,5
Teola,F,100,5,0,5
Teonni,F,100,5,0,5
Tepanga,F,100,5,0,5
Teppei,M,100,0,5,5
Tequana,F,100,5,0,5
Tequela,F,100,5,0,5
Tequella,F,100,5,0,5
Tequira,F,100,5,0,5
Teral,M,100,0,5,5
Teralee,F,100,5,0,5
Terani,F,100,5,0,5
Teremy,M,100,0,5,5
Terenna,F,100,5,0,5
Tereon,M,100,0,5,5
Teresaann,F,100,5,0,5
Terico,M,100,0,5,5
Teris,M,100,0,5,5
Termell,M,100,0,5,5
Ternell,M,100,0,5,5
Terr,M,100,0,5,5
Terrain,M,100,0,5,5
Terralynn,F,100,5,0,5
Terrane,M,100,0,5,5
Terraneisha,F,100,5,0,5
Terreal,M,100,0,5,5
Terresia,F,100,5,0,5
Terricia,F,100,5,0,5
Terriek,M,100,0,5,5
Terriell,M,100,0,5,5
Terrilynne,F,100,5,0,5
Terrineka,F,100,5,0,5
Terrique,M,100,0,5,5
Terrissa,F,100,5,0,5
Terriyon,M,100,0,5,5
Terrolyn,F,100,5,0,5
Terronda,F,100,5,0,5
Terryanna,F,100,5,0,5
Tervell,M,100,0,5,5
Tervin,M,100,0,5,5
Teryon,M,100,0,5,5
Tes,F,100,5,0,5
Teshayla,F,100,5,0,5
Teshena,F,100,5,0,5
Teshina,F,100,5,0,5
Teshira,F,100,5,0,5
Tetsu,M,100,0,5,5
Tevarus,M,100,0,5,5
Tevell,M,100,0,5,5
Teyahna,F,100,5,0,5
Teyanah,F,100,5,0,5
Teyonda,F,100,5,0,5
Teysean,M,100,0,5,5
Thadeo,M,100,0,5,5
Thadine,F,100,5,0,5
Thailen,M,100,0,5,5
Thain,M,100,0,5,5
Thaisa,F,100,5,0,5
Thaissa,F,100,5,0,5
Thaj,M,100,0,5,5
Thalen,M,100,0,5,5
Thamia,F,100,5,0,5
Thamos,M,100,0,5,5
Thanasi,M,100,0,5,5
Thanhphong,M,100,0,5,5
Thanhtruc,F,100,5,0,5
Tharyn,M,100,0,5,5
Thawann,F,100,5,0,5
Thaxter,M,100,0,5,5
Thayla,F,100,5,0,5
Thayna,F,100,5,0,5
Thays,F,100,5,0,5
The,M,100,0,5,5
Theanna,F,100,5,0,5
Thearthur,M,100,0,5,5
Thel,M,100,0,5,5
Thela,F,100,5,0,5
Thelisa,F,100,5,0,5
Themis,M,100,0,5,5
Theodia,M,100,0,5,5
Theofilos,M,100,0,5,5
Theoni,F,100,5,0,5
Theophilia,F,100,5,0,5
Theophus,M,100,0,5,5
Theral,M,100,0,5,5
Therease,F,100,5,0,5
Theresann,F,100,5,0,5
Thereza,F,100,5,0,5
Thermond,M,100,0,5,5
Therone,M,100,0,5,5
Therrin,M,100,0,5,5
Therse,F,100,5,0,5
Thesa,F,100,5,0,5
Thiego,M,100,0,5,5
Thira,F,100,5,0,5
Thistle,F,100,5,0,5
Thoa,F,100,5,0,5
Thomara,F,100,5,0,5
Thomasita,F,100,5,0,5
Thomason,M,100,0,5,5
Thomass,M,100,0,5,5
Thomesa,F,100,5,0,5
Thony,M,100,0,5,5
Thoreau,M,100,0,5,5
Thorson,M,100,0,5,5
Thressia,F,100,5,0,5
Thrisa,F,100,5,0,5
Thuhuong,F,100,5,0,5
Thuraya,F,100,5,0,5
Thurayya,F,100,5,0,5
Thurgood,M,100,0,5,5
Thursa,F,100,5,0,5
Thurza,F,100,5,0,5
Thuthuy,F,100,5,0,5
Thuyvy,F,100,5,0,5
Thyrome,M,100,0,5,5
Thyron,M,100,0,5,5
Thyrone,M,100,0,5,5
Tiadra,F,100,5,0,5
Tiaka,F,100,5,0,5
Tiala,F,100,5,0,5
Tiamia,F,100,5,0,5
Tiandria,F,100,5,0,5
Tianny,F,100,5,0,5
Tiany,F,100,5,0,5
Tianyi,M,100,0,5,5
Tiaona,F,100,5,0,5
Tiarre,F,100,5,0,5
Tiawanda,F,100,5,0,5
Tiaya,F,100,5,0,5
Tiayanna,F,100,5,0,5
Tibby,M,100,0,5,5
Ticarra,F,100,5,0,5
Ticha,F,100,5,0,5
Tiege,M,100,0,5,5
Tier,F,100,5,0,5
Tieranee,F,100,5,0,5
Tierani,F,100,5,0,5
Tiere,F,100,5,0,5
Tiereney,F,100,5,0,5
Tiericka,F,100,5,0,5
Tierna,F,100,5,0,5
Tiesa,F,100,5,0,5
Tiessa,F,100,5,0,5
Tiffaine,F,100,5,0,5
Tiffannee,F,100,5,0,5
Tiffnie,F,100,5,0,5
Tifni,F,100,5,0,5
Tigre,F,100,5,0,5
Tihara,F,100,5,0,5
Tiheim,M,100,0,5,5
Tihisha,F,100,5,0,5
Tiiu,F,100,5,0,5
Tikela,F,100,5,0,5
Tikera,F,100,5,0,5
Tikeria,F,100,5,0,5
Tikiyah,F,100,5,0,5
Tikyra,F,100,5,0,5
Tilena,F,100,5,0,5
Tilon,M,100,0,5,5
Tilwanda,F,100,5,0,5
Timaj,M,100,0,5,5
Timar,M,100,0,5,5
Timarah,F,100,5,0,5
Timarcus,M,100,0,5,5
Timeah,F,100,5,0,5
Timetrius,M,100,0,5,5
Timmiah,F,100,5,0,5
Timmithy,M,100,0,5,5
Timmyah,F,100,5,0,5
Timone,M,100,0,5,5
Timote,M,100,0,5,5
Timothyjohn,M,100,0,5,5
Tinasia,F,100,5,0,5
Tindra,F,100,5,0,5
Tinette,F,100,5,0,5
Tinnelle,F,100,5,0,5
Tinslie,F,100,5,0,5
Tinzleigh,F,100,5,0,5
Tioluwani,M,100,0,5,5
Tiomthy,M,100,0,5,5
Tionah,F,100,5,0,5
Tionee,F,100,5,0,5
Tiphaine,F,100,5,0,5
Tiphanee,F,100,5,0,5
Tiquila,F,100,5,0,5
Tiquisha,F,100,5,0,5
Tirelle,M,100,0,5,5
Tirese,M,100,0,5,5
Tiria,F,100,5,0,5
Tirik,M,100,0,5,5
Tirina,F,100,5,0,5
Tirrany,F,100,5,0,5
Tishae,F,100,5,0,5
Tishay,F,100,5,0,5
Tishayla,F,100,5,0,5
Tisheka,F,100,5,0,5
Tishena,F,100,5,0,5
Tishera,F,100,5,0,5
Tishonna,F,100,5,0,5
Tishya,F,100,5,0,5
Titiyana,F,100,5,0,5
Tiuana,F,100,5,0,5
Tivoli,F,100,5,0,5
Tiyanni,F,100,5,0,5
Tkara,F,100,5,0,5
Tkayah,F,100,5,0,5
Tleah,F,100,5,0,5
Tmaya,F,100,5,0,5
Tmyra,F,100,5,0,5
Tobye,F,100,5,0,5
Tocha,F,100,5,0,5
Tokala,M,100,0,5,5
Tokie,F,100,5,0,5
Tokina,F,100,5,0,5
Tokyo,M,100,0,5,5
Tol,M,100,0,5,5
Toler,M,100,0,5,5
Tolliver,M,100,0,5,5
Toluwalope,F,100,5,0,5
Tomacina,F,100,5,0,5
Tomacita,F,100,5,0,5
Tomako,F,100,5,0,5
Tomari,M,100,0,5,5
Tomario,M,100,0,5,5
Tomaya,F,100,5,0,5
Tome,M,100,0,5,5
Tomea,F,100,5,0,5
Tomesia,F,100,5,0,5
Tomiah,F,100,5,0,5
Tomicko,F,100,5,0,5
Tomiwa,M,100,0,5,5
Tomkia,F,100,5,0,5
Tomme,M,100,0,5,5
Tommesha,F,100,5,0,5
Tommisha,F,100,5,0,5
Tommya,F,100,5,0,5
Tomora,F,100,5,0,5
Tomyka,F,100,5,0,5
Toneesha,F,100,5,0,5
Tonice,F,100,5,0,5
Tonija,F,100,5,0,5
Tonisa,F,100,5,0,5
Tonise,F,100,5,0,5
Tonisia,F,100,5,0,5
Tonka,M,100,0,5,5
Tonza,F,100,5,0,5
Tootie,F,100,5,0,5
Tootsie,F,100,5,0,5
Topazio,F,100,5,0,5
Topper,M,100,0,5,5
Toranio,M,100,0,5,5
Toray,M,100,0,5,5
Torei,F,100,5,0,5
Torianno,M,100,0,5,5
Torika,F,100,5,0,5
Torique,M,100,0,5,5
Torita,F,100,5,0,5
Toriyah,F,100,5,0,5
Torlan,M,100,0,5,5
Torland,M,100,0,5,5
Tornell,M,100,0,5,5
Tornisha,F,100,5,0,5
Torraine,M,100,0,5,5
Torriyah,F,100,5,0,5
Toru,M,100,0,5,5
Torye,F,100,5,0,5
Torynn,F,100,5,0,5
Toschia,F,100,5,0,5
Toshana,F,100,5,0,5
Toshiki,M,100,0,5,5
Toshya,F,100,5,0,5
Totiyana,F,100,5,0,5
Tovan,M,100,0,5,5
Tovaris,M,100,0,5,5
Tovias,M,100,0,5,5
Tovin,M,100,0,5,5
Towa,M,100,0,5,5
Toxi,F,100,5,0,5
Toxie,M,100,0,5,5
Toyana,F,100,5,0,5
Toyea,F,100,5,0,5
Tracei,F,100,5,0,5
Tracianne,F,100,5,0,5
Tracilyn,F,100,5,0,5
Traeshaun,M,100,0,5,5
Traetyn,M,100,0,5,5
Traeven,M,100,0,5,5
Traig,M,100,0,5,5
Trail,M,100,0,5,5
Traison,M,100,0,5,5
Traiveon,M,100,0,5,5
Trajuan,M,100,0,5,5
Trakia,F,100,5,0,5
Tralaina,F,100,5,0,5
Tralaya,F,100,5,0,5
Tramal,M,100,0,5,5
Tramarcus,M,100,0,5,5
Tramari,M,100,0,5,5
Tramisha,F,100,5,0,5
Tranasia,F,100,5,0,5
Tranay,F,100,5,0,5
Tranda,F,100,5,0,5
Tranea,F,100,5,0,5
Traneka,F,100,5,0,5
Tranyah,F,100,5,0,5
Trapp,M,100,0,5,5
Traquez,M,100,0,5,5
Trasen,M,100,0,5,5
Trashell,F,100,5,0,5
Trashonda,F,100,5,0,5
Trasia,F,100,5,0,5
Trava,F,100,5,0,5
Travaun,M,100,0,5,5
Travel,M,100,0,5,5
Travianna,F,100,5,0,5
Travionne,M,100,0,5,5
Travontay,M,100,0,5,5
Trayc,M,100,0,5,5
Traylan,M,100,0,5,5
Trayse,M,100,0,5,5
Treava,F,100,5,0,5
Treaven,M,100,0,5,5
Treavion,M,100,0,5,5
Treda,F,100,5,0,5
Tredan,M,100,0,5,5
Tredon,M,100,0,5,5
Treisha,F,100,5,0,5
Trekwan,M,100,0,5,5
Trelisa,F,100,5,0,5
Tremal,M,100,0,5,5
Tremesha,F,100,5,0,5
Tremica,F,100,5,0,5
Trenadi,F,100,5,0,5
Trenasia,F,100,5,0,5
Trenaty,F,100,5,0,5
Trendan,M,100,0,5,5
Trendarius,M,100,0,5,5
Treneisha,F,100,5,0,5
Trennan,M,100,0,5,5
Trentavious,M,100,0,5,5
Tresca,F,100,5,0,5
Treshell,F,100,5,0,5
Tresta,F,100,5,0,5
Tresvon,M,100,0,5,5
Trevares,M,100,0,5,5
Treve,M,100,0,5,5
Treves,M,100,0,5,5
Trevhon,M,100,0,5,5
Trevier,M,100,0,5,5
Trevira,F,100,5,0,5
Trevona,F,100,5,0,5
Trevore,M,100,0,5,5
Trevorjames,M,100,0,5,5
Trevun,M,100,0,5,5
Trevvor,M,100,0,5,5
Treymaine,M,100,0,5,5
Treymane,M,100,0,5,5
Treyston,M,100,0,5,5
Triandos,M,100,0,5,5
Tribecca,F,100,5,0,5
Trifon,M,100,0,5,5
Trill,M,100,0,5,5
Trimayne,M,100,0,5,5
Trinadi,F,100,5,0,5
Trinay,M,100,0,5,5
Trinea,F,100,5,0,5
Trinere,F,100,5,0,5
Trinidie,F,100,5,0,5
Trintyn,M,100,0,5,5
Trion,M,100,0,5,5
Trisca,F,100,5,0,5
Trishalana,F,100,5,0,5
Trishamae,F,100,5,0,5
Trishan,M,100,0,5,5
Trishawna,F,100,5,0,5
Trishona,F,100,5,0,5
Trisity,F,100,5,0,5
Triska,F,100,5,0,5
Triss,F,100,5,0,5
Tristam,M,100,0,5,5
Tristanjames,M,100,0,5,5
Tristann,F,100,5,0,5
Tristano,M,100,0,5,5
Triste,F,100,5,0,5
Tristianna,F,100,5,0,5
Trivian,F,100,5,0,5
Troas,F,100,5,0,5
Truby,F,100,5,0,5
Truddie,F,100,5,0,5
Trueman,M,100,0,5,5
Trumell,M,100,0,5,5
Trunell,M,100,0,5,5
Trusha,F,100,5,0,5
Tryell,M,100,0,5,5
Trynati,F,100,5,0,5
Trystal,F,100,5,0,5
Trystn,M,100,0,5,5
Tshai,F,100,5,0,5
Tshaye,F,100,5,0,5
Tsianina,F,100,5,0,5
Tsianna,F,100,5,0,5
Tsunade,F,100,5,0,5
Tsvia,F,100,5,0,5
Tucson,M,100,0,5,5
Tudy,F,100,5,0,5
Tuesdai,F,100,5,0,5
Tugg,M,100,0,5,5
Tujuan,M,100,0,5,5
Tukesha,F,100,5,0,5
Tulisa,F,100,5,0,5
Tumekia,F,100,5,0,5
Tunyia,F,100,5,0,5
Turea,F,100,5,0,5
Turin,M,100,0,5,5
Turley,M,100,0,5,5
Turney,M,100,0,5,5
Turron,M,100,0,5,5
Tuscan,M,100,0,5,5
Tushara,F,100,5,0,5
Tushima,F,100,5,0,5
Tuson,M,100,0,5,5
Tuvya,M,100,0,5,5
Tuyetnhung,F,100,5,0,5
Twaniqua,F,100,5,0,5
Twig,M,100,0,5,5
Twilah,F,100,5,0,5
Twon,M,100,0,5,5
Twonda,F,100,5,0,5
Tyairah,F,100,5,0,5
Tyanni,F,100,5,0,5
Tyannia,F,100,5,0,5
Tyaria,F,100,5,0,5
Tyber,M,100,0,5,5
Tybriana,F,100,5,0,5
Tyche,F,100,5,0,5
Tydaisha,F,100,5,0,5
Tydarian,M,100,0,5,5
Tydashia,F,100,5,0,5
Tyecia,F,100,5,0,5
Tyeishia,F,100,5,0,5
Tyell,M,100,0,5,5
Tyere,M,100,0,5,5
Tyesa,F,100,5,0,5
Tygan,M,100,0,5,5
Tygh,M,100,0,5,5
Tyhecia,F,100,5,0,5
Tyheisha,F,100,5,0,5
Tyheshia,F,100,5,0,5
Tyice,F,100,5,0,5
Tyieshia,F,100,5,0,5
Tyira,F,100,5,0,5
Tyjanea,F,100,5,0,5
Tyjhon,M,100,0,5,5
Tyji,M,100,0,5,5
Tyjier,M,100,0,5,5
Tyjir,M,100,0,5,5
Tyka,F,100,5,0,5
Tykaria,F,100,5,0,5
Tykayla,F,100,5,0,5
Tykea,F,100,5,0,5
Tykeith,M,100,0,5,5
Tyker,M,100,0,5,5
Tykeriah,F,100,5,0,5
Tykiana,F,100,5,0,5
Tykierra,F,100,5,0,5
Tykiesha,F,100,5,0,5
Tykirah,F,100,5,0,5
Tylane,M,100,0,5,5
Tylayshia,F,100,5,0,5
Tylerjohn,M,100,0,5,5
Tylerlee,M,100,0,5,5
Tyletha,F,100,5,0,5
Tylier,M,100,0,5,5
Tyliq,M,100,0,5,5
Tylis,M,100,0,5,5
Tylone,M,100,0,5,5
Tylur,M,100,0,5,5
Tymarian,M,100,0,5,5
Tymarius,M,100,0,5,5
Tymberlyn,F,100,5,0,5
Tymerius,M,100,0,5,5
Tymetrius,M,100,0,5,5
Tymiesha,F,100,5,0,5
Tymond,M,100,0,5,5
Tymonte,M,100,0,5,5
Tynayah,F,100,5,0,5
Tyndale,M,100,0,5,5
Tyndall,F,100,5,0,5
Tyneal,F,100,5,0,5
Tyneeka,F,100,5,0,5
Tyneice,F,100,5,0,5
Tyneil,M,100,0,5,5
Tynica,F,100,5,0,5
Tynieka,F,100,5,0,5
Tynija,F,100,5,0,5
Tynzlee,F,100,5,0,5
Tyonnah,F,100,5,0,5
Tyquanna,F,100,5,0,5
Tyquarious,M,100,0,5,5
Tyquin,M,100,0,5,5
Tyquis,M,100,0,5,5
Tyquita,F,100,5,0,5
Tyrale,M,100,0,5,5
Tyranae,F,100,5,0,5
Tyranika,F,100,5,0,5
Tyranique,F,100,5,0,5
Tyraya,F,100,5,0,5
Tyreco,M,100,0,5,5
Tyreec,M,100,0,5,5
Tyreeck,M,100,0,5,5
Tyreef,M,100,0,5,5
Tyreike,M,100,0,5,5
Tyrekus,M,100,0,5,5
Tyrhiana,F,100,5,0,5
Tyrine,F,100,5,0,5
Tyriona,F,100,5,0,5
Tyronesha,F,100,5,0,5
Tyronzia,F,100,5,0,5
Tyruss,M,100,0,5,5
Tysaiah,M,100,0,5,5
Tyshawnna,F,100,5,0,5
Tyshe,F,100,5,0,5
Tysheana,F,100,5,0,5
Tysheed,M,100,0,5,5
Tysheera,F,100,5,0,5
Tysheia,F,100,5,0,5
Tyshekia,F,100,5,0,5
Tysheonna,F,100,5,0,5
Tyshiem,M,100,0,5,5
Tyski,M,100,0,5,5
Tytanna,F,100,5,0,5
Tyuana,F,100,5,0,5
Tyvaeh,F,100,5,0,5
Tyvaughn,M,100,0,5,5
Tyvez,M,100,0,5,5
Tyvonna,F,100,5,0,5
Tywand,M,100,0,5,5
Tywane,M,100,0,5,5
Tywania,F,100,5,0,5
Tywin,M,100,0,5,5
Tywonda,F,100,5,0,5
Tyzae,M,100,0,5,5
Tyzaiah,M,100,0,5,5
Tyzer,M,100,0,5,5
Tyzion,M,100,0,5,5
Tyzir,M,100,0,5,5
Tyzon,M,100,0,5,5
Ualani,F,100,5,0,5
Uche,M,100,0,5,5
Uciel,M,100,0,5,5
Udbhav,M,100,0,5,5
Udit,M,100,0,5,5
Udona,F,100,5,0,5
Udonis,M,100,0,5,5
Udonna,F,100,5,0,5
Ugne,F,100,5,0,5
Uilliam,M,100,0,5,5
Ujala,F,100,5,0,5
Ujjwal,M,100,0,5,5
Ules,M,100,0,5,5
Uli,F,100,5,0,5
Ulise,M,100,0,5,5
Ulysse,M,100,0,5,5
Ulyssee,M,100,0,5,5
Ulyssia,F,100,5,0,5
Ulyssis,M,100,0,5,5
Umama,F,100,5,0,5
Umang,M,100,0,5,5
Umari,M,100,0,5,5
Umaya,F,100,5,0,5
Umayma,F,100,5,0,5
Umber,F,100,5,0,5
Ume,F,100,5,0,5
Umesh,M,100,0,5,5
Umit,M,100,0,5,5
Umoja,M,100,0,5,5
Undrae,M,100,0,5,5
Undria,F,100,5,0,5
Uniah,F,100,5,0,5
Uniquewa,F,100,5,0,5
Uniya,F,100,5,0,5
Unseld,M,100,0,5,5
Urana,F,100,5,0,5
Uranus,F,100,5,0,5
Urena,F,100,5,0,5
Urenna,F,100,5,0,5
Urhonda,F,100,5,0,5
Uria,M,100,0,5,5
Urika,F,100,5,0,5
Urina,F,100,5,0,5
Urmila,F,100,5,0,5
Ursel,F,100,5,0,5
Urszula,F,100,5,0,5
Usef,M,100,0,5,5
Usra,F,100,5,0,5
Uswa,F,100,5,0,5
Utahna,F,100,5,0,5
Utica,F,100,5,0,5
Uver,M,100,0,5,5
Uvonka,F,100,5,0,5
Uyiosa,M,100,0,5,5
Uyless,M,100,0,5,5
Uzay,M,100,0,5,5
Vachan,M,100,0,5,5
Vache,M,100,0,5,5
Vadal,M,100,0,5,5
Vadell,M,100,0,5,5
Vader,M,100,0,5,5
Vagas,M,100,0,5,5
Vahram,M,100,0,5,5
Vai,M,100,0,5,5
Vaila,F,100,5,0,5
Vaimoana,F,100,5,0,5
Vaishvi,F,100,5,0,5
Vaitea,F,100,5,0,5
Vaitiare,F,100,5,0,5
Vakesha,F,100,5,0,5
Valaida,F,100,5,0,5
Valasia,F,100,5,0,5
Valaysia,F,100,5,0,5
Valdene,F,100,5,0,5
Valdimir,M,100,0,5,5
Valdir,M,100,0,5,5
Valencio,M,100,0,5,5
Valentinna,F,100,5,0,5
Valeriana,F,100,5,0,5
Valerieanne,F,100,5,0,5
Valerine,F,100,5,0,5
Valetina,F,100,5,0,5
Valice,M,100,0,5,5
Valier,F,100,5,0,5
Valirie,F,100,5,0,5
Vallyn,F,100,5,0,5
Valyre,F,100,5,0,5
Valyssa,F,100,5,0,5
Vamika,F,100,5,0,5
Vanasia,F,100,5,0,5
Vanderbilt,M,100,0,5,5
Vandra,F,100,5,0,5
Vandrea,F,100,5,0,5
Vanelly,F,100,5,0,5
Vanessaanne,F,100,5,0,5
Vanie,F,100,5,0,5
Vaniecia,F,100,5,0,5
Vanitie,F,100,5,0,5
Vanja,F,100,5,0,5
Vanshon,M,100,0,5,5
Vanyah,F,100,5,0,5
Varda,F,100,5,0,5
Varna,F,100,5,0,5
Varner,M,100,0,5,5
Varshika,F,100,5,0,5
Vasanti,F,100,5,0,5
Vasha,F,100,5,0,5
Vashni,F,100,5,0,5
Vasia,F,100,5,0,5
Vasilije,M,100,0,5,5
Vasken,M,100,0,5,5
Vauna,F,100,5,0,5
Vawn,F,100,5,0,5
Vayah,F,100,5,0,5
Vayron,M,100,0,5,5
Veanne,F,100,5,0,5
Vedette,F,100,5,0,5
Vedhika,F,100,5,0,5
Velan,M,100,0,5,5
Velanie,F,100,5,0,5
Velarie,F,100,5,0,5
Velika,F,100,5,0,5
Velvett,F,100,5,0,5
Venard,M,100,0,5,5
Venie,F,100,5,0,5
Venitra,F,100,5,0,5
Vennis,M,100,0,5,5
Ventrell,M,100,0,5,5
Veona,F,100,5,0,5
Verdel,M,100,0,5,5
Verdena,F,100,5,0,5
Verdi,F,100,5,0,5
Verdonna,F,100,5,0,5
Vere,M,100,0,5,5
Vereen,F,100,5,0,5
Verene,F,100,5,0,5
Verinica,F,100,5,0,5
Verlanda,F,100,5,0,5
Vermonica,F,100,5,0,5
Vernada,F,100,5,0,5
Vernall,M,100,0,5,5
Vernando,M,100,0,5,5
Vernasia,F,100,5,0,5
Vernay,F,100,5,0,5
Verneeda,F,100,5,0,5
Verneisha,F,100,5,0,5
Verneita,F,100,5,0,5
Vernelda,F,100,5,0,5
Vernetia,F,100,5,0,5
Vernisa,F,100,5,0,5
Veronicka,F,100,5,0,5
Vershonda,F,100,5,0,5
Vestina,F,100,5,0,5
Veyah,F,100,5,0,5
Vianay,F,100,5,0,5
Vibol,M,100,0,5,5
Vice,M,100,0,5,5
Vichelle,F,100,5,0,5
Vickilee,F,100,5,0,5
Victorene,F,100,5,0,5
Vidhu,M,100,0,5,5
Vience,M,100,0,5,5
Vierra,F,100,5,0,5
Viesha,F,100,5,0,5
Vigo,M,100,0,5,5
Vihaas,M,100,0,5,5
Vija,F,100,5,0,5
Vijaya,F,100,5,0,5
Vikesh,M,100,0,5,5
Vikhyath,M,100,0,5,5
Vikky,F,100,5,0,5
Vikramjit,M,100,0,5,5
Vilate,F,100,5,0,5
Vilda,F,100,5,0,5
Vili,M,100,0,5,5
Viliamu,M,100,0,5,5
Vilija,F,100,5,0,5
Vimala,F,100,5,0,5
Vincenta,F,100,5,0,5
Vincentia,F,100,5,0,5
Vincenzio,M,100,0,5,5
Vindetta,F,100,5,0,5
Vineel,M,100,0,5,5
Vineisha,F,100,5,0,5
Vinie,F,100,5,0,5
Vinn,M,100,0,5,5
Vinna,F,100,5,0,5
Vinni,F,100,5,0,5
Violetrose,F,100,5,0,5
Vionette,F,100,5,0,5
Virdell,F,100,5,0,5
Virgini,F,100,5,0,5
Virlee,F,100,5,0,5
Virlinda,F,100,5,0,5
Virlyn,M,100,0,5,5
Vironica,F,100,5,0,5
Virsaviya,F,100,5,0,5
Vishwesh,M,100,0,5,5
Vismaya,F,100,5,0,5
Vitani,F,100,5,0,5
Viv,F,100,5,0,5
Vivienna,F,100,5,0,5
Viviette,F,100,5,0,5
Vladik,M,100,0,5,5
Vladislava,F,100,5,0,5
Voctoria,F,100,5,0,5
Vohn,M,100,0,5,5
Vol,M,100,0,5,5
Volare,F,100,5,0,5
Volf,M,100,0,5,5
Vondia,F,100,5,0,5
Vondrell,M,100,0,5,5
Vonessa,F,100,5,0,5
Vonica,F,100,5,0,5
Vonice,F,100,5,0,5
Vonisha,F,100,5,0,5
Vonnette,F,100,5,0,5
Vonnita,F,100,5,0,5
Vonshae,F,100,5,0,5
Vontarius,M,100,0,5,5
Vontray,M,100,0,5,5
Vontrel,M,100,0,5,5
Vonzel,M,100,0,5,5
Vrisa,F,100,5,0,5
Vsevolod,M,100,0,5,5
Vukasin,M,100,0,5,5
Vyctorya,F,100,5,0,5
Vyvyan,F,100,5,0,5
Waconda,F,100,5,0,5
Wadee,M,100,0,5,5
Wadia,F,100,5,0,5
Wadley,M,100,0,5,5
Wahaj,M,100,0,5,5
Waid,M,100,0,5,5
Waide,M,100,0,5,5
Wailyn,M,100,0,5,5
Wain,M,100,0,5,5
Waite,M,100,0,5,5
Wajd,F,100,5,0,5
Wakeel,M,100,0,5,5
Wakeen,M,100,0,5,5
Wakefield,M,100,0,5,5
Wakenda,F,100,5,0,5
Waker,M,100,0,5,5
Waled,M,100,0,5,5
Walee,M,100,0,5,5
Wales,M,100,0,5,5
Walia,F,100,5,0,5
Waliyah,F,100,5,0,5
Walkidia,F,100,5,0,5
Walsh,M,100,0,5,5
Wandalid,F,100,5,0,5
Wanderlei,M,100,0,5,5
Wanjiku,F,100,5,0,5
Waqar,M,100,0,5,5
Wardean,F,100,5,0,5
Wareef,F,100,5,0,5
Warfield,M,100,0,5,5
Waring,M,100,0,5,5
Warran,M,100,0,5,5
Wasay,M,100,0,5,5
Wasi,M,100,0,5,5
Wathena,F,100,5,0,5
Wauneta,F,100,5,0,5
Wayburn,M,100,0,5,5
Waynard,M,100,0,5,5
Weda,F,100,5,0,5
Wedad,F,100,5,0,5
Weida,F,100,5,0,5
Welker,M,100,0,5,5
Welmer,M,100,0,5,5
Weltha,F,100,5,0,5
Wendlyn,F,100,5,0,5
Wendolyne,F,100,5,0,5
Wendylee,F,100,5,0,5
Wengel,F,100,5,0,5
Wenndy,F,100,5,0,5
Wenson,M,100,0,5,5
Wesli,F,100,5,0,5
Weslin,M,100,0,5,5
Westleigh,M,100,0,5,5
Wetona,F,100,5,0,5
Weylon,M,100,0,5,5
Whelan,M,100,0,5,5
Whitli,F,100,5,0,5
Whitlie,F,100,5,0,5
Whitne,F,100,5,0,5
Whitnye,F,100,5,0,5
Whittnie,F,100,5,0,5
Whtiney,F,100,5,0,5
Whysper,F,100,5,0,5
Wialliam,M,100,0,5,5
Wiam,F,100,5,0,5
Wildan,M,100,0,5,5
Wilem,M,100,0,5,5
Wilena,F,100,5,0,5
Wilesha,F,100,5,0,5
Wilisha,F,100,5,0,5
Willasia,F,100,5,0,5
Willfredo,M,100,0,5,5
Williamhenry,M,100,0,5,5
Williamjames,M,100,0,5,5
Williamjohn,M,100,0,5,5
Willies,M,100,0,5,5
Williman,M,100,0,5,5
Willison,M,100,0,5,5
Wilnette,F,100,5,0,5
Wilniya,F,100,5,0,5
Wimberley,F,100,5,0,5
Windale,M,100,0,5,5
Winetta,F,100,5,0,5
Winfried,M,100,0,5,5
Wini,F,100,5,0,5
Winrey,F,100,5,0,5
Winsor,M,100,0,5,5
Wisler,M,100,0,5,5
Wisper,F,100,5,0,5
Wiyaka,F,100,5,0,5
Wizdom,M,100,0,5,5
Wnedy,F,100,5,0,5
Woojin,M,100,0,5,5
Wrenda,F,100,5,0,5
Wrynn,F,100,5,0,5
Wuendi,F,100,5,0,5
Wuilber,M,100,0,5,5
Wuilian,M,100,0,5,5
Wyhatt,M,100,0,5,5
Wykeem,M,100,0,5,5
Wykena,F,100,5,0,5
Wykeria,F,100,5,0,5
Wylde,M,100,0,5,5
Wyle,M,100,0,5,5
Wylean,F,100,5,0,5
Wyleigh,F,100,5,0,5
Wyline,F,100,5,0,5
Wynda,F,100,5,0,5
Wyndee,F,100,5,0,5
Wyndie,F,100,5,0,5
Wynnston,M,100,0,5,5
Wyteria,F,100,5,0,5
Wyvetta,F,100,5,0,5
Wyvonna,F,100,5,0,5
Wyzetta,F,100,5,0,5
Xabriel,M,100,0,5,5
Xachery,M,100,0,5,5
Xaedyn,M,100,0,5,5
Xailey,F,100,5,0,5
Xally,F,100,5,0,5
Xamara,F,100,5,0,5
Xamir,M,100,0,5,5
Xamiyah,F,100,5,0,5
Xande,M,100,0,5,5
Xanden,M,100,0,5,5
Xaniah,F,100,5,0,5
Xannon,M,100,0,5,5
Xareny,F,100,5,0,5
Xarianna,F,100,5,0,5
Xaviea,F,100,5,0,5
Xaviona,F,100,5,0,5
Xaylie,F,100,5,0,5
Xazavier,M,100,0,5,5
Xea,F,100,5,0,5
Xendaya,F,100,5,0,5
Xeniya,F,100,5,0,5
Xeniyah,F,100,5,0,5
Xenophon,M,100,0,5,5
Xenya,F,100,5,0,5
Xiaver,M,100,0,5,5
Xinrui,F,100,5,0,5
Xiomy,F,100,5,0,5
Xitlalit,F,100,5,0,5
Xiyah,F,100,5,0,5
Xizavier,M,100,0,5,5
Xjavier,M,100,0,5,5
Xochithl,F,100,5,0,5
Xsavion,M,100,0,5,5
Xu,M,100,0,5,5
Xylar,M,100,0,5,5
Xylee,F,100,5,0,5
Xyliana,F,100,5,0,5
Xyriah,F,100,5,0,5
Xzaevion,M,100,0,5,5
Xzaivier,M,100,0,5,5
Yaalini,F,100,5,0,5
Yaasmiyn,F,100,5,0,5
Yabriel,M,100,0,5,5
Yachira,F,100,5,0,5
Yackov,M,100,0,5,5
Yacouba,M,100,0,5,5
Yadelis,F,100,5,0,5
Yadhiel,M,100,0,5,5
Yadian,M,100,0,5,5
Yadin,M,100,0,5,5
Yadria,F,100,5,0,5
Yae,F,100,5,0,5
Yaely,F,100,5,0,5
Yahaida,F,100,5,0,5
Yahani,F,100,5,0,5
Yahari,F,100,5,0,5
Yaharia,F,100,5,0,5
Yahna,F,100,5,0,5
Yahne,F,100,5,0,5
Yahoshua,M,100,0,5,5
Yahriel,M,100,0,5,5
Yahzarah,F,100,5,0,5
Yailet,F,100,5,0,5
Yaili,F,100,5,0,5
Yairely,F,100,5,0,5
Yairy,F,100,5,0,5
Yakirah,F,100,5,0,5
Yakyra,F,100,5,0,5
Yalana,F,100,5,0,5
Yamal,M,100,0,5,5
Yamara,F,100,5,0,5
Yamarie,F,100,5,0,5
Yami,F,100,5,0,5
Yamiletz,F,100,5,0,5
Yamisha,F,100,5,0,5
Yamiyah,F,100,5,0,5
Yanabah,F,100,5,0,5
Yanairis,F,100,5,0,5
Yanais,F,100,5,0,5
Yanali,F,100,5,0,5
Yanalis,F,100,5,0,5
Yanaliz,F,100,5,0,5
Yanay,F,100,5,0,5
Yandier,M,100,0,5,5
Yaned,F,100,5,0,5
Yaneisha,F,100,5,0,5
Yanitzi,F,100,5,0,5
Yankee,M,100,0,5,5
Yanko,M,100,0,5,5
Yanneth,F,100,5,0,5
Yansiel,M,100,0,5,5
Yanxiel,M,100,0,5,5
Yaphett,M,100,0,5,5
Yaqeen,F,100,5,0,5
Yarazet,F,100,5,0,5
Yarecsi,F,100,5,0,5
Yarell,M,100,0,5,5
Yaremy,F,100,5,0,5
Yarenys,F,100,5,0,5
Yaretci,F,100,5,0,5
Yaretcy,F,100,5,0,5
Yarett,F,100,5,0,5
Yarira,F,100,5,0,5
Yarisamar,F,100,5,0,5
Yarisleidy,F,100,5,0,5
Yarisley,F,100,5,0,5
Yarisma,F,100,5,0,5
Yarismar,F,100,5,0,5
Yaritssa,F,100,5,0,5
Yaritzza,F,100,5,0,5
Yarizel,F,100,5,0,5
Yarleth,F,100,5,0,5
Yarlyn,F,100,5,0,5
Yarnelle,F,100,5,0,5
Yaschia,F,100,5,0,5
Yashdeep,M,100,0,5,5
Yashir,M,100,0,5,5
Yashmit,M,100,0,5,5
Yashveer,M,100,0,5,5
Yashwant,M,100,0,5,5
Yasiah,F,100,5,0,5
Yasiris,F,100,5,0,5
Yaslen,F,100,5,0,5
Yasley,F,100,5,0,5
Yasmein,F,100,5,0,5
Yasmiin,F,100,5,0,5
Yasmir,F,100,5,0,5
Yasniel,M,100,0,5,5
Yasuko,F,100,5,0,5
Yatharth,M,100,0,5,5
Yatziel,M,100,0,5,5
Yavanna,F,100,5,0,5
Yawanda,F,100,5,0,5
Yaxye,M,100,0,5,5
Yayoi,F,100,5,0,5
Yayra,F,100,5,0,5
Yazayra,F,100,5,0,5
Yazil,F,100,5,0,5
Yazlee,F,100,5,0,5
Yazlen,F,100,5,0,5
Yazmene,F,100,5,0,5
Yazziel,M,100,0,5,5
Yeabsera,F,100,5,0,5
Yedda,F,100,5,0,5
Yedida,F,100,5,0,5
Yehezkel,M,100,0,5,5
Yeicelyn,F,100,5,0,5
Yeidan,M,100,0,5,5
Yeidy,F,100,5,0,5
Yeisy,F,100,5,0,5
Yejide,F,100,5,0,5
Yelaina,F,100,5,0,5
Yelisey,M,100,0,5,5
Yeliz,F,100,5,0,5
Yelizaveta,F,100,5,0,5
Yema,F,100,5,0,5
Yenci,F,100,5,0,5
Yennie,F,100,5,0,5
Yensid,F,100,5,0,5
Yerenia,F,100,5,0,5
Yerica,F,100,5,0,5
Yerimar,F,100,5,0,5
Yerucham,M,100,0,5,5
Yesel,F,100,5,0,5
Yesley,F,100,5,0,5
Yesmi,F,100,5,0,5
Yesmine,F,100,5,0,5
Yessenya,F,100,5,0,5
Yestin,M,100,0,5,5
Yetzaly,F,100,5,0,5
Yevetta,F,100,5,0,5
Yewon,F,100,5,0,5
Yexiel,M,100,0,5,5
Yiana,F,100,5,0,5
Yiorgos,M,100,0,5,5
Yiqing,F,100,5,0,5
Yiru,F,100,5,0,5
Yisenia,F,100,5,0,5
Yisleine,F,100,5,0,5
Yitel,F,100,5,0,5
Yitsel,F,100,5,0,5
Yizelle,F,100,5,0,5
Yizza,F,100,5,0,5
Ylani,F,100,5,0,5
Yler,M,100,0,5,5
Yll,M,100,0,5,5
Yngwie,M,100,0,5,5
Yoany,F,100,5,0,5
Yohsuke,M,100,0,5,5
Yolana,F,100,5,0,5
Yolanta,F,100,5,0,5
Yolenda,F,100,5,0,5
Yolisma,F,100,5,0,5
Yolonde,F,100,5,0,5
Yomo,M,100,0,5,5
Yonika,F,100,5,0,5
Yoonseo,F,100,5,0,5
Yorvin,M,100,0,5,5
Yosaira,F,100,5,0,5
Yoselina,F,100,5,0,5
Yosemite,F,100,5,0,5
Yosgard,M,100,0,5,5
Yosheka,F,100,5,0,5
Yosilin,F,100,5,0,5
Yosmairy,F,100,5,0,5
Yosman,M,100,0,5,5
Yosvany,M,100,0,5,5
Youki,M,100,0,5,5
Youlander,F,100,5,0,5
Yousuke,M,100,0,5,5
Yovela,F,100,5,0,5
Yrania,F,100,5,0,5
Yridiana,F,100,5,0,5
Yubin,F,100,5,0,5
Yuen,F,100,5,0,5
Yuepeng,M,100,0,5,5
Yuga,M,100,0,5,5
Yuhanna,M,100,0,5,5
Yuina,F,100,5,0,5
Yuito,M,100,0,5,5
Yukary,F,100,5,0,5
Yukie,F,100,5,0,5
Yukon,M,100,0,5,5
Yukti,F,100,5,0,5
Yule,M,100,0,5,5
Yuleiky,F,100,5,0,5
Yulemi,F,100,5,0,5
Yuliette,F,100,5,0,5
Yulitzy,F,100,5,0,5
Yulliana,F,100,5,0,5
Yumaira,F,100,5,0,5
Yumara,F,100,5,0,5
Yumin,M,100,0,5,5
Yumira,F,100,5,0,5
Yuneicy,F,100,5,0,5
Yuni,F,100,5,0,5
Yunier,M,100,0,5,5
Yunnuen,F,100,5,0,5
Yunxi,F,100,5,0,5
Yurani,F,100,5,0,5
Yureimy,F,100,5,0,5
Yuritzia,F,100,5,0,5
Yusayrah,F,100,5,0,5
Yushica,F,100,5,0,5
Yushin,M,100,0,5,5
Yusmeri,F,100,5,0,5
Yutaka,M,100,0,5,5
Yuting,F,100,5,0,5
Yuuna,F,100,5,0,5
Yuv,M,100,0,5,5
Yuven,M,100,0,5,5
Yuvonda,F,100,5,0,5
Yuyang,M,100,0,5,5
Yvain,M,100,0,5,5
Yvalondra,F,100,5,0,5
Yvannah,F,100,5,0,5
Yvannia,F,100,5,0,5
Yvelle,F,100,5,0,5
Za,M,100,0,5,5
Zaafir,M,100,0,5,5
Zaakiyah,F,100,5,0,5
Zabelle,F,100,5,0,5
Zace,M,100,0,5,5
Zachariyah,M,100,0,5,5
Zacharya,M,100,0,5,5
Zachiary,M,100,0,5,5
Zackarias,M,100,0,5,5
Zackorie,M,100,0,5,5
Zadrien,M,100,0,5,5
Zaelia,F,100,5,0,5
Zaely,F,100,5,0,5
Zaeya,F,100,5,0,5
Zahcary,M,100,0,5,5
Zahida,F,100,5,0,5
Zahidah,F,100,5,0,5
Zahkee,M,100,0,5,5
Zahkeem,M,100,0,5,5
Zahmaria,F,100,5,0,5
Zahmiya,F,100,5,0,5
Zahran,M,100,0,5,5
Zahri,F,100,5,0,5
Zahro,F,100,5,0,5
Zahyrah,F,100,5,0,5
Zaiana,F,100,5,0,5
Zailie,F,100,5,0,5
Zaimah,F,100,5,0,5
Zaimar,M,100,0,5,5
Zainb,F,100,5,0,5
Zaivian,M,100,0,5,5
Zaiyan,M,100,0,5,5
Zaiyanna,F,100,5,0,5
Zakarey,M,100,0,5,5
Zakarri,M,100,0,5,5
Zakaryah,M,100,0,5,5
Zakayden,M,100,0,5,5
Zake,M,100,0,5,5
Zakeyah,F,100,5,0,5
Zakeyia,F,100,5,0,5
Zakhiya,F,100,5,0,5
Zakiel,M,100,0,5,5
Zakri,M,100,0,5,5
Zakwon,M,100,0,5,5
Zaky,M,100,0,5,5
Zalet,F,100,5,0,5
Zamair,M,100,0,5,5
Zamaira,F,100,5,0,5
Zamaiya,F,100,5,0,5
Zamaiyah,F,100,5,0,5
Zamareon,M,100,0,5,5
Zamarious,M,100,0,5,5
Zamayra,F,100,5,0,5
Zamiel,M,100,0,5,5
Zamiere,M,100,0,5,5
Zamion,M,100,0,5,5
Zanaa,F,100,5,0,5
Zanaii,F,100,5,0,5
Zanayla,F,100,5,0,5
Zandar,M,100,0,5,5
Zandel,M,100,0,5,5
Zandur,M,100,0,5,5
Zaneria,F,100,5,0,5
Zaney,F,100,5,0,5
Zanieya,F,100,5,0,5
Zaniiya,F,100,5,0,5
Zanniyah,F,100,5,0,5
Zanquisha,F,100,5,0,5
Zanteria,F,100,5,0,5
Zanyra,F,100,5,0,5
Zanyyah,F,100,5,0,5
Zaon,M,100,0,5,5
Zaquavious,M,100,0,5,5
Zaragosa,M,100,0,5,5
Zaraiah,F,100,5,0,5
Zaraiyah,F,100,5,0,5
Zareb,M,100,0,5,5
Zarelia,F,100,5,0,5
Zarely,F,100,5,0,5
Zarhianna,F,100,5,0,5
Zarreah,F,100,5,0,5
Zarrin,F,100,5,0,5
Zaryab,M,100,0,5,5
Zaryha,F,100,5,0,5
Zaryk,M,100,0,5,5
Zatara,F,100,5,0,5
Zavi,M,100,0,5,5
Zaviere,M,100,0,5,5
Zavyn,M,100,0,5,5
Zawdie,M,100,0,5,5
Zayanah,F,100,5,0,5
Zayani,F,100,5,0,5
Zayannah,F,100,5,0,5
Zaybrien,M,100,0,5,5
Zayceon,M,100,0,5,5
Zaydren,M,100,0,5,5
Zayir,M,100,0,5,5
Zayland,M,100,0,5,5
Zayleah,F,100,5,0,5
Zaylene,F,100,5,0,5
Zaymere,M,100,0,5,5
Zaymir,M,100,0,5,5
Zayona,F,100,5,0,5
Zaysean,M,100,0,5,5
Zaysia,F,100,5,0,5
Zazil,F,100,5,0,5
Zealan,M,100,0,5,5
Zealyn,F,100,5,0,5
Zeasia,F,100,5,0,5
Zebariah,M,100,0,5,5
Zebidiah,M,100,0,5,5
Zeborah,F,100,5,0,5
Zebra,F,100,5,0,5
Zebrina,F,100,5,0,5
Zecharyah,M,100,0,5,5
Zedan,M,100,0,5,5
Zeddie,M,100,0,5,5
Zedek,M,100,0,5,5
Zederick,M,100,0,5,5
Zeel,F,100,5,0,5
Zeenah,F,100,5,0,5
Zeidan,M,100,0,5,5
Zeidi,F,100,5,0,5
Zeilah,F,100,5,0,5
Zeily,F,100,5,0,5
Zeilyn,F,100,5,0,5
Zeinah,F,100,5,0,5
Zek,M,100,0,5,5
Zekeriah,M,100,0,5,5
Zel,M,100,0,5,5
Zelenia,F,100,5,0,5
Zellah,F,100,5,0,5
Zelle,F,100,5,0,5
Zemiyah,F,100,5,0,5
Zenaiya,F,100,5,0,5
Zenayah,F,100,5,0,5
Zendiya,F,100,5,0,5
Zendy,F,100,5,0,5
Zenida,F,100,5,0,5
Zenora,F,100,5,0,5
Zentavious,M,100,0,5,5
Zeny,F,100,5,0,5
Zephery,M,100,0,5,5
Zephyn,M,100,0,5,5
Zeplynn,F,100,5,0,5
Zeporia,F,100,5,0,5
Zerlene,F,100,5,0,5
Zerriah,F,100,5,0,5
Zeryk,M,100,0,5,5
Zesar,M,100,0,5,5
Zeshaun,M,100,0,5,5
Zetha,F,100,5,0,5
Zeyana,F,100,5,0,5
Zeylah,F,100,5,0,5
Zeza,F,100,5,0,5
Zhair,M,100,0,5,5
Zhaira,F,100,5,0,5
Zhaki,M,100,0,5,5
Zhalen,M,100,0,5,5
Zhanasia,F,100,5,0,5
Zhanaya,F,100,5,0,5
Zhander,M,100,0,5,5
Zhanea,F,100,5,0,5
Zhanel,F,100,5,0,5
Zhanelle,F,100,5,0,5
Zharya,F,100,5,0,5
Zharyah,F,100,5,0,5
Zhian,M,100,0,5,5
Zhianna,F,100,5,0,5
Zhivago,M,100,0,5,5
Zhyair,M,100,0,5,5
Zhyier,M,100,0,5,5
Zhyir,M,100,0,5,5
Zianah,F,100,5,0,5
Zianny,F,100,5,0,5
Ziarre,F,100,5,0,5
Zichen,M,100,0,5,5
Ziclaly,F,100,5,0,5
Ziden,M,100,0,5,5
Ziena,F,100,5,0,5
Zigmond,M,100,0,5,5
Zihanna,F,100,5,0,5
Ziheir,M,100,0,5,5
Zijun,M,100,0,5,5
Zikayla,F,100,5,0,5
Zikee,M,100,0,5,5
Zikeyah,F,100,5,0,5
Zikiria,F,100,5,0,5
Zikiya,F,100,5,0,5
Zikomo,M,100,0,5,5
Zilas,M,100,0,5,5
Zilynn,F,100,5,0,5
Zimaria,F,100,5,0,5
Zimaya,F,100,5,0,5
Zimbabwe,M,100,0,5,5
Zinedin,M,100,0,5,5
Ziniah,F,100,5,0,5
Zione,M,100,0,5,5
Zionn,M,100,0,5,5
Zionne,F,100,5,0,5
Zirui,M,100,0,5,5
Zishe,M,100,0,5,5
Zixi,F,100,5,0,5
Ziyadah,F,100,5,0,5
Ziyear,M,100,0,5,5
Zkai,M,100,0,5,5
Zkye,M,100,0,5,5
Zniah,F,100,5,0,5
Zody,F,100,5,0,5
Zoeanna,F,100,5,0,5
Zoeanne,F,100,5,0,5
Zoeygrace,F,100,5,0,5
Zohe,F,100,5,0,5
Zoheb,M,100,0,5,5
Zohrab,M,100,0,5,5
Zoja,F,100,5,0,5
Zorayda,F,100,5,0,5
Zoree,F,100,5,0,5
Zorien,M,100,0,5,5
Zorriah,F,100,5,0,5
Zorya,F,100,5,0,5
Zowee,F,100,5,0,5
Zoyah,F,100,5,0,5
Zshakira,F,100,5,0,5
Zsophia,F,100,5,0,5
Zubaidah,F,100,5,0,5
Zuheyla,F,100,5,0,5
Zujeily,F,100,5,0,5
Zuleikha,F,100,5,0,5
Zuleymi,F,100,5,0,5
Zulmarie,F,100,5,0,5
Zuszeth,F,100,5,0,5
Zxavian,M,100,0,5,5
Zyairr,M,100,0,5,5
Zyani,F,100,5,0,5
Zyare,M,100,0,5,5
Zyaun,M,100,0,5,5
Zyda,F,100,5,0,5
Zydia,F,100,5,0,5
Zyeer,M,100,0,5,5
Zyeire,M,100,0,5,5
Zyelle,F,100,5,0,5
Zyira,F,100,5,0,5
Zykei,M,100,0,5,5
Zykeriya,F,100,5,0,5
Zykevious,M,100,0,5,5
Zylas,M,100,0,5,5
Zymaire,M,100,0,5,5
Zynab,F,100,5,0,5
Zyonne,M,100,0,5,5
Zyreion,M,100,0,5,5
Zyrek,M,100,0,5,5
Zyrese,M,100,0,5,5
Zysean,M,100,0,5,5
Zytaevius,M,100,0,5,5
Zytavion,M,100,0,5,5
Zyvion,M,100,0,5,5
Zzyzx,M,100,0,5,5
